39 22
0 0 0 5 0 16 46 0 15 0 47 13 13 0 0 14 0 0 21 0 0 6 8 5 6 13 12 0 0 19 14 0 22 4 28 2 15 18 0 
0 0 14 13 3 0 43 3 18 18 20 10 0 20 12 16 44 16 30 3 1 1 1 16 5 0 12 3 3 27 0 1 28 8 0 0 18 31 15 
23 0 0 0 9 0 0 0 29 0 18 0 9 0 0 9 2 0 21 17 16 0 15 23 0 16 0 26 0 25 0 0 18 0 0 18 0 64 1 
33 3 4 21 32 14 12 5 11 3 0 0 21 0 5 8 8 2 0 13 0 0 4 41 15 1 12 25 0 0 0 0 15 12 11 31 2 3 2 
31 0 8 5 21 46 28 0 20 0 0 17 13 0 3 26 23 0 15 3 33 0 27 7 20 21 4 0 28 0 0 39 22 14 30 24 0 32 23 
38 4 7 0 7 0 7 1 0 23 10 0 2 0 20 0 0 0 0 1 0 2 0 7 0 31 0 0 0 4 0 0 39 1 1 0 22 0 14 
0 0 0 8 0 0 0 3 0 0 22 6 0 14 0 0 26 3 43 1 0 0 6 0 3 0 8 3 6 0 6 0 0 17 0 0 18 10 0 
0 34 0 20 7 0 0 0 23 0 14 27 0 4 0 0 0 11 0 6 17 33 0 6 30 0 0 5 0 0 0 17 11 0 0 7 15 0 0 
0 0 4 0 0 0 26 0 2 1 0 0 0 0 9 6 0 7 3 0 11 6 3 0 8 0 0 11 0 0 0 0 26 0 0 0 0 0 0 
0 4 2 29 18 0 0 43 0 22 0 0 8 1 12 0 0 0 14 16 6 8 1 0 1 24 31 9 12 4 0 14 25 2 0 11 0 8 18 
0 0 2 0 2 0 7 0 2 0 0 4 0 0 3 18 8 6 0 0 0 0 1 5 31 3 0 6 4 0 0 3 2 16 13 0 11 15 0 
0 14 23 5 53 0 0 22 10 28 22 10 2 0 22 30 0 6 12 15 13 19 1 20 0 17 0 8 0 8 0 10 0 18 0 34 25 26 26 
27 0 43 4 17 0 0 9 0 0 0 20 50 0 0 0 14 4 0 0 0 0 18 21 6 14 0 40 0 27 0 19 0 20 11 0 0 2 26 
10 26 2 0 2 0 28 22 0 0 10 13 0 0 11 0 0 2 0 13 0 4 0 1 0 18 12 25 21 0 0 0 0 12 28 0 0 0 19 
0 0 27 0 22 0 17 1 0 0 8 0 0 25 21 11 1 14 4 0 5 0 25 0 5 5 0 0 0 0 0 15 13 4 0 0 0 0 25 
28 13 0 25 3 0 0 0 2 7 31 0 0 0 13 0 2 3 9 5 1 0 11 0 0 10 0 0 53 0 0 0 0 26 0 0 0 0 0 
0 0 36 17 24 0 0 15 0 8 0 0 0 0 24 19 0 6 13 0 0 11 1 0 21 0 0 0 0 0 21 1 9 29 19 0 6 4 6 
0 20 3 0 5 0 0 0 16 44 0 0 0 6 0 0 4 17 0 16 10 24 0 16 0 4 7 0 0 0 10 8 0 7 4 0 0 0 33 
8 11 0 0 3 0 18 13 8 30 7 0 0 0 18 7 8 0 0 0 18 0 23 0 1 16 8 9 0 20 0 2 57 0 14 13 0 0 0 
0 0 0 0 30 0 0 15 0 18 0 11 0 0 3 1 18 26 33 17 10 0 19 11 4 0 1 28 0 14 0 0 17 10 30 18 18 0 17 
0 0 5 0 18 0 6 0 6 0 43 0 6 14 1 0 0 8 14 0 0 9 18 11 0 2 0 2 4 0 0 0 13 0 27 32 0 9 0 
27 18 7 0 53 5 10 7 0 0 37 0 15 0 8 14 0 0 4 20 23 3 9 17 23 0 0 18 0 14 0 11 0 0 12 0 0 33 0 
