39 22
16 3 46 0 26 8 27 16 41 18 29 10 1 0 0 0 23 0 8 20 1 11 4 2 0 10 0 7 11 4 25 10 30 29 30 23 0 31 0 
29 5 13 28 18 3 34 31 0 0 2 14 8 0 7 13 22 0 0 17 0 0 0 0 12 0 0 0 0 42 0 28 0 0 0 29 17 0 47 
0 0 0 8 7 0 31 0 0 48 14 0 25 11 2 5 4 0 0 0 7 0 13 9 25 0 12 0 0 0 0 0 0 0 19 13 11 6 0 
0 32 20 14 0 0 3 4 3 13 0 0 0 0 0 0 6 10 0 0 17 18 8 0 17 0 0 0 21 0 0 0 0 32 12 0 0 51 16 
0 16 19 33 8 2 38 0 0 0 23 0 3 16 0 0 34 4 8 0 0 23 20 11 20 5 0 0 0 15 0 0 0 44 18 0 22 0 33 
11 33 4 31 0 0 26 0 0 0 6 0 0 0 2 0 6 0 8 14 2 2 0 0 1 7 0 0 6 0 0 0 33 19 42 16 14 0 16 
10 21 0 0 0 2 6 0 39 11 0 0 2 22 15 0 7 9 0 0 0 16 11 14 11 2 0 15 0 0 0 6 3 6 0 24 0 24 10 
21 13 0 4 33 1 27 0 0 6 11 0 0 0 0 0 3 0 0 3 0 7 0 0 0 0 0 28 9 26 7 0 0 16 0 10 0 29 4 
0 0 0 0 12 1 0 13 0 0 0 9 0 0 0 14 0 0 0 13 21 0 0 0 0 0 35 2 9 45 0 0 0 14 3 0 33 0 34 
0 0 16 0 38 0 69 0 7 0 0 25 0 2 0 8 1 0 25 11 16 0 0 13 3 9 18 0 0 23 15 0 14 10 0 0 40 4 25 
0 0 26 21 0 0 0 0 2 19 1 7 12 29 20 0 0 8 0 12 0 0 0 0 0 1 8 0 9 17 0 12 7 6 20 0 26 0 0 
0 15 77 0 7 19 33 0 3 2 13 8 0 5 5 0 1 0 13 0 0 0 8 13 0 0 6 0 0 0 28 33 0 0 0 0 8 35 0 
12 0 0 5 0 0 5 29 0 0 20 0 12 0 0 10 0 0 21 19 13 5 0 0 0 11 4 0 0 1 24 4 6 23 9 0 29 0 10 
16 0 34 73 0 0 9 0 7 13 3 18 0 10 0 8 34 4 19 0 0 19 0 0 0 5 24 0 17 14 10 13 13 5 0 9 0 34 17 
0 0 30 0 0 2 0 0 0 0 41 0 0 0 0 7 0 0 0 0 2 0 0 14 0 0 7 17 1 13 0 0 31 0 38 0 0 7 9 
2 29 2 0 7 0 0 0 0 0 0 9 5 2 0 0 0 9 0 0 0 0 0 3 0 0 11 8 1 0 0 30 0 0 20 0 0 6 0 
37 38 29 12 2 26 30 28 0 6 6 0 17 15 7 5 29 8 0 0 2 0 16 0 10 8 0 0 14 8 17 52 0 20 37 16 21 31 29 
58 0 48 59 5 13 6 24 18 2 9 0 2 3 0 0 13 0 12 6 0 0 14 0 2 2 12 0 19 22 0 0 10 31 10 22 2 21 16 
18 0 15 26 8 21 1 0 0 0 7 0 22 3 4 0 15 2 6 10 16 0 4 0 0 5 40 0 0 0 0 0 0 0 10 0 16 12 2 
10 0 25 14 34 2 8 0 8 22 9 0 19 0 0 0 29 0 15 12 16 0 11 19 12 0 0 25 0 11 11 30 0 25 16 0 10 0 0 
53 3 18 0 11 0 0 0 0 18 3 0 0 10 0 9 0 0 20 20 11 0 0 15 4 0 0 13 0 0 15 0 0 33 5 0 0 0 35 
14 0 12 3 0 0 0 0 0 0 3 0 23 8 15 3 0 0 0 0 0 0 20 0 0 0 20 0 0 0 0 4 4 14 0 4 0 0 0 
