39 22
1 28 0 21 60 3 0 1 9 3 0 0 10 8 0 0 24 0 5 0 0 0 14 0 21 0 13 11 0 0 0 9 0 32 110 0 2 13 6 
29 0 7 28 0 31 28 0 0 11 0 4 0 31 0 9 0 9 22 20 0 0 0 6 9 23 19 10 0 47 3 28 0 2 25 16 31 0 10 
0 10 8 23 2 2 0 36 0 0 0 0 0 0 12 0 0 0 14 0 2 0 1 0 9 1 41 20 0 17 4 0 0 22 3 1 0 0 0 
37 44 7 0 28 43 1 13 0 17 0 27 0 7 0 40 24 0 1 0 20 0 0 0 0 9 44 1 0 16 29 0 1 17 0 0 57 25 60 
1 25 17 0 20 0 4 0 0 6 0 25 33 3 8 14 0 16 13 0 14 0 0 22 0 3 22 0 0 0 0 14 0 0 5 0 26 0 26 
0 6 4 0 9 33 0 24 9 28 5 0 3 9 11 3 11 0 0 5 8 1 10 0 5 2 0 0 0 2 0 0 0 13 0 0 27 0 33 
25 22 32 34 3 0 6 42 0 0 4 11 0 1 3 3 6 2 13 21 11 24 11 22 0 29 0 11 13 8 0 9 0 0 27 0 11 56 20 
0 0 0 0 0 7 0 0 0 11 7 0 0 20 0 0 0 7 15 14 15 0 0 0 0 3 0 25 14 7 15 9 3 37 0 11 0 0 3 
0 4 0 20 14 28 0 25 0 23 9 0 17 3 0 0 0 13 12 9 8 0 4 0 0 0 0 1 0 29 8 2 23 0 5 0 19 25 0 
7 31 39 36 0 7 14 0 0 1 0 0 8 0 8 0 25 0 0 14 0 0 16 0 0 0 3 1 0 17 2 18 33 16 0 0 34 0 39 
0 1 38 22 3 2 0 0 0 20 5 0 0 14 0 0 0 1 15 0 0 0 0 0 0 8 8 14 19 27 0 2 0 0 33 0 0 6 0 
26 26 7 0 21 0 24 0 0 0 6 1 0 0 17 18 3 3 0 0 14 0 22 8 0 35 45 26 0 0 23 17 0 0 0 13 0 0 22 
0 14 41 0 0 8 13 45 6 17 4 12 7 30 7 0 25 0 21 34 1 0 29 12 2 0 0 25 5 3 0 0 19 15 6 25 0 0 8 
0 0 0 0 0 0 0 0 0 12 16 26 6 0 0 0 0 0 10 0 19 0 0 11 0 0 16 0 0 3 12 0 0 0 11 0 16 26 4 
0 36 18 0 8 49 0 0 9 1 10 17 24 0 2 0 10 6 9 4 16 8 24 0 33 13 0 0 0 1 32 30 0 0 10 15 0 0 13 
0 0 3 0 9 25 0 0 14 0 0 0 27 7 4 0 6 10 9 9 0 0 2 0 0 0 0 12 0 3 8 6 0 21 0 0 11 0 3 
30 15 7 5 16 7 19 14 9 22 12 0 0 7 30 0 8 19 0 0 30 19 8 40 17 15 20 0 0 4 23 13 3 27 5 0 7 6 7 
0 37 0 20 2 0 0 0 0 0 0 0 0 0 0 26 12 0 16 12 4 0 0 0 27 0 0 11 7 0 0 12 0 0 0 39 11 0 32 
1 31 36 0 0 5 0 10 0 20 41 0 18 0 5 0 4 0 6 16 0 0 0 0 0 0 18 17 0 14 28 0 0 0 18 4 15 0 0 
7 16 0 19 27 5 0 14 0 5 21 7 6 6 9 15 7 4 18 14 13 0 19 23 0 0 2 0 21 2 0 21 3 0 9 0 16 0 25 
0 0 0 0 0 31 19 0 4 0 0 0 0 0 3 0 0 3 0 0 9 0 0 0 0 0 0 0 0 1 0 0 0 0 0 0 31 20 0 
37 57 0 0 16 0 22 6 0 9 0 0 0 0 0 14 0 0 13 1 0 11 15 0 11 0 20 0 14 29 0 13 2 0 20 2 0 37 4 
