39 22
7 0 6 0 0 0 21 27 31 12 0 20 0 0 22 7 4 0 0 0 8 26 8 35 0 0 0 0 0 0 37 16 37 0 0 22 12 0 6 
7 0 0 20 0 6 0 27 0 12 20 0 0 2 3 10 28 15 0 5 0 0 0 20 23 16 0 0 21 0 0 8 20 3 0 0 0 0 0 
38 0 33 16 7 15 2 31 19 6 9 8 0 0 0 19 0 11 18 19 15 0 0 0 0 0 23 0 3 0 0 9 0 8 13 34 0 0 13 
2 3 20 18 4 1 2 24 15 0 19 0 14 5 2 8 1 0 22 3 10 5 0 3 4 17 5 6 29 1 65 5 22 25 0 11 0 0 36 
0 37 35 0 0 0 0 1 0 0 0 0 0 0 0 0 16 0 0 19 0 0 12 21 1 0 0 0 0 0 0 7 0 13 0 0 0 15 63 
0 0 0 0 5 2 1 1 3 17 0 0 1 15 0 0 4 0 0 15 0 0 0 0 11 0 0 2 12 0 2 1 3 0 0 2 0 10 0 
0 0 0 0 0 9 45 29 0 1 4 0 1 0 13 0 0 0 0 3 3 0 15 0 5 0 12 0 18 0 0 0 0 15 0 0 4 31 0 
1 0 0 2 18 8 0 0 0 1 1 2 5 0 1 0 0 5 0 13 0 0 7 0 4 9 0 9 22 4 8 0 13 10 0 0 8 0 11 
54 55 2 0 0 6 46 2 0 16 17 0 0 13 2 2 19 3 8 10 16 5 5 0 18 0 8 44 0 13 58 7 19 4 34 59 9 7 8 
67 9 6 0 7 2 0 2 0 4 7 12 0 30 0 0 15 1 1 11 10 0 10 0 13 0 0 0 0 0 41 0 8 0 0 0 40 37 0 
0 0 16 7 10 30 2 12 1 0 0 0 1 7 4 11 19 0 0 11 0 0 10 0 0 0 7 0 21 0 8 0 40 8 0 38 18 0 18 
0 11 10 0 0 37 30 0 0 6 0 0 1 13 7 8 8 16 0 13 4 0 0 7 11 4 0 0 7 0 11 8 2 16 0 0 0 0 33 
0 0 16 0 8 0 0 0 0 0 51 1 9 0 0 4 0 0 17 1 11 8 0 0 0 0 0 0 0 0 0 21 22 5 0 0 0 0 5 
0 4 10 11 11 11 2 26 30 5 0 0 10 4 0 0 9 0 0 21 3 9 0 0 0 0 10 0 20 0 0 0 8 0 0 0 0 16 6 
12 11 43 9 0 0 4 0 39 0 6 4 11 29 0 0 9 0 0 0 0 19 0 5 6 0 31 0 0 2 6 6 24 7 21 12 0 20 0 
37 28 0 0 1 41 17 28 13 19 14 0 2 0 5 8 10 5 0 2 0 13 7 12 14 0 0 4 19 0 3 0 0 3 0 35 0 92 0 
5 0 16 6 18 11 10 0 0 6 10 10 8 8 8 19 27 10 9 4 0 0 11 0 28 0 0 14 0 13 0 16 14 23 0 6 21 0 0 
33 0 9 29 0 16 0 0 5 11 1 6 12 9 0 0 0 29 0 0 7 13 0 0 12 0 0 10 20 0 0 0 29 8 9 3 14 0 0 
17 0 47 3 9 0 19 0 6 18 6 12 4 4 17 0 21 16 27 5 28 0 1 25 13 0 0 18 7 13 0 13 10 0 0 57 0 18 18 
2 0 0 0 0 11 3 17 0 18 17 0 0 13 0 5 0 0 0 0 0 0 0 0 1 10 0 17 0 0 0 0 0 18 0 0 0 15 0 
0 0 0 0 0 0 0 15 0 0 0 47 0 0 0 0 21 2 0 18 0 8 5 0 7 0 1 1 21 0 35 0 0 22 15 3 0 0 18 
13 12 43 0 0 0 50 2 0 9 33 0 10 2 0 15 0 17 0 0 10 0 5 13 0 0 6 4 3 2 5 19 14 19 4 22 4 4 0 
