39 22
13 1 2 47 0 15 49 0 0 3 1 7 4 0 19 9 30 5 0 9 10 0 11 39 9 50 5 0 12 23 0 0 26 0 18 23 0 12 20 
0 24 0 12 0 15 0 18 0 5 19 19 11 0 0 12 0 0 12 0 15 3 0 13 0 15 17 19 0 0 0 0 0 0 0 16 0 19 0 
0 0 24 0 0 25 9 2 12 2 0 1 1 0 0 0 11 0 0 0 29 8 0 16 0 7 33 0 0 8 0 0 0 8 0 0 12 0 0 
10 0 10 9 0 0 0 0 0 2 11 0 17 0 0 0 1 0 0 0 16 0 0 0 2 0 0 0 8 0 0 0 0 0 0 0 0 0 12 
0 0 9 0 0 2 0 2 9 10 0 4 3 5 0 0 9 1 0 0 0 19 14 0 0 0 3 0 0 3 28 15 0 0 0 0 17 0 0 
6 27 0 24 9 53 6 3 3 35 24 19 6 10 43 18 22 0 0 19 31 33 13 18 3 10 5 3 46 1 0 26 4 0 38 2 38 3 24 
9 0 0 11 20 0 25 0 0 8 56 1 0 3 3 21 20 20 8 0 4 10 7 0 8 15 0 10 5 0 7 0 0 0 24 0 49 22 11 
10 28 16 4 0 13 5 1 0 0 5 54 0 8 0 0 0 11 9 11 0 2 14 10 1 0 13 16 4 35 11 18 17 22 0 2 14 0 0 
0 0 0 9 27 1 0 0 0 0 0 0 0 9 7 6 0 2 0 0 9 0 9 9 8 0 5 0 0 3 16 27 8 0 14 1 0 2 0 
0 0 27 0 0 5 0 27 5 1 0 0 0 0 27 0 0 0 0 0 0 4 0 0 0 3 0 13 11 21 9 0 7 0 40 4 0 4 3 
35 0 0 2 0 2 0 0 0 14 0 8 7 1 1 2 25 0 0 0 0 10 0 0 12 0 0 1 13 15 0 0 0 17 5 33 0 0 0 
0 0 0 6 2 0 0 0 0 0 10 0 0 9 0 5 21 0 0 0 0 1 1 0 8 0 0 6 0 4 0 4 0 0 0 0 13 21 0 
19 66 0 9 0 1 0 0 18 0 7 0 19 0 0 0 3 33 0 11 7 8 0 9 5 0 28 7 0 8 24 18 4 16 0 12 6 36 6 
19 0 0 0 26 15 0 0 0 8 0 0 11 21 7 32 20 0 0 3 7 16 17 29 10 11 5 4 12 14 26 3 1 0 24 0 38 7 2 
8 11 34 4 1 21 0 27 14 8 14 7 0 0 0 14 15 5 0 0 8 0 0 0 4 20 0 0 12 7 20 14 32 5 27 0 24 0 0 
9 0 0 15 0 59 0 0 0 9 5 4 0 0 0 11 10 0 0 0 11 0 0 6 0 1 21 0 0 6 0 0 0 0 0 0 11 12 20 
0 16 64 12 7 17 0 0 6 0 0 2 5 0 0 13 0 16 19 8 13 10 6 0 8 0 24 8 0 2 8 3 37 0 0 0 1 15 1 
18 0 0 32 0 25 0 2 14 6 10 7 0 5 30 9 4 0 8 0 13 0 13 18 1 4 0 25 0 20 0 0 30 0 0 24 3 0 24 
0 0 23 10 23 0 0 28 0 0 18 1 9 17 13 3 0 6 0 12 5 2 0 11 2 41 17 23 5 1 26 6 0 0 18 0 0 6 0 
21 17 0 0 19 5 32 1 2 14 25 1 7 0 19 22 3 20 0 16 9 20 26 0 0 19 16 27 1 4 0 15 0 11 0 31 0 12 0 
35 19 0 0 1 33 0 6 3 29 19 18 9 43 0 0 15 0 0 5 3 14 18 14 3 5 7 32 28 0 10 15 11 0 12 15 0 9 32 
22 0 0 13 0 0 0 1 0 0 0 16 4 0 0 11 3 20 14 9 0 5 22 0 0 13 0 0 0 7 0 0 14 0 0 0 0 20 4 
