39 22
9 0 9 13 0 19 3 20 16 0 23 1 0 9 0 0 13 20 19 13 0 0 2 4 20 0 0 0 0 0 0 0 10 23 19 0 17 20 11 
0 0 8 0 22 0 25 41 4 0 23 1 12 9 22 7 20 0 0 4 0 14 0 0 0 14 1 0 0 17 0 1 3 23 18 38 16 18 6 
27 19 8 7 0 43 12 2 14 0 4 4 12 0 8 0 0 3 7 0 31 8 0 0 6 5 2 10 0 32 0 13 12 0 9 25 24 18 15 
45 16 2 0 0 0 0 15 0 5 10 0 0 0 5 0 0 3 0 4 0 0 0 2 0 2 0 5 1 4 0 0 2 33 0 0 0 0 0 
7 5 3 2 4 5 34 48 34 0 0 0 20 14 0 0 10 0 24 0 0 0 0 4 0 0 0 24 0 11 22 13 72 25 16 28 0 10 0 
61 0 0 9 31 7 0 0 4 0 0 4 41 0 1 2 0 11 0 0 0 10 0 23 3 0 0 0 11 0 0 9 1 0 22 0 0 0 75 
2 0 23 0 11 15 12 0 17 0 0 0 0 2 1 10 0 9 17 0 3 0 0 0 0 0 0 19 0 0 0 0 17 31 0 0 0 0 5 
32 0 36 59 3 0 5 39 8 0 6 8 0 21 8 4 3 0 0 9 0 0 7 0 0 14 0 24 0 4 0 0 0 1 2 34 7 3 71 
9 88 2 0 7 0 0 0 20 1 22 0 0 0 12 8 0 2 3 16 0 9 2 1 16 0 22 8 20 31 23 0 0 30 16 34 17 3 0 
38 0 13 0 1 14 0 0 0 0 0 0 0 9 17 12 0 3 0 1 6 0 15 0 32 0 0 50 0 0 16 0 5 31 0 30 0 5 16 
24 3 30 28 3 27 0 5 0 7 0 0 29 0 1 6 14 0 12 1 0 7 1 5 32 0 0 15 0 0 7 0 12 0 2 0 10 34 0 
0 37 0 0 1 30 0 0 42 32 3 0 0 0 10 7 27 15 5 0 0 0 7 16 38 0 0 0 0 3 0 0 7 0 6 27 20 3 19 
1 32 1 1 1 0 8 0 0 22 4 15 0 0 12 0 8 0 0 0 0 0 0 14 0 13 0 0 0 0 0 0 31 22 4 0 22 10 47 
0 8 8 0 65 0 4 0 0 8 0 4 0 7 16 14 8 0 9 4 18 0 0 0 3 0 0 4 0 4 16 0 13 0 3 30 0 8 34 
0 4 0 0 0 6 19 13 0 0 26 0 0 0 0 6 0 0 0 0 14 0 0 0 0 0 0 0 0 0 20 0 0 0 0 1 1 4 12 
0 2 6 0 0 26 0 6 0 0 0 7 0 2 0 1 11 0 7 0 1 27 0 3 7 0 4 18 0 13 0 46 18 0 0 0 0 5 6 
0 38 0 0 0 0 11 9 37 16 0 0 0 0 3 7 3 0 14 5 14 0 0 18 4 31 0 4 10 5 0 17 3 0 0 0 0 50 0 
20 31 7 3 1 0 0 0 3 0 52 0 0 0 0 4 0 0 0 4 20 0 12 13 18 0 0 0 0 4 36 0 0 0 10 0 2 27 5 
1 13 19 41 33 4 0 12 3 10 0 0 0 0 10 15 1 38 0 7 0 0 5 17 4 13 22 0 9 12 43 6 0 0 0 0 8 12 49 
2 34 0 3 26 31 5 11 4 7 0 40 0 37 11 16 0 17 2 16 0 0 8 18 13 17 19 0 0 0 25 18 7 0 35 40 36 0 0 
0 70 18 7 0 3 0 32 22 0 3 0 9 0 0 0 11 11 0 23 18 9 0 6 21 0 0 35 25 0 12 4 0 32 0 13 9 5 37 
0 18 38 11 0 22 31 0 17 0 19 0 0 0 11 0 20 0 12 1 0 0 16 0 0 14 0 22 0 35 28 0 0 0 11 29 2 0 0 
