39 22
43 16 0 5 15 1 1 4 20 0 0 8 43 20 11 20 3 0 7 7 9 8 0 0 23 0 0 18 17 16 29 2 8 51 18 31 0 25 20 
19 0 0 0 0 0 0 1 0 2 24 6 2 13 0 0 26 6 0 0 4 0 0 0 9 0 0 0 0 0 0 12 0 0 0 0 0 12 0 
0 0 0 1 0 0 10 6 0 6 0 0 0 0 2 17 0 19 12 0 0 5 0 0 17 18 0 0 5 0 8 0 20 5 0 3 19 0 8 
0 0 27 20 0 2 0 27 8 9 3 0 18 0 0 0 35 0 3 1 0 19 0 8 0 2 10 63 5 0 21 0 0 6 0 13 0 30 35 
0 0 46 0 19 4 16 11 24 4 9 14 0 3 0 13 3 0 33 15 0 9 16 0 0 5 7 0 0 0 10 0 0 32 0 33 0 0 0 
5 0 0 0 29 1 7 0 26 6 4 8 0 13 14 6 18 0 5 0 6 23 0 5 5 12 0 0 0 0 2 10 0 14 21 0 0 0 0 
0 0 0 6 24 0 0 0 0 0 0 0 0 0 0 13 6 0 0 0 12 0 25 9 0 0 0 0 1 0 11 0 12 0 0 6 0 15 0 
15 2 20 13 0 0 0 0 20 0 10 7 0 5 0 12 0 0 9 10 1 40 34 0 0 0 0 19 0 0 13 0 0 0 0 7 0 16 15 
0 0 28 13 19 33 0 0 14 21 0 4 5 4 0 0 18 19 15 16 11 22 12 0 14 7 10 1 12 0 16 11 14 0 18 0 17 0 1 
10 4 6 0 2 0 21 27 9 0 6 0 0 0 0 0 0 0 2 30 0 18 5 5 7 0 0 8 22 5 0 0 31 0 25 6 14 18 21 
5 36 0 0 0 10 1 0 3 0 13 0 0 5 0 4 7 8 4 0 15 0 8 22 0 24 0 0 0 3 0 0 8 0 0 15 0 35 13 
5 0 0 6 2 7 1 0 2 12 11 0 9 7 1 0 0 0 13 0 0 21 7 8 6 11 0 0 0 0 0 0 5 12 2 11 0 11 0 
6 35 33 0 23 0 9 0 0 33 15 28 14 0 2 13 6 0 30 9 12 0 4 14 0 7 0 0 5 29 0 0 0 1 0 31 42 9 1 
7 0 30 0 8 18 0 10 0 48 21 20 1 0 2 0 0 0 7 0 13 15 3 26 2 1 9 11 16 3 15 21 29 8 20 0 0 11 30 
9 3 16 0 0 0 0 0 1 9 46 30 0 16 0 0 0 16 33 8 14 0 7 0 6 2 0 2 0 0 2 0 14 36 5 1 12 27 7 
57 0 28 0 0 0 0 0 21 0 29 0 13 0 0 0 3 8 0 0 1 0 3 13 2 11 0 0 0 1 28 31 0 23 17 3 0 0 0 
0 40 0 0 0 10 0 14 0 28 2 5 0 0 0 2 0 0 3 16 4 0 26 1 0 21 0 0 17 6 0 4 0 16 0 13 17 28 0 
0 3 33 0 19 0 0 1 0 0 0 0 0 6 16 21 0 0 8 0 1 15 2 19 9 3 0 4 17 0 1 1 0 0 0 33 36 0 0 
0 32 0 11 0 18 0 1 0 8 22 23 24 30 0 17 30 4 17 0 11 4 7 0 0 0 0 18 0 0 14 0 47 10 24 1 26 0 0 
14 10 12 0 21 5 0 13 28 39 16 12 0 6 12 0 1 7 17 6 14 0 0 0 0 7 5 0 11 0 14 15 0 0 5 0 21 40 0 
25 0 0 7 21 4 17 0 18 11 41 1 14 0 0 0 9 0 4 17 6 12 13 17 0 13 2 0 0 10 12 21 15 15 0 30 0 0 0 
0 0 31 33 34 32 29 0 13 0 7 1 0 0 10 5 20 0 0 1 1 0 0 0 0 0 8 0 0 8 26 5 0 23 0 29 33 34 0 
