39 22
0 0 0 17 13 26 21 0 0 0 0 38 5 13 0 0 0 8 6 6 26 0 0 10 19 0 0 0 0 9 10 29 0 10 1 3 25 13 7 
0 1 0 0 7 5 11 23 3 0 22 14 0 14 12 24 0 24 0 0 15 18 13 0 2 0 15 43 0 8 23 17 21 13 0 20 0 0 0 
18 7 0 0 10 13 2 1 16 27 0 17 0 0 0 0 17 18 31 0 0 0 0 15 0 0 0 1 10 17 0 19 0 18 31 0 25 20 4 
20 1 12 51 0 0 0 5 0 0 18 15 10 0 11 0 7 1 0 3 22 6 1 5 8 21 0 3 9 7 18 5 26 0 9 0 14 22 15 
0 0 0 0 9 0 2 2 0 0 0 0 0 0 13 0 0 10 9 14 3 0 14 0 0 0 0 0 9 0 9 3 0 0 0 4 1 0 0 
30 0 6 0 47 29 23 12 22 0 2 0 8 10 20 0 18 11 13 19 8 0 27 10 20 0 0 0 12 44 19 30 0 0 23 0 0 0 3 
15 0 3 0 0 0 0 3 6 5 8 0 0 0 13 0 0 0 0 6 17 0 0 0 0 0 3 16 0 3 3 0 0 0 1 4 9 17 0 
29 0 0 0 0 0 2 0 9 0 0 11 0 8 0 1 1 3 0 0 6 11 5 12 0 0 0 6 0 23 1 3 0 9 8 0 15 0 4 
31 0 0 19 29 10 2 26 9 16 0 6 21 0 7 10 8 3 0 0 14 0 19 15 9 5 0 0 0 7 0 21 0 39 8 0 1 0 0 
14 7 18 34 35 1 4 0 11 5 10 3 0 10 0 0 13 15 0 4 3 2 0 0 12 0 15 11 9 18 6 0 2 29 0 40 23 0 5 
6 0 0 1 19 14 0 0 11 14 0 0 0 21 6 0 0 1 14 14 17 0 5 40 0 5 0 0 0 9 10 34 7 0 21 4 0 31 0 
18 0 12 29 0 15 0 17 3 0 1 0 2 10 36 0 6 0 11 7 10 0 0 0 25 2 3 0 5 7 0 27 9 0 9 3 7 0 27 
5 0 0 0 11 0 7 6 9 0 19 0 0 0 6 0 0 0 12 11 0 4 0 0 0 25 1 0 0 19 22 6 0 0 0 4 3 0 0 
29 0 14 18 9 0 8 5 12 21 0 37 0 5 8 14 0 17 14 10 3 31 14 0 0 0 7 25 1 20 21 14 21 0 5 8 0 8 0 
13 0 20 11 0 16 35 5 37 0 19 0 0 30 9 0 0 0 11 2 3 4 21 0 0 0 5 0 22 24 21 6 2 20 43 1 23 3 0 
0 0 22 0 26 0 0 0 13 0 26 0 10 1 0 0 6 0 0 2 0 0 0 7 28 0 3 0 0 0 14 27 0 0 14 0 9 0 0 
1 0 0 18 0 11 15 2 20 11 0 6 0 0 0 0 16 0 0 0 2 10 1 1 0 2 26 13 15 0 0 2 6 0 13 10 0 0 34 
0 0 11 0 4 12 20 0 15 0 2 0 6 6 13 0 0 3 0 12 0 5 8 14 0 0 8 0 0 0 0 0 0 0 10 6 0 2 0 
38 20 0 0 1 0 10 1 53 19 0 0 0 0 6 0 6 13 13 7 4 29 0 0 0 0 22 0 19 0 0 47 0 0 10 0 2 0 7 
0 10 0 5 17 0 34 0 6 0 22 0 0 0 4 14 32 11 13 0 8 0 11 14 23 0 0 9 5 31 10 18 4 26 59 29 2 4 3 
37 0 6 24 0 0 12 0 6 31 0 0 0 0 21 0 0 5 0 7 0 0 0 0 0 3 0 13 21 7 0 6 23 5 0 21 0 37 0 
27 0 0 0 21 5 1 0 9 0 18 16 8 0 0 0 0 0 0 10 8 0 17 0 0 21 7 16 0 10 30 19 26 7 0 0 0 0 0 
