39 22
3 2 33 62 0 0 0 0 10 5 1 8 21 33 17 0 0 0 20 16 15 0 2 15 11 0 8 8 0 29 15 0 30 0 13 5 12 0 0 
0 7 0 0 31 0 0 0 13 14 0 9 0 0 9 0 0 0 0 1 15 0 7 14 27 1 1 10 6 0 0 0 0 16 17 21 0 6 18 
0 23 6 0 0 0 3 19 0 5 1 3 0 6 13 0 0 0 0 6 11 8 0 22 8 2 0 13 6 5 16 0 8 0 11 2 1 0 0 
15 0 0 53 0 0 0 31 0 0 0 0 18 10 8 0 0 0 8 0 0 12 27 14 0 0 5 8 0 0 27 0 0 18 0 0 1 0 60 
5 32 10 20 72 0 0 0 3 29 0 0 8 7 9 31 0 0 0 2 38 6 6 23 7 37 0 0 0 4 0 18 34 48 0 9 27 0 34 
24 0 0 9 0 0 7 0 0 0 0 32 8 5 0 3 0 0 7 0 22 6 11 0 26 19 4 7 0 0 6 0 6 0 21 13 6 0 28 
6 0 0 0 0 14 24 0 0 0 7 3 6 12 0 4 0 0 0 1 1 17 5 0 0 10 0 0 0 2 0 0 1 0 0 3 30 0 3 
0 0 0 8 0 0 0 23 0 0 0 0 22 0 0 17 1 0 3 0 0 18 12 4 0 0 22 0 0 0 23 0 1 3 9 0 10 6 23 
0 11 0 19 0 12 0 5 15 4 30 0 16 3 4 13 0 7 2 6 6 0 15 22 7 4 15 53 0 3 7 0 3 0 7 22 5 0 25 
35 0 35 0 1 0 57 30 7 0 0 22 0 3 19 1 3 0 0 0 0 0 0 7 0 0 0 9 0 23 37 3 1 23 10 35 6 18 6 
0 26 0 12 8 15 25 0 12 0 5 7 0 5 9 1 11 5 2 28 15 6 27 0 0 22 0 50 33 8 22 2 24 0 0 0 0 18 0 
0 2 3 0 1 29 53 0 12 0 0 3 7 0 7 11 0 0 2 0 0 11 0 6 3 0 11 28 1 17 24 0 0 0 33 10 102 0 0 
2 22 0 0 0 0 0 0 0 46 6 1 18 0 0 6 15 0 23 0 0 27 0 15 5 15 4 22 0 17 0 16 0 0 16 5 0 11 7 
2 1 0 4 34 0 11 5 7 0 0 0 0 0 8 0 0 11 17 12 0 7 5 0 2 0 0 3 0 0 8 3 0 0 31 22 5 0 77 
0 1 16 8 0 14 0 13 6 13 2 0 0 0 7 10 0 0 0 13 3 3 7 14 0 1 0 0 26 0 11 1 0 0 0 0 0 2 0 
14 0 17 5 2 0 0 50 3 24 9 12 4 31 0 5 0 0 5 1 9 12 0 15 0 0 4 0 0 3 38 0 2 26 23 0 0 0 5 
0 13 0 0 8 0 0 0 21 18 21 0 7 33 20 0 0 0 0 2 0 0 0 0 0 0 0 23 15 9 18 0 19 23 0 0 2 0 2 
0 16 10 4 2 0 0 0 0 0 18 0 37 4 12 21 0 14 8 14 0 11 0 11 2 2 18 3 18 16 0 0 5 30 11 5 0 6 25 
0 53 31 9 0 3 0 16 8 9 15 0 8 2 3 8 9 3 9 18 0 7 0 8 0 8 0 14 3 13 52 0 0 15 17 11 32 7 9 
28 9 0 0 0 22 10 0 0 0 0 12 12 0 0 15 16 16 2 20 0 0 18 12 0 0 7 22 9 1 0 0 30 16 0 2 0 0 0 
31 44 0 28 30 2 24 6 32 0 6 0 0 6 11 9 17 4 10 0 20 3 0 0 8 0 0 15 0 0 0 0 0 47 24 7 12 36 5 
0 0 0 21 0 26 0 19 7 0 0 0 0 0 0 10 0 13 15 0 17 29 2 0 0 0 23 0 9 0 5 0 0 0 0 0 0 0 0 
