39 22
35 0 21 0 11 0 0 11 14 14 9 0 0 0 9 11 19 12 0 8 7 0 10 23 0 0 6 0 0 0 0 9 0 0 0 16 14 0 1 
0 12 1 1 15 0 0 31 0 4 0 0 51 0 0 29 30 0 0 22 2 0 0 11 0 0 0 5 1 24 0 2 20 0 0 11 0 0 54 
0 0 0 1 4 13 0 0 18 0 0 5 0 0 0 12 1 15 0 3 8 0 0 6 0 11 5 12 9 0 23 0 0 3 4 5 10 0 23 
43 29 13 1 0 1 0 0 9 2 0 0 0 25 16 23 2 53 0 0 5 11 0 3 0 0 12 27 6 28 0 0 0 0 17 0 0 0 8 
30 30 8 4 2 6 9 0 0 15 4 38 0 9 0 0 1 7 0 9 0 0 1 0 17 0 0 0 0 9 0 30 0 0 23 38 0 10 0 
15 1 17 1 24 0 22 3 13 19 8 6 9 9 0 24 0 18 0 27 10 26 0 3 0 15 11 15 9 12 0 14 5 0 0 19 0 48 19 
3 0 0 23 21 0 7 0 0 0 1 9 0 0 0 0 13 2 7 30 0 12 0 19 2 0 7 10 0 0 0 0 0 12 0 1 0 0 0 
0 0 0 0 8 1 4 48 18 4 0 5 3 19 0 0 0 12 0 16 0 0 0 18 12 0 42 0 0 0 12 19 0 11 15 22 2 6 0 
0 0 1 20 33 0 0 4 1 29 5 0 19 6 19 5 12 8 18 3 0 2 0 20 21 0 14 8 12 2 15 70 0 0 17 16 17 9 20 
0 8 1 3 27 33 0 29 2 3 9 0 3 19 17 0 13 14 5 7 0 6 0 0 0 0 5 9 20 16 0 45 16 12 26 21 29 5 25 
9 0 6 9 0 17 0 0 8 9 10 0 0 0 0 0 0 0 0 0 10 1 18 0 0 0 0 0 11 0 0 0 0 0 0 0 0 2 1 
35 0 10 32 14 2 1 1 30 3 19 18 12 0 3 0 10 15 12 18 1 4 19 9 1 0 2 18 1 18 0 4 13 0 13 59 16 8 3 
0 0 8 0 0 7 0 0 0 0 9 0 8 0 0 9 0 12 0 6 0 14 0 12 9 8 1 7 9 0 0 0 0 0 15 13 1 7 1 
39 60 10 0 2 0 14 49 4 36 7 17 1 21 0 48 0 17 0 17 1 6 14 0 23 24 19 0 17 9 0 3 0 0 0 9 14 72 0 
22 0 0 19 0 18 44 3 14 9 0 5 1 12 0 0 21 0 9 7 3 6 0 18 1 6 6 4 4 9 2 0 0 0 3 0 30 18 0 
0 0 30 0 16 24 8 0 12 20 0 0 2 0 8 0 7 0 14 19 17 7 0 0 3 5 55 2 4 18 4 7 27 6 9 17 15 35 19 
0 7 4 19 33 0 2 10 8 3 0 0 3 0 0 13 0 0 0 0 11 11 23 14 0 13 3 0 0 4 9 12 1 3 0 19 0 4 12 
9 8 9 6 1 29 7 0 25 9 16 11 0 19 14 16 0 15 0 0 0 10 12 0 11 0 16 0 26 16 0 0 0 27 38 0 15 0 0 
9 0 0 16 0 0 4 0 21 9 4 0 17 0 0 0 0 0 3 16 0 0 0 0 0 0 0 0 0 17 0 0 0 0 0 7 0 0 0 
0 31 0 0 4 0 0 0 0 12 0 15 0 0 5 1 10 1 1 0 0 0 0 0 8 16 3 0 0 4 15 14 31 0 0 0 0 0 10 
36 0 0 0 0 31 19 0 0 0 15 0 0 0 0 0 0 0 6 0 0 0 0 0 0 42 0 0 15 0 0 0 0 0 0 0 5 0 0 
0 37 23 0 0 13 4 0 0 29 4 10 7 0 12 5 15 0 9 2 8 43 3 0 0 7 14 0 5 0 0 0 0 12 29 16 10 16 37 
