39 22
0 14 9 0 77 20 27 17 17 3 28 9 32 0 11 9 2 20 0 5 0 8 16 9 8 15 6 23 24 9 12 19 43 29 0 6 1 9 48 
56 35 5 0 17 5 5 0 37 1 0 0 20 5 18 0 0 0 6 1 0 0 0 23 31 5 0 1 26 0 0 0 13 56 0 2 0 5 0 
0 0 22 0 15 11 10 0 0 3 17 0 0 11 8 0 0 7 1 5 0 12 0 0 29 2 22 16 0 0 11 0 7 7 0 0 0 0 0 
0 0 7 0 0 1 0 0 0 3 23 18 0 0 0 0 11 0 0 0 0 0 0 18 0 14 0 11 0 0 0 0 0 21 0 0 0 0 0 
0 60 33 5 0 0 0 11 10 0 14 27 6 1 13 0 7 0 17 0 0 13 17 1 0 0 0 0 0 9 16 20 0 0 0 11 0 0 9 
11 0 0 4 0 0 37 34 0 9 23 5 1 17 7 8 0 0 0 18 0 23 14 11 29 16 0 0 22 25 0 13 0 52 7 6 21 11 0 
0 4 0 5 0 14 8 5 3 3 28 33 29 0 0 21 2 11 12 3 0 0 6 0 23 5 0 0 6 0 30 1 20 2 0 37 0 34 31 
0 20 0 3 0 0 0 1 3 0 0 3 0 0 0 39 0 8 11 0 1 0 3 0 23 20 0 0 0 0 0 7 0 25 0 0 21 0 17 
0 0 17 22 0 37 5 3 0 16 10 0 7 0 7 0 0 0 0 3 1 13 15 6 0 4 0 4 23 9 0 33 26 30 13 7 34 31 20 
0 0 6 0 20 0 14 28 2 0 0 19 0 11 0 9 0 0 0 0 0 0 3 0 0 3 9 0 0 4 16 0 7 22 0 43 0 8 0 
0 4 1 11 0 0 14 22 0 0 9 0 0 3 49 0 4 5 17 0 0 0 5 0 5 12 8 2 0 25 33 0 0 20 8 3 0 23 0 
0 0 0 4 16 0 0 0 6 11 0 0 0 0 3 0 5 0 0 0 2 0 18 7 4 0 7 0 4 9 7 0 28 0 0 0 8 9 0 
0 0 0 4 5 0 0 4 7 23 20 8 0 0 3 0 0 0 4 0 0 0 0 2 1 10 0 0 6 0 5 5 0 7 7 0 0 0 0 
29 11 0 5 0 0 36 0 0 0 0 8 0 4 0 22 0 8 7 14 0 0 0 0 14 0 15 0 0 0 30 0 0 22 0 24 0 29 3 
0 25 11 21 4 12 0 22 0 0 0 0 11 0 15 16 27 1 0 0 5 22 4 3 0 0 0 0 0 22 6 25 46 9 0 6 6 0 0 
1 5 0 12 18 0 4 16 30 14 4 0 21 0 25 0 0 13 0 2 2 2 19 29 18 10 0 0 3 0 0 0 0 0 0 21 1 1 35 
5 34 15 0 0 0 14 10 0 21 5 0 0 0 0 4 0 0 0 0 19 0 1 0 0 9 0 3 0 0 3 0 0 3 9 12 0 7 3 
0 65 0 5 11 22 0 14 1 0 0 0 7 2 3 24 15 9 3 22 0 31 6 0 19 34 0 0 11 25 7 21 5 0 0 0 2 2 2 
9 1 0 39 28 0 0 12 6 6 18 6 18 2 0 2 0 3 3 12 0 11 10 0 9 18 23 3 0 8 0 27 19 7 0 0 0 0 0 
0 19 0 0 20 0 3 24 0 0 11 0 0 0 11 0 0 1 0 0 25 0 8 0 7 26 0 23 0 0 0 23 0 27 27 0 0 0 0 
0 0 0 6 3 84 0 36 29 0 5 3 0 2 0 5 0 0 22 0 0 0 2 0 5 7 0 0 23 5 23 17 8 7 26 14 0 2 13 
22 1 0 14 27 27 5 13 20 3 0 17 0 2 0 0 7 22 0 0 7 0 64 4 16 14 0 0 0 0 0 27 11 0 0 0 0 0 0 
