39 22
3 4 0 11 0 82 14 0 19 28 2 0 7 0 11 0 13 25 0 1 17 14 3 0 0 0 18 19 0 3 0 0 32 28 0 28 0 48 0 
0 39 8 0 17 8 0 26 6 4 0 12 0 4 38 0 0 9 10 5 21 20 20 10 3 29 0 0 0 0 5 0 0 0 0 8 0 0 3 
0 0 10 10 3 1 0 0 26 15 18 0 29 24 42 0 9 13 0 33 1 0 0 12 15 0 0 5 34 0 2 0 0 19 16 12 20 23 0 
0 18 0 3 0 0 7 32 2 0 0 4 4 0 0 0 0 19 0 1 0 13 0 5 0 22 0 0 5 28 0 0 0 15 18 33 0 0 34 
0 44 14 11 0 0 15 0 0 3 0 0 12 12 15 0 4 0 7 4 0 0 8 0 3 13 0 0 0 28 2 0 15 0 0 1 0 5 13 
14 31 0 0 17 14 0 0 4 8 4 0 0 0 0 2 0 19 14 0 13 9 0 0 24 0 0 10 0 11 0 0 26 12 7 31 14 0 2 
8 0 5 17 20 0 9 5 8 17 7 0 13 27 0 0 3 3 4 0 0 20 2 14 3 1 0 0 0 0 4 0 0 0 8 0 0 4 0 
7 14 10 0 3 0 37 3 0 0 0 0 35 0 0 29 0 3 0 8 0 2 11 17 0 0 1 1 1 23 0 0 0 11 0 7 0 22 0 
1 24 32 23 0 22 0 0 0 0 9 0 30 8 4 0 1 1 0 0 3 0 0 0 0 13 29 21 0 0 0 0 19 0 32 0 23 34 0 
38 0 2 63 2 0 0 0 8 29 0 0 0 0 16 0 19 15 24 0 0 0 0 0 0 0 0 1 4 0 16 1 14 0 0 0 12 53 28 
15 34 0 2 16 0 60 7 4 10 5 27 9 4 37 15 1 14 2 11 23 5 0 0 0 0 0 1 0 0 6 1 18 51 28 0 0 0 5 
0 32 0 35 0 0 0 0 0 20 22 0 0 9 14 1 4 7 0 3 4 0 9 4 0 0 8 0 7 26 3 0 25 39 0 13 0 0 35 
0 26 2 2 23 20 0 9 27 2 0 20 21 0 1 1 10 33 0 17 3 9 0 0 0 20 4 20 0 0 0 6 0 17 32 27 8 0 20 
2 28 0 0 0 10 7 0 3 7 0 6 0 4 0 0 13 6 5 20 0 23 0 14 18 12 11 26 28 0 5 12 7 0 0 34 0 12 0 
7 4 38 24 0 0 19 4 22 4 0 10 1 17 16 42 0 6 11 8 0 4 24 16 0 6 0 4 0 0 4 28 7 1 6 0 0 37 65 
21 0 15 24 16 0 7 20 0 35 0 0 4 0 5 22 12 14 9 15 21 0 16 4 0 16 0 0 12 6 23 1 0 18 0 1 0 38 0 
2 0 0 11 0 3 20 27 3 0 0 0 0 3 11 11 3 1 0 0 0 0 1 9 9 0 20 1 1 11 4 7 3 0 25 4 0 6 0 
0 0 0 1 0 26 0 7 0 1 15 4 13 0 16 10 8 0 0 0 22 2 3 13 3 16 0 3 0 0 10 0 0 1 0 15 0 2 1 
0 0 14 2 17 30 11 12 0 0 7 0 13 21 0 0 4 13 0 14 8 19 0 5 0 0 13 0 3 0 0 3 20 3 0 20 0 0 0 
0 11 0 2 0 17 5 0 0 13 0 0 31 0 0 0 0 0 20 17 0 2 0 0 0 18 0 0 0 0 4 3 0 0 0 0 0 0 20 
0 16 0 0 0 9 0 19 5 31 3 19 0 5 28 0 11 16 0 10 5 0 1 11 0 12 0 0 18 10 6 0 0 23 0 0 23 4 0 
6 34 29 16 0 24 0 0 7 0 0 0 7 22 17 0 20 0 1 31 37 17 39 0 13 1 0 0 7 24 0 19 4 0 13 46 28 0 0 
