39 22
0 0 0 0 19 34 0 8 20 0 47 12 10 15 20 0 6 0 0 0 20 16 18 21 4 3 21 17 0 0 21 17 0 0 14 0 0 5 0 
14 33 0 0 13 30 0 18 0 14 0 7 3 11 0 11 28 12 0 0 35 8 0 27 1 0 19 0 0 0 7 1 9 16 33 0 16 17 0 
1 37 22 2 0 0 31 19 2 0 0 0 35 10 11 4 0 21 10 7 24 0 10 34 28 0 20 13 20 3 24 11 10 0 0 0 0 14 6 
5 0 0 0 0 0 0 26 0 24 0 0 0 0 22 1 3 0 0 0 28 8 0 0 0 0 0 0 8 0 0 0 0 2 0 0 22 18 0 
0 0 0 1 3 0 20 0 73 5 22 0 0 3 4 5 0 0 0 18 17 10 0 34 0 12 7 0 20 0 7 0 28 25 0 0 28 2 0 
0 0 98 4 26 23 1 5 8 2 0 3 44 25 3 11 8 3 13 9 2 19 20 15 23 0 4 1 23 0 1 6 0 31 0 0 30 31 33 
0 37 0 0 0 0 0 9 12 0 8 15 4 0 3 33 3 11 8 2 11 9 0 5 0 12 1 2 11 0 36 0 3 17 0 0 0 22 37 
13 23 0 0 0 0 0 0 0 25 0 20 13 13 6 7 0 10 0 0 7 0 0 4 23 13 0 1 0 10 7 20 0 0 25 0 0 0 0 
0 0 21 2 4 2 0 0 0 9 13 33 0 0 3 0 15 0 14 3 7 0 13 1 2 0 12 9 0 8 4 15 0 22 4 46 0 21 8 
15 15 0 0 0 0 7 8 11 7 2 2 0 3 1 13 21 0 2 0 5 0 0 7 13 0 27 7 0 0 21 0 0 0 5 0 0 9 0 
0 0 0 0 0 52 0 0 0 7 2 0 5 0 5 3 10 0 0 2 11 0 0 10 10 0 0 6 23 4 25 0 4 6 0 0 9 0 22 
4 0 0 0 12 29 0 19 0 23 26 0 0 0 3 14 2 0 3 0 0 16 13 7 0 26 31 0 0 0 0 0 0 0 29 5 11 28 22 
11 15 21 2 2 61 9 0 7 1 4 24 0 13 9 38 27 10 13 0 0 19 38 11 21 3 0 0 1 6 7 0 5 0 4 24 0 32 32 
0 0 0 0 0 0 0 0 0 1 0 0 13 0 0 20 23 0 0 5 0 0 0 0 0 0 11 0 0 0 0 0 7 0 0 39 0 0 0 
56 0 0 0 0 0 0 15 0 1 27 4 0 2 0 1 5 0 7 1 4 12 0 14 0 7 24 18 0 4 0 2 0 0 0 35 0 37 0 
4 13 8 24 8 0 2 18 6 3 8 14 15 3 6 7 4 13 18 0 2 0 0 9 0 0 0 24 0 0 16 0 15 15 0 0 0 0 5 
0 6 3 0 13 46 0 6 0 0 0 0 13 0 11 12 15 4 0 0 0 0 17 0 0 13 2 0 0 0 16 14 0 0 0 0 0 14 0 
16 0 0 68 0 31 2 24 24 0 1 0 0 0 4 8 12 10 13 7 0 14 0 11 0 0 7 11 0 10 0 0 40 3 1 14 64 14 24 
7 3 3 13 3 27 5 11 0 0 46 37 23 0 4 0 17 0 24 0 0 16 7 17 0 6 21 22 0 7 0 0 0 0 1 1 0 12 28 
0 23 0 30 10 0 0 12 0 1 7 11 0 9 17 8 0 13 2 0 13 16 4 16 6 0 31 0 0 0 20 0 0 0 0 8 0 35 0 
0 18 4 24 10 0 0 23 50 3 0 2 5 11 2 0 7 0 0 0 0 1 21 8 0 0 50 43 0 0 20 0 0 3 11 0 0 0 0 
14 29 27 34 12 21 9 3 9 49 39 0 10 0 38 18 17 0 8 0 0 7 1 0 0 0 26 0 0 20 16 9 13 7 0 4 8 21 47 
