39 22
0 20 2 1 6 19 0 7 4 7 27 0 42 10 0 10 15 0 0 0 0 7 0 0 8 26 0 20 7 3 12 1 1 4 0 0 24 10 0 
0 8 0 1 20 2 18 0 0 18 0 0 0 24 1 22 0 14 2 6 0 15 0 4 22 18 0 0 13 2 0 0 0 13 9 9 0 32 16 
20 0 33 0 21 0 24 0 3 0 0 19 7 11 19 0 16 0 0 0 18 0 5 0 10 7 0 7 0 19 0 3 0 13 13 33 28 13 18 
2 0 2 3 0 0 0 6 0 0 0 2 0 8 39 0 0 15 4 3 9 38 0 9 11 15 0 7 0 0 7 11 0 10 30 0 0 23 0 
0 20 0 0 0 0 0 4 0 0 0 36 0 0 15 0 6 0 7 0 0 20 0 0 12 22 0 0 3 0 0 7 3 3 6 15 17 4 3 
14 0 0 0 0 0 0 18 0 4 1 1 5 0 21 6 0 5 17 24 0 0 13 0 0 0 0 20 21 0 17 0 14 14 0 27 22 0 1 
25 5 5 4 13 22 0 11 0 14 20 14 12 0 4 5 0 4 5 4 0 18 12 0 8 5 4 0 0 14 0 8 50 6 0 14 31 11 19 
4 0 0 0 0 0 58 0 0 9 4 0 0 0 15 15 0 0 7 5 0 0 5 0 0 0 8 0 7 0 0 0 1 14 28 14 30 0 0 
30 11 32 22 10 0 20 1 28 10 4 0 20 0 0 10 17 2 20 0 0 0 0 5 0 10 24 9 0 0 30 0 0 11 0 0 26 0 0 
0 0 0 0 0 49 0 6 18 0 0 0 7 6 7 0 22 0 5 0 0 11 0 23 5 29 18 7 0 1 1 0 19 8 18 1 19 11 25 
30 9 0 15 0 0 0 28 0 0 0 0 11 0 17 17 16 13 2 0 6 4 8 0 0 18 14 0 0 3 29 0 17 0 15 31 33 0 0 
28 26 5 59 0 19 10 15 0 0 0 0 11 8 0 5 24 6 20 9 0 11 36 15 19 0 0 8 12 5 2 0 0 3 18 10 33 3 25 
9 0 42 6 0 0 25 41 0 38 8 6 5 2 21 9 9 18 17 9 0 9 0 8 10 0 8 9 9 0 4 37 0 35 34 29 26 7 66 
0 11 10 13 3 0 0 13 6 2 0 0 0 0 11 0 0 0 5 0 14 1 0 0 0 0 6 24 0 0 0 0 0 9 0 3 1 13 3 
0 2 0 5 0 0 3 0 16 26 27 6 0 24 10 0 0 0 11 12 0 0 4 4 19 42 0 10 0 13 3 7 13 13 1 25 6 6 0 
15 5 0 7 33 12 0 0 0 0 21 23 0 25 0 5 0 2 0 1 9 0 11 0 0 10 8 1 0 6 1 20 1 0 0 0 7 20 25 
0 0 0 3 0 0 28 0 25 34 0 0 0 0 0 9 0 0 5 8 11 0 0 0 0 4 24 0 19 14 0 0 1 25 13 0 5 8 4 
4 10 4 0 0 0 0 6 23 23 0 25 9 23 5 10 2 4 10 5 1 15 0 0 16 16 0 0 0 1 12 16 13 0 19 0 23 11 5 
25 13 10 14 22 25 0 12 0 0 0 27 10 10 2 8 19 13 18 5 16 10 0 12 0 4 0 24 7 0 32 2 0 0 0 19 48 0 41 
12 4 0 71 2 11 9 32 16 6 0 0 4 0 2 0 2 9 0 0 12 0 0 0 0 0 6 0 0 0 0 0 43 26 0 1 0 1 36 
0 39 0 17 0 0 0 0 16 12 22 36 20 0 10 0 0 20 0 8 3 0 0 0 6 4 8 0 0 20 0 2 58 0 0 0 11 19 16 
23 41 0 0 0 4 27 6 0 0 26 0 0 0 12 0 0 17 5 9 14 13 0 3 0 4 12 0 9 22 5 0 0 57 0 1 21 12 12 
