39 22
14 0 0 0 0 0 41 8 16 24 19 21 22 11 14 19 1 6 24 19 77 0 3 0 36 18 10 25 0 3 4 0 0 18 13 9 0 0 0 
6 7 14 15 0 12 22 0 7 0 9 15 9 1 16 2 1 12 6 0 0 0 8 5 6 0 15 0 0 0 30 19 15 21 0 0 0 0 0 
1 9 0 8 5 25 0 1 0 0 15 19 4 5 0 1 3 27 0 3 0 0 0 22 0 0 0 0 0 0 25 0 11 0 0 44 0 4 0 
29 57 12 29 2 39 14 8 27 1 9 18 8 1 21 7 7 18 8 0 1 0 5 7 16 3 25 0 10 39 7 0 27 32 4 27 19 14 31 
10 2 0 47 0 25 14 29 3 9 1 0 14 0 4 0 0 0 10 0 18 18 14 0 0 0 14 0 21 24 23 10 10 26 0 32 14 0 16 
0 2 0 57 9 4 0 15 0 4 0 0 0 0 0 13 12 5 0 11 0 0 12 0 7 0 23 0 26 0 14 7 0 0 4 0 0 13 13 
2 0 0 0 0 0 11 4 3 0 12 0 0 0 21 0 0 0 0 0 13 0 12 0 0 0 18 0 1 0 1 0 0 0 0 21 0 0 4 
24 2 6 21 23 5 0 0 0 0 0 0 7 0 0 0 0 0 14 0 0 0 0 0 13 22 0 14 0 6 1 2 2 0 0 0 0 0 0 
30 0 33 5 0 0 20 46 4 24 3 10 0 19 5 0 0 12 7 0 0 0 15 0 5 0 20 20 1 37 8 13 0 26 10 33 0 7 11 
0 45 44 23 0 4 19 15 0 5 9 0 15 0 0 0 11 16 12 0 0 0 9 4 0 12 23 18 0 0 6 0 21 0 0 0 0 0 6 
14 0 27 27 0 12 0 4 8 0 8 11 16 0 26 23 17 12 0 0 3 16 24 9 0 1 15 2 16 34 27 0 25 24 2 10 1 15 1 
4 0 17 14 0 35 20 0 16 0 0 19 0 0 11 6 16 0 10 11 0 9 0 23 0 23 0 0 10 8 59 2 16 12 0 0 46 9 15 
0 0 2 34 0 16 18 4 11 19 0 1 28 0 3 14 0 0 0 11 4 16 0 0 16 0 0 0 0 14 25 7 2 0 22 10 6 6 0 
0 0 20 24 21 0 0 0 7 7 3 34 0 23 0 0 0 0 4 0 0 4 13 7 0 12 17 0 0 26 0 0 2 30 32 0 0 0 0 
33 4 38 10 30 4 11 0 11 7 10 0 0 4 22 0 14 8 23 14 6 0 9 23 22 1 0 0 9 0 10 10 10 1 3 1 30 9 10 
2 12 20 0 0 4 4 18 0 0 0 0 2 1 13 0 0 0 9 0 0 0 0 13 1 0 10 0 0 0 0 0 20 0 0 23 10 0 0 
0 0 0 26 35 0 7 6 0 11 3 16 9 7 11 0 0 0 1 16 33 0 0 19 11 0 0 24 0 9 0 2 15 19 0 11 0 14 11 
19 44 0 14 0 0 18 0 32 74 11 3 1 0 9 0 27 0 4 5 0 11 13 0 29 25 17 10 0 0 6 7 10 0 18 0 27 68 0 
11 0 14 0 25 0 7 0 15 6 16 33 6 15 5 17 0 15 0 8 3 0 18 2 0 7 11 0 0 43 1 20 15 18 0 24 34 13 29 
0 0 0 4 0 41 18 0 0 11 0 0 0 0 2 0 0 17 12 0 15 5 0 0 0 0 1 0 0 0 12 0 27 0 0 0 0 0 4 
0 21 0 0 0 30 32 21 7 0 13 0 0 0 0 0 4 11 0 18 16 0 21 19 4 0 19 0 0 6 0 34 25 0 0 30 0 18 31 
0 0 20 5 0 0 19 0 10 9 0 0 10 3 2 7 0 0 11 3 25 0 42 0 7 19 5 14 8 0 0 6 0 2 0 17 6 19 15 
