39 22
2 6 30 0 0 75 0 8 0 10 21 12 0 16 0 0 0 9 16 18 9 10 4 0 14 14 12 8 14 11 9 29 0 4 12 0 7 36 23 
0 15 57 3 12 0 9 6 0 33 0 0 8 19 0 0 43 0 12 13 16 0 11 13 14 9 8 15 0 9 0 0 0 18 9 0 6 21 43 
2 0 0 0 11 0 31 23 0 11 0 0 0 20 0 0 0 0 14 0 11 0 0 0 5 2 6 1 13 15 0 4 14 0 27 0 0 21 0 
0 0 2 11 0 29 6 0 17 0 0 16 6 0 17 10 0 0 14 0 22 6 4 0 9 7 3 5 3 2 12 18 0 0 8 0 0 0 13 
29 0 4 28 0 0 5 0 0 0 0 29 0 0 0 9 0 0 0 7 0 0 14 0 6 11 9 0 0 72 0 8 0 27 1 15 8 11 47 
9 0 4 15 1 0 0 0 0 19 0 4 0 0 0 0 0 2 4 0 9 0 1 0 0 23 5 10 0 16 0 0 0 0 3 0 16 35 11 
11 0 2 0 1 0 0 44 0 16 21 23 0 0 0 1 5 1 0 7 13 0 0 12 4 15 31 0 11 3 0 21 27 13 10 0 2 10 0 
24 23 0 0 3 14 0 7 5 0 7 0 0 5 5 0 0 0 0 19 13 0 2 1 23 14 0 0 0 0 0 0 0 0 4 0 13 5 0 
8 10 17 0 20 0 26 0 0 0 33 10 33 1 1 7 0 0 4 19 0 2 11 0 0 21 3 4 0 0 0 3 42 13 13 25 6 0 17 
4 0 12 0 0 26 30 0 0 15 0 11 5 5 5 19 0 0 17 0 0 8 8 0 3 25 0 27 0 17 16 38 0 5 19 14 4 0 9 
0 36 0 7 16 15 1 0 0 0 7 23 0 0 7 0 0 0 0 10 1 0 0 0 9 0 1 0 0 25 3 0 0 0 33 6 0 31 0 
0 0 21 0 0 7 0 9 32 1 4 35 4 24 0 18 19 0 0 7 0 16 7 21 8 0 10 0 0 3 0 0 0 18 0 0 0 43 0 
16 0 6 22 1 0 5 0 19 15 1 12 0 12 18 18 13 0 0 0 0 15 11 0 11 21 2 1 0 3 5 4 17 19 13 0 7 18 2 
0 29 9 0 32 0 3 5 0 37 8 21 20 8 14 9 0 8 19 0 7 8 0 13 1 0 11 1 40 8 39 14 36 18 30 0 4 45 34 
0 5 0 2 11 17 15 0 3 0 3 0 7 0 17 17 2 20 0 7 0 0 11 17 20 13 8 0 38 0 3 0 17 3 0 0 0 13 0 
7 0 0 12 6 13 0 0 0 1 0 23 4 0 11 23 0 0 13 5 0 5 8 0 7 11 5 0 0 8 0 4 0 0 50 0 26 19 23 
28 1 36 17 0 0 19 24 0 8 17 4 12 0 11 23 0 1 15 9 0 21 0 15 0 23 0 0 18 0 7 31 12 0 41 0 1 4 38 
0 34 6 13 31 46 0 0 36 5 5 0 0 22 31 21 29 0 0 10 0 0 0 0 3 19 3 3 0 9 0 8 16 0 20 51 37 5 30 
3 0 25 1 0 7 0 0 4 24 0 0 0 23 1 7 13 12 5 2 17 8 0 0 0 0 16 13 0 10 0 0 10 49 15 0 0 0 12 
0 5 1 1 0 32 0 1 3 0 0 20 0 18 0 0 0 0 0 0 0 0 13 12 0 0 0 0 0 0 0 20 0 0 29 13 0 0 15 
53 0 0 27 1 19 21 1 17 19 0 20 0 3 0 12 3 0 0 0 7 0 0 0 19 4 3 23 0 16 5 1 0 0 0 35 0 0 0 
0 15 27 15 1 14 0 15 29 1 0 20 0 12 0 0 0 0 8 0 5 0 5 0 0 6 8 0 35 17 1 3 0 0 0 0 34 34 21 
