39 22
0 0 0 13 0 37 0 0 4 10 0 0 0 35 13 6 31 0 16 0 0 0 1 1 0 24 0 0 14 25 20 34 19 3 22 0 0 2 0 
12 4 20 0 0 58 4 38 0 0 0 0 12 0 14 0 0 3 1 10 3 0 2 18 17 0 0 22 26 1 0 0 31 11 0 21 19 10 17 
18 17 8 0 42 0 10 29 0 15 0 7 0 16 10 2 50 0 71 0 0 0 0 19 15 0 0 0 0 0 0 13 0 4 4 19 61 2 4 
0 0 11 0 11 7 7 17 16 0 3 4 10 10 0 10 4 0 17 10 4 13 12 0 0 0 7 0 0 7 28 0 16 7 9 0 0 0 0 
32 0 0 16 3 0 24 0 0 0 0 0 20 4 23 0 0 6 12 16 6 0 11 0 4 0 8 21 0 0 0 10 12 0 0 0 0 14 9 
5 10 7 0 3 0 0 7 8 0 0 11 0 0 0 8 0 8 0 11 18 0 13 0 0 8 10 0 0 9 8 0 13 14 9 0 0 11 34 
0 12 12 34 0 0 0 24 0 0 0 0 3 17 0 0 0 0 16 0 8 0 0 14 6 0 15 20 0 0 9 3 5 3 6 0 0 53 0 
10 12 0 12 18 2 37 4 4 0 0 3 15 23 16 2 8 2 0 0 0 8 6 5 0 11 0 1 12 1 0 10 0 21 4 0 23 32 0 
27 0 0 23 0 37 34 7 7 0 11 0 7 0 10 19 8 2 3 9 15 0 5 0 6 0 16 61 2 25 0 8 0 20 0 7 0 27 32 
15 3 35 0 0 27 0 25 9 4 0 7 0 0 0 15 0 0 19 0 0 3 5 0 3 9 8 0 0 0 6 0 25 0 9 0 0 16 33 
7 0 3 0 0 0 26 28 0 0 0 20 0 6 9 2 19 10 0 0 5 18 3 6 8 3 0 0 7 4 17 4 0 0 0 0 0 2 0 
0 2 0 19 34 0 30 6 0 11 0 0 5 5 0 9 3 13 3 21 0 12 3 0 20 0 4 8 0 0 9 8 5 10 0 0 30 5 0 
60 2 0 0 22 9 16 23 0 0 0 17 19 2 0 14 31 8 3 0 5 0 22 0 18 7 5 0 15 9 0 26 14 11 34 0 0 1 0 
8 6 0 19 15 1 10 0 5 10 4 8 21 9 12 10 1 15 14 8 12 4 0 0 16 2 3 0 5 0 15 7 2 24 0 5 0 26 14 
0 7 0 0 0 0 18 0 0 14 0 8 0 6 5 0 0 0 0 35 4 0 0 3 17 0 8 0 7 9 0 0 0 0 20 0 17 7 0 
4 0 22 34 7 0 1 19 20 0 0 0 1 0 0 0 0 7 0 0 13 16 0 0 10 0 1 0 0 0 0 0 0 7 0 27 0 10 0 
9 11 15 0 28 0 1 0 7 9 0 0 1 0 13 6 36 16 12 2 0 0 0 7 0 0 2 23 0 0 6 0 16 2 0 0 0 29 0 
48 9 0 0 0 0 9 7 0 0 0 23 0 0 15 16 5 0 4 0 0 7 6 0 0 0 8 22 7 0 7 4 0 0 23 0 33 0 38 
0 1 10 10 5 13 44 6 1 3 0 11 21 0 20 14 20 0 0 6 0 0 11 0 13 19 0 8 0 14 18 25 0 2 0 0 22 29 0 
0 9 0 0 7 0 0 0 5 5 0 18 0 5 8 0 6 0 17 0 0 0 15 22 0 7 0 0 0 0 0 0 19 4 13 15 27 4 0 
19 1 51 9 0 0 0 0 0 0 0 1 43 8 0 8 0 8 0 13 0 0 0 0 12 20 0 25 17 61 0 0 14 0 0 0 19 9 26 
30 40 0 12 13 10 32 0 23 21 6 8 26 28 19 7 0 0 14 6 0 17 3 17 0 0 0 13 10 10 30 44 25 13 21 33 35 0 30 
