39 22
13 32 23 0 0 0 0 35 31 1 11 6 4 0 13 0 4 12 20 0 0 42 17 0 16 0 31 13 0 35 0 0 6 25 0 0 0 30 24 
17 0 1 1 0 1 0 27 0 1 0 0 0 9 0 0 0 17 0 0 0 7 9 0 12 0 0 0 12 2 0 20 0 0 0 0 0 30 0 
16 0 0 0 0 3 14 0 0 13 13 0 8 3 0 6 18 6 6 0 0 3 0 24 13 19 7 15 0 0 0 0 0 0 0 19 12 0 0 
0 0 10 16 19 10 0 0 14 1 31 0 15 0 8 0 1 21 10 16 0 14 0 25 14 33 6 7 8 19 0 5 0 23 13 1 0 0 7 
0 24 7 0 3 7 27 3 29 15 0 0 2 15 0 15 19 0 0 9 8 31 0 33 9 5 2 4 9 0 0 4 8 0 2 36 1 37 30 
0 23 25 0 0 6 18 0 3 0 5 6 0 5 22 0 2 15 2 17 0 7 4 7 30 7 0 34 0 19 1 3 4 0 0 0 33 19 20 
0 0 0 0 0 16 4 14 0 0 21 15 6 10 11 0 0 0 10 0 0 16 0 12 4 5 15 0 1 0 2 21 0 0 0 28 0 10 0 
4 4 31 0 0 28 13 0 2 0 0 5 9 0 6 8 0 0 7 13 7 0 11 12 0 5 13 15 17 0 0 5 0 63 0 0 14 0 15 
2 0 0 0 0 15 0 2 0 0 0 0 23 0 0 0 0 11 6 17 15 0 0 0 0 0 5 10 0 1 17 4 0 0 0 4 0 0 4 
3 0 32 0 17 17 40 14 14 2 0 26 0 5 0 4 0 0 0 0 0 30 26 23 0 28 13 40 0 20 23 10 2 0 46 0 11 19 0 
2 11 27 1 0 6 11 23 0 15 0 0 6 0 5 9 13 0 12 0 10 8 10 0 16 0 26 0 4 0 13 0 6 0 18 5 33 34 0 
72 4 0 0 19 0 17 2 17 0 49 0 9 0 23 43 6 0 8 0 20 9 0 0 8 17 4 0 7 40 0 0 0 0 0 13 0 66 39 
5 18 32 0 0 0 0 0 10 0 0 0 19 4 0 0 0 4 17 16 8 14 0 5 7 9 4 0 5 0 7 18 0 6 19 13 0 7 4 
0 11 3 0 0 7 19 8 4 0 0 0 0 0 0 5 1 0 0 12 5 2 0 0 3 0 5 0 0 9 0 0 0 1 15 0 0 0 0 
35 17 31 0 0 0 0 25 0 0 0 0 10 0 0 3 12 19 10 0 6 10 0 0 0 0 6 8 12 2 0 7 25 31 3 41 28 6 0 
0 9 27 2 4 0 21 0 4 1 0 0 0 0 22 0 20 0 12 32 16 0 4 0 3 0 4 3 3 17 0 3 0 14 5 5 9 17 19 
0 45 16 0 22 18 15 4 7 0 9 16 0 0 0 0 0 8 5 15 19 0 0 18 11 32 18 8 0 0 0 0 11 0 0 0 31 10 37 
21 0 0 0 6 38 7 4 6 31 5 0 0 21 11 13 25 11 0 0 0 23 29 18 0 5 9 7 1 16 17 0 23 30 0 0 27 0 0 
52 3 20 0 0 0 0 10 0 18 0 0 0 0 0 1 0 0 0 11 0 0 34 0 0 0 0 18 9 0 0 0 0 0 0 4 36 0 16 
12 6 28 12 0 19 30 17 0 0 14 0 12 1 13 28 20 5 8 13 0 3 0 4 21 16 3 13 0 5 0 11 0 0 27 13 2 10 4 
17 0 7 0 2 0 0 9 26 25 0 0 22 0 23 6 11 15 0 0 0 14 15 16 18 0 13 13 0 0 8 4 0 3 7 0 5 54 12 
4 48 27 0 0 11 3 4 0 0 2 21 2 19 22 0 2 0 23 0 0 8 4 0 18 32 2 20 28 0 0 7 7 21 5 5 11 2 11 
