39 22
29 2 5 14 8 0 4 18 14 4 1 0 4 4 0 11 3 14 6 17 14 15 21 24 0 7 0 3 0 0 5 0 2 0 26 6 15 0 0 
40 16 33 0 49 0 3 9 5 8 6 2 12 17 23 20 4 18 0 8 21 0 42 0 11 5 5 1 0 0 0 9 20 0 0 15 36 21 34 
1 29 3 4 0 0 21 11 0 5 0 5 0 0 5 24 0 7 9 5 0 4 0 27 6 7 11 15 0 0 20 0 0 22 0 0 6 27 0 
0 15 0 27 23 0 0 0 0 0 0 0 25 0 0 3 33 6 13 4 0 0 18 0 1 11 13 23 0 14 27 4 1 7 18 9 0 42 0 
4 2 16 0 0 0 0 5 8 0 0 0 0 5 2 0 13 8 0 0 0 0 0 20 0 6 0 0 0 12 0 0 17 12 15 0 9 8 0 
0 25 55 2 0 20 0 20 0 13 53 34 16 0 5 0 23 16 0 14 4 4 45 13 21 20 33 28 2 0 0 0 30 23 23 29 14 11 30 
0 14 0 14 0 0 29 27 7 0 0 24 31 0 2 6 1 4 0 0 8 0 0 8 0 6 0 10 0 0 0 19 5 0 27 9 21 4 0 
11 0 0 22 0 0 0 0 0 0 24 21 1 0 14 0 15 0 0 4 0 0 5 0 0 0 8 23 1 3 0 19 0 3 24 0 3 0 2 
19 0 0 17 0 4 4 3 16 4 17 0 3 5 4 21 0 17 11 11 10 0 1 13 16 0 0 2 0 12 0 16 5 4 0 53 0 0 0 
18 0 0 0 6 0 0 7 12 0 18 0 16 21 0 7 2 17 8 22 0 1 8 23 3 0 16 0 5 0 0 0 0 14 21 0 0 0 0 
10 24 0 4 0 26 0 7 27 3 15 21 0 41 33 0 3 7 11 5 14 0 0 10 0 15 5 10 0 37 16 7 46 0 14 22 22 6 9 
12 29 0 3 0 0 26 1 10 0 6 0 0 0 0 0 0 0 0 0 0 0 26 0 18 0 0 0 0 0 29 0 5 0 28 0 4 0 0 
28 0 22 7 0 0 4 0 12 2 3 0 0 17 0 0 0 5 12 6 0 4 7 0 22 0 9 17 0 0 0 3 3 10 0 8 44 2 40 
43 7 0 4 5 0 0 15 5 5 10 0 5 46 0 0 0 12 4 0 2 3 6 13 4 5 0 0 15 0 30 0 0 0 0 0 0 24 25 
4 4 0 0 35 0 0 0 4 0 0 0 18 22 4 0 0 0 10 14 24 0 2 0 0 4 8 0 0 0 18 0 0 0 1 54 0 0 2 
18 0 47 25 0 2 3 4 0 36 0 0 1 5 0 11 15 1 10 0 0 7 0 13 0 7 19 0 14 4 0 7 6 4 0 0 4 0 29 
50 7 0 43 0 0 1 12 28 10 0 9 0 0 0 13 7 0 0 1 27 15 11 2 11 5 19 8 15 0 13 0 1 0 0 25 24 17 0 
23 35 0 29 10 0 0 9 0 0 11 20 0 12 12 0 0 5 12 11 19 13 37 8 0 11 26 5 9 26 7 0 0 0 13 24 14 1 0 
18 32 0 0 0 0 16 7 3 8 10 0 19 13 7 0 8 0 0 7 64 0 1 1 2 19 4 20 14 0 7 0 0 13 14 0 0 3 15 
0 0 0 20 26 0 0 2 0 0 7 0 0 1 2 2 2 13 0 11 2 0 14 0 0 0 0 2 0 0 12 0 0 0 0 0 14 0 0 
13 5 34 60 21 0 46 0 0 0 0 20 0 11 0 18 0 2 0 3 0 17 9 9 5 0 20 0 9 11 0 20 6 0 31 0 16 34 0 
0 0 0 0 0 0 0 0 0 14 0 31 7 11 9 20 16 16 6 5 2 0 61 13 0 14 0 18 8 0 0 0 20 17 21 13 0 9 0 
