39 22
38 1 0 49 22 0 0 5 1 9 24 3 0 7 31 5 22 0 1 5 32 18 15 14 11 0 26 0 0 15 2 20 0 19 0 2 6 0 5 
0 0 53 74 9 13 6 0 0 0 15 17 0 19 0 0 22 7 1 0 17 21 22 0 15 15 44 14 4 25 2 5 0 8 0 6 20 0 41 
0 9 0 2 15 14 0 2 0 11 1 1 0 5 0 0 0 0 0 0 33 2 0 0 4 0 11 0 18 2 0 0 0 13 0 0 15 0 0 
0 0 59 28 13 0 0 10 0 29 31 9 10 0 15 5 14 0 0 0 16 12 1 0 0 0 16 17 0 2 0 28 30 0 0 0 13 0 46 
52 0 5 0 0 1 18 12 0 12 8 0 0 0 4 18 0 0 0 0 0 2 0 10 21 55 0 27 0 2 13 8 0 20 10 0 0 0 14 
0 25 0 0 0 0 67 0 0 4 0 12 0 3 1 26 0 9 4 0 13 5 14 17 7 10 25 0 0 30 0 16 0 2 0 12 0 0 4 
0 29 0 32 10 0 15 25 0 0 13 0 2 2 10 11 20 15 0 6 0 0 0 0 8 0 0 0 0 23 25 5 26 0 4 19 20 0 0 
5 1 10 0 1 20 27 5 27 0 5 0 19 0 18 20 0 7 0 21 16 7 4 7 11 8 0 12 24 0 1 20 13 8 0 0 3 5 0 
12 1 0 0 0 0 20 0 26 0 0 8 6 13 1 0 0 0 6 5 0 0 3 0 0 0 20 0 6 0 12 0 0 10 41 2 0 13 4 
0 0 0 9 29 0 23 0 6 4 38 4 0 0 0 7 0 21 4 0 0 6 6 0 0 0 0 0 8 31 0 0 0 24 4 12 0 27 4 
0 10 31 17 2 0 10 14 0 0 0 2 1 13 0 6 0 0 6 14 17 14 0 5 6 0 0 0 0 0 9 25 11 12 6 28 7 16 0 
17 24 0 0 0 0 0 0 0 0 0 20 0 0 0 0 3 0 0 13 7 10 14 0 0 24 0 0 4 0 0 0 0 0 6 0 0 0 0 
0 0 0 14 5 18 18 1 3 10 13 0 5 0 8 0 7 14 0 3 22 0 0 18 10 19 1 7 4 6 0 10 0 0 1 7 0 2 0 
0 20 9 16 0 0 0 4 30 6 33 8 14 0 0 8 4 18 0 42 6 23 3 5 26 0 11 4 0 3 3 0 7 0 31 13 26 0 30 
0 0 30 25 25 13 0 24 4 8 0 15 0 0 0 0 0 7 0 7 12 13 0 1 0 1 0 20 19 10 0 0 30 5 23 0 0 0 0 
31 0 0 0 3 26 3 0 6 36 1 6 19 0 12 7 12 0 0 4 3 22 2 0 14 10 0 16 24 15 15 14 3 0 25 13 0 33 0 
0 0 0 0 0 5 0 0 0 12 0 0 0 17 8 1 19 18 0 2 0 16 1 15 4 0 0 0 10 3 4 8 0 12 30 20 17 3 0 
6 26 33 3 15 0 13 16 0 0 11 0 0 4 17 0 0 4 0 0 2 0 2 17 8 0 4 32 0 8 13 0 0 0 8 45 24 23 6 
0 11 0 21 0 18 0 8 23 0 0 16 1 0 4 1 9 31 25 13 2 0 2 23 33 18 12 16 7 6 0 0 10 5 0 0 0 20 10 
15 12 31 0 0 3 0 0 0 0 6 36 4 8 13 12 0 12 7 20 25 4 24 0 0 3 6 0 7 0 1 20 2 32 10 24 0 0 0 
12 0 0 22 0 0 18 5 56 0 0 0 5 7 0 50 15 16 0 7 13 0 5 15 60 22 32 0 14 0 19 5 0 11 26 14 0 22 55 
15 18 0 0 0 25 11 0 1 0 0 16 0 32 0 0 0 15 0 29 0 21 13 10 17 0 1 0 0 0 15 0 0 0 21 1 42 20 0 
