39 22
45 34 6 17 18 13 6 13 42 11 27 14 16 30 11 0 0 1 14 16 15 13 21 19 0 1 27 7 19 31 19 11 13 1 11 3 0 19 24 
0 0 0 0 0 0 10 6 6 12 0 20 0 20 9 7 14 0 15 0 0 12 16 14 15 3 20 0 8 20 20 25 3 0 0 0 13 5 2 
3 34 12 18 0 0 6 4 22 0 0 18 0 23 4 27 0 28 5 8 0 0 15 20 9 3 0 8 0 23 20 12 0 7 0 34 28 22 23 
0 0 6 27 4 0 0 0 18 0 13 0 2 0 4 0 0 0 10 0 3 0 0 0 0 24 0 25 0 8 16 0 3 0 5 4 6 18 0 
17 0 32 0 21 0 0 0 0 0 2 9 27 10 22 0 12 17 0 3 13 12 0 0 0 14 0 0 8 5 10 15 0 0 37 35 22 0 13 
16 0 0 0 0 0 6 0 0 0 3 0 10 24 4 4 0 0 0 4 5 0 0 5 0 1 0 0 20 5 0 0 22 8 5 0 0 14 0 
47 0 0 0 0 0 0 26 6 0 45 10 9 9 14 3 6 6 13 23 8 10 6 0 0 0 0 0 0 0 0 0 22 40 0 0 0 37 0 
0 31 0 0 6 0 20 1 19 0 0 5 0 14 12 6 9 0 0 0 0 17 0 15 0 10 9 19 2 0 0 4 5 0 0 2 0 23 17 
20 0 6 15 12 24 0 0 24 10 0 16 4 14 20 6 12 17 0 2 0 2 5 0 0 0 0 9 0 0 5 7 24 0 12 0 0 3 4 
31 3 31 27 3 17 13 4 1 0 29 13 2 3 4 37 12 6 14 0 8 0 24 17 12 10 18 14 5 0 10 13 24 66 0 9 32 10 4 
7 15 14 2 0 2 26 0 0 10 0 12 26 0 0 0 31 0 0 3 0 2 2 5 0 13 12 0 0 6 0 20 0 0 8 6 0 0 7 
15 0 8 0 0 12 0 6 6 21 22 20 2 2 6 0 16 0 0 12 4 11 2 0 4 10 6 0 2 9 46 23 11 13 24 6 0 0 9 
0 0 0 42 0 0 9 9 1 0 0 1 0 7 0 22 12 0 0 3 4 6 8 0 4 10 12 0 1 0 9 0 10 6 0 14 0 0 13 
0 0 0 23 1 3 6 4 6 13 0 9 16 16 3 29 3 0 10 19 0 6 22 6 4 11 1 1 2 0 0 0 0 0 11 0 17 0 0 
0 0 12 0 0 68 32 0 27 0 11 4 1 10 11 23 0 0 10 0 17 17 0 0 0 8 13 19 4 2 0 0 6 0 0 0 0 32 21 
46 0 16 0 5 0 0 8 0 9 6 0 14 14 0 0 0 0 1 0 0 6 0 0 0 0 8 0 0 0 0 0 0 0 0 18 0 37 26 
24 0 0 7 0 10 6 4 0 0 0 9 0 8 0 0 0 0 15 0 9 20 0 11 15 0 0 0 32 0 0 0 5 0 34 12 0 17 33 
61 25 0 34 39 27 0 3 9 0 1 23 0 0 0 40 7 0 0 16 1 20 0 7 24 4 25 27 0 2 17 0 17 8 34 30 32 0 8 
26 40 27 11 9 0 12 0 0 17 0 1 16 0 8 0 15 21 13 0 1 12 1 18 8 0 0 15 22 24 4 4 0 3 34 0 27 0 27 
0 1 22 0 0 0 0 0 0 0 0 6 0 24 0 10 6 11 12 19 0 0 0 0 22 10 0 1 1 0 0 17 0 0 0 0 0 28 18 
0 0 6 0 1 1 0 8 0 0 0 25 5 6 14 22 0 0 0 0 16 0 13 5 0 0 13 0 0 20 0 0 17 0 0 8 6 0 0 
0 0 23 0 0 0 0 0 0 0 15 20 0 0 8 0 9 20 3 0 0 3 0 1 19 4 14 0 9 10 9 17 0 0 0 0 0 21 1 
