39 22
11 28 0 25 11 0 30 22 0 9 0 0 0 0 0 0 0 10 0 2 0 27 0 14 0 10 0 0 21 6 0 12 4 0 3 10 30 0 37 
0 0 0 4 0 0 3 0 5 0 0 0 0 20 0 0 0 0 0 0 16 20 17 0 5 6 0 20 0 6 0 0 8 0 2 5 0 0 0 
19 0 0 0 2 18 8 12 0 3 0 0 0 0 6 0 0 0 0 13 2 0 0 53 1 1 0 15 0 0 15 1 0 0 0 3 0 7 15 
0 0 1 0 27 1 21 0 3 0 20 9 6 22 11 0 13 5 5 3 3 0 0 25 0 5 6 2 0 0 13 0 9 0 8 1 0 1 0 
11 27 27 0 0 4 0 9 11 6 17 9 9 0 2 0 9 6 3 10 2 24 1 17 0 0 0 2 27 29 25 0 0 0 16 0 17 1 19 
34 0 0 26 2 32 7 6 27 5 28 4 5 0 18 3 15 10 0 0 7 17 14 53 9 9 12 22 1 32 11 23 4 19 8 9 5 17 41 
2 45 14 19 25 5 3 9 0 0 23 17 20 15 4 22 1 1 7 15 12 15 21 28 1 34 12 2 5 12 6 5 24 8 0 1 35 30 13 
1 1 0 0 6 0 0 16 3 9 0 15 2 12 10 0 4 0 1 3 0 0 0 3 10 1 0 15 4 0 0 0 0 4 0 0 14 0 0 
0 33 0 7 24 6 9 0 16 0 13 0 10 0 2 14 2 0 6 0 11 0 2 31 18 0 4 0 35 24 4 0 0 0 33 3 1 0 0 
0 9 15 21 24 25 9 0 0 9 1 7 0 0 10 9 21 25 0 0 14 2 0 7 53 0 0 4 24 0 3 0 4 1 14 0 4 46 21 
50 0 0 7 2 24 20 0 11 0 6 0 0 0 34 4 0 0 0 0 0 8 0 8 0 0 8 0 3 16 0 5 0 2 17 0 22 11 5 
2 0 0 0 0 5 23 0 11 5 2 0 38 0 0 1 0 2 0 2 0 13 14 0 3 0 0 15 0 28 0 1 0 3 0 26 6 0 4 
0 37 23 35 1 12 25 0 0 6 6 5 5 25 7 18 9 7 0 13 13 11 9 0 0 11 24 1 10 33 9 20 1 10 23 0 2 35 1 
0 0 0 0 32 4 0 0 3 18 4 0 0 0 10 3 0 0 0 0 0 7 5 0 2 21 4 41 0 0 4 0 1 0 0 0 0 0 0 
0 0 2 12 4 0 0 11 3 9 19 0 0 20 11 23 21 0 0 2 7 0 0 14 5 0 37 6 6 0 6 0 0 23 0 0 6 21 0 
1 0 14 1 7 5 5 31 22 7 0 0 5 14 7 14 0 4 16 13 0 7 20 0 9 0 13 0 0 0 19 9 16 20 6 0 4 25 8 
0 0 28 0 0 33 10 0 0 5 0 0 11 6 0 3 13 8 0 0 0 14 0 0 0 8 0 0 0 0 17 4 0 9 0 0 3 0 33 
4 0 2 0 24 25 0 7 0 0 8 0 9 17 15 0 0 0 5 0 3 0 0 4 0 2 9 24 35 0 0 0 4 2 0 10 0 0 0 
9 9 28 0 7 0 0 0 25 35 23 2 0 12 19 0 0 0 0 0 6 2 0 21 0 0 3 0 18 0 44 22 0 62 0 0 0 0 0 
34 0 0 13 42 14 14 19 0 0 16 1 8 0 19 0 0 0 0 13 14 5 11 0 0 3 10 24 8 9 2 0 28 0 56 0 3 0 9 
71 55 30 0 32 20 23 11 0 0 0 0 16 4 0 0 6 0 0 20 0 7 3 18 0 27 17 0 6 0 0 31 26 8 0 0 4 0 0 
12 0 23 10 0 16 16 0 0 17 0 11 16 15 0 1 1 2 0 0 0 11 0 0 0 0 3 26 0 8 17 14 0 4 0 0 0 0 0 
