39 22
7 0 0 16 1 9 31 0 17 4 27 17 2 8 37 7 0 21 0 10 8 0 8 14 3 10 9 4 0 0 8 25 11 4 20 21 0 22 0 
3 0 15 28 9 0 0 0 0 0 13 7 3 0 10 0 16 0 0 16 0 0 0 0 10 0 0 5 0 0 0 0 0 0 0 0 0 10 0 
28 42 9 0 0 2 1 15 0 18 17 0 5 7 16 11 15 5 9 0 11 1 5 0 13 6 2 10 8 5 16 35 0 14 0 0 0 0 5 
19 0 25 0 14 0 26 22 0 16 7 23 0 2 0 7 4 14 21 19 4 0 2 6 11 1 2 1 1 22 12 46 21 0 4 0 0 0 0 
0 0 34 0 22 0 0 0 0 7 0 0 4 0 24 4 0 5 4 0 0 0 3 9 12 0 22 0 6 0 0 0 10 6 0 0 34 0 0 
0 23 0 0 0 9 0 47 0 6 4 12 0 19 5 5 0 26 0 0 6 8 0 5 30 0 8 6 2 19 0 0 16 0 7 4 29 1 13 
5 15 13 30 0 0 0 26 3 24 0 3 0 14 15 1 16 14 0 16 0 0 28 5 0 2 1 19 3 0 0 1 0 9 0 4 0 0 16 
27 0 31 23 0 27 24 18 20 7 1 19 0 7 5 8 0 0 14 0 0 0 10 3 2 30 22 9 18 0 55 0 4 0 4 4 0 0 0 
0 1 1 0 0 10 0 0 0 0 0 0 11 8 0 6 4 0 8 8 8 0 6 0 0 2 0 3 6 0 0 15 1 0 8 0 9 0 0 
0 12 0 31 30 9 43 20 3 30 19 16 24 0 0 0 1 12 2 0 9 0 0 6 4 9 12 8 21 15 21 0 6 0 22 14 0 0 0 
1 31 35 9 23 9 0 5 0 8 7 3 0 26 21 5 19 6 16 0 0 3 36 21 0 0 0 23 0 2 19 8 16 11 0 22 0 0 0 
9 0 9 1 1 22 12 0 8 40 0 0 0 0 5 0 8 19 10 0 0 14 7 5 0 0 2 22 0 0 0 0 15 26 0 16 42 10 0 
0 37 0 9 29 11 0 22 7 44 21 7 9 25 3 21 33 2 0 9 0 0 0 21 20 7 7 3 0 39 13 3 0 16 23 17 0 49 92 
0 0 19 0 0 0 0 26 0 0 0 3 19 18 0 8 0 6 5 5 0 21 6 0 5 9 0 0 11 0 0 7 1 35 10 0 0 1 0 
0 5 0 0 0 8 18 0 0 27 7 0 0 15 14 0 0 0 0 0 0 3 4 14 28 0 0 8 0 0 2 0 19 0 1 17 25 0 0 
0 6 0 29 0 0 0 0 0 8 0 0 0 1 0 0 1 16 0 0 0 4 6 0 10 5 2 0 5 0 12 18 27 1 9 3 0 0 3 
1 36 20 0 9 2 0 10 0 0 10 23 2 11 26 4 0 20 4 26 10 4 0 0 5 29 0 9 0 9 0 26 0 14 11 0 41 58 11 
0 0 14 0 5 0 2 15 1 0 12 36 0 18 4 16 1 5 5 0 6 2 30 20 8 0 0 8 1 11 2 34 2 0 5 32 1 29 44 
0 9 9 1 2 0 0 27 0 9 36 0 0 12 8 33 0 0 9 0 0 0 4 10 4 18 4 12 3 0 4 19 19 0 46 0 26 0 0 
13 4 13 0 0 18 0 0 7 16 0 0 11 9 0 0 0 2 18 0 0 12 8 7 0 15 0 0 0 2 0 2 2 5 0 0 0 0 7 
34 1 0 0 4 0 2 0 20 17 0 0 2 0 2 0 0 22 0 2 18 5 10 0 2 20 12 0 0 0 33 0 0 3 14 0 0 0 4 
6 67 0 28 24 0 6 0 0 0 20 0 10 0 18 15 0 16 31 0 7 17 14 11 14 3 0 4 5 0 21 10 1 0 18 9 0 0 22 
