39 22
33 32 32 0 28 13 27 26 29 13 0 11 0 15 0 0 3 0 3 14 0 23 20 0 18 0 0 2 7 2 17 0 8 24 0 0 0 5 0 
0 0 0 4 25 0 2 0 0 0 0 0 0 0 0 5 0 2 0 10 0 13 10 0 0 9 0 23 0 6 0 9 0 0 0 7 0 0 0 
11 8 0 38 15 0 0 0 20 0 6 0 24 15 0 36 14 17 0 3 19 0 2 0 7 18 23 15 14 13 2 8 17 11 17 24 0 0 0 
3 0 2 6 0 12 5 8 44 20 0 0 0 0 0 8 12 2 2 8 1 2 0 2 2 0 10 0 0 0 0 15 0 0 0 27 0 0 0 
29 0 0 19 0 0 8 23 1 4 31 25 5 0 5 6 0 14 0 0 1 17 19 19 0 2 16 0 0 0 0 8 0 2 1 0 26 0 27 
0 12 33 5 0 14 15 0 22 0 0 6 21 0 0 11 1 1 0 14 2 12 2 21 21 8 1 8 0 6 5 0 15 21 1 41 0 34 15 
23 4 0 30 0 0 1 1 7 0 7 2 3 0 0 0 4 0 0 1 0 0 0 23 2 12 0 8 0 7 4 0 0 0 0 32 0 12 0 
0 0 0 0 21 21 31 0 0 0 19 3 19 22 0 11 0 0 0 5 0 3 0 0 0 29 1 6 16 25 0 0 0 0 0 0 0 31 25 
0 0 15 26 0 13 2 0 2 0 0 2 0 4 6 7 15 39 12 16 0 3 0 7 2 0 0 4 0 20 0 11 0 0 0 9 2 20 0 
0 36 7 11 0 0 2 0 12 0 10 0 3 0 11 0 2 17 1 0 9 11 0 0 0 0 0 7 0 19 0 0 0 9 0 0 0 0 0 
0 0 0 33 0 0 0 29 8 0 0 0 0 3 0 0 5 0 1 0 11 11 0 0 8 12 0 0 0 0 8 3 0 0 0 5 31 0 31 
6 0 10 0 9 9 6 0 23 0 13 18 0 0 0 0 2 15 11 10 18 0 22 0 12 0 16 17 17 20 12 21 15 0 4 10 13 0 40 
0 22 10 21 21 30 9 12 18 5 0 17 76 6 13 8 0 26 24 10 5 6 13 6 0 22 5 11 7 10 22 21 29 21 0 23 5 0 0 
0 0 13 0 53 0 32 6 51 17 0 0 0 0 0 0 7 4 0 0 9 14 14 0 0 0 17 2 7 1 3 15 0 4 0 31 0 0 62 
12 17 10 0 31 0 10 5 0 20 7 7 24 0 0 13 22 2 7 12 0 13 34 0 0 0 54 8 50 27 0 48 0 29 0 13 54 11 0 
13 38 24 0 0 24 34 29 19 18 1 37 30 1 4 0 2 15 15 0 9 7 3 1 2 41 23 0 1 2 4 19 24 27 0 0 26 0 37 
3 0 2 1 0 3 0 2 0 9 0 0 0 4 24 0 4 0 0 0 0 28 0 0 0 0 8 25 7 0 0 29 0 0 10 0 1 16 2 
23 12 27 0 0 0 10 18 9 14 0 0 8 5 21 9 15 30 0 17 0 4 8 17 0 5 0 0 11 17 0 16 0 0 6 6 1 5 0 
15 31 20 0 17 0 31 19 0 23 5 0 24 0 0 2 6 14 6 17 4 10 21 0 15 4 6 0 16 4 4 10 54 26 1 0 29 31 28 
0 51 14 0 0 0 6 1 14 0 10 12 13 0 0 0 14 0 7 0 0 9 1 0 0 1 3 6 3 24 9 0 0 13 0 34 0 0 0 
26 17 14 6 2 11 7 0 24 12 14 6 0 0 0 38 3 0 17 0 0 7 1 8 15 9 23 0 12 8 0 16 15 0 8 0 9 0 0 
24 9 0 0 19 53 9 7 12 17 16 6 2 0 12 19 0 2 0 12 0 0 0 17 1 0 17 0 1 0 0 9 8 3 3 10 3 4 0 
