39 22
7 34 33 0 0 50 0 17 0 0 0 10 6 13 0 20 10 8 15 4 15 0 0 23 0 17 0 11 0 0 27 0 0 0 0 23 0 0 0 
21 15 3 0 0 3 19 35 0 0 12 14 6 16 12 0 0 34 3 8 0 21 10 13 0 3 13 36 6 0 30 7 0 2 0 24 9 30 21 
28 0 0 0 0 0 0 31 0 32 0 5 24 45 0 0 20 11 2 0 13 1 1 9 8 10 11 1 34 0 2 20 0 0 21 16 49 5 8 
1 0 0 22 4 5 0 0 27 0 0 0 9 0 2 0 12 3 26 0 5 0 0 0 2 23 0 9 2 0 0 7 1 3 0 9 0 0 5 
0 0 17 20 8 12 16 2 0 18 0 8 1 2 5 0 0 25 0 7 4 0 0 0 17 3 0 0 0 8 0 6 2 14 2 0 7 0 0 
36 0 10 0 0 0 33 0 7 13 0 0 11 9 16 5 2 0 2 21 12 0 0 9 2 0 0 8 0 0 52 9 6 25 0 0 6 0 0 
2 1 20 18 2 0 25 16 0 0 0 31 32 23 0 13 0 0 0 20 14 21 0 0 10 0 0 2 0 0 0 10 27 1 44 14 22 11 25 
0 0 0 19 0 0 0 0 0 5 0 24 0 25 12 0 13 0 0 14 0 2 0 0 4 6 2 0 7 0 0 0 0 14 0 7 0 1 52 
16 0 0 3 13 33 0 27 0 0 0 41 9 11 3 0 12 4 10 11 0 18 0 0 0 1 17 10 1 4 8 6 1 5 50 14 0 5 38 
22 2 16 0 15 2 0 0 0 0 0 0 0 0 0 0 12 17 15 10 0 1 18 0 2 19 11 0 0 0 1 38 4 0 2 3 3 18 0 
22 0 2 0 36 0 0 0 16 1 0 3 11 0 0 11 0 8 0 0 6 12 0 10 17 0 2 0 11 0 7 0 17 0 0 6 1 37 28 
0 33 25 31 0 45 0 0 0 22 3 14 23 12 0 7 0 0 0 7 0 0 14 8 2 24 0 14 23 0 0 22 0 4 6 32 0 21 0 
0 0 8 0 23 0 2 0 20 8 15 8 21 0 5 0 6 0 17 7 0 0 0 4 9 0 6 24 0 4 0 7 3 25 0 17 0 8 0 
21 0 22 6 0 7 10 0 0 39 1 6 6 7 0 0 4 10 18 5 19 8 14 0 6 3 3 8 22 18 8 0 0 20 5 5 14 31 0 
25 0 0 6 0 0 1 13 0 7 0 20 0 18 0 11 0 0 19 4 0 0 13 11 0 39 4 8 0 18 3 0 0 0 21 0 0 25 0 
23 20 4 0 0 32 0 5 3 3 0 37 19 2 1 0 7 0 15 2 1 7 1 37 3 1 0 10 4 5 0 1 0 1 33 3 13 42 0 
10 0 28 0 0 0 0 0 30 0 0 3 26 18 0 5 0 0 3 0 6 12 1 7 9 1 6 0 0 16 28 8 1 2 0 16 0 24 56 
10 0 0 21 0 32 0 26 13 0 0 25 9 8 19 0 0 10 0 6 3 12 1 0 13 0 19 0 0 0 4 0 8 2 10 0 25 9 14 
0 18 0 0 30 20 0 0 23 16 0 4 0 5 25 4 9 15 0 6 0 0 11 4 0 2 4 0 8 0 17 40 0 0 51 3 8 0 0 
0 10 22 29 0 10 0 24 24 38 0 0 0 0 12 0 0 0 37 13 0 0 14 0 22 16 0 0 4 5 0 20 40 11 29 3 4 10 0 
27 0 0 10 0 11 45 0 0 8 26 0 1 10 0 11 31 0 2 7 4 0 3 0 23 0 2 35 0 23 29 5 10 2 5 33 0 7 0 
4 0 0 0 14 21 16 15 5 19 0 16 0 5 0 2 0 29 0 0 0 13 1 1 2 0 5 29 24 0 0 0 12 0 12 0 0 0 0 
