39 22
0 3 0 0 3 0 11 0 0 20 0 0 19 4 0 18 0 11 3 6 0 21 0 0 0 0 0 20 0 0 9 1 1 12 0 19 0 15 0 
74 35 5 4 2 24 0 19 0 27 0 0 18 0 0 15 0 0 0 0 18 0 0 5 1 19 0 0 0 25 51 0 0 33 11 35 46 14 0 
17 22 0 0 3 0 0 12 0 0 15 10 0 21 3 0 3 3 0 17 0 0 0 0 0 7 0 0 35 0 0 14 0 12 0 17 36 27 14 
0 0 21 13 23 30 4 0 29 14 0 0 18 0 0 50 7 0 16 0 0 12 0 7 6 15 0 26 0 17 2 0 0 0 19 30 0 25 17 
36 2 10 0 48 0 0 19 21 12 1 0 1 13 13 8 7 0 7 11 0 0 0 0 5 0 0 0 14 16 0 0 0 4 0 0 68 28 0 
8 0 12 7 21 7 14 0 5 14 11 0 0 3 20 13 15 4 0 4 0 0 29 5 0 20 22 0 0 0 27 5 27 1 0 33 0 2 0 
83 0 27 27 4 0 9 26 12 17 4 4 6 0 0 9 8 17 9 0 0 2 0 24 12 2 23 24 0 6 0 20 12 13 34 24 24 0 11 
18 24 36 0 11 2 3 0 2 13 18 33 0 11 0 0 0 0 0 3 8 0 10 5 0 26 11 8 13 1 12 0 6 5 0 16 0 26 37 
2 36 1 1 0 30 1 0 9 0 0 0 9 0 0 0 0 2 0 0 0 2 7 0 5 0 3 0 0 13 0 10 0 0 0 30 0 36 0 
28 0 0 4 0 8 0 0 29 9 0 5 4 1 1 0 0 0 3 7 0 18 2 0 4 0 0 0 0 0 9 0 0 0 3 4 0 24 11 
2 0 3 0 0 10 0 29 0 7 24 6 12 0 11 0 16 2 0 0 0 13 3 3 22 9 0 0 0 0 0 0 0 0 37 0 38 0 0 
5 25 27 0 31 21 0 9 21 0 0 0 0 11 7 5 2 6 15 5 9 0 0 14 0 0 43 19 0 25 0 0 0 10 6 28 0 14 63 
1 0 11 21 22 0 7 0 0 0 9 0 9 6 10 0 7 8 0 9 0 0 0 0 32 17 5 0 0 25 3 0 1 8 12 0 3 0 0 
42 0 22 36 4 14 16 0 0 2 0 1 0 7 14 0 8 0 11 0 0 0 10 23 21 2 1 8 0 0 30 8 7 0 4 32 0 0 24 
8 46 14 0 0 7 2 0 3 4 0 4 4 32 0 0 8 3 11 0 3 0 9 14 4 0 0 0 0 5 0 0 0 12 2 34 0 5 20 
37 0 0 8 3 2 1 7 20 8 3 0 10 24 0 38 16 17 0 0 0 0 3 29 17 0 9 28 6 0 2 16 31 0 0 35 10 20 23 
5 0 0 2 0 0 2 16 5 5 21 0 2 0 0 12 5 9 0 0 0 0 11 12 3 14 0 3 28 12 29 36 5 25 0 6 0 12 17 
15 0 0 0 0 0 1 0 0 1 5 0 9 13 22 10 21 0 0 7 0 9 0 5 0 23 7 0 5 36 9 0 0 0 0 1 22 0 18 
35 0 0 0 19 39 25 22 0 9 40 13 2 4 15 0 18 9 22 17 15 1 13 1 0 13 23 1 6 22 1 11 12 32 0 11 55 14 0 
8 0 47 0 0 0 18 14 24 9 0 5 19 1 0 14 7 15 7 0 20 25 0 0 6 7 0 1 0 19 42 29 26 12 0 35 0 29 0 
0 9 0 18 9 7 3 3 4 5 9 2 8 15 0 14 14 0 0 0 17 0 0 4 3 22 0 19 0 21 0 0 0 0 10 28 0 6 34 
0 11 0 1 17 33 15 0 0 0 0 0 25 14 0 0 5 0 0 0 0 6 16 15 0 6 0 14 0 4 18 0 0 9 0 0 3 32 4 
