39 22
30 9 0 1 4 0 2 2 74 16 24 5 0 0 4 35 11 0 0 15 1 1 0 0 38 0 15 21 0 22 67 1 30 32 0 0 4 0 13 
19 0 0 33 4 19 0 24 0 31 0 0 0 0 0 4 16 0 2 26 9 0 15 0 34 0 0 11 13 3 0 15 18 7 5 32 27 21 0 
16 35 0 30 27 24 2 0 15 1 13 0 10 0 8 0 7 8 10 0 0 0 0 11 0 5 0 0 35 28 0 4 2 44 0 21 0 0 13 
0 0 13 0 1 13 1 7 10 0 16 0 2 0 0 0 0 0 0 2 0 0 0 11 0 1 7 2 0 0 0 0 0 0 11 0 0 0 2 
0 0 0 0 31 22 14 3 0 6 0 0 0 0 27 0 0 0 0 1 0 0 0 14 0 0 0 15 0 14 25 3 4 19 11 26 9 0 0 
0 0 0 3 4 5 15 6 0 4 0 4 17 4 11 14 9 21 6 18 0 0 0 0 11 9 13 0 0 0 6 6 23 9 0 0 6 50 32 
22 4 5 39 0 0 0 36 16 1 0 0 0 7 2 0 13 0 20 16 11 1 3 15 0 7 28 27 1 2 0 34 19 16 6 13 0 6 20 
0 2 0 0 18 3 0 3 0 3 0 0 12 17 14 10 14 3 0 0 0 20 19 39 3 0 4 3 0 13 13 0 0 0 0 0 0 0 7 
23 0 0 0 15 18 12 8 0 0 24 0 0 0 16 12 0 0 11 19 10 0 5 25 0 0 0 0 10 7 33 3 5 8 18 0 0 8 4 
15 6 0 4 1 7 4 10 7 14 18 19 0 13 1 24 30 0 9 12 1 0 3 1 13 16 18 0 0 4 27 35 9 0 1 5 12 0 22 
0 45 0 0 1 0 0 6 0 3 0 20 0 0 2 10 3 0 0 3 6 0 2 1 11 0 7 6 0 14 0 20 0 0 11 20 6 0 23 
3 0 17 10 1 3 0 0 4 25 13 34 17 6 10 31 10 7 0 9 14 0 23 0 5 0 12 5 4 25 0 25 22 0 23 20 0 0 0 
0 46 0 29 0 0 0 28 12 18 0 5 31 7 6 8 18 3 14 0 30 0 5 7 4 3 1 10 13 0 5 0 9 10 10 33 0 7 0 
7 32 0 0 0 8 0 0 18 0 11 21 5 18 21 0 0 0 0 7 0 0 1 9 2 0 1 13 6 1 0 12 38 36 0 21 8 0 23 
1 0 0 5 12 2 0 22 0 43 0 0 1 1 5 0 0 0 0 0 0 0 0 0 0 0 0 0 0 22 5 0 5 7 25 0 5 1 0 
57 25 10 0 22 4 0 0 4 17 0 0 10 0 0 15 0 0 0 19 3 0 3 3 0 0 1 5 0 6 6 6 5 0 8 13 46 3 21 
0 0 1 4 14 2 4 12 9 14 0 2 1 0 0 3 1 1 8 0 18 16 0 0 0 0 0 0 0 10 0 0 1 1 1 0 0 16 0 
2 3 9 0 2 14 8 1 26 22 0 5 12 8 0 11 8 0 0 18 13 3 11 0 31 0 0 0 4 0 17 3 0 0 27 0 13 0 0 
16 0 19 1 4 25 2 47 33 4 24 0 23 0 11 1 5 0 0 0 14 23 12 11 18 0 16 0 31 14 16 11 30 21 0 0 5 29 0 
11 0 0 13 0 2 0 15 8 6 21 6 10 1 3 24 0 9 15 0 0 0 8 12 0 0 9 8 3 0 0 11 0 0 19 0 4 3 7 
26 0 0 0 31 0 22 0 20 0 1 11 4 0 0 6 35 0 0 0 0 21 12 13 0 0 20 8 2 1 0 3 0 0 8 50 13 0 0 
10 0 0 30 0 0 0 0 26 0 2 21 2 0 9 0 46 0 0 0 14 0 0 0 0 9 3 11 4 11 0 0 0 37 8 19 12 0 0 
