39 22
32 9 0 29 21 9 0 18 0 0 16 40 0 0 0 0 7 0 7 10 0 2 0 9 13 24 14 4 0 0 0 4 6 0 29 0 0 0 27 
8 0 0 26 0 0 0 0 0 5 0 9 24 0 18 0 0 3 0 17 3 7 1 3 0 0 0 0 0 14 0 18 0 0 20 0 0 0 26 
0 45 17 17 1 1 12 22 2 13 2 35 13 0 0 0 6 0 11 35 13 2 0 12 0 5 4 0 14 6 0 7 0 0 0 17 18 11 7 
0 9 61 22 26 0 0 0 0 13 13 23 2 0 6 4 9 0 0 0 6 18 2 0 0 16 24 0 0 18 26 2 0 0 0 17 34 42 0 
2 1 0 11 17 53 24 0 0 7 0 0 9 4 8 0 0 21 12 2 0 3 6 0 16 19 0 28 17 5 24 0 0 0 18 0 8 32 4 
0 0 2 18 15 12 25 0 0 0 0 0 15 5 0 0 0 0 16 14 0 9 0 19 0 14 0 29 12 0 15 49 0 0 0 0 0 4 0 
0 4 3 0 0 18 8 44 16 0 0 3 4 0 10 0 0 0 6 0 0 13 13 0 0 0 6 12 14 0 23 0 2 0 0 0 0 0 0 
0 11 0 2 0 17 6 0 3 0 0 22 9 1 1 0 7 0 0 0 0 0 0 18 0 14 0 0 1 8 6 5 0 22 9 0 0 5 0 
0 0 7 7 6 0 3 10 0 44 11 9 0 11 8 0 14 24 6 12 9 7 1 17 19 8 2 0 11 13 20 0 18 0 0 0 2 0 35 
21 9 0 53 19 5 41 1 5 0 35 0 0 0 0 0 0 0 0 8 24 2 0 4 21 0 5 13 0 19 4 4 0 11 0 25 0 4 32 
27 0 0 0 24 0 0 0 0 22 0 9 0 6 19 0 0 0 0 10 0 0 13 0 0 0 26 0 35 2 0 24 2 19 32 35 0 7 10 
34 0 3 28 0 0 8 1 0 22 31 0 8 8 24 13 0 18 7 0 0 7 0 0 0 15 0 0 0 3 0 0 32 23 6 18 0 28 53 
3 8 4 55 1 12 11 0 22 0 0 2 0 10 6 0 4 11 0 2 20 2 0 3 0 9 0 0 0 0 22 2 0 20 23 0 0 34 2 
0 0 0 24 15 1 5 11 1 1 38 0 14 0 10 0 0 5 0 23 0 0 0 8 7 8 13 24 1 0 8 21 0 0 0 36 8 0 0 
0 35 3 23 0 47 27 0 5 2 23 0 0 3 7 0 0 0 0 0 0 9 0 19 1 0 24 1 0 3 0 0 0 23 0 0 4 0 2 
0 0 4 28 1 19 19 15 26 13 2 26 13 5 0 3 7 1 0 0 6 17 19 16 17 7 0 4 0 14 23 4 0 9 2 27 12 39 35 
3 12 4 18 24 9 0 24 1 9 2 27 10 13 19 0 0 0 14 0 7 11 0 0 12 0 0 19 23 4 3 24 0 11 0 0 0 0 27 
0 0 1 0 0 2 1 14 3 3 8 0 10 0 7 0 0 2 0 13 0 37 12 0 0 3 0 13 6 5 14 3 11 5 6 0 28 1 3 
9 0 0 0 0 6 10 12 0 0 0 0 0 6 3 3 0 7 4 9 0 14 4 0 8 13 9 0 0 22 24 0 8 0 3 9 0 16 0 
15 0 21 64 0 0 25 24 0 0 13 2 22 19 11 3 0 17 0 0 0 0 24 23 0 23 1 31 28 0 3 14 20 4 2 32 0 4 1 
0 79 0 16 34 15 24 0 8 15 3 0 9 13 1 0 31 6 0 18 4 15 0 16 18 7 10 19 19 11 48 5 24 7 0 48 35 15 25 
0 14 7 25 16 10 1 0 14 17 6 31 0 0 23 0 1 7 0 18 0 42 25 8 23 0 25 13 11 18 0 0 4 0 3 8 4 0 0 
