39 22
21 0 0 28 0 52 21 6 16 0 5 0 7 14 14 9 52 0 2 0 6 36 36 8 0 0 0 23 0 0 15 3 0 0 0 19 25 0 16 
28 0 10 33 10 10 0 1 0 0 15 23 2 0 1 5 22 13 0 2 13 6 0 23 0 13 0 4 0 19 16 32 0 16 23 16 2 0 32 
0 5 0 0 0 4 0 15 0 1 2 20 17 1 0 9 0 0 2 12 8 14 0 0 0 12 0 2 9 0 5 20 3 3 1 37 16 16 0 
18 6 0 34 16 34 14 61 20 0 0 0 0 0 13 7 0 0 28 17 13 2 16 0 2 18 0 27 28 24 48 52 3 0 0 0 12 40 0 
0 21 0 0 29 23 9 10 0 0 18 10 0 12 0 0 16 13 0 0 19 0 0 6 1 0 0 0 52 0 2 0 16 27 0 0 0 0 0 
0 25 0 0 14 15 0 16 0 7 90 0 0 24 0 0 6 16 0 6 12 14 0 19 2 0 3 1 18 0 0 18 12 4 45 0 0 27 5 
0 0 0 0 20 10 16 13 0 5 4 5 0 19 1 9 9 12 5 0 17 11 12 0 20 3 23 0 13 12 10 0 13 0 0 0 0 13 10 
0 1 30 0 10 0 6 0 0 0 12 9 13 0 13 22 1 12 27 34 9 0 0 3 3 0 0 0 9 4 18 0 0 29 15 0 13 66 4 
35 5 19 1 1 14 13 1 0 0 5 0 0 0 0 32 0 3 5 0 16 19 12 11 6 0 10 4 0 1 0 0 0 7 12 35 16 2 23 
24 0 27 38 0 0 0 0 7 0 0 0 9 20 0 0 0 0 3 0 16 0 20 0 24 0 10 17 0 1 0 0 0 20 0 8 4 34 23 
10 6 0 0 0 0 22 0 11 5 6 0 0 0 42 4 17 0 0 12 0 2 4 1 0 11 0 7 0 0 0 22 2 11 22 0 0 10 32 
6 8 10 0 0 0 40 1 14 2 1 3 0 15 0 7 6 12 17 25 0 9 0 0 0 2 0 2 15 23 0 16 5 14 6 10 7 10 0 
37 5 0 0 14 22 13 18 0 5 0 7 15 25 0 22 5 0 26 0 11 7 12 14 0 18 0 11 10 0 0 0 0 0 6 4 7 1 4 
26 45 11 0 0 13 22 11 3 26 0 0 14 11 0 7 3 19 6 0 19 0 6 0 12 1 26 26 11 0 0 0 5 0 0 25 6 25 14 
0 0 20 0 0 0 11 0 20 28 18 0 1 0 0 22 0 0 19 0 0 0 20 0 7 0 0 0 10 0 0 23 6 4 0 0 8 9 6 
20 0 0 6 0 0 13 0 16 0 0 2 14 14 0 0 0 0 0 5 8 9 5 0 11 0 0 14 0 0 9 0 0 0 13 0 0 3 2 
20 2 39 1 13 29 0 1 21 0 6 9 26 0 11 7 11 13 4 0 44 13 4 0 12 0 0 3 0 24 30 17 0 31 0 0 4 0 56 
18 7 6 3 10 14 0 1 29 0 0 5 12 6 10 0 15 0 0 28 0 2 0 0 24 0 15 0 4 0 14 12 4 0 3 11 0 29 10 
0 0 10 0 3 9 17 15 0 0 0 0 25 0 3 0 18 21 28 13 6 0 0 32 6 6 6 9 10 0 0 0 5 0 9 0 17 9 46 
18 25 41 23 20 16 18 7 0 0 16 21 15 0 12 0 21 0 13 4 18 2 5 4 7 21 0 46 15 0 0 7 0 30 4 0 21 6 32 
0 0 0 0 7 37 1 21 0 16 16 7 0 0 9 7 0 13 12 0 2 9 11 14 12 0 6 5 16 22 0 0 6 0 15 0 0 10 0 
0 0 41 59 3 41 0 0 21 0 6 0 0 0 0 20 6 2 41 28 0 9 19 0 13 49 0 25 0 26 9 20 0 30 0 20 0 16 2 
