39 22
23 0 0 0 30 0 21 11 3 4 5 1 12 12 4 0 0 6 6 11 2 4 0 10 0 9 19 7 16 0 10 17 24 0 39 21 0 0 0 
10 0 0 20 29 1 0 4 0 5 9 10 0 0 5 8 18 16 10 0 0 14 0 12 9 0 6 0 5 0 9 15 2 35 0 0 0 0 10 
13 8 9 0 10 1 0 0 0 0 6 0 0 13 2 33 10 27 0 10 0 17 6 0 1 0 0 3 0 10 3 0 17 0 0 0 0 36 30 
11 0 8 0 0 2 0 2 6 10 0 0 1 6 0 12 0 10 10 6 18 10 25 10 9 0 0 0 12 0 0 28 33 13 12 15 0 9 31 
0 5 0 0 15 11 32 29 16 14 0 11 14 0 22 0 0 0 17 19 11 0 6 0 0 0 6 0 26 22 24 0 2 0 8 0 29 0 24 
36 33 0 0 0 1 6 29 0 27 0 9 11 23 7 11 0 6 7 20 0 9 0 6 0 12 10 0 19 0 0 13 37 12 33 2 29 11 0 
3 0 0 34 2 0 20 0 0 19 10 0 0 14 6 3 0 0 10 0 0 0 4 19 1 0 4 0 5 0 7 0 1 3 31 0 14 0 0 
46 0 0 0 5 0 13 28 8 3 13 1 8 7 0 5 18 5 0 0 0 0 0 9 1 0 0 7 0 8 9 0 0 0 52 28 0 0 0 
7 20 8 0 0 16 0 7 14 33 8 11 10 0 30 20 10 13 0 21 15 21 7 6 7 0 3 1 0 20 11 7 0 0 0 26 0 0 11 
32 21 0 0 0 8 0 15 9 3 4 0 11 0 0 5 0 0 0 0 3 7 27 0 16 0 16 0 0 6 0 4 10 2 12 11 0 1 0 
22 9 14 48 2 4 11 41 0 0 69 0 5 5 14 19 0 2 19 16 18 19 12 16 3 15 0 0 0 4 15 3 14 27 17 37 36 29 17 
29 32 12 15 28 31 2 6 28 27 0 21 14 1 3 0 19 0 37 9 7 0 0 4 10 3 11 27 15 0 0 13 32 1 3 0 32 8 26 
3 0 0 0 17 8 4 0 13 0 8 6 12 8 0 28 14 2 0 2 4 3 0 4 14 0 0 0 13 0 30 0 8 0 10 0 0 3 4 
35 0 0 0 4 9 18 0 5 14 3 0 2 24 0 10 0 18 0 5 0 3 4 7 14 0 0 0 13 0 0 7 13 0 0 35 13 32 11 
0 35 37 0 32 11 0 24 5 10 12 22 3 13 0 1 14 15 21 0 1 0 11 5 0 6 24 0 0 0 0 6 0 0 0 55 48 0 0 
21 7 0 2 20 10 0 9 13 0 27 12 5 8 0 15 5 19 13 0 32 0 1 1 22 4 0 0 6 41 0 0 22 0 0 2 19 2 0 
24 0 8 0 5 0 32 0 0 0 7 15 0 4 0 11 5 0 10 0 0 0 0 4 0 0 0 0 0 2 9 0 3 2 0 0 3 25 18 
0 31 8 15 0 8 23 0 0 0 8 19 13 0 9 0 10 10 17 0 8 0 0 0 23 0 3 10 0 9 0 3 4 0 5 0 6 0 1 
0 0 13 3 0 4 0 14 5 6 26 18 17 13 37 0 10 5 12 0 14 0 25 0 0 0 0 0 0 7 12 0 0 21 14 0 4 8 27 
12 0 7 0 6 5 0 29 0 4 0 0 0 4 0 0 5 3 10 0 3 0 6 0 0 4 1 11 9 0 0 0 16 0 0 0 29 0 0 
31 0 0 0 0 0 85 41 9 15 32 7 6 13 18 0 12 0 26 0 0 11 0 0 0 19 3 9 13 0 0 9 13 0 0 10 14 30 0 
0 0 11 23 9 8 10 25 15 16 0 3 3 12 0 3 0 19 3 0 0 0 9 15 8 16 0 16 3 4 0 21 32 0 0 7 0 8 19 
