39 22
25 0 20 0 56 0 19 0 0 0 10 17 9 10 1 13 0 2 18 8 7 11 0 8 0 46 17 23 15 0 6 25 1 1 14 21 19 44 19 
11 0 33 0 1 0 0 7 5 0 0 9 0 1 14 0 15 0 6 7 0 4 8 0 2 4 6 20 14 7 12 0 0 0 32 0 0 7 1 
0 0 0 3 27 0 3 18 2 0 10 4 2 5 18 0 0 0 0 11 9 0 4 33 13 18 0 18 14 14 0 0 2 0 0 0 28 21 13 
3 5 19 15 6 0 0 14 29 1 6 0 3 22 0 0 22 0 5 0 9 36 0 0 0 11 5 0 10 25 15 0 3 13 0 9 11 46 10 
24 33 0 0 0 0 0 0 13 33 1 19 0 0 7 0 0 4 0 11 11 7 0 10 24 0 0 3 4 0 28 9 6 1 9 25 0 0 7 
0 0 0 14 0 0 0 20 9 0 14 25 0 0 18 0 16 8 0 0 0 4 8 0 25 2 0 3 15 0 0 20 2 3 0 5 0 4 25 
3 60 28 34 15 3 0 3 11 0 7 28 0 5 0 19 0 4 8 0 16 13 4 0 0 13 13 0 2 1 11 0 0 31 19 0 0 70 27 
47 0 0 1 28 19 7 0 0 0 0 0 10 0 0 6 1 7 20 5 0 1 1 9 19 27 12 0 0 0 0 0 5 0 0 35 0 0 2 
22 21 0 17 0 35 16 11 19 28 2 14 0 0 0 0 9 0 3 6 3 1 42 1 9 3 8 6 0 7 0 6 12 38 0 0 0 3 14 
0 0 57 1 0 4 10 0 0 10 5 0 13 6 0 21 8 30 10 2 0 6 0 5 0 20 34 6 0 13 28 32 16 6 3 18 0 11 0 
0 8 0 0 0 1 0 0 6 5 30 8 8 0 22 26 5 0 0 0 3 0 0 5 2 5 0 0 5 0 0 11 22 0 19 11 19 0 2 
0 7 10 7 12 31 0 0 0 1 0 3 14 5 0 12 18 0 0 0 0 0 0 0 9 4 0 23 0 17 0 0 0 29 19 0 32 0 25 
32 42 0 63 47 0 5 0 6 21 10 0 0 10 7 17 0 25 0 12 0 17 21 22 0 1 7 12 4 0 0 18 9 30 30 34 29 20 10 
7 0 2 0 20 35 40 0 9 10 3 7 12 0 0 4 6 0 14 19 10 5 0 14 9 0 4 0 23 4 6 27 0 1 4 7 0 0 12 
0 10 0 0 0 0 6 0 9 0 11 0 0 0 2 14 2 0 6 3 0 21 7 15 9 0 0 17 0 0 0 0 0 1 1 0 0 14 0 
0 9 12 0 5 0 0 10 0 6 6 26 10 0 0 20 0 10 0 0 0 0 0 0 0 5 5 0 15 4 5 0 0 4 0 0 0 39 0 
0 36 0 7 12 0 35 50 13 6 0 20 0 15 1 25 17 0 5 0 0 6 0 19 0 0 20 1 29 17 0 20 0 39 0 22 4 36 0 
22 30 1 5 9 0 26 16 0 2 13 4 0 14 0 7 0 0 0 13 7 0 20 13 0 0 0 1 0 4 0 27 26 8 14 0 0 0 3 
0 11 12 8 21 0 0 17 1 15 0 0 6 0 19 24 0 0 7 0 0 0 16 9 30 15 0 0 0 0 0 10 4 17 0 18 0 16 7 
0 0 31 25 27 0 23 7 1 0 16 0 2 2 4 3 6 4 6 15 17 17 19 5 9 20 12 0 0 20 10 27 3 51 15 0 0 17 17 
26 35 0 6 19 6 7 0 5 16 6 15 0 9 0 0 5 9 0 25 0 0 9 19 2 0 33 27 15 0 4 0 0 2 4 7 52 27 13 
0 24 0 0 0 0 0 0 0 0 8 7 0 21 17 3 5 0 16 3 21 26 17 19 16 21 15 13 6 0 0 28 0 0 0 11 0 13 0 
