39 22
16 9 50 51 1 7 0 23 0 15 6 19 12 12 12 9 4 0 3 8 0 3 10 0 7 16 7 1 0 1 7 3 9 27 7 28 0 12 37 
31 21 45 0 6 0 0 0 0 0 0 0 45 0 2 3 0 21 0 0 0 0 21 0 2 0 5 0 0 35 0 25 4 18 0 23 34 2 21 
0 0 18 0 0 25 2 17 0 1 1 7 13 3 0 0 0 3 2 15 16 12 0 0 9 5 7 0 4 16 11 4 4 0 0 30 18 0 21 
36 20 3 0 52 4 0 6 8 0 7 17 0 0 5 11 15 0 11 0 0 0 3 13 1 29 8 23 10 2 5 0 14 20 0 3 36 0 0 
15 33 21 4 1 12 5 0 8 0 0 2 3 8 7 0 3 19 0 0 7 2 10 1 0 14 4 0 6 24 0 0 2 3 2 0 3 33 10 
0 15 0 0 15 10 0 0 12 0 0 9 5 0 0 0 15 0 0 3 0 6 17 1 9 4 0 0 0 2 19 0 0 0 12 0 0 4 0 
22 0 0 27 33 0 0 0 0 0 0 0 0 27 0 20 0 0 0 0 0 4 29 8 0 18 0 12 0 7 8 4 0 0 0 0 0 34 13 
0 8 32 35 8 9 0 0 0 15 0 29 0 2 0 27 18 0 0 0 5 0 3 7 6 20 3 1 0 0 23 7 0 5 32 0 3 7 8 
2 24 3 20 23 23 27 15 7 22 7 8 8 0 13 17 9 9 0 17 0 0 0 7 0 0 10 41 6 0 7 0 22 43 4 3 42 0 0 
0 34 0 0 15 0 0 8 13 2 7 0 0 5 0 24 0 0 8 23 6 0 6 0 0 4 0 8 5 0 0 0 7 0 0 34 1 0 0 
2 73 0 40 8 6 10 6 11 15 21 0 0 17 0 14 0 19 0 0 13 14 3 32 47 0 0 6 13 9 0 9 28 30 0 0 5 27 4 
6 0 20 0 6 12 31 3 0 0 0 0 7 0 4 0 0 0 0 0 7 0 10 0 0 20 10 2 0 0 0 48 11 0 3 0 0 1 1 
23 0 0 8 49 10 0 14 0 3 0 5 0 15 1 1 7 4 0 27 0 2 7 23 17 1 1 4 10 0 26 0 0 10 0 0 10 0 8 
2 0 7 0 48 14 0 0 0 20 20 9 0 19 0 27 0 18 0 0 0 9 0 3 20 36 19 7 0 5 35 27 8 0 1 18 0 0 4 
0 26 10 16 0 0 0 22 0 6 0 9 10 0 1 29 0 12 0 22 9 4 1 0 0 0 0 33 21 0 0 0 17 0 0 6 0 7 0 
17 0 19 9 28 12 12 2 0 12 0 14 0 11 0 2 19 17 9 13 8 0 3 18 3 42 20 21 3 7 0 8 28 11 0 0 27 0 0 
21 23 2 16 24 26 0 24 0 0 0 3 0 6 2 0 1 8 16 23 2 0 4 0 0 0 0 0 0 4 0 2 42 4 0 0 52 16 0 
0 1 17 4 11 3 2 4 19 0 0 17 13 1 24 3 0 0 0 0 0 0 0 0 20 13 0 0 2 0 4 0 0 22 0 0 3 6 0 
0 18 0 21 5 0 31 0 0 10 0 16 0 11 12 0 10 0 0 0 0 10 0 0 21 15 12 0 0 18 0 10 0 0 0 0 23 31 0 
11 31 0 2 4 11 0 12 14 4 0 7 0 34 0 0 0 0 0 12 0 0 39 0 14 12 15 0 6 14 19 0 31 42 0 22 0 13 0 
23 0 5 4 12 19 90 6 19 28 0 5 19 10 5 3 0 0 0 11 15 10 0 55 13 16 8 19 22 1 7 24 45 20 29 33 29 0 32 
18 0 17 33 0 35 0 6 15 0 17 0 13 22 0 0 21 0 0 8 0 20 27 0 0 4 7 11 0 0 4 32 1 28 0 21 0 8 8 
