39 22
0 5 0 6 2 6 4 0 0 24 16 0 6 0 0 15 19 30 0 2 12 0 21 0 0 5 10 0 0 0 7 5 0 24 19 3 0 0 3 
23 12 0 2 10 0 29 6 11 3 2 16 3 3 17 7 12 0 6 11 0 13 0 12 14 0 5 0 15 8 19 0 14 0 0 0 0 0 0 
6 1 0 29 0 14 21 0 7 14 5 0 0 0 0 21 0 0 0 12 2 0 7 5 1 0 0 6 10 0 0 6 23 12 1 1 0 2 0 
0 0 0 1 1 1 15 0 0 18 0 0 11 0 0 0 0 0 0 0 19 0 0 0 0 0 0 15 0 0 0 0 0 0 4 5 17 20 15 
0 25 16 17 0 0 1 1 7 17 0 2 30 0 12 0 0 20 0 18 0 0 5 8 8 17 0 0 26 4 0 0 4 4 32 1 8 31 0 
26 36 0 0 0 25 0 0 58 0 5 8 5 43 0 0 0 5 0 0 0 20 0 0 0 12 9 11 0 0 0 39 0 25 21 3 7 0 5 
37 1 1 4 0 11 2 29 11 19 28 21 23 20 16 0 0 0 7 9 1 1 16 4 0 12 68 0 0 0 0 30 26 44 0 0 35 13 16 
0 3 0 0 0 14 1 0 22 0 0 5 3 0 0 0 0 7 6 14 0 11 10 0 7 0 0 0 3 0 4 6 2 11 2 0 13 6 0 
68 1 4 36 0 30 6 6 22 17 9 11 9 0 10 7 7 4 20 0 20 7 13 1 0 0 0 18 0 0 11 0 3 1 0 18 0 37 8 
13 0 0 5 0 13 10 0 2 12 0 4 8 0 0 0 3 19 11 8 1 12 25 0 0 0 0 10 0 0 7 0 6 3 0 38 4 14 3 
7 33 0 26 0 35 23 22 20 1 6 22 0 3 5 0 0 0 0 0 12 0 0 9 0 0 8 2 20 1 0 30 21 52 0 0 23 0 0 
23 0 25 21 0 0 4 0 20 20 0 0 34 5 0 12 7 0 0 7 0 0 2 24 22 0 4 12 0 0 18 1 25 0 0 12 2 13 33 
27 0 10 10 0 0 13 0 0 13 21 25 26 12 0 0 0 19 0 5 9 6 6 4 6 19 0 2 22 0 0 7 4 28 0 0 11 6 5 
34 0 0 0 14 0 3 0 7 5 0 37 3 0 0 23 4 3 7 0 0 0 0 0 0 0 0 0 0 0 0 0 18 3 15 0 3 0 0 
2 22 31 4 0 0 0 0 11 0 16 0 0 0 0 17 10 0 0 11 4 0 9 6 5 0 7 11 27 0 9 12 17 28 9 0 6 21 0 
0 3 0 0 1 0 45 30 10 23 14 0 0 11 3 0 0 0 12 0 5 8 0 3 8 15 16 0 0 0 24 0 31 8 5 0 57 33 12 
0 7 0 33 14 4 0 15 8 2 16 0 0 11 0 22 4 0 6 0 15 3 27 12 0 0 0 11 0 0 49 6 3 0 0 0 27 36 0 
7 25 33 21 2 1 28 28 1 24 18 4 5 30 0 16 0 21 0 5 13 0 4 0 22 0 24 0 18 0 21 9 39 9 10 0 0 5 58 
33 0 0 0 0 9 10 0 0 10 29 0 11 13 19 25 0 4 0 13 4 9 14 14 4 0 1 0 0 0 20 11 7 10 0 0 38 13 15 
0 5 4 21 30 0 22 0 0 0 11 15 0 0 10 23 1 0 16 0 8 13 1 1 16 0 13 0 10 0 2 0 3 0 27 24 0 45 0 
0 0 8 13 0 7 5 17 26 0 8 0 12 0 14 0 13 0 11 7 31 14 0 6 0 1 0 0 3 15 19 0 0 0 45 1 4 17 31 
0 32 6 37 4 33 9 18 5 13 21 1 26 5 10 23 12 9 27 0 17 18 0 5 6 11 1 10 9 0 9 21 0 32 4 0 29 39 33 
