39 22
0 27 0 13 0 7 0 9 21 3 18 2 5 6 7 9 23 15 16 6 24 0 0 12 15 0 0 0 20 0 0 0 17 0 6 11 12 23 0 
47 0 23 0 0 32 21 0 0 16 0 25 0 0 6 18 0 18 9 19 0 0 0 0 0 34 6 0 1 4 0 0 3 0 2 5 16 32 0 
5 6 10 0 2 9 0 7 3 0 10 0 18 13 0 0 0 3 4 0 23 0 0 19 0 0 0 0 0 0 0 0 11 3 0 9 0 0 5 
11 3 11 0 8 0 20 25 24 0 23 15 0 0 18 0 12 0 1 0 2 0 12 0 12 0 27 8 18 0 5 0 77 35 0 6 15 8 12 
0 6 0 14 46 0 0 0 31 23 29 0 23 15 3 40 8 3 17 0 30 0 10 20 14 1 9 9 3 0 0 35 24 15 0 23 23 46 7 
36 18 6 7 44 17 0 0 27 0 21 5 8 25 7 10 0 21 10 22 0 4 0 0 0 5 0 0 19 4 0 0 3 14 41 0 36 0 3 
5 14 13 6 14 1 19 23 0 4 3 0 24 0 0 37 0 1 1 8 0 22 12 0 0 0 18 8 7 8 0 12 7 0 0 0 0 25 0 
5 11 6 21 32 2 0 5 0 0 0 7 1 0 32 3 0 0 5 5 0 0 0 13 9 10 1 0 0 11 12 0 6 0 26 0 0 7 9 
12 6 0 27 5 0 31 6 7 10 28 0 0 24 0 0 0 10 0 0 6 5 0 0 0 0 8 10 0 7 22 0 0 11 0 5 0 19 28 
0 41 0 0 0 0 0 0 11 9 5 8 0 0 0 9 3 0 0 2 5 12 0 0 0 12 0 12 0 0 0 0 7 6 0 34 4 3 0 
0 26 0 0 20 55 1 0 5 4 0 0 2 0 0 0 10 13 10 0 12 37 4 0 39 4 3 31 0 7 4 0 55 10 0 2 0 5 0 
0 12 8 0 0 9 0 0 41 0 18 0 1 12 3 2 4 0 0 2 19 3 0 0 7 0 8 0 3 0 0 21 14 0 4 22 0 6 30 
18 5 10 27 0 0 0 0 0 32 16 0 10 26 15 12 20 4 12 0 0 8 22 0 12 9 16 26 4 0 12 10 3 20 40 0 12 6 4 
0 5 27 0 4 25 16 7 0 0 0 25 10 0 10 9 17 13 0 32 12 5 5 0 1 0 0 10 7 1 25 0 9 29 15 5 14 10 9 
11 51 9 2 14 0 0 24 0 17 0 0 1 2 3 1 6 14 0 0 5 3 0 0 3 0 9 1 1 0 0 1 1 19 27 0 0 43 4 
0 0 30 0 40 5 0 16 8 0 5 0 4 13 0 3 12 5 14 0 8 14 18 16 2 0 22 0 0 0 8 2 44 1 0 25 0 5 12 
17 14 2 25 0 18 30 29 0 0 0 0 0 19 25 0 16 0 0 0 5 15 13 19 0 32 6 11 25 0 7 1 6 18 0 13 48 4 11 
0 27 5 29 0 9 0 0 0 7 7 0 17 0 0 0 6 3 0 14 19 0 0 0 10 10 3 8 23 33 0 2 4 0 17 0 0 0 10 
0 5 0 0 21 0 16 1 1 11 18 3 0 23 3 11 0 0 12 0 8 21 15 0 0 13 13 0 15 11 12 22 8 2 3 1 29 14 5 
3 3 2 32 1 0 0 0 25 7 0 0 0 0 0 3 0 0 0 0 0 0 0 2 9 0 21 0 0 0 3 0 0 86 0 1 0 0 0 
8 0 31 0 10 19 7 12 21 2 0 5 37 3 19 6 1 8 11 21 13 8 8 24 19 0 0 14 16 16 8 0 0 20 15 14 0 12 11 
0 16 0 0 0 14 0 10 19 11 2 14 15 6 0 0 0 18 9 6 0 12 0 17 0 10 0 0 18 28 25 0 0 0 21 22 0 0 0 
