39 22
1 15 9 0 9 33 15 0 0 18 0 0 13 15 0 4 1 0 18 19 4 0 0 0 0 0 27 16 13 13 10 5 5 0 0 0 0 16 48 
0 2 57 34 41 11 13 0 0 0 0 14 40 6 26 8 1 5 0 1 16 0 11 4 0 14 0 0 14 0 27 0 1 8 12 5 0 59 0 
0 0 7 0 30 0 4 10 0 17 0 3 8 18 0 0 13 10 0 1 8 0 2 14 9 0 2 37 0 8 0 0 0 1 0 8 8 0 0 
0 7 15 2 0 13 0 0 0 0 9 0 0 18 0 3 0 0 13 0 0 0 17 0 7 0 17 0 13 9 4 7 0 2 14 1 3 0 0 
0 0 0 0 11 0 0 0 0 16 17 0 35 2 15 14 0 14 19 7 10 0 18 0 0 8 9 16 10 16 0 0 0 18 0 0 0 0 0 
4 13 31 5 4 14 0 0 24 45 9 0 0 19 21 0 6 14 13 6 0 0 19 6 0 0 0 1 2 14 0 18 14 4 57 53 0 0 0 
0 0 5 0 5 13 0 22 13 22 10 2 13 1 0 24 8 16 0 12 2 1 13 0 7 0 7 13 14 4 0 3 1 16 0 1 71 22 27 
0 4 25 38 0 0 14 0 16 24 2 0 6 34 0 0 0 0 0 8 18 0 0 11 12 0 1 25 0 0 10 28 0 5 0 0 23 12 0 
12 10 29 0 0 19 6 18 12 0 29 10 7 0 0 0 20 0 1 1 2 0 0 8 3 18 0 2 3 0 8 19 0 23 0 0 4 3 2 
3 22 48 0 7 3 0 0 0 0 8 0 0 10 0 3 3 6 11 12 0 3 21 2 3 0 0 0 0 0 7 29 7 4 4 0 0 4 0 
13 0 0 12 31 0 0 5 0 0 0 0 13 13 4 21 19 0 10 7 0 8 14 16 0 0 4 0 0 12 0 5 20 0 0 12 6 26 1 
0 43 38 9 30 22 0 5 8 0 8 7 6 9 4 42 8 12 0 18 3 0 0 1 14 0 14 23 0 0 29 0 30 0 0 29 0 26 10 
0 11 0 0 11 16 0 0 0 0 0 0 11 7 1 10 1 0 0 0 1 15 0 0 0 8 0 0 0 8 0 3 0 0 3 0 0 0 0 
0 34 27 0 13 0 0 25 20 0 0 6 13 13 1 12 11 0 10 0 1 14 11 0 0 0 1 5 16 22 3 5 3 0 0 34 0 3 0 
5 4 8 0 7 0 17 5 0 3 8 1 21 0 0 0 20 5 20 7 4 0 11 23 0 0 0 0 17 0 0 1 1 10 0 0 28 9 0 
5 0 0 23 3 8 0 34 26 0 0 1 17 27 0 19 0 5 14 0 0 11 0 0 0 18 12 0 7 11 0 25 11 2 51 15 0 30 0 
19 0 12 0 0 10 0 0 22 0 0 1 0 8 12 0 11 0 18 0 17 8 0 14 13 0 0 0 9 16 22 0 0 0 4 0 0 16 10 
18 1 23 0 22 12 65 0 29 10 31 4 0 2 14 0 5 14 1 19 11 0 16 18 0 15 18 0 6 5 1 37 0 3 15 16 16 29 31 
15 9 8 21 0 16 17 12 21 7 0 7 3 37 13 15 9 12 0 22 0 12 0 11 6 33 0 0 28 7 1 16 8 0 4 10 0 2 12 
0 0 10 12 2 18 12 0 13 0 2 6 4 18 25 0 0 11 0 14 3 0 4 0 11 0 4 0 0 0 0 7 0 0 0 0 13 12 6 
5 0 0 34 23 15 0 6 19 17 17 0 19 0 0 8 20 0 0 15 15 0 4 11 4 0 10 9 6 0 4 4 0 12 0 12 0 24 0 
0 0 16 0 19 30 14 0 30 0 0 27 0 18 0 17 12 9 10 12 0 0 20 0 6 0 11 0 5 16 0 0 17 0 0 0 0 0 4 
