39 22
5 36 12 39 0 0 0 59 0 16 8 0 11 8 0 19 0 0 0 0 0 18 20 13 9 1 1 20 15 2 0 5 14 23 0 34 0 0 0 
1 1 0 0 18 6 14 16 0 3 17 22 3 35 0 3 5 7 0 7 0 12 14 3 10 14 0 17 0 8 0 0 0 20 0 0 24 32 0 
8 6 77 12 0 1 20 0 6 6 14 16 0 21 37 13 0 17 0 8 0 17 5 0 3 23 12 5 24 0 12 0 0 0 53 0 19 0 0 
0 0 5 4 0 18 28 1 0 0 1 7 1 1 17 10 12 28 17 14 6 0 0 6 18 14 8 0 0 3 0 14 5 18 0 3 30 13 33 
69 11 0 2 14 0 0 0 13 0 0 0 19 6 0 17 11 0 14 11 0 0 10 16 11 0 14 11 0 0 0 0 56 0 0 17 2 0 38 
24 0 10 40 1 11 2 7 5 4 0 2 9 28 0 2 0 3 4 33 17 17 7 18 2 4 2 0 5 7 0 0 29 5 0 0 28 41 0 
13 13 30 1 6 0 0 0 13 18 1 0 14 0 13 2 0 0 1 0 20 0 0 0 0 0 0 9 0 6 2 0 30 24 0 6 2 0 0 
34 12 34 0 3 6 1 42 0 0 25 0 0 19 0 18 0 0 17 10 0 14 28 3 8 0 13 0 0 22 0 29 25 15 36 11 37 0 16 
0 2 0 12 3 10 8 25 0 4 27 0 1 37 0 2 4 6 0 15 0 3 5 6 10 8 13 2 0 0 0 0 25 0 18 7 6 51 0 
0 0 17 4 0 0 0 4 28 25 0 0 0 8 0 0 29 0 0 14 1 12 1 11 0 0 6 9 5 4 7 11 0 4 37 7 39 11 4 
17 0 0 0 0 0 13 0 8 0 10 0 6 19 0 0 0 7 0 1 0 0 0 0 8 5 0 0 0 0 5 12 2 0 2 22 36 0 0 
0 8 0 3 0 18 0 0 7 0 2 3 0 13 12 0 0 0 0 0 0 24 4 19 4 6 5 5 11 0 0 0 11 1 1 5 0 0 0 
0 0 0 33 0 0 31 20 0 0 0 5 7 11 1 5 0 43 0 7 12 1 0 0 0 9 20 4 12 12 6 0 21 0 0 0 26 21 0 
44 22 0 24 2 26 6 4 0 0 0 36 39 25 1 12 10 5 8 0 0 11 0 70 0 3 10 0 0 0 0 18 16 0 3 27 1 52 51 
46 0 1 20 64 3 1 28 0 4 0 35 9 4 0 14 16 4 0 3 10 8 12 9 14 7 6 3 5 0 41 7 34 8 3 31 23 19 48 
4 0 10 20 14 8 0 15 0 5 4 0 0 14 25 3 11 17 10 5 0 4 24 25 9 15 6 1 10 0 0 4 10 3 4 29 14 0 1 
0 24 0 0 6 14 29 0 0 16 20 0 0 12 0 0 1 4 9 21 0 0 0 0 0 16 0 0 0 0 26 0 0 0 0 0 0 0 0 
0 32 29 9 31 2 0 0 0 6 0 0 0 0 0 3 0 0 3 13 0 0 4 0 3 14 3 0 4 0 0 33 0 32 0 0 9 0 34 
0 0 0 0 0 50 21 32 0 1 0 4 2 17 1 0 9 12 0 0 0 0 0 2 9 0 17 0 1 21 21 0 0 4 0 0 1 0 0 
16 9 17 0 16 5 0 34 11 20 5 0 13 11 4 16 17 8 0 0 7 6 8 0 0 38 0 8 2 0 0 0 17 0 0 8 7 0 0 
33 1 0 41 31 0 0 24 33 0 0 8 14 0 9 23 6 2 12 23 3 9 6 14 17 0 1 1 1 0 14 13 17 27 0 3 33 8 34 
6 10 0 21 2 5 36 20 0 0 5 15 0 0 19 17 9 0 1 0 0 5 0 16 0 7 44 11 2 0 0 4 0 6 0 17 35 9 0 
