40 23
27 30 33 40 13 0 26 0 17 0 20 0 11 0 0 5 0 2 1 13 0 13 0 13 0 8 0 8 0 10 0 0 0 2 7 34 14 0 25 0 
15 0 0 0 0 0 0 0 27 0 9 19 14 0 0 0 16 0 3 19 0 2 1 17 0 0 7 0 0 1 15 0 0 7 0 27 0 0 0 0 
0 44 22 1 0 10 2 0 0 0 13 0 13 8 0 11 0 0 0 5 0 18 0 15 11 13 16 13 27 7 0 2 12 0 0 2 17 27 0 0 
0 20 11 20 0 0 0 0 10 19 0 13 0 23 0 13 0 0 0 6 0 10 18 0 0 0 7 10 25 5 0 18 11 0 0 6 0 0 0 0 
0 26 9 0 10 0 31 0 0 0 6 26 0 16 0 21 17 0 2 0 0 14 0 8 32 0 20 26 0 7 15 2 43 56 0 30 0 0 28 21 
16 6 0 0 39 9 14 0 7 20 0 7 11 2 0 10 19 35 0 0 1 0 0 5 9 46 10 9 0 7 7 4 0 15 0 0 56 3 37 0 
0 17 13 1 23 0 0 0 16 0 18 0 0 6 9 18 0 1 32 0 1 1 1 7 0 2 0 23 5 11 0 0 0 2 0 0 0 3 0 21 
5 0 8 1 9 5 0 12 7 0 6 3 0 3 0 43 12 1 10 7 0 0 0 17 3 8 11 12 25 1 14 4 0 2 10 7 0 0 15 0 
10 0 0 0 0 0 5 1 0 0 9 0 0 3 38 15 10 0 3 0 0 6 16 16 0 11 10 6 0 6 11 3 8 0 0 21 3 0 0 0 
19 3 18 0 0 21 0 0 0 4 1 0 0 4 4 0 6 0 1 2 18 12 1 0 12 1 21 24 3 0 0 0 7 12 0 0 12 7 0 0 
0 29 40 7 6 9 5 0 4 7 5 3 0 0 0 0 0 14 5 16 0 19 1 30 29 0 7 0 1 6 35 26 1 0 0 0 0 0 3 0 
0 10 19 0 20 4 0 40 22 0 3 14 0 0 3 17 9 14 0 8 0 19 0 8 34 0 11 19 6 0 22 6 15 0 0 0 0 9 31 0 
0 5 0 2 4 9 38 3 0 16 0 0 0 6 17 19 0 0 1 0 20 11 10 5 0 5 20 0 3 7 0 7 2 12 3 0 0 0 0 0 
9 8 1 0 13 12 0 4 48 1 7 0 5 0 4 8 0 20 3 4 0 0 0 12 0 0 0 23 0 12 0 0 5 0 0 0 28 9 30 0 
0 0 1 14 39 7 0 1 37 0 3 0 0 10 0 0 0 0 0 0 0 14 5 12 14 24 12 15 0 13 0 0 8 29 0 0 4 0 30 0 
31 10 22 0 14 0 8 0 14 15 51 3 11 0 10 0 36 7 6 18 16 0 25 0 17 19 24 1 8 26 0 36 12 28 0 0 11 2 9 54 
0 23 4 4 19 0 17 0 0 4 1 13 31 0 0 0 0 10 0 0 0 0 0 9 23 0 4 0 5 6 12 19 2 0 9 16 4 0 0 33 
8 15 27 5 0 0 47 2 17 4 18 20 0 12 19 13 17 4 0 8 0 0 0 6 5 0 2 8 0 88 5 28 0 36 41 25 1 18 0 29 
0 30 0 0 0 0 0 0 0 1 9 3 4 6 6 0 21 5 0 2 4 0 21 6 0 0 10 0 5 1 0 17 0 0 2 0 1 15 0 0 
1 1 46 0 0 18 5 2 0 25 0 14 0 7 0 0 15 2 0 14 7 0 1 4 0 14 4 26 10 23 41 0 27 31 20 0 8 0 0 3 
20 15 0 0 0 37 17 0 7 8 1 0 0 2 0 0 0 0 0 17 0 18 0 0 16 0 0 0 29 5 0 18 11 0 20 7 12 0 0 2 
41 0 0 5 17 10 0 0 8 0 22 17 0 0 0 0 6 22 9 0 16 0 18 0 17 0 0 0 0 29 0 0 17 23 0 0 3 0 0 23 
0 17 0 22 19 26 26 0 6 5 0 0 4 0 25 1 0 15 17 0 4 18 0 2 0 1 10 0 0 2 0 43 47 16 26 0 2 0 0 20 
