40 23
0 1 1 0 10 3 23 18 10 0 7 3 30 10 3 2 0 0 24 7 8 20 9 0 9 0 17 2 3 0 0 0 0 0 6 19 0 10 0 17 
10 29 10 14 0 0 0 0 21 24 0 9 3 0 0 0 0 2 13 0 0 17 0 32 0 8 0 0 0 0 50 0 0 0 0 15 0 0 2 0 
3 29 0 0 0 12 0 0 0 5 7 8 18 6 8 8 4 5 22 6 20 3 0 7 3 21 0 7 0 0 29 12 0 0 8 0 36 9 0 0 
0 0 0 20 5 28 0 8 0 0 25 3 9 6 0 0 3 12 6 5 11 27 1 28 5 12 0 17 8 0 0 0 0 14 0 0 3 55 1 0 
0 1 1 16 0 18 0 15 1 0 0 0 2 4 0 8 0 19 0 18 0 0 15 19 21 0 10 0 0 0 0 6 0 0 0 0 1 5 0 0 
14 0 0 64 16 8 3 29 0 11 3 0 0 22 0 0 23 0 19 12 8 16 13 0 0 16 7 1 12 12 8 10 4 0 19 28 4 5 0 25 
19 0 29 0 15 0 0 16 0 0 0 13 16 10 5 18 9 6 7 9 0 0 0 28 0 0 4 0 10 0 1 29 0 15 0 0 7 0 10 20 
0 0 16 23 0 0 26 1 19 20 18 0 0 7 19 0 0 0 4 0 0 0 1 6 15 0 13 21 0 0 8 2 0 19 0 0 10 0 0 77 
9 6 0 0 4 28 7 48 18 7 29 6 11 0 14 0 7 16 14 0 1 43 14 8 0 3 19 1 1 0 44 8 0 0 17 28 19 0 0 34 
0 0 0 13 0 28 0 18 23 0 0 0 2 0 12 0 0 0 2 0 0 13 7 0 10 26 0 0 11 0 9 23 0 28 27 0 0 0 0 0 
28 11 0 2 32 20 2 0 0 18 0 24 0 0 0 0 0 18 9 0 10 0 16 0 0 20 0 6 9 0 10 7 0 11 23 17 32 10 7 0 
7 17 10 0 37 31 25 21 40 0 28 23 0 5 15 0 7 1 27 7 0 8 18 1 0 14 0 12 11 17 2 29 3 11 9 33 66 0 26 17 
10 0 0 2 0 20 8 12 0 6 0 23 0 0 0 2 2 0 1 1 0 0 0 8 0 10 0 5 0 13 0 10 0 0 5 0 0 0 0 0 
0 18 0 0 13 69 31 30 0 0 0 0 5 21 8 0 0 0 1 0 0 6 4 9 0 0 0 13 13 0 2 5 11 28 25 2 2 11 33 0 
0 9 62 7 0 0 6 15 13 6 2 0 0 0 0 0 0 0 0 0 6 17 4 7 0 9 4 2 7 0 5 0 5 26 23 0 0 5 1 19 
0 0 0 32 1 0 8 5 22 0 4 18 5 0 11 0 1 13 12 0 0 0 0 0 21 5 11 0 0 18 9 0 0 0 0 31 32 21 0 1 
0 16 9 41 5 0 0 28 0 0 44 6 17 0 0 0 13 14 0 0 0 2 0 15 0 0 0 14 0 3 0 0 3 30 0 40 0 0 28 12 
0 4 13 16 44 0 0 0 0 20 3 17 17 1 0 13 14 0 0 9 0 8 10 0 0 15 17 1 6 13 10 1 1 11 0 3 0 0 3 35 
0 0 3 2 0 0 0 0 17 20 4 2 5 1 0 0 0 0 0 14 24 0 26 46 2 17 2 4 0 8 8 11 1 20 16 0 0 4 0 17 
12 0 27 0 0 0 61 0 0 0 15 11 0 0 0 0 5 26 3 1 12 15 0 3 18 7 1 16 20 19 8 21 29 17 5 19 15 0 32 10 
0 0 0 35 23 0 0 15 9 17 3 2 18 0 5 0 3 28 0 15 0 2 0 14 0 0 3 23 11 3 0 10 0 0 0 32 0 0 0 1 
11 15 0 0 3 9 0 0 0 1 0 0 0 0 0 0 0 0 0 0 0 0 18 2 0 2 0 7 0 0 4 19 0 0 2 0 0 0 0 0 
2 0 4 20 0 0 16 21 0 30 0 15 22 0 25 0 5 4 0 0 5 10 0 20 0 5 5 12 19 20 19 5 23 4 27 5 0 23 29 0 
