40 23
1 27 0 0 57 26 4 0 21 14 36 18 0 0 1 9 0 0 4 9 0 7 8 0 10 0 0 0 0 20 16 32 0 23 17 0 21 0 0 28 
7 0 0 0 23 2 0 26 0 8 0 0 0 0 0 10 1 8 0 0 2 0 8 0 0 17 0 3 19 29 0 0 0 0 0 2 27 2 0 1 
0 0 0 17 0 0 0 4 16 0 0 16 3 10 7 6 0 12 0 27 17 6 0 12 37 4 0 19 4 17 27 0 17 13 0 12 0 0 0 21 
0 7 0 0 0 1 0 7 0 0 0 4 0 0 7 0 22 4 8 11 0 0 0 0 1 0 20 0 0 3 4 0 0 7 14 9 11 0 51 1 
4 8 6 40 16 30 48 25 0 0 0 8 14 19 12 25 0 21 0 0 9 2 2 17 3 0 14 0 0 17 0 0 32 18 12 32 25 1 0 1 
4 0 17 11 29 35 0 0 6 7 0 12 17 0 0 7 0 3 0 17 15 0 5 20 16 0 0 2 8 36 9 5 0 4 7 0 0 9 0 34 
13 0 0 0 0 24 0 4 18 4 0 3 25 9 0 10 14 45 7 0 10 6 6 2 0 4 11 14 0 14 2 26 13 0 0 0 19 9 0 0 
0 7 0 2 2 0 1 0 14 0 0 12 12 0 0 7 0 0 16 3 0 12 0 0 2 0 2 0 2 0 0 0 0 0 24 0 0 1 0 0 
11 22 12 0 1 0 0 7 0 0 6 0 14 3 12 9 14 13 0 6 6 8 9 30 9 0 29 0 0 8 16 19 0 0 0 9 0 0 0 39 
0 0 0 27 26 0 26 0 21 17 13 27 2 0 8 0 4 0 19 8 2 0 14 0 27 11 12 28 0 7 0 0 24 22 0 38 0 12 11 0 
0 1 6 0 0 9 8 0 0 8 0 0 0 0 0 0 0 11 0 3 0 7 0 10 2 13 7 11 0 0 0 0 0 11 9 0 0 2 4 0 
28 31 0 10 22 26 20 3 0 0 0 0 0 13 20 9 0 14 0 7 0 8 1 10 0 0 29 0 24 9 26 26 7 12 0 0 29 0 21 41 
17 40 0 21 67 0 0 4 0 7 0 1 0 0 18 0 0 31 0 0 0 6 1 4 6 2 12 23 0 0 3 14 18 29 0 0 0 28 46 0 
0 4 21 3 0 0 0 12 2 0 2 12 5 6 0 12 0 10 0 0 6 0 0 28 0 14 0 16 2 0 1 0 0 3 0 0 0 0 0 14 
0 21 19 0 18 0 0 0 0 22 1 19 4 20 12 9 0 0 0 0 0 8 0 6 0 14 0 0 0 0 21 27 0 0 1 26 0 0 12 45 
0 0 0 3 0 0 20 0 0 16 0 7 0 24 0 15 0 0 0 0 0 1 1 0 0 0 3 0 6 0 0 0 6 13 13 22 21 0 0 1 
0 20 10 0 6 0 2 0 0 25 3 0 30 7 12 2 0 0 17 0 34 10 3 5 12 12 4 5 0 28 16 0 25 5 33 3 13 0 26 0 
0 33 28 31 17 33 1 15 0 29 12 12 5 2 0 0 0 41 0 4 0 24 12 4 15 14 4 3 3 0 46 8 0 0 62 0 5 2 62 0 
27 3 0 50 11 2 2 14 0 0 0 12 9 12 0 22 9 7 0 7 5 33 7 0 0 13 0 11 0 6 3 20 0 3 0 0 15 62 34 35 
0 20 0 0 33 9 0 0 11 5 0 11 19 28 20 0 0 22 0 2 11 22 0 0 10 17 18 0 9 16 0 10 6 2 33 2 0 31 6 22 
0 0 32 0 0 3 0 0 23 20 0 20 0 0 0 0 0 0 0 0 42 3 16 11 22 4 9 14 33 20 4 9 3 0 3 3 9 0 36 0 
0 16 0 27 0 0 17 1 42 6 10 11 1 6 0 6 8 30 2 0 13 11 0 0 3 0 0 6 15 0 46 0 0 26 24 0 3 65 18 0 
0 3 0 6 0 0 4 29 0 7 0 0 5 16 13 2 0 14 0 0 0 0 0 0 0 0 0 16 2 0 0 0 0 0 0 0 38 0 8 0 
