40 23
0 31 18 29 14 6 0 3 0 0 8 7 2 14 27 20 0 2 3 4 2 15 28 22 8 0 0 28 31 10 0 0 10 18 0 5 0 0 0 10 
20 20 0 11 39 0 14 14 0 15 0 0 0 7 29 0 0 15 0 0 21 27 11 9 1 0 13 23 0 0 0 0 2 21 0 0 0 0 0 0 
20 0 0 5 14 4 0 0 0 0 18 0 25 11 0 0 0 1 5 20 0 0 0 22 20 0 14 0 0 1 1 13 0 0 0 18 0 6 0 17 
0 1 16 33 9 0 0 20 0 0 41 0 20 0 0 0 13 10 2 4 1 7 0 8 0 0 7 3 7 0 0 4 31 3 0 0 55 11 0 0 
0 3 6 0 0 4 26 0 33 0 0 22 0 11 0 0 2 0 8 0 8 0 0 27 12 0 0 0 3 17 0 0 26 8 11 29 0 0 40 7 
12 0 4 0 0 5 36 24 21 1 0 0 12 5 15 6 0 0 10 37 5 21 10 18 10 15 6 5 10 37 1 6 7 0 10 33 0 12 5 0 
0 0 5 31 7 32 14 25 0 7 11 4 10 1 8 0 1 0 11 0 8 13 21 0 0 0 16 22 16 7 3 0 25 0 4 32 0 0 33 0 
8 0 55 43 0 0 5 7 0 20 1 30 7 0 24 24 20 4 0 21 0 9 0 33 0 0 15 27 0 38 36 0 6 0 12 0 34 0 15 0 
0 0 0 0 0 0 5 1 0 0 28 12 0 7 0 0 0 0 0 0 0 0 3 8 0 0 0 11 0 0 0 1 22 16 0 5 0 0 15 0 
0 0 0 0 0 0 0 0 0 0 0 16 2 0 15 0 0 0 3 0 0 13 0 0 9 7 0 8 10 0 0 0 9 7 0 0 0 0 0 0 
11 16 6 0 0 24 28 3 0 0 61 10 0 5 0 0 0 8 8 0 0 4 12 0 0 2 0 0 0 11 12 1 12 1 21 0 2 0 28 29 
67 11 0 12 0 0 0 13 0 0 4 3 34 1 11 3 4 0 0 0 0 0 1 0 0 0 0 11 0 29 0 16 1 4 2 7 0 0 34 8 
0 0 0 0 43 0 5 37 6 2 0 0 24 4 12 7 0 0 14 1 24 4 0 0 0 13 0 8 0 0 3 24 14 1 0 2 24 5 38 10 
12 12 30 26 0 0 7 25 21 11 0 13 0 15 0 8 0 6 1 19 10 0 2 14 17 7 0 0 7 64 0 2 14 0 0 21 0 0 0 0 
0 23 0 0 16 0 3 3 43 0 6 24 0 0 5 0 7 0 15 5 0 9 0 7 23 0 12 0 0 0 0 6 1 20 34 13 1 13 50 0 
0 0 13 8 5 0 5 28 16 2 0 0 8 20 25 6 0 20 3 0 20 16 8 17 33 0 6 20 2 0 0 20 7 0 0 0 23 25 0 4 
37 0 0 0 36 0 0 26 9 14 0 1 3 4 0 0 4 24 0 20 16 17 0 0 1 0 0 0 9 0 0 1 0 33 7 16 2 24 29 0 
0 0 2 0 31 0 20 0 13 1 0 10 0 0 21 10 0 5 11 0 0 0 17 0 0 2 0 6 24 0 8 22 28 14 6 0 0 12 0 0 
1 1 0 0 0 0 4 11 20 0 27 1 0 2 0 7 3 18 13 0 0 0 10 0 0 0 0 0 0 0 0 7 9 9 0 4 0 0 0 0 
0 0 33 0 17 28 17 18 0 0 0 0 0 0 0 9 15 6 2 0 0 53 4 41 0 13 0 7 0 6 3 25 7 31 7 12 3 0 0 4 
37 14 5 1 11 20 14 24 0 0 1 12 0 4 1 6 6 0 4 0 14 0 6 26 17 10 0 11 30 0 0 0 13 9 2 19 11 75 31 0 
0 0 0 0 0 7 9 0 0 0 26 0 7 3 0 23 0 0 2 6 0 0 13 0 0 0 0 0 0 10 0 0 14 13 0 6 0 0 0 29 
20 19 0 0 12 25 2 17 22 0 9 8 15 21 5 1 13 11 0 2 16 13 0 7 5 0 43 2 0 0 56 5 12 0 1 13 2 0 0 4 
