40 23
16 10 18 0 18 31 27 18 15 17 29 4 21 10 3 2 25 22 0 12 34 3 20 6 8 18 21 19 3 5 41 9 0 15 0 61 31 0 21 11 
0 3 27 0 26 8 39 13 0 0 0 9 10 3 19 9 22 13 1 0 0 27 3 12 0 30 13 21 6 11 6 0 7 0 0 19 0 15 22 0 
0 0 2 0 0 0 0 0 0 0 0 0 0 14 0 0 16 0 7 14 0 0 0 5 0 1 3 14 6 7 4 0 48 14 0 0 8 0 0 0 
31 0 0 0 1 14 0 26 0 16 1 1 2 6 15 2 0 0 0 11 7 0 17 0 12 12 6 4 0 15 12 49 0 39 0 5 0 1 0 2 
0 0 3 0 17 27 0 0 0 0 14 0 0 20 0 2 6 5 2 0 3 0 0 0 0 3 8 2 4 2 0 1 42 17 12 0 0 1 0 0 
13 0 0 0 13 4 33 29 0 0 0 0 8 5 0 8 0 0 0 20 15 0 0 7 15 9 0 0 5 0 0 29 11 0 11 0 33 14 0 11 
0 0 21 18 1 0 0 0 0 8 0 7 19 15 8 0 0 22 1 10 17 0 0 0 0 0 5 0 9 27 16 9 0 28 2 0 1 23 0 3 
31 7 5 55 6 0 6 9 16 3 0 0 3 2 0 9 2 0 8 18 0 8 0 27 9 0 6 31 0 0 0 29 0 0 31 0 0 18 7 33 
39 0 11 0 8 0 0 16 0 0 0 0 10 26 1 0 0 11 11 0 0 0 0 22 0 0 0 0 0 15 13 0 28 19 2 5 0 1 0 65 
35 11 1 0 5 0 0 0 0 4 6 0 11 0 7 17 0 5 19 3 5 1 0 0 0 0 0 2 0 0 0 2 0 23 5 36 18 35 0 32 
0 0 0 0 1 0 0 0 0 0 12 0 17 1 18 0 0 4 0 0 0 4 0 19 8 1 7 0 0 17 10 0 59 4 0 1 0 5 10 3 
38 35 15 0 4 0 23 20 0 0 7 0 0 26 25 0 0 16 11 0 0 0 11 6 0 13 0 4 1 33 0 8 6 31 5 40 35 8 9 36 
0 0 22 9 3 12 0 0 4 0 13 12 0 0 0 44 0 8 0 3 7 2 0 23 7 23 14 0 0 18 0 21 3 0 2 15 5 0 0 24 
13 35 39 1 0 18 23 0 0 4 25 2 0 13 0 2 3 3 1 0 0 0 22 16 8 12 6 0 0 23 0 4 44 0 12 22 26 6 0 3 
0 0 0 0 24 0 0 37 5 0 8 0 0 26 7 14 0 3 12 1 6 0 2 6 0 5 0 0 8 14 0 0 12 29 1 22 0 11 19 14 
34 0 69 0 0 0 15 2 50 0 0 19 0 0 0 0 0 5 18 0 3 15 0 5 0 0 11 3 10 0 6 0 21 40 35 17 31 40 0 0 
0 0 0 0 18 30 17 0 22 0 0 25 0 19 0 5 4 0 0 0 26 4 0 17 20 0 0 0 0 0 2 4 3 0 19 26 7 9 0 0 
0 0 0 0 5 0 10 12 0 0 0 2 0 22 0 0 0 5 8 0 0 0 0 7 4 10 2 0 16 0 7 0 1 0 0 34 0 3 0 0 
19 2 4 2 35 0 25 27 13 11 0 1 0 4 29 0 0 0 14 27 11 25 0 18 2 11 30 8 5 2 28 27 0 12 27 0 0 0 0 0 
23 0 9 0 16 0 51 4 80 28 12 67 0 15 0 0 0 26 5 8 4 13 1 35 4 7 27 8 0 1 18 27 13 33 16 27 32 0 0 33 
8 43 0 26 12 1 24 0 17 22 28 7 47 14 0 14 0 5 0 0 0 4 0 0 21 1 8 0 15 0 24 22 3 24 3 6 11 2 65 27 
0 14 45 18 2 0 0 0 0 0 11 0 0 0 0 0 0 0 0 0 0 2 0 0 0 14 3 0 0 3 4 0 0 0 4 0 8 12 36 0 
0 35 7 0 35 0 0 0 0 0 42 0 0 19 14 0 11 24 18 0 16 0 0 12 0 1 0 11 0 27 0 0 41 0 0 0 1 0 22 0 
