40 23
0 26 36 0 7 26 0 12 0 0 21 0 0 2 11 0 3 0 2 12 21 19 13 7 0 1 16 17 8 0 0 0 0 58 8 0 0 0 19 0 
4 5 0 0 10 0 16 13 10 1 6 0 0 20 0 0 6 30 0 0 7 0 0 0 10 1 0 1 7 0 7 14 12 0 4 0 0 24 0 0 
26 19 0 13 0 12 30 0 0 12 0 0 0 12 8 0 0 0 0 0 32 19 8 8 10 0 0 21 0 0 0 2 17 11 5 0 5 0 17 5 
18 15 31 0 3 9 0 31 0 17 11 17 0 0 22 9 0 0 35 0 13 11 29 0 13 2 3 8 5 0 18 5 0 21 9 0 11 0 63 0 
7 0 13 22 10 28 12 0 0 16 0 0 0 0 10 4 22 0 0 0 16 0 2 0 9 32 0 0 0 18 0 0 12 26 0 5 0 0 43 0 
34 49 4 0 3 13 0 0 7 69 13 0 0 0 4 10 3 0 0 0 0 0 2 18 0 2 0 7 8 2 0 22 0 20 30 0 23 38 14 25 
0 0 0 0 11 0 2 0 0 7 0 0 0 7 0 0 0 0 0 16 0 6 2 0 8 15 2 10 0 0 9 0 0 1 0 21 0 9 0 5 
39 0 3 0 14 0 0 26 8 0 28 19 0 3 0 15 13 15 14 0 0 10 8 12 16 4 12 0 0 7 15 1 21 0 0 0 12 30 28 39 
73 33 14 0 18 30 0 0 0 6 0 16 0 13 10 0 10 0 7 3 11 12 0 0 0 2 50 18 22 0 0 16 18 0 16 65 0 2 38 5 
0 2 6 0 8 9 0 10 0 15 0 0 0 0 0 3 0 0 0 15 13 0 3 0 4 4 0 11 19 0 0 0 0 5 0 5 0 11 0 35 
2 0 27 28 35 0 29 0 0 7 33 14 0 8 0 0 0 11 0 0 0 10 15 8 5 1 16 0 20 25 0 5 7 5 0 57 0 13 0 10 
25 8 31 0 4 0 0 1 12 0 0 2 9 11 5 0 0 0 6 3 0 9 0 0 0 8 26 0 10 0 0 2 14 33 7 0 0 0 24 5 
39 0 0 0 61 29 20 12 23 7 0 0 0 35 0 16 17 6 0 20 0 2 12 0 0 13 43 14 5 6 15 23 25 5 15 0 0 1 46 34 
0 8 0 0 0 0 0 11 29 11 9 46 15 7 0 0 10 0 0 9 0 9 20 0 4 0 4 0 2 10 6 7 2 8 9 3 25 29 7 0 
0 31 0 17 50 12 0 17 0 0 5 0 0 0 7 0 0 5 11 0 23 0 3 0 0 21 0 0 3 7 0 27 31 1 7 8 32 6 1 1 
8 37 0 5 14 0 0 7 28 0 0 0 3 0 2 3 15 20 1 1 3 0 16 0 1 10 8 0 0 0 0 1 31 0 1 0 28 0 19 0 
0 0 0 26 0 8 0 3 0 0 0 16 4 8 0 0 0 2 0 15 0 0 13 0 28 0 0 3 0 23 0 0 0 0 0 0 0 19 0 4 
67 0 0 1 5 0 0 4 14 4 0 0 0 0 0 19 9 0 0 0 17 18 25 15 0 0 0 0 0 29 0 2 0 2 2 0 12 0 51 0 
4 0 0 0 5 10 2 0 2 13 6 7 3 24 4 13 0 12 4 18 3 0 11 13 0 0 0 0 10 13 0 5 0 0 17 18 16 40 3 0 
14 16 0 34 9 21 8 13 45 49 20 27 31 12 3 2 44 16 0 7 4 29 0 0 0 3 19 16 27 1 33 16 11 0 5 38 32 13 31 23 
0 0 0 5 0 0 0 7 28 3 0 17 3 0 5 0 13 0 0 0 1 1 3 0 0 5 10 0 0 9 0 0 16 0 0 4 20 5 8 1 
2 0 20 0 0 0 0 0 20 39 11 0 0 9 0 0 0 0 11 0 2 35 3 0 6 8 5 0 20 8 5 6 23 11 10 2 34 0 4 0 
25 1 29 0 5 0 0 0 0 18 0 0 0 0 22 0 0 9 0 0 13 0 0 6 0 4 0 5 0 25 0 29 11 22 14 8 0 0 1 25 
