40 23
0 0 15 28 13 0 8 0 4 0 21 3 20 0 11 3 2 1 2 10 10 13 8 20 21 0 0 0 1 0 12 0 7 0 12 9 0 19 17 11 
26 0 0 46 19 3 0 0 0 19 0 13 16 5 0 30 0 0 0 35 0 8 17 0 1 14 26 0 20 0 0 24 17 0 15 3 0 0 7 14 
10 7 0 0 0 0 17 5 7 19 14 0 5 0 20 0 0 0 0 0 10 0 0 28 7 8 0 6 22 0 5 15 20 0 0 0 0 0 29 0 
0 2 5 5 16 27 28 0 0 25 25 18 0 0 0 18 2 3 13 9 1 0 0 5 7 13 10 15 1 12 0 13 6 18 30 13 0 14 2 15 
0 0 61 3 0 53 31 0 15 0 0 0 0 7 2 0 0 0 13 0 15 12 23 17 30 12 24 0 23 10 7 14 23 12 31 35 12 0 6 47 
26 0 0 7 4 0 0 2 0 0 7 0 0 0 7 15 2 2 0 7 0 0 0 3 40 0 0 0 12 29 0 16 0 0 0 43 0 0 0 0 
0 0 15 0 0 0 0 3 0 0 25 0 10 4 3 0 6 5 2 3 0 0 18 6 0 0 3 12 0 17 0 0 0 0 7 22 0 0 0 3 
0 0 0 9 0 0 9 27 0 6 0 19 7 0 0 3 0 30 0 13 0 0 0 0 0 8 0 13 0 0 26 0 18 0 0 0 3 0 1 39 
0 27 26 2 0 0 0 0 0 0 0 0 9 0 0 0 0 10 0 2 0 5 0 6 0 0 8 10 23 0 0 8 0 0 5 0 0 0 0 0 
17 0 6 9 23 4 45 15 0 0 2 0 2 13 0 0 0 5 4 11 0 19 20 0 0 18 18 22 8 12 5 0 0 0 0 61 0 13 6 0 
0 34 1 50 32 0 6 0 18 25 24 0 0 4 0 0 9 5 0 16 4 13 0 0 14 0 6 0 9 0 34 0 6 0 11 34 21 0 1 36 
7 13 9 0 0 0 8 0 5 0 0 9 0 3 25 3 8 0 0 0 0 0 0 0 3 11 0 0 3 0 0 0 0 0 0 0 0 13 0 0 
0 41 0 14 0 0 5 0 18 15 0 16 3 11 6 3 15 6 0 9 27 10 13 1 27 11 0 42 8 0 5 14 0 0 8 21 0 0 29 0 
0 26 0 0 0 7 21 0 0 0 0 0 7 0 10 8 0 21 15 19 0 0 9 0 28 6 0 26 0 0 0 9 0 15 0 8 0 0 22 0 
0 14 5 0 0 0 0 0 0 0 0 43 16 23 0 8 9 0 13 0 18 5 16 10 12 0 0 16 0 27 7 13 0 0 13 0 21 23 42 0 
32 66 27 0 32 0 20 7 0 0 1 0 0 0 26 1 8 7 9 0 0 0 0 9 8 18 20 0 11 37 13 16 38 27 9 18 1 1 0 19 
3 42 0 3 10 0 13 0 5 13 17 11 0 6 2 0 15 9 0 7 11 0 14 14 5 4 16 0 31 0 7 7 0 0 0 28 0 0 0 0 
19 0 0 0 17 0 15 0 28 0 0 13 36 0 0 0 8 4 0 2 1 20 0 17 11 8 14 0 0 6 1 1 0 21 0 8 83 14 21 3 
30 0 18 2 0 32 8 28 0 29 0 0 0 43 0 3 0 21 3 25 0 2 4 0 0 4 0 41 0 1 20 0 0 6 2 28 0 51 20 6 
0 3 48 18 21 14 14 44 5 4 0 0 0 0 13 25 11 9 0 7 32 10 15 21 0 0 9 0 0 6 0 2 30 10 0 19 61 19 0 0 
0 25 0 10 19 0 3 0 26 24 0 11 23 0 14 1 1 8 5 0 0 0 4 0 0 7 37 24 14 14 0 0 1 7 14 27 0 0 14 17 
0 0 15 11 0 11 2 0 18 7 32 18 2 16 11 0 7 0 3 12 14 15 0 13 3 0 13 0 20 32 0 2 7 0 21 30 18 0 0 3 
21 29 17 22 0 0 0 12 30 7 0 0 0 12 11 10 7 0 18 44 7 0 0 0 0 12 0 21 13 0 41 0 38 2 15 2 0 15 9 39 
