40 23
32 19 0 0 0 0 14 0 0 0 7 0 0 31 10 13 14 15 6 18 33 12 0 0 10 0 14 0 0 13 22 0 24 8 0 0 0 19 25 2 
36 0 36 24 9 23 0 0 0 0 30 19 2 15 3 0 8 0 0 58 0 0 0 0 4 11 0 0 8 0 3 0 6 19 0 0 64 11 0 20 
12 8 15 57 7 0 0 13 30 5 14 9 21 0 25 9 11 8 20 15 7 32 0 0 0 9 7 11 10 0 2 0 2 37 9 14 17 0 43 36 
0 0 26 0 0 0 30 0 0 0 25 2 27 22 7 9 0 30 13 8 0 5 0 10 3 23 0 27 0 0 3 3 0 6 0 62 0 0 0 27 
0 40 0 5 0 34 17 0 0 24 0 11 5 0 21 25 0 0 6 13 19 16 10 8 0 18 0 0 7 0 0 1 0 20 0 0 17 23 0 41 
0 17 0 3 0 8 16 0 0 1 24 7 2 0 0 3 7 0 17 0 6 2 15 0 0 0 7 0 0 0 0 4 9 0 0 0 0 13 0 0 
31 32 3 43 1 0 0 0 2 2 1 0 23 1 0 11 0 0 5 4 0 17 0 7 11 8 0 12 25 0 10 31 0 43 0 10 0 6 0 0 
0 0 0 2 0 0 0 0 0 11 8 0 3 0 0 0 0 8 7 0 18 1 9 14 6 0 0 7 14 0 0 0 12 12 0 0 0 12 4 0 
0 24 4 4 35 3 10 1 0 51 0 2 0 0 17 0 13 0 5 0 0 0 17 0 22 24 0 0 13 0 14 0 20 0 0 15 22 5 29 45 
58 1 6 3 3 6 0 13 0 0 17 0 0 0 4 17 0 13 0 0 12 7 7 47 0 0 0 9 1 23 20 0 17 3 41 0 0 10 4 2 
0 0 1 1 26 0 0 0 11 0 1 18 7 21 0 9 0 0 10 14 1 7 16 0 1 0 3 0 8 8 0 0 9 0 32 2 23 0 34 42 
0 16 4 2 1 0 0 0 7 0 18 34 11 0 8 13 0 0 0 1 11 0 10 0 0 9 0 0 18 7 27 6 0 0 0 0 0 0 1 28 
35 0 1 4 0 0 0 27 0 0 0 8 6 11 0 17 7 0 2 0 10 0 0 0 9 0 19 0 2 0 21 0 14 3 14 5 1 0 0 0 
0 0 0 8 4 0 0 0 0 33 2 8 11 0 5 18 3 0 5 0 8 0 0 4 0 0 3 0 4 4 0 0 20 3 0 0 0 28 0 0 
39 10 16 0 1 0 9 0 0 1 3 8 30 0 0 0 0 5 0 12 1 0 10 0 0 15 34 26 16 18 2 0 1 1 2 8 9 5 0 0 
5 19 0 6 22 0 0 9 0 7 0 0 18 9 7 0 29 1 0 13 19 0 0 0 0 11 6 0 0 13 18 0 4 0 0 0 11 0 13 0 
29 24 10 0 21 7 0 0 0 0 24 1 11 5 1 1 18 6 10 0 0 7 2 3 0 33 3 1 0 19 0 0 14 29 0 5 0 0 13 7 
36 1 1 36 0 0 0 0 25 30 3 3 11 0 15 0 0 17 0 13 0 1 0 9 0 0 17 8 0 0 16 23 9 11 0 0 36 16 0 73 
0 23 0 15 32 0 18 0 22 5 25 31 22 3 25 0 34 10 4 14 1 1 5 12 10 0 0 4 0 15 35 7 0 0 22 13 37 33 0 10 
0 1 19 13 9 0 4 0 0 0 4 0 0 0 22 9 5 0 0 0 0 0 0 0 8 0 0 1 7 0 0 0 18 0 17 20 0 0 12 1 
5 0 29 22 2 6 0 0 0 25 69 28 28 0 0 0 0 6 9 6 1 16 4 0 0 59 16 7 16 0 0 0 0 19 24 0 32 0 8 1 
5 0 6 11 4 0 33 12 6 0 11 1 20 5 0 4 10 35 0 15 2 11 10 0 0 9 13 0 27 0 0 28 17 0 12 15 45 0 0 0 
0 0 34 0 0 16 0 24 0 0 5 1 10 0 7 0 20 4 2 21 0 25 0 0 1 21 0 10 0 3 0 24 7 4 17 8 34 4 6 12 
