40 23
0 33 18 7 7 0 17 20 18 9 7 4 0 0 23 0 5 0 0 0 48 0 0 0 22 1 44 0 8 0 4 0 0 0 9 0 0 0 0 1 
0 0 0 18 0 0 13 0 3 0 0 21 0 0 21 0 15 0 0 10 9 0 0 12 0 1 0 0 11 0 0 0 0 0 17 33 9 0 27 1 
0 21 12 2 28 0 24 0 21 0 4 0 0 9 0 13 12 0 0 0 20 0 21 36 15 0 0 4 16 21 0 0 20 0 28 0 0 4 1 15 
0 4 14 0 0 11 1 27 9 0 3 7 11 0 14 0 2 9 0 0 3 11 8 12 0 3 8 14 3 15 5 0 0 5 56 0 0 0 0 0 
4 24 36 52 3 38 40 4 5 9 16 51 0 2 12 0 2 14 6 14 4 2 0 16 20 13 13 24 8 30 28 0 27 13 39 0 38 0 61 12 
11 0 0 3 0 14 0 26 7 27 20 0 6 15 17 0 5 17 9 0 0 0 0 18 2 0 2 0 27 0 0 0 0 0 0 11 56 13 0 0 
8 0 6 22 8 23 13 48 1 3 29 0 15 2 14 0 0 32 0 0 7 0 0 6 17 11 0 33 15 0 15 0 3 0 17 39 0 0 33 48 
6 17 3 0 0 3 8 22 19 0 0 14 19 19 0 0 12 15 0 0 12 0 10 13 2 48 1 1 19 0 7 19 19 9 8 0 0 3 0 0 
0 0 18 27 29 0 4 0 0 9 9 3 3 21 11 0 12 0 0 0 17 0 0 0 0 0 0 0 17 12 2 18 0 24 18 0 0 0 0 0 
15 0 33 11 0 4 31 5 0 1 4 0 0 0 11 0 0 17 5 10 4 0 12 10 0 0 2 28 10 0 0 0 0 16 7 33 30 58 0 0 
0 9 0 10 0 3 22 13 0 0 24 0 6 0 12 0 3 1 0 14 10 0 0 0 28 0 9 0 4 0 0 0 0 14 21 0 17 23 0 0 
29 0 0 0 8 18 0 0 9 7 6 8 1 3 0 8 0 3 0 14 0 18 11 5 3 0 0 0 9 5 0 11 15 0 34 1 0 0 14 18 
1 0 21 9 32 10 0 23 0 29 0 0 23 3 0 0 0 0 0 0 7 0 0 19 4 0 12 0 1 0 23 5 5 0 0 22 32 29 29 11 
4 0 0 23 0 6 9 0 0 0 0 23 1 1 0 2 5 14 14 8 4 0 9 0 0 0 23 0 15 0 17 9 14 0 38 18 0 26 8 0 
5 7 12 0 3 0 13 0 7 0 23 0 0 0 10 0 8 14 2 8 0 11 12 15 29 19 0 5 16 0 45 0 0 0 22 0 12 10 0 5 
0 5 20 0 0 1 27 10 2 6 0 0 0 3 0 8 4 6 6 0 1 12 15 13 6 5 0 0 0 0 0 0 0 6 32 0 0 0 0 0 
105 0 0 0 2 24 12 6 0 19 0 19 0 0 0 17 15 4 3 0 1 0 0 0 0 0 0 0 19 24 9 0 17 0 0 0 0 37 38 0 
44 38 0 17 0 0 29 19 9 36 3 0 0 5 14 15 0 8 6 0 33 36 2 11 0 41 14 13 0 14 0 4 12 6 27 0 15 0 15 52 
0 44 22 38 27 2 0 9 9 0 0 0 0 22 12 2 0 9 0 9 9 0 1 7 14 1 11 0 16 0 2 21 31 30 6 25 1 6 0 0 
0 0 0 18 18 52 0 24 12 0 36 23 0 0 0 6 0 2 2 15 14 0 28 5 22 0 0 7 40 19 0 24 3 11 12 30 12 0 0 0 
0 26 0 16 0 1 27 9 26 3 22 8 0 31 0 0 17 0 0 0 19 18 0 5 1 9 0 24 7 8 20 0 3 27 0 14 0 0 0 0 
0 4 0 0 3 25 9 0 36 0 0 18 4 0 16 10 1 10 2 0 2 0 0 5 11 0 0 23 23 0 0 27 0 0 0 33 0 0 8 15 
5 12 0 34 27 26 7 0 5 0 12 26 9 5 0 0 18 17 0 2 14 22 12 14 11 2 9 14 0 0 0 38 3 33 35 0 0 32 38 0 
