40 23
0 0 0 0 0 29 0 0 0 0 0 0 31 0 16 0 0 0 7 0 0 0 0 5 0 0 0 9 6 0 0 7 0 12 29 6 0 13 7 0 
0 19 0 32 0 11 21 9 0 30 0 0 0 7 0 0 0 0 0 15 7 0 14 21 0 0 9 15 25 0 0 9 0 0 0 0 1 0 0 7 
18 7 0 0 0 0 0 4 7 0 0 0 0 0 56 0 0 17 3 0 19 13 3 0 18 0 0 0 0 0 0 0 0 0 16 0 1 0 14 44 
0 30 11 0 0 0 0 31 15 0 4 0 25 5 4 14 10 17 0 0 0 4 0 25 0 0 0 0 8 22 16 0 0 10 0 0 9 0 0 0 
0 0 35 0 0 12 0 0 0 0 4 1 0 14 2 28 0 6 1 2 27 12 9 8 14 0 0 0 7 0 17 0 12 12 0 24 0 35 23 0 
0 0 33 0 24 0 3 0 2 0 19 0 0 17 10 0 0 0 0 0 0 0 3 0 0 0 22 0 24 19 0 18 10 0 21 55 0 7 18 0 
0 9 15 0 10 19 0 6 66 5 3 2 6 4 22 11 1 14 0 46 0 13 12 10 13 25 6 4 20 20 22 4 36 0 16 0 22 13 0 33 
0 0 66 5 0 0 0 27 5 0 26 0 0 0 13 5 0 1 0 0 16 0 5 21 0 13 13 8 0 0 0 28 6 2 27 0 0 28 1 0 
4 31 49 10 0 0 19 0 8 0 4 0 17 1 7 2 2 1 0 0 5 2 0 19 4 23 13 11 2 0 0 1 0 0 2 4 1 25 0 14 
38 12 13 0 22 0 0 23 0 7 12 1 21 12 0 13 12 0 3 10 0 7 11 0 0 4 0 0 4 10 18 1 0 23 7 3 0 12 38 0 
0 14 2 36 24 16 0 13 0 0 0 1 0 7 8 22 2 19 6 0 0 20 6 11 9 1 17 0 35 10 0 0 2 10 1 12 13 15 0 2 
0 0 25 0 0 5 2 0 7 1 0 0 8 14 5 0 6 22 4 0 10 5 3 0 0 11 0 39 5 0 10 0 0 5 0 0 0 11 0 12 
0 4 9 0 26 32 33 37 73 8 15 1 23 15 0 9 5 16 11 0 3 21 0 48 0 0 37 17 11 6 2 3 2 12 13 14 10 13 0 75 
0 13 0 0 0 0 17 0 0 4 0 27 1 12 3 0 2 0 17 0 7 0 0 17 3 13 0 0 4 0 0 0 0 0 0 0 0 19 34 9 
0 0 17 10 3 0 6 0 0 0 0 0 0 43 1 0 7 0 0 21 0 0 0 10 0 8 0 0 0 2 0 2 2 20 2 0 0 0 0 0 
37 10 0 16 0 1 30 3 7 0 0 7 0 21 9 7 32 0 0 16 14 19 14 12 0 0 10 0 0 0 0 14 5 12 21 29 0 37 22 6 
0 22 18 30 0 8 2 6 48 2 0 12 11 57 19 18 3 0 0 15 3 13 0 6 9 2 5 0 7 0 7 17 7 15 7 22 28 17 4 0 
6 29 10 0 20 0 8 0 22 0 4 0 0 11 4 12 0 3 7 0 9 17 5 5 0 0 0 17 4 0 29 6 15 0 0 0 2 11 3 8 
19 0 20 8 0 12 0 0 0 0 23 8 0 0 14 7 29 10 9 52 15 0 13 5 10 2 0 0 0 7 0 0 0 0 0 1 6 0 1 23 
18 0 0 0 23 0 17 0 16 37 0 21 23 13 17 0 14 37 31 1 2 0 7 17 0 0 13 7 19 0 56 0 3 0 26 16 0 20 0 28 
1 44 29 14 3 7 21 4 0 0 9 5 29 13 0 11 14 4 6 1 0 15 2 0 12 1 21 0 0 0 0 60 3 0 0 0 23 15 19 40 
0 0 15 0 0 27 0 0 0 14 0 9 0 7 25 9 0 3 19 0 0 12 10 13 0 0 12 1 3 0 14 4 21 3 9 0 13 3 0 0 
15 18 0 0 0 0 17 2 24 3 25 1 0 6 16 13 10 0 9 18 0 0 0 34 0 11 12 2 7 0 0 0 4 0 0 7 26 14 23 40 
