40 23
2 0 33 35 7 0 25 20 31 0 19 13 0 4 0 2 18 18 16 11 0 0 0 0 0 22 9 4 0 6 10 25 45 20 0 24 28 10 42 18 
0 27 4 4 0 0 6 0 0 0 0 0 0 0 0 0 5 16 1 4 0 0 0 0 0 0 0 7 0 10 0 0 0 17 0 0 0 0 0 2 
32 33 0 12 6 4 21 2 19 1 15 11 27 0 13 5 24 9 1 13 14 0 0 16 0 8 14 4 0 16 0 22 0 0 19 23 8 33 6 59 
0 31 5 0 0 1 11 27 0 34 7 27 0 0 0 8 3 0 0 9 18 0 0 0 0 0 0 16 13 0 3 0 31 0 0 36 6 0 0 0 
2 0 22 0 2 2 0 12 1 8 36 14 0 5 0 0 10 0 5 0 8 0 2 21 6 0 26 0 0 0 20 0 8 0 0 9 0 0 0 14 
38 0 0 39 0 0 9 4 26 0 0 4 0 0 0 0 17 0 0 3 0 0 15 0 0 0 7 27 0 0 0 20 15 23 20 19 0 13 35 2 
2 29 23 23 6 0 2 0 0 0 4 0 4 34 1 0 15 17 1 16 17 0 0 0 0 22 24 22 0 0 0 0 0 7 2 2 12 0 1 7 
5 0 0 5 7 3 0 32 0 0 23 0 31 12 0 0 0 0 24 0 0 0 0 0 12 1 0 11 0 0 0 31 0 29 0 3 0 0 4 39 
0 7 0 1 33 0 54 1 29 0 5 0 0 8 0 11 0 13 0 0 18 0 11 0 18 0 0 0 1 0 0 0 0 10 0 10 0 21 20 32 
0 23 7 1 4 0 21 26 7 8 0 0 9 0 0 10 0 0 0 1 4 11 0 13 4 2 0 25 1 0 10 0 4 46 0 15 10 14 0 0 
54 0 13 12 11 29 1 50 8 0 18 0 5 35 10 0 0 0 0 0 0 21 0 0 12 0 6 25 11 8 23 6 33 0 21 3 27 20 10 10 
6 7 29 1 0 26 11 0 0 2 4 2 11 26 0 0 10 0 4 0 4 0 1 11 0 0 1 21 0 0 0 35 0 20 19 3 27 0 0 5 
13 0 0 4 10 43 0 0 5 16 16 0 1 9 0 0 0 6 9 0 8 12 6 2 6 24 0 9 0 0 0 0 3 9 0 39 26 0 0 0 
18 26 34 0 4 0 0 39 0 16 0 10 22 20 18 0 4 23 18 0 15 0 2 10 19 24 0 3 11 0 0 0 27 29 17 14 25 15 5 18 
50 4 6 3 38 5 17 0 25 3 1 2 0 2 0 0 0 1 5 19 23 24 0 2 0 8 24 0 1 0 0 31 7 38 3 67 5 3 0 25 
0 0 0 3 7 0 1 25 0 0 47 22 1 0 0 0 0 0 4 0 4 0 0 0 0 0 1 2 1 2 0 2 20 23 24 0 5 0 0 32 
20 0 47 0 31 0 0 4 0 0 0 9 8 5 41 0 0 0 11 0 19 12 0 13 0 5 21 12 6 15 1 1 0 16 18 31 7 10 7 27 
0 0 37 0 0 0 0 0 0 3 28 0 5 0 0 0 0 0 0 8 0 15 3 0 0 3 0 0 0 0 0 21 25 12 0 0 14 0 0 52 
54 16 0 18 8 7 4 1 8 35 2 6 3 9 14 12 18 7 19 0 2 16 22 11 29 34 0 6 19 25 0 2 14 8 15 25 0 16 9 37 
0 13 61 0 0 0 0 0 0 0 7 0 10 0 0 5 8 17 5 0 1 0 0 0 14 0 4 12 9 27 14 0 6 1 0 0 34 19 0 18 
29 7 0 10 34 0 0 17 6 18 0 7 0 9 6 19 5 12 0 0 0 16 0 0 0 0 0 18 0 41 0 0 4 19 19 11 0 10 26 1 
3 19 0 0 0 0 0 0 0 0 0 0 11 0 8 0 0 0 0 0 1 0 8 0 0 13 1 1 5 0 0 16 0 0 0 16 7 0 0 0 
4 10 25 32 10 0 17 9 4 0 14 14 12 0 4 0 37 0 15 19 0 0 0 4 12 0 1 20 0 0 0 15 0 0 0 51 0 0 2 0 
