40 23
29 0 0 5 0 24 23 17 7 0 6 44 22 9 9 0 27 0 0 14 14 12 5 0 26 27 18 6 13 29 0 20 22 28 0 9 31 0 0 55 
95 35 13 0 2 0 0 6 11 0 0 9 0 10 1 0 0 17 18 8 0 2 0 0 14 0 16 17 35 0 0 0 0 0 26 24 9 0 29 1 
0 0 4 36 15 0 1 0 9 0 19 37 1 6 0 29 20 0 18 8 15 3 9 6 1 0 1 0 14 16 0 2 0 19 21 59 21 1 0 36 
0 0 0 0 2 17 9 0 0 0 1 0 0 25 12 0 0 29 6 0 3 0 0 28 9 15 6 3 0 18 34 0 27 20 0 14 2 0 8 0 
33 0 0 10 8 0 5 0 0 18 5 0 13 10 2 16 25 16 0 20 7 4 19 2 0 4 1 7 9 4 0 0 0 33 28 0 30 0 0 12 
0 0 20 35 13 45 0 17 9 0 5 0 3 3 0 0 0 13 0 0 0 0 15 0 17 0 1 10 7 7 0 28 0 0 4 0 40 0 61 4 
0 0 4 2 0 0 0 30 0 0 11 4 18 0 10 0 12 0 0 0 0 11 0 0 10 7 13 0 0 6 2 6 5 9 0 0 0 24 0 0 
18 0 19 35 64 0 21 30 15 26 17 20 24 0 22 2 23 6 2 12 0 7 0 11 16 29 5 2 21 17 0 19 7 0 11 5 15 0 10 12 
0 0 12 5 0 12 35 0 0 0 0 0 3 7 17 8 10 0 0 11 0 7 0 0 0 8 0 5 3 0 0 0 0 31 0 0 0 23 0 0 
40 0 0 26 6 0 8 0 0 27 4 13 0 0 6 14 0 13 0 0 10 0 0 0 15 0 12 0 0 26 11 0 25 0 0 11 27 0 1 8 
0 5 0 25 6 4 0 16 2 0 1 12 22 4 0 0 0 36 3 3 17 0 14 0 4 11 9 0 14 7 0 0 0 26 3 8 28 0 8 0 
0 0 18 37 0 0 0 35 0 6 8 0 33 1 10 0 20 3 0 7 15 17 0 16 25 0 1 0 0 22 10 11 2 0 4 3 11 0 0 27 
0 0 27 0 9 0 28 0 13 0 0 5 4 1 0 5 6 0 0 0 3 0 6 0 0 2 0 0 1 15 9 0 9 4 54 0 7 0 9 0 
10 0 0 3 30 32 9 0 6 4 59 0 3 12 0 2 0 0 20 1 0 7 0 10 11 7 0 5 22 3 0 11 0 14 27 0 0 9 8 4 
0 0 64 2 0 6 0 15 12 0 0 17 4 22 0 0 11 0 0 1 18 0 0 12 44 6 3 0 15 0 2 0 0 2 13 57 4 0 0 0 
14 5 29 15 0 0 0 11 24 0 7 0 6 0 4 8 0 6 8 5 0 6 0 2 5 7 8 21 0 5 5 5 2 4 5 15 18 0 30 5 
0 30 1 16 23 16 16 0 4 0 28 0 4 12 1 7 0 0 0 8 0 16 4 12 0 0 13 7 17 5 0 29 0 11 0 10 0 14 15 12 
15 38 5 34 29 13 0 0 0 30 19 0 0 0 8 20 6 0 0 35 0 0 0 2 0 0 0 22 1 18 21 5 0 0 30 18 5 0 3 54 
67 9 23 2 3 8 0 0 2 3 0 8 19 15 3 0 20 12 0 0 0 10 13 0 0 47 18 0 2 0 0 12 7 0 0 0 36 0 0 0 
0 49 0 0 0 18 0 2 1 0 5 1 0 12 0 0 15 0 0 9 0 5 0 0 17 0 17 1 6 0 0 0 0 0 6 0 2 0 25 19 
0 31 0 0 0 10 105 3 16 3 18 0 10 0 9 16 0 2 0 0 0 0 0 0 0 19 0 2 4 27 63 14 18 26 4 0 0 0 14 0 
0 10 41 59 7 7 0 18 22 7 18 38 7 0 0 0 0 17 7 0 18 14 0 18 0 0 24 0 24 39 31 0 18 25 0 0 2 34 18 0 
0 72 0 33 20 0 0 18 3 23 0 0 22 0 0 23 20 0 13 0 0 0 0 0 22 33 0 2 0 0 0 18 0 0 0 0 18 0 60 0 
