40 23
0 20 11 0 18 32 0 0 1 3 0 6 0 27 42 0 11 16 0 0 20 4 0 0 0 9 5 0 21 0 0 0 10 11 0 0 23 23 5 0 
0 33 18 13 33 0 0 0 1 0 26 16 14 2 0 0 29 19 2 7 11 7 2 0 0 11 7 16 28 8 2 18 5 0 13 23 6 65 0 0 
0 0 7 0 0 12 0 0 9 0 0 12 0 5 23 0 11 0 5 0 0 0 0 0 0 1 12 16 2 0 0 15 0 0 0 0 0 11 5 0 
0 0 0 0 24 13 5 15 0 0 0 0 0 17 0 2 0 13 3 0 0 0 24 19 0 8 11 0 24 7 11 0 5 13 10 15 15 0 0 0 
10 0 10 16 0 0 0 23 32 26 29 0 0 0 9 0 5 12 16 16 5 5 21 3 0 8 0 0 20 5 12 0 0 25 5 35 0 15 4 29 
0 19 31 0 9 24 24 23 5 37 5 0 10 5 4 8 1 0 0 10 0 0 3 14 0 0 3 4 8 29 24 0 13 0 33 0 0 9 25 30 
0 0 0 0 0 0 0 13 0 0 0 3 5 13 10 0 4 9 16 14 0 9 13 10 0 0 0 6 22 5 0 0 5 23 5 15 22 0 0 0 
29 4 0 0 0 0 29 0 0 0 0 1 40 0 8 0 0 0 4 0 0 17 0 0 0 24 14 0 1 29 0 0 0 5 0 31 0 2 25 0 
0 33 30 0 0 27 18 7 6 0 0 0 18 0 13 3 3 0 11 12 17 0 0 4 18 0 0 2 12 0 25 8 10 0 40 0 9 0 3 8 
0 0 23 0 1 1 0 10 0 0 0 0 0 11 5 0 4 0 2 4 5 0 12 0 0 6 0 0 8 1 0 1 30 9 10 0 10 0 0 8 
0 58 0 29 0 0 11 12 9 0 0 0 0 1 0 0 0 11 8 0 10 17 0 7 11 0 0 8 3 5 0 24 7 32 0 38 0 0 0 0 
59 9 38 0 0 0 0 0 3 6 31 5 0 15 0 0 0 0 1 0 6 0 22 21 13 2 6 14 0 15 20 0 10 8 34 0 0 13 0 0 
0 0 0 56 0 25 4 11 19 2 0 22 9 0 5 1 0 0 19 0 22 9 16 12 18 21 5 8 0 8 22 28 0 0 3 32 12 3 0 19 
3 0 0 0 4 0 2 0 15 0 1 0 0 0 8 0 8 15 35 4 0 6 0 0 0 17 0 4 3 4 1 0 0 23 17 12 0 0 20 0 
46 9 28 25 15 12 6 4 15 0 0 3 2 4 0 19 1 0 5 12 1 0 0 0 6 0 24 7 11 21 8 0 0 0 0 0 0 0 38 11 
34 24 10 0 0 0 24 15 31 0 3 0 52 11 27 0 18 24 19 0 8 3 9 3 0 38 14 10 6 1 3 3 21 0 4 9 36 41 32 17 
1 0 0 0 0 39 5 2 29 0 4 0 0 12 1 0 0 16 0 2 0 0 13 0 0 6 0 4 8 5 0 7 27 23 20 13 8 29 0 0 
0 0 1 1 35 0 0 12 17 0 0 3 0 2 0 0 16 0 0 9 0 0 0 6 0 19 5 1 0 0 0 15 0 0 0 0 13 0 0 43 
19 26 0 23 49 4 15 22 0 29 33 2 10 17 10 0 3 15 42 19 4 9 0 0 18 0 31 19 0 0 9 24 16 32 16 38 37 27 40 0 
0 1 0 0 0 3 3 29 5 0 0 0 4 1 18 1 7 25 0 0 14 3 0 3 17 7 10 20 0 4 1 24 11 0 0 0 7 3 0 0 
5 23 26 0 0 34 0 0 34 21 0 9 0 7 34 10 12 0 23 3 15 0 16 15 0 2 0 10 12 19 6 47 0 0 33 21 0 8 38 34 
0 0 25 1 3 0 0 9 24 0 8 1 26 0 0 9 0 8 11 0 10 0 6 1 0 0 0 0 4 30 0 2 4 0 0 0 0 0 9 58 
2 25 11 0 0 22 32 0 0 6 9 0 0 17 0 0 3 0 21 22 0 9 2 18 2 20 25 18 21 0 0 0 0 6 34 19 0 0 0 5 
