40 23
4 0 12 51 0 18 0 0 0 4 19 9 0 22 25 8 13 0 0 0 18 0 0 36 11 0 0 0 11 35 0 0 9 0 47 5 22 4 0 10 
0 0 8 26 19 0 0 11 7 8 0 0 20 0 18 24 0 0 11 1 0 20 17 20 9 0 0 4 11 3 21 7 33 4 0 0 0 1 22 0 
26 0 0 0 0 0 6 0 0 18 1 0 0 0 15 0 0 0 0 10 0 0 9 0 0 0 0 17 0 10 0 9 0 0 0 0 0 0 0 18 
3 6 11 0 0 0 0 37 0 23 29 15 2 26 26 18 0 0 3 10 0 13 15 0 5 0 15 0 0 16 6 7 0 0 13 0 21 37 30 15 
12 11 27 34 0 32 0 18 0 20 0 0 4 0 25 0 0 0 0 7 9 36 0 0 14 18 0 10 7 27 0 26 3 0 25 14 0 21 0 13 
5 11 0 30 11 7 34 13 72 0 19 33 14 10 0 0 13 1 45 0 27 0 0 11 0 0 20 0 7 37 0 0 14 21 30 17 0 0 4 0 
23 9 22 8 0 0 0 15 0 0 7 28 11 16 10 0 0 0 0 0 2 7 5 23 1 5 23 13 7 1 7 10 7 9 0 5 6 0 35 5 
6 21 1 50 10 2 0 3 20 0 0 2 8 13 0 0 0 0 0 0 0 16 10 4 3 9 0 14 7 0 29 0 29 1 9 0 33 16 6 0 
0 3 0 2 21 0 0 13 15 0 2 9 4 24 16 0 0 0 0 10 9 0 0 0 2 21 7 0 0 10 0 0 0 9 0 23 0 24 0 0 
65 18 23 0 0 10 14 0 10 4 0 10 7 0 13 15 0 20 13 29 42 2 0 0 43 11 7 0 14 29 49 4 30 6 2 33 12 11 0 33 
0 0 6 0 0 0 5 26 6 27 18 0 12 0 7 0 0 3 0 7 0 0 15 4 32 0 29 9 20 23 23 21 0 0 0 10 36 0 0 0 
2 17 5 0 6 0 0 0 3 19 3 0 5 0 0 3 12 9 17 6 0 16 0 7 0 0 7 0 8 12 0 10 0 0 0 14 0 11 0 0 
9 0 0 4 33 28 0 21 0 27 16 4 0 0 16 1 4 3 0 0 0 0 0 0 13 7 2 11 15 24 0 2 15 2 0 6 6 20 29 7 
0 9 0 4 0 13 0 28 25 0 0 1 12 8 0 17 0 4 0 0 0 0 0 0 6 0 18 4 0 6 20 1 17 0 0 29 0 0 0 0 
0 1 0 0 15 1 0 0 0 0 0 0 0 0 2 0 15 0 10 12 0 0 2 13 0 0 0 10 5 5 8 30 1 0 0 0 13 0 0 0 
0 29 0 0 0 4 0 31 0 8 11 1 4 2 13 0 14 15 12 14 0 11 6 7 29 0 7 10 5 0 0 26 0 0 0 0 18 0 10 15 
34 5 34 0 11 0 13 0 1 13 21 0 11 3 57 23 0 3 13 5 12 0 4 20 24 24 2 19 2 0 16 62 3 33 16 4 15 2 5 14 
0 9 0 55 0 12 20 25 0 7 2 21 0 21 0 15 10 10 19 0 0 13 36 0 5 0 0 6 15 28 15 0 8 2 13 11 1 43 0 27 
24 15 0 15 0 21 0 0 7 9 11 11 0 17 4 17 25 0 2 17 0 6 17 1 37 11 4 26 15 11 4 17 0 0 20 0 0 20 0 26 
0 24 10 7 0 0 0 2 1 17 20 14 5 0 0 0 0 0 12 10 0 15 0 0 0 0 7 8 27 6 6 16 18 0 0 0 9 25 0 7 
13 0 0 15 0 0 25 12 7 0 10 20 0 1 0 2 2 5 28 30 7 0 6 9 13 0 10 7 8 0 0 19 0 0 0 10 0 18 4 3 
0 23 0 14 0 0 0 6 13 0 3 0 14 18 14 0 0 2 10 14 17 24 0 0 46 0 0 14 0 21 12 43 2 12 26 0 0 0 17 12 
20 39 0 0 8 0 0 0 17 0 0 27 0 16 13 0 9 0 0 0 0 10 20 7 0 8 4 21 5 11 0 0 18 0 12 0 0 11 0 0 
