40 23
0 14 2 14 2 9 0 3 0 0 3 0 4 30 17 14 37 19 19 10 10 0 14 0 14 10 13 11 0 10 1 0 0 41 0 12 0 3 36 13 
39 0 18 0 0 0 0 0 0 9 0 0 8 7 5 21 0 0 0 4 6 0 0 13 14 0 8 0 8 5 0 8 15 0 0 12 7 0 0 0 
2 0 10 0 3 0 0 0 21 1 20 0 1 10 22 0 12 0 10 9 0 0 5 6 0 12 0 1 11 5 11 0 0 11 0 2 33 20 0 11 
0 0 15 10 22 0 0 15 0 0 3 0 26 10 4 0 0 5 0 16 0 0 0 0 0 4 0 11 0 0 0 0 0 8 0 2 2 20 0 6 
0 0 0 5 1 0 24 45 17 0 0 4 23 0 0 20 4 13 0 0 14 13 0 0 7 0 0 0 22 4 0 0 0 2 0 23 0 0 12 32 
0 0 6 15 0 0 0 2 10 8 0 3 14 16 0 0 0 13 6 0 0 13 6 0 0 3 14 0 8 9 0 9 0 6 1 3 20 17 7 0 
28 1 0 0 0 29 6 0 9 0 0 6 0 0 20 0 0 23 16 0 20 0 0 16 0 0 0 3 0 5 0 31 18 0 15 1 12 0 0 34 
4 1 13 0 0 11 14 11 0 9 0 0 0 24 10 0 7 0 9 25 4 2 0 9 4 25 0 0 9 29 0 0 0 19 0 0 15 38 0 0 
14 7 0 0 25 3 0 3 15 39 37 23 0 19 2 0 18 0 0 0 0 0 7 0 13 0 9 19 18 20 0 0 0 17 3 4 0 0 29 0 
18 9 17 31 10 21 0 3 0 0 9 0 19 0 0 5 20 0 12 10 19 21 10 0 0 0 21 0 2 10 13 0 0 0 22 32 27 0 3 14 
0 0 19 25 58 0 32 8 23 0 8 5 0 0 17 0 13 4 0 8 1 0 0 12 13 15 2 0 43 27 0 13 0 10 1 0 8 8 18 16 
5 2 29 7 18 23 0 18 17 23 14 4 9 6 1 0 28 22 13 15 6 7 23 1 5 64 0 0 10 19 9 34 23 6 1 29 51 7 0 2 
3 47 0 12 9 7 6 6 7 7 1 13 0 0 7 13 0 0 13 0 15 7 3 0 1 3 13 0 17 1 31 4 2 0 0 0 0 0 3 13 
19 14 0 0 1 1 0 0 5 0 19 0 0 11 0 14 7 0 2 8 0 0 6 3 1 0 0 0 15 8 0 6 7 44 2 0 0 4 0 20 
27 0 0 0 0 5 10 2 27 27 5 0 8 13 5 0 10 18 0 1 0 0 5 1 0 23 26 19 9 9 8 22 0 20 0 5 5 0 0 14 
0 0 0 0 5 0 2 0 0 23 10 25 12 7 0 0 0 16 5 0 14 0 0 0 14 12 9 0 0 4 0 0 44 0 0 0 0 0 10 6 
39 17 0 17 24 0 14 0 9 0 9 9 11 19 0 0 0 10 17 9 8 5 11 0 0 1 5 0 18 0 9 36 14 0 34 0 36 16 32 9 
57 0 2 13 2 23 0 29 27 0 6 0 14 5 0 4 14 20 13 19 0 0 0 0 0 3 2 12 57 29 0 0 13 0 6 0 18 0 21 5 
12 1 4 57 10 11 21 4 7 8 0 17 0 5 0 1 5 16 15 0 14 22 0 0 21 0 10 2 16 2 0 25 0 31 0 4 7 0 0 40 
7 38 28 0 0 5 0 17 31 4 0 0 18 0 32 0 0 8 14 3 1 27 3 0 0 8 0 33 0 0 0 7 0 32 0 0 10 0 8 7 
0 12 13 0 0 15 14 0 11 0 12 0 12 12 23 0 7 20 5 13 14 2 0 0 6 0 0 13 0 36 0 0 19 20 0 0 0 0 0 34 
0 43 35 0 0 0 14 40 16 0 12 13 0 14 0 0 0 0 14 28 0 3 7 3 11 0 0 9 5 10 12 0 54 0 10 14 38 30 0 10 
34 12 0 0 7 0 18 12 0 0 11 48 34 0 0 0 12 0 0 12 19 0 7 24 18 25 0 5 17 4 0 0 37 22 0 0 35 43 44 9 
