40 23
12 13 2 31 45 82 15 22 11 27 10 8 14 9 0 9 0 42 12 0 0 1 22 5 33 3 4 19 14 23 3 0 15 15 48 0 21 24 73 47 
9 26 15 0 0 31 13 15 0 5 7 0 16 1 0 17 1 11 26 20 0 3 13 11 0 2 15 11 30 12 2 15 31 1 0 0 31 0 0 1 
4 0 45 0 19 0 0 11 4 49 3 2 0 9 0 13 4 0 20 15 0 17 0 0 0 0 7 0 0 16 0 0 23 7 33 26 0 0 0 8 
0 26 12 3 0 0 0 0 11 0 5 18 5 0 14 0 8 5 4 11 0 10 16 0 7 1 1 0 31 17 0 7 0 0 17 7 0 0 0 0 
15 0 0 18 0 1 28 0 10 0 11 0 2 20 8 22 0 0 12 24 0 11 0 0 24 0 0 0 0 0 0 0 4 0 65 3 0 22 46 0 
20 30 0 2 18 43 1 0 4 62 4 0 7 23 15 39 0 17 8 0 28 1 4 4 0 20 0 0 10 16 0 35 0 17 14 30 44 22 0 30 
27 14 0 4 15 26 0 2 0 15 0 9 0 4 7 13 32 8 0 0 2 39 0 23 1 17 0 8 0 20 0 0 27 4 0 0 15 32 0 0 
0 35 0 10 2 5 27 0 27 62 72 0 5 2 33 21 0 1 20 10 6 0 0 22 23 15 0 0 0 0 8 0 13 0 3 80 0 27 54 0 
0 38 0 0 0 0 4 0 4 12 0 13 12 7 3 1 12 3 11 12 12 12 0 12 25 0 0 0 0 11 10 0 2 4 0 12 0 4 0 38 
27 49 38 40 0 15 10 0 2 6 17 0 18 0 2 13 0 4 12 0 0 20 5 4 8 0 0 17 14 0 1 5 32 4 0 0 0 40 0 37 
4 3 8 7 9 72 9 8 11 9 15 0 0 21 3 15 0 0 0 0 0 10 0 23 0 17 0 0 0 4 25 10 5 20 0 7 26 1 0 2 
35 4 0 0 11 3 1 1 0 0 0 0 13 22 1 0 5 22 13 7 0 0 22 0 0 13 0 0 0 13 0 13 0 1 7 0 4 1 7 27 
0 0 0 0 31 25 13 40 0 0 25 1 18 0 0 0 0 9 0 11 0 0 0 17 0 8 0 24 7 22 43 31 0 12 0 29 2 0 0 0 
4 0 56 1 11 13 4 0 9 29 0 21 10 0 3 22 0 15 0 10 0 0 3 0 5 20 0 0 0 0 4 0 13 0 8 4 0 13 0 4 
10 29 12 0 0 3 13 7 0 0 0 11 0 0 19 0 0 5 0 0 2 7 10 11 0 0 7 21 13 0 0 24 0 7 11 0 4 0 0 0 
1 2 12 0 3 0 14 16 1 13 0 9 26 12 6 6 2 3 0 3 6 0 0 10 0 8 8 11 0 0 0 24 0 7 7 22 0 0 37 0 
0 72 0 14 0 31 0 43 25 3 0 3 0 0 2 7 5 0 14 0 2 26 10 10 0 36 15 46 4 0 0 19 10 46 24 32 31 36 28 38 
10 4 8 41 0 6 33 0 0 0 2 28 4 14 16 3 0 16 3 0 0 3 0 0 18 0 7 14 0 0 16 0 0 45 0 4 0 36 37 33 
0 4 0 0 0 9 0 0 3 0 0 0 10 14 15 0 0 12 0 5 0 3 10 0 8 0 0 0 13 4 5 17 0 13 0 5 7 2 2 0 
0 0 0 15 0 0 9 0 0 15 0 0 29 0 0 27 0 18 9 15 11 14 5 4 12 0 14 4 17 12 0 0 23 10 0 0 0 0 0 8 
0 20 17 0 10 30 29 10 0 4 17 18 3 0 15 0 12 8 0 29 27 0 3 16 11 3 0 0 0 1 10 0 25 0 0 0 30 17 4 0 
0 18 0 5 0 0 3 34 30 23 1 1 0 0 10 0 0 23 26 17 0 0 3 14 17 11 0 0 2 31 23 0 0 0 18 0 21 0 17 0 
0 4 0 0 0 0 0 0 0 0 0 13 0 4 0 0 0 4 27 0 0 0 6 0 0 12 0 0 1 5 0 0 0 7 0 0 17 0 0 0 
