40 23
24 0 22 8 47 0 19 0 0 0 1 33 0 0 8 0 12 14 18 17 19 5 3 13 26 28 0 23 0 0 5 5 26 0 20 0 89 0 34 14 
43 0 42 0 0 0 0 5 27 0 1 17 22 0 10 0 2 40 7 42 7 1 2 18 0 5 6 35 17 0 28 12 6 0 5 27 19 0 19 10 
34 0 0 0 24 0 0 0 0 0 23 28 18 9 25 15 13 16 0 17 3 0 0 1 5 32 25 11 0 23 29 0 0 6 43 0 17 1 24 27 
0 0 0 0 39 31 10 0 8 0 0 0 4 0 17 0 7 2 12 3 16 0 3 17 32 0 0 0 16 18 1 10 1 29 16 8 47 10 0 0 
0 0 0 6 0 22 18 11 8 0 24 0 21 0 0 0 13 0 11 0 0 9 2 10 10 0 0 0 23 8 20 0 1 0 0 0 0 0 0 14 
2 3 22 31 14 2 19 12 0 0 0 0 0 0 0 0 14 15 0 4 3 4 16 4 17 4 0 0 0 0 8 19 0 0 47 0 0 0 0 0 
22 21 8 3 7 0 0 0 19 12 0 8 27 0 20 14 0 6 0 3 6 12 24 11 6 0 4 37 0 0 0 0 6 0 20 0 9 9 0 0 
1 0 10 18 5 0 12 23 6 4 21 0 5 4 3 22 0 23 6 0 3 18 0 8 7 11 1 18 3 12 28 24 6 0 5 0 0 0 0 27 
4 3 35 35 3 11 0 0 2 25 16 11 18 0 0 0 4 7 14 13 1 0 0 0 12 0 16 12 3 0 14 0 0 0 7 0 33 0 0 0 
4 18 57 4 6 4 12 8 0 0 0 14 12 3 26 3 20 2 19 4 0 0 0 18 0 46 0 0 21 19 1 12 0 1 32 21 8 27 0 0 
0 26 4 6 2 0 10 0 10 13 54 2 0 0 20 0 0 15 10 8 9 0 16 0 3 3 4 26 3 9 24 0 0 0 0 27 26 0 28 34 
32 0 2 15 18 31 11 0 0 23 0 14 0 0 0 0 0 24 0 3 16 0 12 0 2 14 0 10 25 0 3 0 32 0 7 8 38 0 0 0 
4 6 35 24 12 0 0 0 8 3 26 9 0 0 0 0 11 0 11 9 5 0 0 8 0 12 0 8 19 21 21 11 3 0 22 2 26 56 0 0 
0 0 21 0 14 8 22 0 0 0 12 0 0 3 0 0 1 26 0 0 11 0 0 34 14 0 22 10 4 25 25 23 0 0 28 0 31 1 7 23 
21 23 50 0 13 0 3 0 0 0 9 61 3 15 24 7 21 3 6 3 0 0 4 4 21 15 14 0 26 18 6 29 0 0 2 0 25 14 37 8 
28 68 0 56 22 0 17 0 0 0 1 0 0 9 0 0 8 0 0 0 3 5 0 25 1 0 13 0 28 25 0 0 0 0 33 0 68 9 0 0 
2 0 25 35 0 0 11 25 6 0 3 0 0 0 0 0 2 0 0 0 0 0 3 0 2 8 0 19 0 0 0 0 19 6 0 0 1 0 29 14 
99 0 10 0 10 0 16 0 21 0 0 0 0 24 6 0 8 17 0 19 8 0 15 0 2 20 4 0 8 21 12 0 0 0 9 35 1 13 3 0 
0 6 0 0 0 0 0 0 4 0 0 18 4 25 0 4 2 5 0 0 0 0 2 11 15 0 0 3 6 0 7 0 0 22 18 0 7 0 25 14 
28 0 30 10 2 18 22 10 30 14 13 0 0 0 0 0 9 19 14 0 0 19 14 22 15 10 0 0 0 6 0 14 0 33 20 26 33 0 26 0 
17 0 0 12 20 0 19 19 0 0 0 0 0 0 9 3 0 8 15 11 0 20 0 5 13 0 27 1 8 0 33 0 20 0 12 0 0 9 0 0 
37 0 26 0 21 13 44 0 0 10 29 22 0 0 0 12 6 1 19 7 12 0 0 0 0 20 4 21 26 11 7 0 12 21 16 2 9 20 0 0 
0 0 25 13 25 0 22 0 6 20 9 3 17 2 0 19 0 0 0 8 0 0 0 0 3 6 0 9 13 9 0 2 0 0 47 33 0 0 0 15 
