40 23
0 32 20 11 0 0 5 0 5 11 6 13 0 0 0 0 2 0 0 0 0 5 7 0 11 10 0 0 0 0 5 22 0 14 0 6 5 0 0 0 
0 0 0 33 0 22 9 0 0 5 5 2 0 0 16 11 1 0 0 0 10 0 0 9 0 17 2 13 0 0 14 0 2 3 0 0 10 18 0 0 
38 18 2 15 4 29 23 14 4 11 7 0 0 15 13 8 0 2 1 3 11 0 0 0 14 14 0 0 3 11 0 29 0 11 0 0 11 0 4 48 
14 48 0 15 32 22 40 8 14 29 9 6 18 4 14 7 10 2 12 0 3 0 24 2 13 9 28 12 2 6 25 0 11 1 33 17 57 18 4 6 
0 23 39 32 0 5 36 0 20 0 0 15 14 12 0 10 10 10 0 0 0 0 0 0 36 8 30 0 13 5 3 0 12 10 31 1 0 0 35 0 
5 34 27 15 0 15 0 13 0 0 7 0 1 0 0 14 18 20 15 14 0 20 29 2 0 3 0 0 3 12 11 0 0 1 13 28 4 20 0 2 
0 26 0 61 9 12 0 4 2 2 10 7 20 0 10 0 23 32 6 0 3 0 6 0 10 0 23 20 10 0 15 9 0 17 27 0 24 0 0 0 
48 12 0 1 8 0 0 24 17 0 0 4 0 4 1 0 0 0 5 1 2 21 5 15 6 12 25 13 0 9 48 17 7 13 9 0 8 0 11 42 
0 3 0 0 2 0 5 0 6 11 5 5 0 0 11 12 2 0 2 20 0 0 0 0 0 14 5 0 0 2 0 6 0 0 0 0 7 6 0 34 
6 1 0 18 0 12 4 0 0 0 0 23 8 15 0 6 4 0 0 0 8 18 0 0 2 1 1 0 8 0 0 18 0 3 28 0 0 0 0 8 
0 11 12 12 0 20 7 10 1 1 0 0 23 2 12 27 5 0 5 0 0 0 21 9 0 27 0 0 0 14 0 9 0 6 5 23 7 0 0 6 
1 0 2 33 20 33 32 5 24 7 24 0 5 0 6 0 5 17 0 0 14 10 11 4 1 20 20 7 1 20 31 5 0 0 0 30 31 0 10 0 
5 25 0 0 0 9 20 18 3 24 37 20 27 13 4 0 0 8 6 0 4 0 0 0 15 39 42 0 0 3 0 0 0 42 7 14 10 0 11 0 
24 0 0 0 10 49 13 0 4 4 5 0 5 18 2 19 7 8 19 0 0 0 1 0 18 8 6 0 21 0 4 26 14 11 0 0 23 1 0 24 
9 41 0 0 0 17 5 0 16 0 0 10 0 0 0 0 14 0 14 0 15 10 18 0 16 7 0 0 0 22 5 0 0 17 0 52 1 27 6 10 
0 5 0 0 26 0 5 0 0 31 7 0 27 0 13 7 6 14 5 0 16 0 6 0 0 0 0 3 0 0 26 0 0 22 8 1 1 0 0 19 
2 6 30 12 18 4 12 5 18 44 58 13 0 7 12 0 29 5 0 6 1 0 21 0 13 13 42 10 12 7 24 3 14 23 0 26 28 2 0 0 
25 39 0 18 67 0 0 0 0 0 0 0 11 0 0 0 13 1 0 0 0 11 0 0 0 4 12 11 12 28 0 8 24 2 0 3 32 0 7 65 
6 10 35 0 23 11 3 0 53 0 0 19 14 0 18 10 12 3 0 6 0 18 0 15 12 11 0 15 38 0 0 8 8 18 0 3 28 29 52 10 
3 25 0 3 0 0 2 21 4 11 13 6 4 14 0 0 0 9 0 0 4 0 0 0 0 0 6 14 1 23 0 27 0 0 0 0 0 18 0 0 
17 33 11 0 0 4 0 9 20 25 0 0 0 0 7 0 0 15 6 3 0 0 0 0 0 0 0 13 26 26 0 22 15 15 5 43 29 35 0 20 
0 0 0 1 1 10 0 0 1 0 0 9 6 0 18 21 10 0 0 1 4 0 17 0 19 0 10 9 0 0 11 0 0 7 4 0 30 0 0 0 
0 29 0 0 0 0 0 0 1 7 11 24 0 0 0 12 9 0 0 6 0 0 29 0 23 0 0 12 6 0 15 0 0 0 0 24 17 0 0 0 
