40 23
39 31 0 14 6 11 38 11 0 11 9 19 0 0 1 10 34 10 0 0 0 4 13 18 0 9 0 0 0 13 0 0 54 0 1 1 0 0 14 39 
3 0 17 23 0 2 0 9 17 26 0 25 0 1 34 0 4 0 7 0 0 0 6 0 22 11 17 22 7 19 2 17 0 9 0 22 8 0 7 43 
38 0 28 60 0 23 0 12 0 10 0 0 29 0 0 0 0 8 0 0 5 7 2 0 0 4 0 0 25 0 3 0 0 4 0 0 24 48 39 0 
0 38 0 0 0 0 14 7 0 32 0 19 0 12 7 0 0 8 0 0 26 22 0 0 0 0 0 17 0 0 31 19 0 0 0 9 42 0 0 38 
0 8 0 29 0 0 25 4 0 2 0 1 0 0 0 0 26 0 15 0 0 0 7 0 0 6 0 0 27 0 12 19 0 0 33 0 5 0 4 0 
0 20 0 0 1 0 32 0 7 0 37 4 0 26 0 12 1 10 8 0 5 18 9 15 0 30 0 26 0 1 17 0 0 8 3 0 26 0 25 18 
0 0 46 1 16 19 0 8 1 5 0 0 20 0 0 0 6 8 3 13 12 12 5 0 21 8 14 1 7 21 15 0 44 29 0 3 1 2 14 7 
0 24 0 1 0 16 0 2 0 0 8 14 0 18 7 28 0 2 15 23 5 3 13 12 7 23 1 12 5 3 0 2 0 0 7 0 3 0 5 6 
18 0 0 0 0 5 15 0 0 0 5 0 0 0 0 6 2 0 20 4 0 15 12 0 0 0 0 0 0 0 0 21 7 0 9 0 0 0 3 20 
48 30 12 21 10 0 15 3 0 2 3 0 12 0 0 1 0 45 5 3 1 0 0 16 8 0 14 0 8 0 11 21 0 27 4 17 42 27 0 16 
42 0 0 19 0 0 21 16 8 13 11 0 0 3 1 6 12 10 0 3 12 0 0 0 10 0 0 0 0 11 0 7 42 17 34 32 0 5 32 8 
0 17 0 0 0 0 29 0 0 35 23 5 41 3 0 13 23 4 0 6 6 0 4 24 12 7 4 0 15 0 20 0 23 13 18 29 12 0 37 0 
0 0 0 16 0 20 0 21 0 4 0 0 13 0 0 0 8 1 1 14 0 14 0 5 0 28 0 0 3 7 1 0 18 0 4 9 3 0 5 7 
2 18 11 2 16 1 14 17 18 0 16 13 10 2 4 10 0 7 14 27 24 0 22 12 10 0 3 24 0 14 3 4 26 8 30 0 4 0 22 12 
1 38 36 19 0 0 6 13 8 0 27 1 18 0 0 0 3 0 26 5 13 2 2 3 0 0 0 8 0 0 0 9 14 0 7 7 33 0 78 41 
40 16 0 38 23 2 0 0 11 15 24 35 8 33 2 20 18 20 0 27 5 17 15 12 0 15 0 2 8 0 30 0 13 3 86 0 3 2 38 39 
56 0 16 0 0 31 0 0 0 4 27 0 0 7 3 6 13 0 13 15 7 0 0 0 24 1 6 0 0 22 9 0 32 0 0 15 0 26 9 34 
2 21 0 13 0 0 14 0 0 0 6 3 7 24 9 0 19 0 20 2 0 31 32 4 0 0 0 2 7 0 14 0 0 11 4 5 0 13 20 2 
16 0 0 0 2 4 9 12 35 19 0 0 12 0 0 3 10 1 2 0 0 0 17 12 13 7 10 0 2 8 2 0 12 0 0 0 28 13 0 40 
0 14 0 0 8 0 5 19 0 14 17 31 19 1 2 11 0 4 6 2 16 14 15 15 0 27 0 18 0 2 0 30 0 0 0 2 0 13 13 0 
6 9 0 0 1 15 26 0 0 11 14 0 9 0 0 0 16 18 6 16 15 14 1 1 15 0 14 28 18 19 0 0 8 28 2 2 2 0 19 0 
0 0 0 0 0 0 11 0 0 26 11 2 0 8 0 0 0 0 19 0 0 8 0 10 0 6 0 16 0 15 15 6 8 0 8 33 1 0 0 34 
13 18 25 0 0 0 14 0 0 24 20 9 1 12 0 15 18 4 7 0 5 5 0 0 0 7 1 0 0 0 20 19 7 20 1 1 1 4 11 7 
