40 23
0 17 55 0 8 0 0 0 11 0 1 1 0 15 0 23 14 13 0 0 0 10 13 0 0 0 0 6 19 0 13 4 10 0 0 4 30 35 17 13 
34 0 0 17 7 15 23 29 17 0 41 16 19 1 1 12 0 0 18 0 17 23 0 8 0 30 0 13 25 5 19 22 2 0 30 10 39 0 4 9 
21 2 1 0 19 12 10 7 0 0 15 15 7 12 7 0 0 0 0 7 1 28 17 6 20 12 35 0 4 6 0 0 0 0 28 7 14 0 0 0 
28 3 16 27 0 2 0 4 3 0 2 2 0 22 0 10 2 0 0 5 1 0 0 0 8 10 0 2 39 0 8 18 17 3 0 22 40 0 0 4 
0 42 29 0 3 0 11 0 27 9 22 0 0 1 18 0 0 6 0 7 11 14 0 6 0 0 0 2 3 15 0 14 30 32 0 40 19 0 0 0 
19 0 45 28 4 17 2 0 4 12 0 18 1 1 15 0 2 0 0 28 0 19 22 1 12 0 0 0 26 0 11 8 7 0 0 1 17 6 0 0 
0 0 26 0 10 0 8 37 0 8 8 11 20 0 19 11 0 1 6 0 13 11 11 13 0 7 8 5 26 0 9 15 20 0 0 0 0 14 11 0 
7 30 0 0 17 5 0 9 0 0 9 0 11 0 0 0 22 0 0 9 0 9 0 12 0 25 0 0 0 0 0 14 32 0 0 12 0 0 22 8 
15 0 10 0 15 0 16 6 12 3 0 10 13 14 0 0 13 13 10 17 2 10 0 17 0 0 0 14 24 0 23 12 0 5 0 0 0 31 0 0 
27 32 4 7 17 0 88 7 23 0 17 6 0 8 0 11 17 27 4 7 19 5 14 11 0 0 0 0 2 5 0 40 26 1 48 36 35 0 4 0 
0 0 0 15 0 0 0 0 1 16 15 0 5 0 3 46 23 23 12 16 0 4 0 6 15 6 16 0 0 0 18 0 15 14 17 0 3 20 0 5 
9 11 26 0 28 5 0 9 11 11 5 11 18 0 3 0 0 10 0 6 10 1 3 0 6 12 8 1 12 0 0 11 28 0 0 14 0 9 7 8 
0 0 0 0 0 0 4 54 0 0 9 0 20 1 8 0 0 1 5 11 8 0 0 11 0 10 12 0 8 16 0 10 0 21 4 11 0 2 16 32 
0 1 3 14 0 10 0 0 15 3 0 10 7 23 1 10 9 4 2 3 0 0 13 22 0 0 6 0 0 0 12 6 11 0 4 3 23 11 0 13 
0 14 0 0 2 0 30 0 0 1 0 16 1 0 1 18 8 1 4 0 5 0 0 0 20 3 2 4 5 0 28 0 0 0 4 0 0 0 0 0 
9 20 7 37 17 0 5 0 5 16 0 14 14 0 31 0 0 1 13 0 0 28 0 0 0 0 18 0 0 7 9 42 12 30 0 0 17 0 8 0 
34 34 25 0 6 1 21 9 8 12 0 0 0 3 0 2 0 0 9 22 4 15 0 21 16 0 2 15 28 15 0 12 0 2 0 41 20 0 0 0 
34 5 8 2 0 42 8 0 18 15 6 10 0 8 16 3 10 8 8 0 0 10 0 0 13 6 24 0 9 0 25 0 8 0 37 0 0 0 0 70 
10 0 0 7 6 9 0 18 14 29 31 0 11 2 5 14 0 0 22 5 0 8 12 18 16 18 13 4 6 14 0 11 26 0 17 17 0 28 20 0 
5 0 0 0 3 0 0 31 0 0 0 0 0 17 0 0 3 0 0 0 0 0 0 0 0 25 8 0 6 1 30 0 0 20 0 2 15 0 28 1 
83 33 0 17 26 15 21 9 1 0 10 0 32 16 14 19 15 0 12 3 9 13 0 0 0 4 1 0 24 34 5 0 0 0 15 9 36 43 38 10 
0 31 24 12 41 0 0 0 6 7 13 18 8 0 0 33 13 1 1 0 23 6 4 6 0 6 6 12 0 0 0 38 31 0 0 2 28 0 2 0 
27 46 0 0 3 0 0 0 0 15 0 26 5 0 18 0 3 9 0 0 24 1 16 0 2 23 0 23 2 6 0 13 0 21 0 0 43 0 0 0 
