40 23
0 5 0 0 0 7 24 36 0 4 0 0 9 0 0 0 17 0 20 14 12 0 0 9 11 16 17 18 12 0 0 24 0 29 0 3 18 23 18 0 
0 0 18 15 26 0 16 1 0 0 0 0 1 14 35 0 30 11 4 0 0 10 16 0 11 4 0 0 33 9 26 15 21 2 0 24 0 8 0 25 
11 4 13 0 0 12 7 1 3 8 0 32 0 4 0 24 4 10 13 0 0 11 0 0 0 0 0 0 0 0 0 0 11 0 0 18 31 20 19 0 
4 5 16 17 22 0 23 8 12 27 0 0 17 1 0 11 0 0 11 0 12 0 0 0 5 0 0 0 0 0 0 0 0 24 0 17 48 2 5 0 
0 0 0 0 43 21 4 0 0 0 4 0 3 0 5 0 0 0 0 0 24 0 0 0 0 1 9 0 11 0 0 0 11 0 0 0 10 0 0 35 
0 0 12 0 12 0 20 14 21 10 12 2 0 39 25 4 72 0 5 12 4 0 6 5 0 17 6 3 6 13 7 0 0 2 15 3 20 8 25 25 
0 16 13 16 7 11 0 1 1 0 0 0 0 0 0 0 7 1 0 0 0 12 0 0 2 5 0 0 1 2 0 2 0 12 0 1 36 6 0 0 
4 1 0 6 0 15 19 0 1 17 15 2 3 21 0 5 2 14 7 0 0 0 10 7 1 5 8 1 0 4 39 3 22 19 24 0 30 14 21 0 
0 4 0 1 21 0 14 14 9 11 0 14 9 0 7 1 0 0 33 13 11 24 0 27 8 0 19 0 0 9 0 13 3 13 25 0 10 4 32 29 
0 0 4 3 1 0 0 0 4 3 0 0 4 6 5 21 0 0 19 6 1 19 0 0 0 11 0 0 0 20 10 0 0 18 1 0 0 41 0 0 
21 0 14 0 4 0 8 10 0 12 19 12 0 0 0 19 8 25 7 0 0 33 0 10 0 0 0 0 3 0 0 3 0 24 21 33 19 11 4 0 
15 0 0 28 0 4 0 11 31 3 0 2 9 0 5 0 12 6 0 0 13 13 15 11 8 12 11 0 0 0 0 31 14 13 5 7 0 31 3 31 
0 0 0 5 9 0 12 0 0 30 19 8 0 11 0 0 23 12 7 0 12 0 5 0 0 0 0 0 9 7 8 0 0 0 0 0 20 9 0 30 
0 0 0 26 0 6 40 0 0 0 8 3 3 0 0 3 16 0 0 19 32 0 0 0 0 0 0 11 3 0 0 0 10 0 2 7 5 0 21 0 
21 1 0 36 30 2 12 5 0 0 0 11 0 2 14 0 0 9 0 0 0 0 0 2 0 2 5 0 0 0 0 0 6 0 24 0 0 47 0 6 
0 0 13 0 32 0 0 0 0 0 6 0 1 0 0 0 6 0 2 0 15 0 0 12 20 0 0 0 0 0 0 0 11 17 0 6 32 13 17 0 
0 1 2 1 0 39 18 0 6 0 24 1 24 0 7 12 4 31 0 18 18 2 0 5 1 16 0 0 0 0 25 21 12 0 0 18 16 26 0 8 
16 83 38 24 5 0 29 1 37 25 15 0 8 24 21 0 3 0 17 2 14 5 0 2 10 2 11 0 0 19 6 33 29 31 30 40 29 34 19 49 
0 1 0 27 5 1 25 0 30 20 5 0 0 25 13 3 1 0 4 13 6 16 0 10 13 0 24 0 2 0 1 0 0 30 11 14 18 3 5 1 
35 0 31 90 0 53 29 19 26 0 0 0 9 0 10 0 10 5 0 9 0 4 8 0 0 0 32 0 0 0 1 26 11 30 31 35 31 0 0 19 
0 2 0 54 0 2 0 2 0 17 0 26 5 1 4 18 0 15 17 0 16 0 0 7 6 23 4 0 27 4 18 17 2 0 2 36 8 0 8 0 
0 54 3 0 0 22 3 7 25 0 0 4 0 10 11 24 0 0 15 16 19 16 0 47 4 13 14 0 0 10 25 0 0 10 4 28 11 8 32 49 
0 5 0 13 14 13 20 0 19 8 7 14 0 15 0 1 19 7 4 0 0 0 15 0 19 0 4 5 4 0 0 0 50 0 18 0 0 45 0 0 
