40 23
0 9 0 0 9 6 0 0 8 4 25 6 20 0 0 0 0 0 2 0 0 22 9 0 0 20 0 2 0 0 0 9 0 0 20 0 10 0 0 16 
56 74 0 0 6 5 0 29 9 0 0 6 0 5 13 0 27 0 5 0 0 4 17 14 0 3 18 9 8 16 23 30 0 33 0 0 43 0 20 18 
0 0 19 14 6 0 8 46 15 13 0 0 31 25 26 7 0 21 0 0 3 21 5 29 9 18 7 4 29 0 16 0 0 0 11 7 13 2 31 9 
0 27 11 0 0 17 0 0 5 8 16 31 25 11 0 0 8 15 0 16 0 0 6 4 17 0 2 4 37 10 11 15 17 1 1 0 0 25 9 31 
30 15 0 49 23 74 44 0 20 20 0 3 0 12 0 0 19 0 0 13 11 0 6 0 0 23 4 24 0 2 55 3 9 11 57 0 24 64 0 7 
0 4 12 30 5 8 0 20 0 1 3 0 6 1 0 0 0 0 0 10 12 0 1 14 0 0 25 20 23 10 0 0 19 30 0 0 35 0 0 0 
46 12 22 9 1 1 0 18 23 23 9 0 9 7 0 6 0 12 5 5 2 0 18 13 5 0 16 0 0 6 30 0 10 3 3 6 3 0 30 30 
17 0 27 17 0 0 16 12 17 9 2 21 0 0 14 0 6 19 0 11 9 8 16 14 2 19 8 0 0 3 0 46 21 0 36 9 19 0 0 0 
22 6 0 1 9 7 1 0 18 11 18 0 0 9 0 1 0 4 0 0 3 25 11 0 0 0 0 0 11 8 0 0 7 23 0 0 16 0 0 25 
54 47 0 1 17 33 10 12 0 0 34 0 6 0 0 0 14 0 4 23 4 2 18 6 2 2 6 16 0 8 25 30 34 0 6 8 0 3 33 50 
0 0 0 3 4 5 5 0 18 0 0 19 0 0 2 6 0 5 0 12 0 4 0 19 0 0 0 13 0 0 3 27 18 1 0 2 10 8 15 0 
24 32 0 3 7 40 31 24 0 23 1 30 6 30 20 12 2 12 9 0 15 9 0 3 46 4 15 14 4 32 3 0 5 40 0 5 29 31 65 33 
13 0 17 6 14 7 0 28 4 0 0 8 0 0 0 0 0 10 2 31 7 2 0 0 24 0 5 0 3 0 0 12 0 0 0 13 7 1 0 9 
7 0 0 25 14 3 0 14 4 13 0 0 0 0 2 0 12 0 0 10 4 6 13 0 0 0 11 23 25 5 26 7 12 0 0 0 9 23 0 25 
21 6 7 11 0 0 0 8 0 0 20 0 0 0 13 0 3 14 0 0 0 21 4 0 0 8 0 2 0 5 20 1 0 0 2 0 0 0 0 0 
9 1 1 2 68 6 24 19 12 9 0 3 22 5 0 0 17 8 0 0 0 0 0 8 0 1 12 4 22 0 0 0 0 12 22 31 0 11 0 10 
19 29 0 47 52 7 14 10 1 17 12 18 14 12 0 0 8 0 0 6 8 0 22 8 6 7 18 0 25 8 26 1 0 3 4 5 33 0 34 16 
7 37 0 0 31 0 0 14 0 14 35 0 0 0 6 0 0 0 0 12 10 14 10 3 0 4 5 0 3 35 5 15 4 0 0 22 0 0 37 0 
0 0 36 0 1 0 11 0 18 0 28 0 7 16 0 0 14 0 15 10 0 0 14 4 0 0 0 9 0 3 0 9 0 15 0 0 12 8 36 0 
3 15 0 0 15 10 0 12 10 0 1 0 0 0 13 0 6 0 0 16 0 5 23 14 16 6 18 9 1 0 0 0 0 0 38 0 16 0 13 0 
3 2 15 16 24 19 0 6 21 30 38 0 20 6 2 20 0 0 0 0 0 7 0 0 19 0 0 0 24 26 17 7 0 0 24 24 29 0 0 33 
2 0 2 0 12 30 25 19 30 0 0 15 0 0 3 17 8 0 0 6 0 18 0 7 8 2 0 0 0 0 0 30 9 0 0 30 0 0 50 12 
0 21 16 12 7 18 0 0 0 0 11 17 0 12 0 0 9 15 0 16 1 18 0 2 22 24 21 0 0 19 0 0 0 31 0 8 33 0 35 0 
