40 23
21 0 18 0 27 9 16 17 0 7 0 20 7 18 5 24 7 0 0 0 0 24 21 14 7 0 22 3 0 0 6 20 8 28 0 25 6 0 0 0 
28 20 0 12 16 19 0 0 6 8 0 11 46 3 21 0 19 8 0 16 0 20 0 5 19 6 0 0 9 0 19 6 0 0 22 16 26 0 2 10 
0 0 26 33 0 23 0 0 0 0 0 17 0 0 0 3 0 6 0 0 6 0 0 1 5 23 0 1 0 23 5 20 0 0 0 5 43 6 0 0 
0 0 0 18 32 10 0 0 33 6 0 6 25 0 20 11 2 19 0 0 0 8 1 3 20 11 0 0 18 25 0 1 17 0 16 15 19 5 0 0 
9 0 0 0 0 0 0 0 0 16 7 0 1 0 0 9 13 0 0 11 18 0 6 1 13 27 5 1 0 1 18 16 5 0 0 0 0 1 18 25 
0 28 15 0 0 16 12 16 0 0 0 6 0 10 0 16 0 15 17 15 0 30 0 45 0 15 0 13 5 12 0 0 15 5 18 5 0 7 0 0 
1 32 0 0 21 0 0 9 0 14 9 11 0 12 16 0 9 0 13 15 2 0 2 22 0 31 0 6 0 11 6 17 0 0 48 1 1 0 0 0 
35 36 7 0 10 0 16 6 15 1 4 9 0 11 30 0 9 6 0 26 11 0 11 8 3 9 0 10 2 11 22 0 32 21 24 1 17 29 5 1 
31 10 0 28 0 0 0 1 13 7 7 10 24 25 23 7 23 1 13 10 2 3 2 1 16 0 0 7 0 17 3 16 9 12 0 5 5 22 24 27 
17 42 0 3 29 5 11 10 0 6 9 2 0 22 6 0 3 22 0 19 8 5 15 0 2 0 0 0 0 0 0 2 13 31 33 10 0 6 0 12 
15 0 5 26 51 0 0 9 0 0 19 0 2 7 0 15 4 0 8 16 0 0 12 10 0 0 0 29 9 0 0 0 0 3 0 0 0 0 34 12 
12 5 0 0 9 19 0 7 20 0 6 9 0 0 3 0 3 6 25 7 6 8 0 1 20 0 19 11 20 8 0 0 2 0 0 0 8 0 12 17 
11 46 0 5 0 1 0 0 5 0 21 5 6 0 0 0 4 0 0 3 2 0 1 0 0 0 0 0 3 14 0 0 9 0 13 0 17 0 37 0 
17 4 0 39 0 4 0 17 3 0 15 11 0 0 0 10 9 0 7 0 20 0 0 0 0 7 0 17 0 0 0 0 0 18 0 0 0 4 0 36 
7 0 36 11 0 1 32 1 20 17 28 10 0 3 0 12 5 0 0 11 0 17 0 8 0 18 17 9 0 0 0 9 0 0 5 6 9 0 39 0 
37 20 15 0 0 37 0 24 18 14 23 0 0 8 0 7 16 0 9 1 0 20 0 18 0 1 18 25 0 14 7 11 5 23 1 0 7 56 0 0 
17 72 25 0 13 0 0 55 47 0 0 0 0 16 0 1 17 32 11 17 13 5 2 35 6 13 1 37 0 18 29 0 0 1 30 6 0 29 0 16 
33 30 0 36 11 0 0 17 0 0 16 6 0 0 0 1 13 10 8 17 0 0 0 10 0 0 24 4 9 23 11 27 0 33 0 3 0 13 19 38 
0 3 8 0 25 27 31 7 0 56 19 0 1 12 0 0 0 0 0 0 11 0 2 10 2 0 2 8 26 62 3 0 30 0 4 15 33 24 29 0 
8 2 36 3 8 9 2 0 34 0 0 3 7 0 12 0 0 11 0 0 12 14 21 23 0 0 5 1 11 14 0 13 0 0 21 0 4 12 51 16 
0 13 0 39 9 5 33 0 0 5 5 0 24 0 0 17 0 0 12 17 0 1 0 0 3 11 2 0 11 0 40 0 37 0 4 8 7 1 4 38 
0 32 0 0 0 27 5 0 7 0 0 0 10 20 37 26 0 0 0 8 0 0 2 0 0 0 3 14 9 3 0 0 18 32 24 0 30 0 0 80 
37 0 18 2 0 0 0 15 14 3 0 21 15 0 36 22 0 0 1 5 12 0 23 8 18 11 3 4 0 14 26 5 21 1 0 0 22 37 0 5 
