40 23
0 16 0 40 41 0 0 0 0 31 22 0 0 0 1 0 17 4 3 21 0 0 2 22 2 0 0 0 0 0 12 3 13 0 30 0 18 0 0 0 
0 14 0 8 0 4 1 0 39 2 0 3 23 47 1 17 7 0 0 10 21 0 17 0 19 0 14 0 18 0 37 0 30 25 0 27 27 11 25 0 
33 0 9 0 1 34 1 0 0 22 0 16 4 0 0 14 0 3 20 8 13 4 0 0 0 4 2 11 9 8 0 14 0 49 0 7 20 0 0 30 
0 22 14 0 12 61 12 0 0 0 8 14 0 0 0 0 12 0 14 0 0 18 0 20 0 6 0 0 0 0 3 36 16 0 0 0 0 32 1 0 
9 0 0 8 13 0 9 7 0 6 0 1 0 5 0 5 1 32 0 0 14 12 0 0 3 8 20 0 0 0 0 0 10 5 0 9 0 11 1 10 
28 21 0 0 23 1 0 21 7 27 14 0 0 12 17 16 0 7 14 5 47 0 2 3 15 6 2 7 1 1 13 17 0 23 0 20 0 0 22 19 
12 0 22 6 0 10 11 2 2 2 5 0 8 20 8 0 1 0 10 16 11 1 7 14 26 6 0 10 6 1 0 0 1 26 0 3 11 0 20 16 
0 29 0 0 0 19 36 11 0 0 0 0 0 5 22 2 1 5 18 0 0 1 0 4 13 0 0 1 0 0 13 4 0 0 0 2 22 0 0 0 
27 0 3 0 6 0 0 0 0 0 0 0 0 0 0 0 0 4 6 10 14 1 0 3 0 6 0 0 0 0 12 6 0 0 14 0 0 37 0 0 
0 9 1 20 36 29 2 0 15 17 0 7 12 17 8 7 15 3 3 0 19 0 0 20 14 13 38 2 7 0 0 0 5 15 29 44 0 13 0 21 
6 18 23 8 6 8 4 5 9 5 0 0 32 6 0 2 9 27 0 3 0 15 0 4 4 6 0 5 0 0 0 11 0 8 3 6 9 12 0 0 
32 8 11 2 9 0 2 0 0 0 0 6 1 13 10 0 0 0 0 31 0 0 8 12 2 0 14 3 0 0 4 20 32 0 0 16 0 0 0 0 
0 0 24 0 0 6 29 0 0 8 0 0 0 0 0 3 2 12 9 2 0 10 5 15 0 0 21 0 0 6 9 0 0 17 0 25 0 11 8 0 
2 5 29 17 16 0 0 0 12 22 0 5 3 0 0 36 12 0 12 0 22 13 4 22 0 23 0 26 7 9 17 67 4 0 0 5 0 8 1 13 
0 12 27 5 6 0 18 0 5 0 29 3 0 0 0 0 11 21 0 0 14 0 21 4 3 5 5 6 0 27 0 0 36 6 14 0 0 36 21 26 
2 14 0 6 2 0 0 0 12 7 0 3 8 0 5 3 1 15 3 7 27 0 0 20 1 6 10 0 0 15 10 2 0 0 20 1 40 11 0 0 
0 0 0 15 55 0 9 0 23 16 3 10 0 0 0 11 33 2 29 0 0 27 0 0 12 0 0 19 0 14 4 8 0 13 0 7 32 0 0 0 
7 0 14 19 5 25 23 5 23 24 0 17 5 0 17 11 31 0 7 0 11 1 15 0 3 0 10 0 0 23 38 55 0 24 0 0 0 0 5 0 
8 0 25 8 3 0 16 15 0 0 0 8 0 17 0 11 20 4 16 0 34 0 26 0 14 13 12 0 0 7 3 4 17 34 1 0 27 0 12 0 
23 0 32 22 0 0 5 0 3 26 3 26 3 0 0 0 11 6 6 0 7 0 12 0 6 22 4 12 12 0 0 0 16 6 7 0 27 2 0 5 
14 0 0 0 0 56 2 0 0 19 17 5 0 0 8 0 0 0 0 5 4 0 0 0 5 6 0 39 9 0 17 0 0 10 0 19 31 4 0 0 
0 0 45 33 0 2 13 47 0 2 0 0 20 0 0 13 6 18 0 8 1 4 39 10 0 8 0 7 0 7 0 19 49 13 32 18 18 25 31 8 
0 11 4 18 0 0 3 0 3 25 15 0 5 0 13 0 47 0 0 0 4 12 9 9 20 15 0 21 5 27 9 23 0 0 12 12 20 48 5 0 
