40 23
0 0 29 0 0 31 0 22 0 10 2 0 0 0 18 0 0 0 11 39 0 15 15 8 0 3 18 0 0 0 0 16 27 11 0 12 2 18 0 0 
0 27 21 0 7 0 0 0 0 0 10 1 0 0 4 14 0 6 5 3 0 0 6 39 0 11 0 0 6 14 28 0 4 0 0 12 0 7 0 0 
4 2 16 29 0 27 0 0 0 0 2 17 0 0 0 6 15 0 1 39 0 9 1 0 10 2 0 2 4 8 8 1 2 0 32 0 5 0 19 0 
4 0 7 23 14 0 0 0 9 21 0 21 3 0 0 14 0 17 6 0 11 0 0 1 5 12 2 19 7 38 0 0 0 2 17 18 16 21 2 41 
41 19 21 6 32 4 0 0 8 19 16 18 1 0 14 0 0 16 0 2 0 18 7 1 0 0 0 21 31 9 0 0 0 4 0 1 54 0 6 3 
6 9 32 6 0 0 0 0 15 2 7 7 7 27 16 0 19 0 9 0 9 0 12 6 19 2 0 0 34 0 36 14 4 15 18 41 0 23 0 3 
29 0 32 0 0 0 13 0 0 0 11 13 12 0 23 14 0 9 0 0 0 0 2 0 0 4 9 16 0 30 29 12 14 0 28 5 0 31 5 2 
22 38 11 46 0 2 31 6 22 15 0 0 24 15 0 1 0 24 4 0 0 0 19 6 19 11 10 0 0 5 22 0 0 10 0 0 16 65 16 18 
24 0 0 0 7 16 7 9 3 0 15 23 10 22 0 6 0 0 0 5 0 8 0 0 3 25 0 0 28 2 7 21 0 0 0 0 23 0 0 13 
31 0 0 0 0 0 11 2 21 0 10 0 23 0 4 0 16 17 8 6 9 0 0 13 10 8 0 19 5 13 0 8 9 12 9 33 0 8 5 0 
22 21 37 1 0 0 30 30 31 10 3 15 12 60 17 0 0 0 12 8 0 0 10 0 30 9 0 10 26 53 0 4 14 0 20 0 0 30 0 5 
0 0 0 29 7 0 0 4 6 22 7 0 5 29 9 0 9 2 21 0 0 10 9 10 6 21 0 0 0 6 0 5 19 11 3 0 0 0 5 0 
52 33 1 12 1 35 5 41 0 3 0 17 8 17 5 12 0 4 15 0 18 20 44 8 10 18 9 6 11 30 16 10 32 32 15 30 21 24 9 10 
31 0 15 0 44 0 21 0 0 0 16 10 0 25 0 0 3 15 12 14 0 28 1 0 2 21 25 20 7 7 0 27 0 0 0 7 32 0 0 0 
10 9 0 0 0 0 0 21 30 0 8 0 9 0 4 0 5 19 2 4 0 21 0 0 0 5 0 13 21 0 0 0 0 0 0 0 40 0 30 0 
16 0 0 17 4 6 0 0 1 7 26 6 0 4 7 0 0 12 2 2 17 7 11 7 7 0 6 4 3 3 12 0 6 0 0 0 10 0 5 0 
13 0 0 0 0 0 0 0 0 0 0 0 1 9 2 0 0 0 0 0 4 0 0 0 14 0 0 0 0 0 0 1 0 0 14 22 7 0 19 0 
68 0 14 10 5 21 0 9 21 28 17 22 15 4 36 10 15 0 5 0 8 0 0 0 8 14 45 42 22 0 0 12 8 32 0 5 36 28 0 12 
4 13 16 11 0 29 16 0 0 0 6 0 3 0 2 0 22 0 0 4 9 0 2 11 5 1 3 0 0 8 0 18 16 0 40 0 0 0 0 0 
14 0 2 3 0 34 9 0 3 0 10 24 0 22 0 0 0 0 4 20 0 0 4 0 3 2 35 1 3 0 17 0 0 0 2 43 38 0 4 53 
25 0 0 33 0 0 1 1 1 21 42 9 0 5 3 14 0 42 0 0 9 14 1 0 3 6 8 10 28 7 34 12 0 15 24 0 19 0 4 0 
0 0 17 0 0 0 1 29 5 0 0 0 0 16 30 0 22 60 21 3 1 7 5 16 0 11 18 1 0 0 0 0 15 35 0 0 24 1 43 33 
13 0 0 6 0 21 12 6 8 6 0 23 0 0 0 0 0 0 10 9 0 11 10 16 7 0 21 0 2 0 21 0 2 0 40 28 0 19 0 0 
