40 23
0 3 9 4 10 8 51 4 0 0 0 1 14 7 3 3 17 3 9 17 19 21 0 0 16 14 13 0 15 39 11 7 2 0 30 11 17 0 0 14 
0 23 12 10 35 22 75 0 13 0 0 6 0 13 0 20 0 18 3 1 0 0 35 0 0 0 0 42 0 25 0 16 1 0 0 29 0 0 0 2 
0 0 0 0 0 21 13 5 0 20 19 0 20 0 0 11 0 0 0 7 7 0 0 0 0 0 25 7 0 0 9 0 28 0 0 0 0 0 0 2 
0 2 14 0 14 18 42 0 19 37 1 0 0 0 0 39 0 0 0 0 0 0 0 1 5 0 12 0 13 4 19 0 26 30 0 0 5 0 22 24 
0 8 12 0 23 27 2 0 5 14 1 12 0 29 12 2 2 3 8 10 20 23 7 21 27 13 8 23 1 13 9 19 33 0 0 13 23 0 39 0 
0 0 0 15 12 0 57 0 0 0 0 1 0 0 0 0 12 0 0 6 0 0 0 0 1 0 0 3 0 0 37 1 0 0 0 0 0 13 16 18 
0 0 0 32 5 23 8 1 0 17 8 20 15 0 0 0 20 0 8 27 4 0 0 0 0 0 5 15 0 21 14 20 13 24 8 44 0 8 9 30 
0 0 48 9 4 7 0 5 4 23 26 0 0 3 0 1 7 0 0 16 0 14 10 15 22 23 7 9 11 6 0 0 15 8 0 0 0 0 0 0 
0 0 0 35 9 47 30 0 7 0 0 0 6 4 4 1 14 9 9 0 2 12 5 0 11 0 10 26 0 16 17 18 0 21 0 5 44 6 38 22 
0 0 0 30 0 0 23 0 0 0 24 0 0 17 0 18 0 16 4 0 9 12 1 6 0 0 0 8 0 23 17 0 10 66 24 3 0 0 5 0 
0 0 8 11 34 0 3 24 0 14 32 0 0 0 0 6 6 9 1 0 21 0 6 0 2 0 9 25 0 5 5 18 22 0 0 64 0 0 34 0 
0 18 0 0 28 0 0 0 11 0 0 22 0 0 0 0 10 0 1 12 2 0 5 0 0 0 0 7 0 0 11 0 39 22 4 1 0 0 3 5 
19 8 0 50 0 4 0 0 2 22 35 0 13 13 4 29 0 3 0 6 2 3 19 0 13 2 6 0 5 1 4 11 2 12 1 39 0 0 38 0 
35 50 0 0 13 0 0 3 0 0 9 22 0 2 13 1 8 32 0 19 9 5 0 22 1 11 23 0 0 40 19 2 7 22 0 26 19 0 12 4 
29 0 0 0 2 7 34 8 0 0 0 0 22 22 0 15 0 14 0 20 15 0 2 0 10 5 16 0 28 13 1 0 4 5 29 8 0 6 0 6 
21 19 0 0 56 7 16 0 29 3 26 0 6 24 12 22 0 2 18 18 34 16 4 2 1 34 17 9 1 0 0 0 0 0 0 23 25 7 0 35 
37 31 11 33 2 4 1 42 0 7 38 11 8 6 3 6 4 13 13 12 19 0 11 12 0 13 13 10 0 6 23 0 27 51 0 30 25 0 0 0 
0 55 14 0 0 0 0 0 0 0 0 6 0 0 0 0 4 3 0 16 0 0 11 10 0 0 9 0 0 3 12 4 2 2 33 0 0 5 0 0 
2 14 36 23 15 10 0 11 0 6 42 2 0 3 6 25 4 3 34 8 5 7 13 2 0 30 38 0 0 1 0 0 11 15 5 27 0 33 7 3 
18 3 0 0 15 19 0 0 0 0 0 0 1 0 0 0 0 0 18 19 1 17 0 0 19 0 3 0 0 0 0 0 0 0 0 7 0 0 17 0 
6 1 0 15 11 0 0 0 0 0 0 0 6 0 0 50 0 0 0 7 0 0 1 10 7 0 0 0 0 0 0 7 9 6 0 20 0 0 0 15 
12 11 0 12 33 5 3 7 5 0 13 25 2 5 0 41 16 19 9 17 18 45 6 0 0 0 5 10 0 17 12 0 7 0 0 1 30 55 8 21 
0 0 3 50 8 22 0 1 8 20 9 0 21 0 0 10 0 16 0 9 0 17 8 11 0 22 9 0 15 0 32 28 0 16 0 0 0 0 18 0 
