40 23
0 0 9 0 13 4 60 0 4 4 0 6 17 0 0 11 58 0 0 4 27 15 0 13 18 10 0 0 26 2 10 6 15 13 0 0 18 38 0 33 
0 36 25 35 4 33 0 11 11 0 14 12 16 0 2 13 0 0 13 15 2 0 0 3 0 10 0 0 21 0 26 13 0 0 0 10 0 39 75 15 
0 0 0 20 13 4 31 3 41 4 16 0 7 15 0 0 0 22 3 17 0 16 0 5 0 0 0 0 20 0 12 1 0 0 19 0 0 31 0 9 
0 0 3 0 2 8 13 15 0 17 16 0 4 0 5 0 11 4 0 18 6 9 13 0 0 13 16 20 0 0 9 0 0 1 19 44 0 10 28 5 
0 38 5 21 19 28 1 0 7 11 0 1 4 0 0 33 0 12 13 6 3 0 28 2 0 5 0 6 26 10 5 15 0 22 0 0 0 34 0 16 
0 20 0 11 8 0 0 13 4 12 0 21 5 2 0 0 3 0 0 9 15 10 17 0 0 6 23 5 6 0 26 4 7 26 0 31 16 47 3 17 
0 19 4 0 0 25 15 0 0 0 4 34 4 0 7 0 3 3 0 0 11 10 9 0 12 2 0 0 0 0 0 1 27 27 0 0 14 26 0 16 
13 6 29 14 0 28 18 4 0 7 12 0 3 35 15 10 6 2 0 10 6 18 0 1 21 10 2 2 27 5 22 1 0 42 24 0 0 24 3 0 
0 5 22 4 4 9 0 0 24 0 0 14 26 0 0 0 0 11 0 10 0 2 0 0 34 14 0 6 0 14 0 1 51 0 19 0 0 0 11 33 
0 0 0 23 7 16 15 0 0 5 0 19 8 0 0 0 1 33 2 0 14 54 13 2 3 6 11 1 24 0 19 7 0 0 3 14 7 13 11 22 
0 0 4 5 2 30 0 40 0 7 27 10 9 14 0 8 6 3 0 0 6 14 6 0 3 10 0 15 18 0 1 0 0 13 2 6 0 20 15 32 
0 0 0 8 0 8 0 0 0 0 1 11 4 0 2 0 0 0 7 0 0 3 8 4 1 10 0 12 0 0 9 0 1 0 0 10 0 9 0 12 
0 0 46 12 32 0 35 15 10 20 12 3 12 0 0 0 17 9 0 22 9 0 0 13 18 13 0 8 0 14 5 0 16 0 9 2 2 31 1 36 
3 5 2 3 0 9 0 0 0 24 0 1 28 0 6 0 0 5 8 0 6 5 37 0 24 0 16 5 0 0 0 0 0 24 12 0 24 0 12 9 
11 4 4 0 7 20 21 0 8 12 2 15 11 7 0 0 8 10 22 9 1 0 1 0 0 0 22 17 0 0 9 21 14 6 0 0 7 5 18 20 
0 0 12 9 17 17 4 10 0 5 14 7 5 21 5 0 10 0 0 5 0 13 32 0 0 15 0 0 25 0 0 0 28 0 13 0 0 0 0 0 
35 0 3 0 1 3 12 3 3 2 0 16 0 0 0 0 4 0 0 11 2 0 14 16 2 0 0 0 0 0 0 31 0 0 0 0 0 0 0 15 
1 3 3 4 1 6 11 0 0 41 0 6 9 6 0 0 0 11 0 0 4 0 0 0 0 0 0 0 7 0 0 0 0 0 21 7 35 7 0 68 
0 0 17 11 14 0 12 33 0 2 0 0 0 0 0 1 16 23 0 0 10 0 0 4 6 18 6 0 8 0 13 15 0 0 0 0 29 0 0 0 
0 11 8 9 0 0 0 0 0 0 3 7 12 25 0 0 16 19 17 0 0 0 4 17 9 0 0 2 3 28 2 0 0 9 1 2 19 29 14 0 
11 0 30 4 4 0 11 25 0 45 10 0 16 14 2 0 0 11 0 0 2 1 0 2 12 34 17 3 10 0 10 0 56 0 0 0 48 4 0 9 
0 0 0 0 0 0 24 20 0 3 0 0 12 0 14 0 2 0 4 0 6 1 0 0 28 2 1 31 0 0 33 0 0 27 6 0 3 3 24 0 
0 0 66 81 0 30 7 0 15 0 17 11 1 0 11 5 0 19 0 0 19 18 5 6 14 0 12 8 2 27 6 0 2 18 0 3 0 34 33 12 
