40 23
8 11 1 11 1 0 0 4 11 11 1 1 10 0 23 0 19 4 11 0 11 17 7 18 11 0 0 10 0 7 0 0 0 0 0 22 1 23 21 0 
11 19 0 0 31 6 20 14 8 0 7 0 0 0 0 0 22 7 12 27 40 1 0 0 15 0 6 0 15 0 0 10 22 2 0 29 28 0 19 3 
0 17 0 11 0 28 6 32 0 8 4 3 0 0 25 6 20 17 11 2 13 5 0 0 0 20 2 0 6 0 0 28 0 15 0 30 20 19 0 0 
0 27 20 0 0 32 17 10 0 3 0 13 9 0 15 0 7 0 2 0 0 9 20 0 8 15 21 3 31 15 14 0 4 11 18 0 10 1 0 12 
0 0 2 18 11 0 0 0 0 16 0 42 0 0 0 0 19 0 0 2 0 9 6 12 0 36 0 0 0 0 17 10 0 8 23 0 0 12 6 0 
14 11 0 45 0 20 0 13 28 0 31 13 0 0 12 17 8 3 5 0 3 0 19 0 0 10 25 0 6 26 9 21 16 9 6 4 14 3 0 37 
36 0 0 0 0 0 0 13 5 0 12 0 0 0 0 0 14 0 5 0 13 10 0 0 0 0 6 0 0 0 0 10 3 6 0 13 36 0 0 6 
32 0 0 7 9 0 14 5 0 0 3 0 0 20 9 13 6 0 0 6 14 0 15 0 5 0 11 9 0 5 0 4 38 20 19 0 0 0 0 6 
39 0 9 21 8 8 0 0 0 24 2 9 8 13 0 32 22 20 17 0 0 0 17 0 9 0 5 0 8 0 0 0 0 37 17 0 0 0 6 80 
20 2 9 33 23 0 0 23 36 0 0 15 0 0 19 0 0 3 3 1 23 8 0 0 1 9 11 36 0 0 0 10 50 5 0 5 5 2 13 3 
0 25 3 0 1 32 0 0 3 0 14 10 0 0 0 0 0 13 0 0 0 4 0 0 6 11 5 0 0 0 0 0 0 0 0 10 24 0 33 4 
0 8 36 0 0 3 17 0 5 0 18 4 0 0 15 0 7 0 15 0 10 0 0 17 2 9 2 4 18 28 16 0 3 0 0 0 0 7 36 37 
0 15 26 3 12 0 2 6 2 10 0 32 0 11 0 3 1 17 0 0 9 11 0 0 24 16 21 19 0 9 0 29 11 0 0 0 0 0 0 3 
0 0 17 28 63 3 0 10 11 0 15 0 11 0 1 7 13 8 8 6 0 7 0 11 10 15 0 0 20 13 33 24 0 2 10 0 8 33 21 10 
26 4 0 2 0 4 0 5 14 0 1 0 1 0 20 4 0 0 9 0 0 0 4 0 0 6 3 0 0 0 9 10 3 17 0 25 15 0 8 6 
0 32 25 9 0 33 5 0 10 0 0 0 9 0 4 5 23 3 4 8 0 0 0 6 0 4 20 33 0 7 14 1 2 28 1 27 12 13 9 26 
69 1 7 22 13 20 14 2 15 31 0 23 12 25 29 0 3 4 0 11 15 10 16 18 0 22 13 0 5 0 0 22 0 0 41 0 1 37 16 0 
35 0 23 0 27 27 5 0 2 26 0 0 20 22 0 3 1 0 12 22 0 0 9 0 6 4 0 0 6 0 0 29 39 0 0 48 1 0 0 4 
0 0 23 11 15 2 9 7 5 0 7 5 0 0 18 11 13 4 0 23 8 7 16 21 8 28 1 44 2 8 0 23 9 0 0 0 12 1 14 0 
10 1 25 30 27 0 10 1 18 47 22 22 8 20 0 16 9 36 1 15 0 0 0 0 14 0 0 2 0 12 1 23 23 1 5 20 14 0 0 23 
0 35 7 25 0 1 2 19 2 2 7 7 0 4 0 23 13 11 28 0 0 18 16 0 0 6 19 0 11 14 10 15 29 3 0 31 0 0 13 0 
0 19 1 0 13 7 8 0 4 0 0 0 0 18 8 0 9 9 20 0 1 10 14 0 2 3 19 16 7 0 5 12 16 0 8 0 14 0 32 0 
2 0 1 0 0 0 53 7 17 3 19 3 3 1 9 11 14 2 0 9 0 6 24 0 10 0 7 11 0 22 3 9 15 0 2 20 0 0 13 33 
