40 23
0 0 0 0 0 21 36 19 18 23 0 13 0 0 0 10 0 0 0 0 14 0 14 0 0 31 4 9 25 4 0 0 7 11 18 0 0 3 27 13 
25 0 12 15 0 0 0 0 17 0 9 21 0 0 2 17 0 25 0 0 0 8 0 0 0 17 0 0 17 18 10 1 10 3 17 0 24 0 0 0 
0 0 0 32 16 0 42 16 12 0 19 0 26 0 0 9 0 0 0 6 7 12 0 0 0 0 0 0 10 23 0 0 7 13 0 18 14 0 26 15 
0 0 5 8 33 0 0 0 5 0 14 0 0 32 2 8 14 0 0 5 9 0 10 4 2 0 0 12 0 0 7 7 0 0 0 0 0 29 0 0 
21 6 0 8 10 0 26 8 0 8 0 18 0 0 13 10 0 46 0 8 1 28 0 7 0 18 0 5 4 7 10 0 31 22 17 0 2 1 0 9 
33 36 0 27 0 11 9 0 0 0 9 0 5 0 7 0 0 16 6 0 13 7 15 11 13 0 14 0 3 1 32 0 0 19 11 0 0 15 0 0 
0 15 2 0 12 0 13 7 44 22 0 23 0 0 9 0 15 10 0 3 18 0 20 2 0 0 0 17 0 0 0 0 0 34 23 0 28 4 0 16 
34 17 3 0 0 0 0 15 14 4 7 13 0 14 13 0 0 0 0 0 8 21 0 2 13 8 7 7 8 18 0 0 0 7 0 0 7 0 27 3 
2 6 35 0 0 8 8 0 3 0 14 0 11 1 0 15 0 0 0 0 13 20 11 2 14 0 7 16 0 20 0 0 0 10 6 0 0 27 26 6 
18 31 0 0 0 29 0 16 0 8 29 6 0 0 0 0 19 18 4 3 3 6 3 0 0 0 0 10 0 2 0 7 2 0 24 19 12 0 0 1 
8 0 27 8 21 25 0 25 31 0 13 18 0 0 11 10 20 32 0 21 0 2 0 0 8 5 24 3 12 4 25 0 34 15 1 1 27 19 0 42 
6 2 28 2 0 5 0 6 0 0 0 20 0 5 26 8 0 3 17 0 5 9 18 7 23 3 0 0 0 0 6 17 0 11 0 0 0 0 36 0 
0 0 33 0 8 10 1 4 21 0 10 9 42 0 2 1 18 0 0 0 8 5 0 6 0 2 5 0 0 21 0 0 0 0 18 33 0 0 26 0 
6 7 12 0 6 5 0 26 7 0 3 0 0 3 0 0 12 17 1 0 5 14 32 7 0 0 0 6 0 36 10 0 3 0 0 5 0 9 0 35 
0 21 11 32 5 29 28 1 0 0 4 15 5 8 6 1 0 17 16 4 17 2 33 0 57 0 0 22 14 32 16 0 0 6 71 8 33 47 7 12 
0 8 0 0 35 0 0 0 3 0 0 1 0 7 0 13 19 3 0 2 7 0 11 0 4 1 0 19 0 7 0 0 0 0 0 19 1 1 8 35 
21 6 13 11 6 27 8 6 0 0 3 13 8 17 18 10 0 22 0 1 1 19 9 0 27 5 27 6 0 14 0 1 34 23 0 5 17 8 28 47 
2 0 0 0 1 0 1 33 1 1 11 0 2 14 0 9 23 8 0 0 0 14 0 0 9 0 0 8 0 0 14 0 0 17 0 0 0 0 0 31 
7 4 0 3 15 19 52 5 38 0 1 5 5 20 21 8 25 4 0 19 17 1 0 6 21 9 0 0 0 13 13 34 28 16 19 14 8 0 0 0 
3 0 2 32 3 5 13 17 5 0 3 0 0 5 0 15 0 0 5 0 16 11 0 10 3 13 14 0 0 29 11 0 0 0 4 32 16 12 3 0 
0 0 17 30 12 15 36 7 0 0 17 0 0 0 4 2 29 18 15 4 16 5 0 8 3 3 4 0 0 16 0 33 9 45 11 20 0 0 0 0 
0 0 12 29 20 21 19 5 14 0 11 0 0 0 23 9 3 16 0 0 6 0 2 13 14 1 21 0 0 26 0 0 0 11 24 0 12 13 0 0 
11 3 4 3 0 4 5 20 29 15 12 4 8 33 0 0 4 16 17 18 19 2 16 15 12 0 5 16 0 2 9 0 5 16 4 16 39 0 46 33 
