40 23
53 16 72 1 5 10 0 5 4 0 14 11 20 0 0 6 11 15 0 0 20 0 22 20 3 0 2 0 0 0 0 59 8 19 17 0 5 11 0 37 
6 29 0 36 9 11 6 19 1 0 0 36 8 9 14 9 4 14 8 6 3 0 5 9 10 12 11 7 0 1 19 5 1 16 0 20 0 5 0 0 
0 33 25 0 33 0 0 18 0 0 12 17 17 2 20 1 10 11 20 3 7 4 0 20 0 0 43 36 12 22 38 11 8 3 6 0 18 46 3 0 
0 24 1 0 16 2 0 2 5 8 1 0 7 20 2 26 3 0 15 0 33 0 0 0 2 8 1 0 0 0 0 0 0 14 0 6 21 17 0 0 
14 10 13 28 0 12 0 4 15 14 4 60 3 8 4 15 0 9 4 0 10 11 9 1 14 0 1 9 0 5 0 6 5 22 33 1 0 6 1 0 
5 36 34 12 0 4 0 0 0 0 0 0 0 32 17 11 8 0 0 0 0 4 14 0 11 16 14 3 12 0 0 0 0 20 0 11 57 0 37 0 
0 0 0 0 0 0 10 0 5 30 0 20 0 0 7 0 8 0 0 0 0 7 0 15 2 0 2 15 27 5 0 5 0 7 0 23 0 12 0 44 
0 30 7 4 31 4 5 24 0 18 0 0 11 0 0 0 0 0 0 6 9 5 0 0 0 5 0 18 0 3 34 27 0 9 0 43 0 0 12 0 
0 13 0 10 0 0 0 0 0 2 3 24 21 4 0 8 0 13 8 6 0 2 0 7 14 6 15 0 0 0 20 0 8 22 0 5 2 7 21 0 
0 0 24 0 0 2 0 9 31 0 4 0 0 0 9 0 0 0 2 20 19 4 0 2 6 0 24 8 0 3 0 5 5 13 0 8 0 0 0 11 
8 19 0 3 2 0 10 0 0 37 8 23 10 7 0 21 7 5 12 0 21 21 2 0 0 15 3 10 3 3 12 0 2 3 22 0 19 0 17 4 
10 0 3 23 20 2 0 9 0 25 21 10 0 9 0 2 0 0 0 10 0 18 2 6 52 0 11 0 12 5 0 3 0 0 1 0 0 8 0 0 
0 0 0 0 0 0 0 0 0 0 0 1 0 0 25 0 8 0 5 0 9 3 0 0 0 13 0 0 0 13 1 0 0 0 7 0 0 0 13 25 
5 12 7 17 0 7 0 4 0 18 3 13 6 13 23 0 0 0 0 12 28 0 0 4 8 18 0 9 0 16 0 21 15 5 0 0 4 27 17 0 
0 45 10 20 0 0 33 0 0 11 2 0 0 12 6 18 14 0 21 0 13 0 9 0 0 13 12 0 10 0 27 17 0 0 0 1 1 0 7 8 
0 36 32 30 0 42 1 0 0 0 4 5 0 7 21 13 0 5 0 0 9 20 0 0 6 14 5 0 13 0 2 0 18 2 38 1 13 9 25 0 
18 0 0 0 4 0 0 3 0 26 3 0 0 0 0 0 0 0 7 0 0 0 22 12 0 0 6 14 0 0 0 2 0 6 6 15 0 3 0 0 
0 2 0 25 3 0 16 0 0 31 0 0 18 1 0 15 0 5 1 0 18 14 2 9 0 0 11 2 2 7 0 7 0 54 0 31 1 22 11 0 
1 45 0 4 0 0 37 4 0 0 0 0 10 10 29 0 0 16 52 14 0 4 21 0 0 12 0 0 9 3 16 0 1 30 0 29 4 16 0 0 
34 16 9 13 0 0 27 19 0 5 0 6 1 14 19 21 17 0 0 6 0 10 2 0 0 6 9 26 0 9 0 29 0 48 40 31 35 1 9 0 
0 4 17 9 3 21 0 8 0 0 21 8 19 17 16 0 11 0 0 41 8 9 0 2 13 2 39 10 6 11 0 21 0 0 9 3 7 13 0 14 
4 13 1 14 0 14 0 0 8 11 10 25 0 30 15 21 0 14 0 5 23 1 11 21 11 22 2 10 4 1 3 5 0 0 1 33 58 0 0 28 
15 5 8 29 0 0 21 9 12 19 8 0 0 7 24 6 0 0 5 12 2 4 0 0 0 5 9 24 7 15 3 18 0 0 0 16 9 22 0 0 
