40 23
27 9 20 35 0 22 0 0 0 0 0 7 21 14 0 0 0 12 17 0 14 0 8 13 13 0 0 44 18 15 0 0 12 0 0 0 13 8 25 0 
0 27 0 17 13 34 2 6 0 12 22 8 7 15 7 0 3 0 8 0 0 0 0 0 37 0 12 0 17 0 0 0 6 0 0 24 11 7 0 34 
35 36 16 16 0 11 29 3 23 4 3 29 24 12 4 11 8 19 25 31 11 0 19 21 0 0 22 12 18 31 7 23 6 2 0 31 8 8 0 40 
0 2 34 39 0 7 31 27 28 25 21 6 34 0 0 14 0 27 0 0 0 0 12 13 15 3 0 0 39 3 0 5 11 0 9 0 14 0 10 7 
28 2 0 8 68 0 5 39 0 28 3 0 0 9 0 17 3 8 5 4 0 3 1 9 0 8 30 23 13 11 26 1 12 0 0 16 0 31 46 18 
0 0 0 36 1 0 16 17 16 0 24 3 0 0 7 14 11 7 5 0 0 6 0 17 11 0 0 0 7 3 0 1 21 0 20 17 12 0 9 24 
12 10 30 50 1 50 0 0 29 11 0 18 0 12 10 18 0 0 0 41 6 7 0 13 0 3 0 0 0 12 0 0 30 18 15 30 5 22 0 0 
4 25 28 18 5 0 0 0 5 13 0 0 2 0 2 6 0 2 0 11 17 25 3 0 0 28 11 5 6 4 36 0 3 0 6 0 6 17 5 28 
29 8 2 0 9 14 5 19 43 17 6 17 15 1 7 0 0 0 2 20 3 0 0 10 11 16 36 15 0 37 11 0 12 22 7 9 0 44 0 5 
0 38 0 13 33 0 31 0 0 0 7 9 0 12 13 14 0 18 21 13 0 8 0 5 0 10 8 4 0 0 0 0 5 16 0 20 0 2 0 0 
0 5 32 0 7 0 11 0 3 0 0 0 0 0 20 2 8 2 3 13 0 42 0 2 15 4 15 25 0 0 0 0 0 5 53 16 7 0 10 15 
9 0 22 31 0 0 10 7 17 19 9 15 0 0 5 0 0 0 12 0 0 6 6 14 36 15 15 0 6 0 9 0 0 3 22 0 0 2 0 0 
0 7 1 10 0 9 11 30 15 0 11 10 18 3 0 0 0 0 22 0 0 0 0 17 8 11 23 0 6 9 0 23 3 0 0 59 5 1 4 0 
35 0 0 9 0 34 0 1 7 12 27 1 0 0 21 11 11 0 0 0 16 2 13 0 2 0 3 6 3 3 0 3 0 0 0 73 8 5 28 25 
5 0 32 37 19 2 3 0 8 0 17 11 22 18 2 0 0 16 15 16 9 39 0 0 0 9 0 19 8 28 0 28 0 15 28 4 8 8 0 7 
0 28 35 0 8 5 0 0 3 0 0 23 0 11 0 0 0 0 0 8 6 10 6 1 4 0 19 6 0 44 0 11 3 9 36 0 2 35 0 0 
1 49 0 29 0 0 0 8 17 0 0 0 0 0 3 7 0 0 0 8 0 12 0 8 0 3 0 28 3 21 16 6 0 0 11 34 0 0 0 36 
0 8 29 0 0 48 15 21 0 6 9 6 0 0 0 0 0 0 20 4 3 15 1 31 5 0 0 17 21 39 0 0 10 10 27 0 0 0 6 22 
12 9 0 17 0 0 0 30 8 0 10 10 0 12 0 0 0 0 0 0 10 18 0 0 0 7 0 5 24 0 0 4 0 3 13 4 0 30 0 13 
3 9 0 2 0 2 0 0 0 0 0 0 0 25 0 0 0 0 0 20 0 0 0 2 0 0 0 0 15 0 11 0 0 0 0 0 0 24 0 21 
0 37 20 14 4 25 7 28 17 0 26 0 11 8 6 0 0 0 0 0 0 0 5 0 8 0 0 6 34 28 3 0 0 0 19 34 0 0 0 0 
2 2 20 28 23 37 21 25 9 14 18 8 0 9 0 0 21 29 22 14 0 4 16 22 0 10 9 1 17 16 4 19 6 28 15 2 17 9 0 0 
0 0 0 35 0 13 0 18 22 0 0 10 5 0 0 0 0 0 20 9 0 9 0 0 11 7 18 0 0 22 1 6 0 12 5 0 16 0 35 11 
