40 23
43 1 30 0 19 12 0 25 0 8 17 28 0 1 14 0 11 8 10 8 21 12 17 5 9 42 0 17 0 14 14 11 55 5 0 16 16 23 0 12 
29 3 0 0 25 7 5 0 35 5 0 19 0 3 5 18 1 0 0 0 7 17 6 0 59 0 0 12 6 26 0 1 2 16 10 16 8 0 0 0 
0 14 0 0 0 27 5 16 0 30 5 0 9 0 12 5 0 11 0 2 4 9 12 4 27 3 0 0 3 20 24 20 27 0 12 0 6 0 0 30 
12 28 14 0 15 0 11 25 10 27 0 0 23 25 0 10 14 2 17 24 16 0 14 53 15 7 0 36 0 0 28 0 4 0 11 39 12 12 32 2 
0 34 11 18 8 0 0 0 4 4 14 26 0 5 0 17 46 0 5 8 16 18 0 0 6 0 0 0 0 8 0 0 1 0 0 0 0 0 22 0 
20 0 58 0 12 0 0 0 0 15 25 0 0 5 4 20 5 0 16 10 12 0 17 16 25 0 0 4 9 1 1 15 13 0 14 12 0 11 36 0 
0 0 0 0 0 0 6 0 0 1 15 0 9 0 0 7 10 0 0 0 11 21 0 0 6 4 0 0 0 0 8 0 0 0 0 0 0 10 0 0 
12 0 2 9 0 0 0 8 0 0 4 35 7 0 2 15 0 11 0 12 0 0 2 1 21 4 2 0 13 18 5 6 0 0 12 20 0 0 0 0 
8 11 3 0 23 27 17 3 0 14 31 0 27 0 23 3 16 7 13 0 0 0 6 9 6 20 1 9 19 1 0 14 6 0 0 3 14 10 0 23 
0 23 15 12 0 0 8 0 0 23 10 0 11 5 0 41 9 9 9 11 0 0 9 0 0 0 0 0 0 0 6 0 6 6 0 22 8 3 29 4 
6 36 2 33 39 10 21 0 0 2 0 2 0 0 21 3 0 6 8 9 7 2 3 4 12 4 21 11 0 7 0 0 7 14 16 10 12 36 0 7 
13 0 0 12 16 52 0 0 10 29 23 0 11 23 24 0 0 2 0 0 1 0 5 11 0 22 0 0 6 43 5 4 0 28 0 0 2 0 47 0 
0 8 12 8 11 11 0 12 0 3 1 0 0 0 1 30 16 8 0 12 10 27 5 9 0 0 5 17 0 21 10 5 2 0 0 23 20 0 3 12 
23 0 29 0 0 27 4 16 6 2 4 14 0 0 1 32 9 14 0 0 0 0 13 35 7 14 0 0 23 7 0 15 32 0 19 0 0 5 0 32 
6 0 0 0 0 33 25 7 16 0 8 3 23 0 5 0 5 6 7 5 1 9 13 3 0 0 10 0 22 14 14 1 3 8 0 29 0 32 0 0 
0 0 11 0 6 1 17 0 0 2 27 14 5 0 10 0 2 0 0 11 0 16 7 10 14 7 0 0 4 0 0 21 7 6 0 0 5 5 0 23 
5 22 2 0 2 0 0 0 0 0 0 0 0 11 0 0 5 7 0 0 0 0 1 7 15 0 0 0 0 0 0 11 0 0 0 0 16 36 0 0 
4 0 2 1 13 4 21 5 2 0 0 4 20 12 0 11 21 1 9 13 0 0 3 14 7 0 14 0 10 0 0 38 12 16 0 10 5 12 0 0 
37 8 34 4 51 0 0 52 10 10 35 8 0 23 17 14 10 17 17 11 0 4 14 5 0 0 10 0 0 0 0 11 0 0 20 17 89 45 0 0 
7 23 11 0 22 18 21 7 3 22 13 9 13 11 0 0 8 1 0 5 0 0 8 17 17 22 0 30 0 0 4 14 0 11 16 0 0 0 0 8 
25 16 32 3 0 3 20 42 6 22 14 0 23 0 0 19 0 0 2 18 6 0 0 23 14 20 10 1 1 5 0 2 7 0 3 15 42 30 0 0 
31 21 30 0 0 11 0 2 0 43 15 0 11 0 0 17 0 0 24 2 21 4 0 0 11 16 39 0 4 0 0 10 3 14 2 0 0 0 0 21 
43 18 14 2 25 0 0 8 0 15 20 43 5 36 3 10 27 4 15 0 8 4 14 7 14 0 14 0 0 79 30 32 0 2 25 0 23 8 0 0 
