40 23
3 0 59 25 0 14 13 18 6 0 9 21 17 0 3 0 3 0 14 10 0 0 16 0 0 0 25 4 0 0 31 1 37 19 0 5 0 0 6 0 
0 37 0 0 26 25 3 0 9 41 0 0 10 3 0 6 3 0 0 0 0 0 27 0 10 16 0 11 0 5 23 6 0 0 3 8 0 7 37 0 
12 0 0 0 29 33 4 5 40 41 0 0 0 0 0 0 17 0 0 0 0 0 5 0 4 0 2 0 12 0 0 3 11 20 1 30 12 0 0 0 
26 0 10 0 7 17 2 13 15 0 28 7 22 24 43 0 0 0 0 20 9 13 17 0 19 0 26 0 0 5 0 0 6 0 41 16 0 0 26 10 
0 0 0 0 0 0 2 0 30 23 0 0 0 0 3 12 0 19 0 0 16 0 4 14 2 0 9 0 0 0 30 5 23 0 0 0 45 6 11 0 
24 0 0 0 0 3 0 0 0 0 0 0 0 13 0 17 12 2 0 0 3 4 0 2 4 0 3 5 0 11 1 1 6 0 15 0 0 11 10 5 
36 34 4 0 0 44 4 0 4 0 0 0 10 20 1 0 0 8 0 0 0 0 10 1 10 0 0 1 0 15 0 26 19 8 40 11 0 37 0 0 
0 0 0 20 19 0 20 13 0 6 0 14 11 0 0 0 0 0 10 0 2 0 0 2 19 12 20 5 10 9 0 12 36 0 6 1 0 28 8 0 
0 0 48 14 8 12 15 0 5 10 0 11 8 19 9 0 3 6 0 20 46 14 17 0 0 12 7 33 21 2 9 2 5 7 0 5 4 55 8 3 
4 4 0 34 0 2 30 0 19 0 9 28 9 9 4 10 8 0 8 0 0 16 0 5 0 0 11 0 0 0 0 0 11 0 28 0 0 66 2 31 
19 19 27 0 8 41 0 0 9 9 10 27 7 4 4 0 1 12 16 0 29 0 0 15 6 0 0 0 12 2 4 0 4 0 12 0 1 6 18 0 
30 96 3 0 20 2 7 9 13 10 6 3 22 7 0 1 3 15 0 20 23 8 5 0 6 24 19 4 0 18 48 8 27 3 14 3 35 0 53 0 
39 32 0 21 40 4 2 11 12 0 2 0 15 6 23 0 5 1 14 18 9 6 0 0 7 12 6 4 0 2 18 19 0 19 4 0 0 2 41 34 
9 1 23 9 0 0 0 13 8 28 11 0 0 0 15 3 2 10 9 16 9 4 0 0 9 10 7 11 5 2 25 22 14 0 19 4 0 8 0 6 
12 65 58 18 6 17 0 0 14 0 18 20 0 4 12 0 15 3 9 16 10 0 2 0 0 2 25 9 8 3 28 0 21 8 18 0 0 0 0 0 
0 24 1 0 21 22 7 9 15 0 22 0 25 12 17 0 2 6 10 0 0 0 0 0 0 12 0 22 30 21 2 13 0 0 0 3 0 25 11 3 
3 3 0 61 9 0 15 14 0 0 0 8 0 0 0 19 3 2 0 0 0 7 13 0 12 0 0 11 6 0 5 0 0 27 13 0 0 11 35 4 
0 0 11 31 0 8 9 32 15 18 0 31 11 15 0 2 8 16 12 0 0 10 0 14 0 0 0 6 7 0 23 8 17 16 38 5 7 31 17 0 
0 1 21 33 0 0 9 20 12 10 3 13 0 4 0 35 15 15 4 0 0 0 0 21 11 10 0 9 0 0 6 13 8 0 36 8 33 0 0 3 
0 0 0 0 12 2 3 22 11 17 1 1 19 14 0 0 11 0 0 11 0 8 0 16 12 14 0 0 5 14 0 10 0 12 0 16 0 6 1 21 
0 28 13 0 15 10 11 13 11 2 2 3 0 0 0 7 5 0 11 6 9 0 0 0 10 23 12 0 0 13 26 8 8 6 10 2 6 0 12 8 
0 0 20 0 0 2 5 2 22 24 17 0 0 0 14 0 15 8 7 2 0 0 20 13 0 7 0 0 7 10 14 1 0 20 0 8 0 0 9 0 
38 0 4 10 1 12 4 22 0 0 2 0 0 19 0 21 9 0 5 3 12 12 1 3 19 0 0 0 0 9 0 0 0 0 27 0 0 15 47 0 
