42 24
7 4 1 0 26 11 22 0 0 8 31 0 6 29 3 50 11 9 5 0 3 0 0 34 32 14 2 14 0 0 16 61 22 6 0 3 0 0 23 9 22 41 
29 1 6 0 6 0 0 0 21 14 36 0 0 22 0 0 0 0 0 0 10 0 0 0 15 7 1 0 0 11 0 2 18 1 0 0 0 0 14 0 10 19 
0 18 0 23 0 0 0 0 1 0 31 0 2 0 0 0 0 5 1 9 6 26 1 7 0 18 29 21 7 0 0 0 0 0 0 0 0 0 0 0 0 0 
0 0 0 0 0 0 0 0 0 10 0 0 19 0 0 0 4 0 14 0 4 0 0 8 0 0 4 0 0 0 0 12 14 13 0 16 0 10 19 0 0 13 
0 25 3 18 10 30 15 9 18 8 0 13 0 22 4 0 45 30 9 7 1 20 13 8 21 0 37 9 4 14 44 25 7 0 4 17 7 0 19 19 36 3 
2 0 22 4 4 14 1 0 21 0 2 9 5 0 0 0 13 0 0 17 17 0 8 14 9 0 0 13 9 21 0 0 0 0 0 0 0 8 0 0 0 0 
35 49 9 17 9 0 26 10 9 3 18 0 0 6 4 0 10 12 15 11 9 17 0 0 20 16 0 2 40 0 13 19 31 13 7 2 0 2 0 22 0 16 
56 9 24 5 25 32 37 20 7 3 5 9 0 0 0 0 21 3 23 14 1 8 19 0 4 8 8 20 1 24 57 10 33 0 0 0 4 0 42 36 87 53 
0 0 33 0 4 5 0 0 0 0 15 8 7 23 0 0 4 0 10 0 0 0 10 0 0 0 3 0 7 1 0 3 0 0 0 28 0 0 9 0 0 0 
0 25 14 0 4 4 0 0 0 4 0 30 0 0 0 0 0 5 23 0 0 0 0 12 13 0 21 0 0 0 5 2 0 0 2 2 0 11 0 0 1 54 
4 3 0 31 26 0 5 0 0 24 3 0 0 17 3 0 0 0 0 0 13 2 8 17 11 10 12 5 11 15 3 0 5 0 31 0 0 0 0 0 0 0 
36 8 9 0 12 4 0 0 12 0 3 14 0 0 0 0 0 0 0 0 22 11 16 11 13 18 0 3 0 14 0 8 53 12 11 0 0 0 0 0 10 0 
0 6 30 0 4 40 4 1 0 0 0 0 0 0 0 18 7 0 0 5 0 0 0 6 10 0 11 3 0 13 0 9 28 21 0 6 3 0 0 0 35 0 
0 14 0 11 0 1 9 0 24 15 3 6 0 11 1 27 9 27 0 11 0 16 2 9 12 0 4 0 0 0 4 27 14 12 25 5 0 10 0 30 23 10 
0 13 0 0 10 43 0 0 0 0 0 2 16 0 4 0 0 0 8 0 20 0 0 6 0 0 8 0 9 24 16 26 2 0 0 0 0 0 0 0 20 1 
0 0 0 0 0 0 5 0 27 14 5 4 7 0 3 0 5 8 0 8 11 4 0 0 16 23 0 0 0 23 0 12 0 0 0 0 0 30 0 0 0 0 
65 2 10 0 0 23 0 0 2 0 0 8 4 0 0 0 0 0 23 0 0 0 2 4 17 0 7 27 16 0 16 0 0 0 0 6 0 8 0 39 7 53 
28 15 42 30 1 14 18 0 2 0 29 28 0 10 15 0 0 21 15 13 10 20 0 3 13 42 20 12 0 33 0 6 0 12 32 33 0 0 2 12 0 38 
19 4 0 0 18 4 0 0 2 0 0 3 0 0 0 0 0 14 0 22 0 0 1 0 0 0 8 13 14 7 0 14 0 0 0 15 0 0 0 0 0 14 
0 0 25 0 0 1 2 22 31 9 0 9 0 17 18 0 15 0 0 0 16 8 17 0 0 0 1 0 9 10 39 0 11 0 0 0 31 0 0 13 12 0 
6 43 28 25 26 16 31 9 0 0 42 5 11 0 3 0 46 10 0 0 0 33 9 17 23 10 15 0 1 0 0 14 0 0 20 0 30 36 15 0 24 6 
2 7 12 0 0 22 23 0 2 4 37 0 2 36 6 0 0 0 15 0 0 0 8 0 22 0 0 0 11 0 25 2 0 0 0 0 0 0 0 0 0 31 
0 9 33 0 0 0 12 0 21 0 1 10 31 0 0 20 25 0 20 4 9 0 0 24 6 7 3 8 0 0 4 0 11 0 0 12 0 25 27 21 0 0 
1 18 14 17 12 4 0 33 14 0 7 0 0 10 17 10 4 0 0 8 12 0 0 9 23 13 11 21 0 6 0 2 0 0 0 1 0 0 0 29 26 0 
