42 24
50 2 0 12 27 0 14 0 12 0 23 49 23 13 0 0 15 0 0 20 34 8 22 0 0 11 0 0 26 15 21 12 11 0 0 23 11 0 0 37 0 9 
37 0 6 59 37 16 0 0 30 0 0 0 0 0 5 0 3 1 4 8 0 22 0 17 0 7 0 13 0 20 9 0 33 1 16 0 0 40 0 0 37 37 
53 0 3 9 25 11 44 11 24 0 41 2 11 2 0 6 1 6 1 23 2 15 14 26 0 18 0 8 0 27 0 7 11 6 41 25 5 19 7 17 34 31 
0 0 0 0 0 17 0 0 0 13 13 0 19 0 0 0 9 0 0 0 0 5 20 19 0 0 0 0 13 14 2 0 0 0 0 0 7 8 0 16 17 3 
0 23 9 8 1 0 0 27 3 0 13 3 0 15 0 11 14 0 0 12 2 5 23 48 20 31 0 0 1 0 0 9 0 3 17 3 0 11 2 1 3 54 
3 25 3 11 0 12 20 1 12 0 3 0 0 9 0 0 4 12 14 4 0 0 1 0 8 22 5 0 0 10 0 0 22 0 13 0 13 0 0 14 0 0 
0 33 0 12 0 0 5 0 0 1 0 4 0 13 26 16 12 24 0 0 0 20 13 6 2 0 0 26 16 5 12 0 5 24 14 0 27 31 0 0 83 22 
11 0 0 22 0 2 0 0 0 10 1 0 0 9 0 18 10 0 6 11 4 4 12 20 4 0 25 0 10 20 0 2 10 23 0 0 0 0 10 0 0 0 
0 35 4 0 0 0 0 4 31 0 1 0 7 0 0 1 25 0 2 6 8 3 20 11 0 0 9 0 6 0 0 0 0 0 15 27 49 7 10 0 24 0 
0 17 19 25 0 56 11 10 0 0 34 0 0 0 0 0 1 4 24 7 0 25 0 15 0 0 8 6 1 0 11 16 0 0 2 12 0 12 28 0 35 6 
0 0 0 0 0 0 0 8 0 0 0 0 0 23 7 0 14 14 0 0 0 0 8 8 12 0 6 0 0 0 3 0 6 0 10 0 16 0 0 0 0 0 
28 0 4 10 2 0 13 20 30 15 3 0 9 12 18 0 0 14 0 0 10 26 6 9 0 3 5 24 59 17 2 0 7 33 0 9 0 28 48 0 0 7 
23 0 4 12 0 0 0 0 0 6 0 0 0 0 0 8 11 0 0 0 0 0 0 23 0 0 0 14 0 0 12 7 0 0 0 0 0 0 0 0 0 14 
38 14 23 5 0 3 11 0 5 8 9 0 0 18 0 0 0 13 7 0 12 2 0 18 0 15 6 0 2 19 10 1 12 0 16 0 0 5 58 10 1 15 
0 10 0 0 0 0 13 0 0 0 3 0 3 0 11 0 16 0 0 11 8 12 3 9 0 11 14 13 0 3 3 0 17 0 0 0 0 21 0 0 0 5 
19 0 22 34 0 0 0 0 5 0 0 33 0 18 0 19 6 0 16 0 0 21 2 5 0 21 3 14 0 29 0 0 6 7 19 0 0 14 6 28 44 14 
0 0 0 12 0 9 11 0 0 13 0 0 0 9 0 6 0 12 0 10 0 20 7 0 0 19 4 0 0 7 0 3 2 7 0 0 35 0 0 0 0 20 
15 81 4 0 32 6 5 0 12 0 0 33 23 0 0 0 27 9 0 0 4 15 12 10 11 0 2 0 0 41 3 10 6 32 34 62 35 0 27 0 5 27 
0 66 0 19 35 0 31 0 22 6 0 3 0 5 25 24 2 5 0 0 14 0 23 2 0 0 4 0 0 0 8 0 30 8 0 0 13 38 0 85 8 17 
0 0 0 4 0 1 5 30 22 29 26 6 13 15 9 0 0 13 1 0 3 0 0 13 1 21 9 20 13 5 24 17 0 0 17 7 0 32 29 15 0 20 
0 0 21 0 0 1 0 6 0 0 0 0 0 6 0 8 14 1 1 20 0 0 15 0 0 0 0 0 4 9 2 0 11 0 16 0 3 34 0 2 0 0 
0 0 0 0 8 30 0 0 24 11 15 21 8 8 0 2 0 24 1 20 17 12 1 19 6 15 14 0 0 0 2 0 23 0 1 30 10 7 18 20 15 24 
10 0 6 46 27 18 0 2 26 11 8 0 19 0 14 12 12 0 0 0 0 0 0 5 34 49 0 0 43 4 25 33 15 0 17 0 8 3 1 1 0 39 
21 0 0 10 0 0 0 0 0 0 23 0 28 0 0 24 0 24 0 0 5 0 7 0 13 15 0 0 11 21 0 0 0 0 0 0 0 35 0 0 13 23 
