42 24
15 0 0 4 20 3 10 38 13 15 0 0 29 25 7 0 2 0 4 19 0 0 0 0 1 25 1 1 0 13 0 21 0 0 0 0 4 0 37 3 45 36 
12 0 31 33 63 0 2 20 0 32 30 15 12 21 19 5 0 0 0 3 0 0 0 13 0 0 9 29 3 5 3 4 6 27 0 0 33 4 34 20 18 46 
1 14 29 0 26 0 18 0 0 0 26 13 0 0 37 14 14 18 0 0 14 0 16 0 0 3 0 0 0 0 21 44 32 22 15 1 23 2 0 2 26 0 
0 0 0 0 0 0 0 20 0 0 5 12 0 0 0 5 1 0 0 0 0 0 0 6 0 0 0 3 5 6 23 0 0 5 11 0 3 0 0 4 0 7 
0 0 0 0 0 29 9 9 0 0 0 0 0 0 9 0 10 0 5 1 0 0 22 0 0 16 0 0 0 0 0 0 0 0 29 1 18 0 0 1 0 35 
0 3 50 16 3 27 0 0 0 0 14 0 0 9 14 0 6 19 16 19 18 0 0 15 14 0 12 22 12 0 0 0 0 2 0 0 40 0 0 0 31 0 
0 0 10 7 5 8 0 0 0 12 0 0 0 4 6 5 8 0 8 9 0 0 9 0 7 0 6 3 13 5 2 14 5 12 0 16 0 7 0 2 0 0 
37 6 11 1 2 0 1 5 16 0 3 0 8 9 15 0 0 0 4 11 0 0 10 2 18 9 14 3 21 8 14 9 0 3 16 28 10 44 0 0 24 7 
0 20 39 0 0 0 0 6 0 0 0 0 0 1 6 0 0 11 0 0 0 21 5 0 0 2 0 12 7 3 13 0 6 0 0 5 0 0 21 18 13 37 
0 0 3 23 0 0 28 0 31 0 0 10 0 0 27 0 13 0 0 0 6 10 0 0 12 0 29 0 0 17 0 6 0 4 28 0 0 0 0 31 0 27 
6 0 7 11 23 6 52 22 0 10 18 0 15 3 1 5 4 0 0 6 14 0 9 0 3 0 6 31 22 4 8 19 16 3 5 0 0 0 24 0 0 16 
1 1 5 0 0 0 12 0 0 0 14 0 0 16 10 0 0 16 15 0 0 0 3 3 3 11 12 10 1 1 0 9 0 0 0 11 0 0 13 0 0 0 
40 0 38 12 0 20 5 6 0 0 0 0 28 27 0 0 5 0 61 0 4 5 3 0 2 17 6 0 0 11 3 0 10 0 0 0 24 19 20 4 28 19 
0 13 15 19 4 0 45 18 3 19 23 0 0 0 42 0 9 33 10 7 2 0 19 0 10 0 9 10 1 13 7 0 0 0 0 0 0 8 21 0 34 0 
0 0 13 31 0 8 7 12 0 0 12 1 5 6 4 12 13 3 19 0 0 0 0 0 5 0 23 1 13 0 7 13 0 7 4 0 44 14 0 0 9 4 
0 0 27 3 23 9 33 14 0 32 0 0 11 0 6 8 0 13 3 7 0 0 0 11 3 0 0 0 0 36 13 5 13 8 10 0 17 1 0 33 0 29 
23 0 10 0 28 0 36 4 17 29 37 0 4 0 0 0 9 15 12 25 14 0 0 0 16 7 7 28 0 9 34 0 2 7 7 10 0 6 11 19 3 0 
25 27 0 0 0 29 15 0 4 8 0 0 0 0 11 0 15 23 23 5 0 0 0 4 8 30 1 0 7 9 0 0 0 7 78 3 35 0 6 0 32 23 
4 19 5 0 20 5 30 0 0 0 8 0 0 0 0 0 0 4 2 16 20 4 2 0 34 4 5 0 8 0 0 1 0 12 4 0 30 0 0 0 0 0 
1 13 0 4 0 0 0 0 0 16 29 8 10 23 22 0 0 37 0 3 0 0 10 0 5 1 0 0 12 7 0 1 15 4 1 12 23 0 0 7 45 0 
0 0 0 74 0 0 0 17 6 0 22 0 0 0 7 26 13 0 0 5 0 0 0 29 5 0 0 19 0 0 25 5 51 0 0 32 0 25 0 0 0 31 
0 0 36 11 57 0 0 0 9 0 11 0 5 0 0 2 8 0 9 0 0 0 0 14 5 0 0 10 23 0 9 2 0 0 18 0 0 44 36 0 22 11 
0 0 26 0 7 0 0 0 0 15 0 0 28 21 15 1 1 0 0 0 7 0 0 15 0 7 0 9 27 0 0 0 0 0 0 9 1 0 3 0 59 8 
0 6 39 9 23 31 30 7 23 0 0 0 27 16 5 2 0 0 0 0 0 6 2 0 0 19 12 0 7 12 20 26 0 8 16 27 55 39 0 29 0 40 
