42 24
39 0 0 17 0 0 5 27 19 17 16 0 0 0 0 24 5 0 3 0 0 1 0 17 0 0 0 0 0 0 0 0 25 0 5 0 0 0 29 12 15 0 
0 23 0 36 0 0 0 0 41 22 0 3 0 0 0 0 19 15 2 3 0 12 0 0 37 0 5 9 0 0 27 8 13 0 0 5 25 0 29 0 12 32 
0 0 15 0 2 30 2 0 11 0 10 0 17 0 0 0 12 8 0 0 24 0 0 19 6 0 0 35 8 0 17 1 0 21 0 0 12 13 0 0 0 14 
0 1 13 9 0 47 0 0 0 0 9 0 9 0 0 0 2 0 30 18 0 10 1 0 0 0 0 19 0 0 25 26 9 0 0 15 4 0 0 0 6 11 
11 0 0 0 0 12 53 34 0 0 0 18 23 0 14 15 5 0 0 3 2 0 0 0 8 13 71 1 35 21 16 0 16 4 0 23 6 30 21 0 24 15 
0 18 9 0 0 0 30 2 0 13 8 0 4 21 11 24 0 0 6 0 11 19 0 14 0 11 0 26 16 0 0 0 11 0 21 34 0 14 32 24 39 0 
0 0 0 0 0 5 0 12 11 0 0 0 15 12 0 0 0 0 8 0 11 0 7 0 0 12 1 23 33 0 0 0 0 11 0 5 0 0 0 0 14 0 
3 0 25 0 0 3 6 2 1 0 10 2 39 0 0 15 0 0 16 11 10 0 0 13 0 1 0 0 9 0 25 0 6 20 2 13 13 0 18 0 0 0 
0 5 0 36 34 30 13 36 0 0 3 4 11 0 3 0 7 0 3 19 16 21 0 11 13 0 15 29 3 0 0 0 0 0 14 0 29 13 56 33 0 3 
0 24 10 8 0 26 22 0 0 26 0 51 23 0 0 0 6 0 0 16 0 9 0 0 0 19 0 0 25 0 1 0 2 28 0 14 25 2 0 2 10 0 
0 0 0 0 4 18 9 0 1 0 2 0 0 0 0 2 0 2 0 0 8 0 0 8 0 1 0 0 2 0 1 10 0 19 0 0 0 0 5 0 8 8 
12 0 15 4 3 3 27 1 33 0 15 10 22 2 16 0 3 17 28 18 12 5 0 0 17 0 15 3 0 0 23 0 11 4 17 25 0 29 20 3 30 51 
25 2 0 13 1 23 0 5 0 6 10 0 17 0 0 0 4 0 0 0 0 0 0 0 0 14 10 34 25 8 0 0 0 0 0 6 4 0 0 0 0 33 
0 12 0 39 0 0 19 6 8 0 8 0 0 12 0 0 0 9 0 0 0 12 1 0 0 0 23 1 1 26 7 0 0 11 2 0 14 7 25 29 0 5 
0 2 2 3 18 3 4 0 13 0 11 28 0 0 23 0 12 0 24 8 0 15 0 0 13 19 0 0 6 0 0 6 0 0 0 0 12 25 0 0 26 0 
0 10 23 0 13 11 11 6 16 0 26 23 0 4 2 0 21 16 0 14 0 8 12 0 7 29 0 9 0 0 0 0 0 24 1 18 32 0 11 0 0 0 
0 28 19 23 25 8 0 2 3 3 4 1 0 0 0 0 15 0 3 10 10 13 3 0 0 0 0 0 1 38 0 12 33 30 1 30 37 0 1 5 37 4 
0 0 17 8 0 3 0 0 25 24 0 0 14 28 0 15 7 0 0 13 0 0 0 28 0 0 14 5 11 0 5 0 13 67 0 0 0 0 1 0 0 28 
0 28 13 0 0 4 0 20 0 26 0 1 0 0 0 0 11 0 16 0 0 4 0 6 0 0 0 5 23 24 36 0 0 0 23 14 0 0 5 2 8 40 
0 4 0 18 3 11 15 22 17 9 10 0 11 1 3 9 17 16 33 9 0 22 8 15 9 13 20 12 0 15 35 0 41 9 22 5 0 0 21 12 10 15 
2 36 35 0 23 19 15 0 19 4 0 0 1 1 0 5 10 0 17 0 5 0 5 31 0 8 1 23 14 0 0 0 0 23 0 4 13 1 0 6 14 0 
0 15 4 0 0 0 9 0 0 0 0 16 0 10 0 12 15 0 0 0 10 3 0 38 3 12 2 13 16 0 10 0 9 14 6 0 0 0 6 0 0 0 
38 0 0 7 21 0 25 32 0 16 6 0 18 0 0 0 0 0 0 16 0 12 7 0 0 2 6 11 3 13 9 25 3 0 0 4 0 16 5 18 0 21 
3 10 0 25 1 0 13 0 28 0 22 0 0 46 36 2 23 21 0 3 1 11 20 15 11 0 27 21 0 0 7 23 0 9 14 11 74 27 0 49 0 47 
