42 24
0 20 56 0 32 0 0 0 36 13 57 0 0 0 0 11 9 0 0 17 4 1 12 0 11 0 11 2 20 2 0 0 21 0 0 0 15 40 0 39 30 0 
21 27 24 0 11 10 0 12 0 0 27 0 0 0 54 4 14 5 12 10 0 7 17 14 10 23 3 0 31 1 30 0 18 2 0 0 0 27 2 0 13 0 
42 0 18 25 0 0 0 10 3 31 0 0 10 23 0 0 16 14 0 13 3 10 0 0 20 0 44 3 25 0 1 0 6 1 0 0 10 0 0 15 45 0 
7 0 4 4 12 0 19 8 13 12 8 7 0 0 5 0 9 23 0 17 0 10 13 0 0 9 9 0 15 0 0 8 11 18 0 23 0 7 0 1 23 0 
67 0 14 34 0 10 0 26 0 0 0 25 23 0 6 22 20 0 6 0 6 0 22 0 0 0 0 0 0 46 1 19 0 42 0 0 36 12 0 18 19 0 
8 26 4 0 3 0 15 0 11 21 3 26 0 0 19 3 4 7 12 4 5 20 0 0 30 5 6 11 0 0 6 0 0 0 14 20 5 19 11 0 0 2 
25 0 77 34 35 10 0 0 28 2 11 20 0 10 0 27 8 27 10 28 3 4 28 15 14 28 15 21 15 9 24 0 0 31 0 3 3 24 71 54 38 19 
0 0 19 0 0 0 31 0 0 10 0 0 0 0 1 29 3 21 0 13 0 5 13 0 1 0 6 3 1 1 0 0 9 0 0 0 0 31 21 24 21 0 
3 1 60 3 0 7 24 9 0 15 23 16 0 14 3 8 16 13 0 17 3 0 18 14 0 15 3 1 51 0 0 0 0 0 2 33 32 0 45 28 17 0 
0 0 12 0 0 0 7 0 0 0 0 0 0 20 0 0 0 3 0 15 11 0 0 0 0 0 0 0 9 0 0 0 0 20 14 3 24 0 0 13 0 3 
19 0 1 0 26 0 7 33 25 3 25 2 0 0 19 9 18 0 4 16 6 0 13 6 1 1 6 8 0 0 10 0 10 13 18 0 11 0 0 0 34 0 
0 0 7 34 0 2 0 0 0 0 8 23 0 6 3 0 0 0 3 4 3 5 0 13 11 0 12 2 4 2 0 0 5 0 54 9 13 11 9 0 0 0 
0 3 5 0 0 9 29 5 42 0 0 27 15 14 7 9 10 0 30 0 0 4 0 5 0 0 2 33 0 0 19 0 0 0 0 29 3 40 0 10 32 0 
9 0 4 33 4 0 0 49 6 0 0 0 0 0 7 0 0 5 0 0 0 0 0 0 3 1 8 7 0 0 0 0 5 0 0 4 37 30 11 0 0 0 
0 30 0 0 0 10 0 11 12 2 15 0 0 3 0 11 4 0 0 0 0 0 5 22 1 9 11 0 17 5 12 3 0 0 0 0 0 0 0 0 1 1 
0 0 0 0 0 12 3 0 0 12 43 2 0 0 0 0 19 0 12 6 1 0 1 23 9 0 2 0 2 0 12 21 0 0 9 0 13 11 0 27 0 5 
0 0 0 0 0 1 7 0 16 2 0 19 7 10 0 0 15 0 5 8 11 9 6 5 0 6 14 0 0 0 30 0 5 0 0 2 0 6 0 1 6 0 
0 31 3 0 0 0 0 18 1 35 0 20 0 0 0 11 0 24 1 7 11 0 0 0 0 0 11 0 4 13 0 31 27 2 4 2 0 0 13 5 31 24 
17 0 82 0 0 10 45 33 0 20 2 0 0 27 6 0 4 21 17 12 19 0 14 4 16 5 4 13 33 13 0 0 32 22 0 8 31 23 0 19 33 13 
20 0 21 0 0 0 0 0 0 0 0 0 0 0 0 0 18 0 1 0 20 5 2 0 19 4 17 0 8 13 9 0 5 0 0 7 0 3 0 0 0 0 
0 20 25 0 0 0 19 33 0 0 21 18 0 0 0 13 0 4 8 0 0 10 0 0 0 0 14 14 12 16 19 4 0 7 0 0 19 0 2 0 62 5 
32 0 36 0 17 5 0 0 21 15 0 15 1 0 16 9 0 0 8 12 8 12 3 0 15 0 16 21 1 21 11 0 2 1 24 1 11 37 37 14 14 25 
15 9 9 0 22 0 0 0 0 14 0 0 40 10 24 0 1 0 0 16 0 0 0 0 0 0 31 12 16 0 21 0 8 17 50 9 12 13 24 9 8 39 
0 0 0 0 0 0 0 21 0 23 0 0 22 1 5 0 0 3 0 21 3 0 0 0 0 35 0 0 21 0 17 0 23 0 2 0 0 0 0 0 40 29 
