42 24
48 33 13 18 4 0 20 0 0 4 0 21 0 32 0 15 0 17 0 27 19 3 33 22 3 37 0 0 0 0 0 54 20 16 18 15 21 0 0 0 4 7 
20 12 9 0 29 24 12 3 0 17 49 0 7 0 16 23 0 3 14 8 0 23 0 0 0 0 5 33 26 67 30 6 21 29 14 6 0 18 40 0 0 0 
5 0 19 2 0 2 19 59 0 2 12 0 0 6 5 0 9 20 19 0 12 0 4 0 0 0 3 0 21 19 18 5 0 39 0 0 12 1 0 0 0 0 
1 0 0 16 21 14 6 29 0 0 29 0 0 0 0 9 0 0 0 17 3 0 0 3 0 21 3 0 9 0 0 0 0 0 19 5 29 8 0 0 35 22 
1 37 15 0 0 35 0 29 0 32 1 0 0 26 0 6 20 0 18 0 14 16 19 0 0 0 0 0 2 8 31 25 3 8 0 26 83 0 0 9 20 2 
9 13 0 0 0 0 9 8 22 0 0 8 17 0 0 0 10 10 7 0 14 14 0 0 0 0 18 0 4 0 52 0 0 0 0 0 0 0 38 0 0 10 
1 7 0 12 2 0 0 28 45 3 24 15 14 0 0 19 29 0 0 0 3 16 0 19 2 2 15 14 0 12 0 1 24 13 43 34 28 16 1 10 0 22 
5 34 30 37 0 0 0 20 0 0 16 4 8 1 27 8 0 0 3 0 3 0 0 0 0 0 10 0 0 0 29 6 0 19 20 21 0 0 1 0 37 5 
0 14 28 7 5 25 0 13 34 6 0 14 1 2 0 10 9 0 0 24 0 0 0 0 11 3 0 0 0 24 28 0 0 0 26 0 0 0 11 0 0 0 
7 10 8 16 0 3 0 19 11 0 14 7 18 0 0 5 0 0 15 11 1 0 0 0 0 0 11 5 27 9 15 34 5 0 0 11 11 0 2 0 0 4 
0 71 0 9 0 28 0 19 0 0 15 8 0 0 25 5 4 1 22 0 1 20 8 12 0 4 19 0 9 9 0 0 0 28 5 11 31 45 12 30 0 47 
0 0 17 0 24 0 25 21 43 0 0 30 0 6 4 0 19 10 5 37 6 0 6 4 0 9 1 0 31 45 0 20 0 8 9 15 0 2 0 0 32 3 
0 39 0 0 0 0 1 0 0 0 23 0 0 0 5 0 14 0 10 9 0 0 0 15 0 17 0 0 29 5 11 0 0 23 3 0 0 0 25 0 5 5 
0 47 13 0 19 14 2 0 3 0 0 0 0 0 11 0 0 7 0 2 3 26 18 48 1 0 0 5 9 8 0 0 39 0 0 11 12 8 0 0 41 40 
31 32 0 24 2 28 0 2 0 8 3 20 8 31 0 25 8 0 0 0 12 0 0 0 0 12 0 51 0 5 0 35 0 4 0 0 16 1 0 0 25 28 
33 8 0 0 0 0 15 11 0 14 0 0 0 0 0 6 10 8 16 0 0 0 0 0 0 8 26 3 3 0 3 0 0 13 8 11 0 0 0 0 0 0 
0 17 0 0 0 0 3 31 11 0 0 7 0 0 15 9 0 20 0 16 0 0 16 0 10 0 0 2 0 2 0 0 0 0 0 16 0 22 31 10 0 40 
26 0 29 0 0 0 0 5 0 5 0 0 4 0 12 25 0 7 0 7 0 0 17 0 7 0 50 2 0 7 16 12 0 5 3 0 0 0 0 0 16 0 
42 13 0 46 10 0 12 12 0 17 17 0 0 0 6 0 3 0 20 1 14 5 15 5 3 22 11 3 3 1 0 0 0 13 11 0 9 0 52 0 37 0 
2 10 14 18 34 18 0 33 0 0 0 0 18 0 9 0 0 4 8 14 6 36 12 18 8 18 38 0 0 7 18 0 7 0 5 0 43 0 23 0 21 18 
7 12 57 67 0 6 19 12 4 31 27 0 13 28 7 13 0 14 0 0 13 8 0 0 4 19 11 3 0 8 31 20 29 1 18 11 50 20 29 32 0 66 
0 9 29 0 55 1 9 6 0 6 0 5 0 0 10 0 10 0 8 0 8 0 6 8 0 0 8 0 16 52 42 0 0 3 0 0 32 18 8 17 0 1 
8 0 28 0 0 0 51 39 33 1 9 0 33 17 0 5 0 0 17 22 0 0 1 6 12 0 39 1 25 0 45 5 0 32 29 20 0 13 19 0 10 44 
15 21 0 34 15 0 50 0 0 3 14 19 0 0 22 15 0 0 0 15 0 4 38 0 3 19 0 7 0 15 21 19 6 0 10 0 26 18 0 0 0 12 
