42 24
0 12 44 14 8 7 14 27 26 52 0 0 0 0 0 0 0 0 16 8 14 0 11 0 12 0 6 18 1 0 0 2 4 17 8 0 0 11 20 0 38 0 
0 3 52 28 0 0 0 9 0 0 0 0 11 0 0 3 9 0 0 10 0 0 0 11 0 17 0 14 0 4 0 58 0 0 0 12 0 0 0 37 0 14 
0 0 20 0 34 0 0 0 0 3 0 0 0 23 19 0 0 0 15 0 0 12 12 23 0 18 0 0 3 8 0 0 0 23 12 2 6 6 31 4 15 8 
0 6 7 0 27 0 0 0 0 18 0 0 0 12 0 0 0 0 0 32 0 0 15 18 0 16 0 28 5 0 5 27 0 0 0 0 1 16 12 0 0 3 
36 0 32 38 0 0 33 0 0 0 46 21 12 9 0 3 1 3 0 0 0 0 19 0 8 14 0 10 16 0 49 41 4 0 34 25 40 0 16 34 0 0 
0 0 0 26 0 0 18 0 0 28 0 0 0 0 26 2 0 2 13 18 0 0 0 0 0 10 0 0 14 15 0 13 0 0 0 0 15 0 0 0 47 0 
0 20 17 6 0 0 39 33 30 10 30 31 6 0 7 0 0 18 0 7 19 11 4 0 14 0 0 4 0 0 27 4 6 0 10 0 0 12 5 61 32 0 
40 0 26 32 0 10 0 2 0 21 0 7 0 10 15 16 0 0 2 1 43 4 0 8 2 0 0 0 34 12 21 15 15 0 2 12 0 17 0 0 51 0 
19 0 26 7 23 0 0 0 19 0 7 7 3 13 0 0 9 4 0 27 6 28 6 0 0 16 22 19 24 1 1 10 4 5 13 0 15 0 0 2 0 26 
40 0 7 3 30 8 0 4 0 0 8 0 9 0 0 21 15 3 13 6 0 0 5 14 1 0 8 0 9 2 3 7 6 0 30 0 9 0 5 0 40 0 
0 15 15 0 0 0 0 0 0 0 0 0 0 0 11 0 22 0 0 2 0 17 18 0 0 11 0 1 1 0 5 9 0 0 1 0 14 0 0 0 0 27 
26 0 24 0 0 17 0 24 0 0 0 0 3 0 15 14 0 3 19 5 0 4 0 4 0 5 10 22 0 2 0 26 4 0 13 1 0 7 0 0 0 0 
11 12 24 3 0 0 30 0 27 24 8 0 0 5 10 0 2 9 8 0 0 0 0 3 4 1 16 1 0 0 10 0 33 24 0 1 0 5 23 0 7 6 
5 0 4 0 1 2 5 17 27 0 34 17 9 0 0 0 10 22 6 0 0 21 4 0 17 0 0 4 17 0 13 0 0 0 3 27 15 0 28 0 0 14 
5 53 19 14 1 27 7 6 0 0 6 18 29 26 6 0 10 30 0 13 9 36 26 0 16 0 15 3 11 15 0 0 24 12 34 0 10 0 3 11 53 49 
0 0 1 31 26 2 0 30 0 0 0 2 0 1 3 0 10 14 0 7 0 19 0 23 0 10 4 0 2 22 21 15 24 0 6 9 10 12 0 2 0 40 
0 4 34 0 0 0 0 9 20 0 0 0 11 0 0 38 14 20 0 7 23 19 5 0 0 0 0 0 18 7 0 16 8 0 0 0 14 37 18 0 19 0 
34 35 16 0 0 32 5 0 2 0 7 24 5 0 0 0 2 22 0 14 0 0 21 0 0 0 0 6 0 0 0 4 10 6 51 12 0 32 0 0 0 40 
30 4 0 21 0 7 9 7 0 0 0 9 8 8 3 4 0 9 4 0 8 12 2 0 11 19 0 39 4 6 2 0 24 6 1 1 16 20 6 9 0 41 
0 0 0 3 26 5 0 0 0 0 8 14 4 0 0 2 20 0 10 3 0 0 0 4 0 2 0 7 19 5 27 6 0 19 11 0 8 0 0 15 0 0 
0 27 32 20 31 15 42 32 0 0 12 5 5 28 0 20 0 6 7 0 9 16 29 0 0 0 24 2 0 3 24 23 0 27 0 4 14 0 1 29 36 42 
0 0 0 0 2 0 8 22 27 5 10 0 0 13 13 2 7 0 0 0 15 23 0 2 9 0 14 0 0 22 0 0 0 0 11 36 12 0 0 4 0 6 
19 44 15 25 28 4 27 2 0 22 0 10 0 0 0 0 0 9 31 33 3 0 27 14 9 24 5 11 0 7 0 15 28 20 0 0 18 0 11 37 0 19 
29 0 38 0 2 0 18 0 0 0 0 0 18 5 11 0 0 3 14 18 11 0 0 14 0 0 5 7 0 16 0 10 0 0 29 0 0 0 0 0 38 0 
