42 24
107 0 24 0 34 18 23 34 0 1 44 0 16 0 21 0 35 2 0 19 20 17 5 16 13 26 15 7 4 36 0 22 0 0 0 14 0 13 90 38 0 87 
0 16 31 0 10 18 2 2 0 5 1 3 15 4 11 0 31 1 0 0 0 8 12 34 9 0 19 0 0 16 17 0 6 18 0 8 15 0 18 0 0 0 
4 0 0 0 3 0 13 3 0 0 19 23 27 0 72 11 8 14 0 2 0 20 21 0 20 2 20 0 2 4 0 14 26 4 34 2 0 0 0 2 0 0 
36 15 9 3 50 3 1 24 18 3 8 9 0 28 15 18 11 0 0 0 10 39 0 0 0 0 3 22 24 11 7 0 0 48 0 6 0 0 0 0 15 2 
11 0 0 29 0 0 21 34 5 21 16 0 10 12 18 25 8 6 0 0 11 0 0 4 42 5 4 9 0 0 2 15 31 0 19 11 0 0 0 0 16 46 
0 0 0 36 0 18 0 0 0 30 0 0 0 0 3 0 0 48 0 0 19 2 5 20 0 0 0 0 0 0 10 0 0 0 0 18 0 0 3 47 10 0 
2 0 17 0 0 25 5 0 0 8 0 2 8 0 0 6 16 20 26 0 6 0 11 14 17 0 0 8 0 11 25 6 9 15 5 4 12 61 18 0 0 0 
0 0 29 14 0 27 12 32 13 0 0 29 0 0 6 1 8 14 0 5 0 0 2 13 2 8 12 13 21 3 2 29 8 2 0 9 0 0 3 0 16 0 
15 0 31 1 0 0 16 5 8 0 21 6 7 3 9 4 9 26 0 0 12 26 22 10 10 0 0 5 32 0 0 8 12 14 0 0 19 16 0 0 0 8 
37 40 1 0 6 25 9 5 1 9 2 0 14 0 0 6 0 15 18 13 17 0 0 0 0 2 14 8 0 0 16 7 0 20 7 32 4 0 4 0 6 1 
0 0 3 0 0 65 0 0 5 11 2 11 1 1 13 17 8 1 0 0 25 0 21 18 0 0 0 13 4 0 1 1 2 12 19 19 0 0 3 0 0 10 
24 0 5 40 0 0 16 16 5 5 4 5 16 12 14 12 0 0 0 2 1 23 12 16 0 0 0 2 11 2 0 28 26 9 0 9 0 0 17 32 0 0 
8 0 28 8 7 6 5 0 0 2 19 14 23 0 1 4 0 7 22 7 0 0 15 0 0 5 0 4 0 0 26 5 0 0 7 25 0 12 0 0 6 8 
9 0 16 0 22 26 0 0 0 0 13 23 0 0 0 11 15 13 0 4 4 0 22 0 0 0 0 3 10 7 13 5 0 4 19 0 29 15 0 0 12 36 
0 0 0 0 0 21 8 5 0 13 0 23 31 0 0 11 0 9 9 11 0 2 3 0 8 13 21 9 0 0 21 0 0 6 23 0 0 7 0 0 0 11 
23 10 60 8 2 0 13 0 0 0 3 2 0 0 0 0 0 2 0 12 0 1 12 27 22 0 0 0 17 0 0 0 0 0 0 0 0 3 6 0 38 0 
0 15 0 22 0 16 0 0 1 1 0 5 7 12 0 21 0 0 10 6 0 0 0 15 15 35 12 12 10 0 0 1 0 0 0 0 6 0 0 15 0 12 
73 0 0 0 36 6 0 0 0 0 0 16 12 0 0 0 0 2 0 0 0 16 11 0 0 25 0 0 0 0 0 5 11 0 0 3 36 0 34 0 0 0 
0 4 53 1 22 17 0 5 8 2 6 0 3 0 11 6 12 15 11 33 12 8 10 8 8 0 0 5 18 0 17 0 55 2 0 2 0 35 0 0 23 0 
33 4 21 0 0 1 12 0 55 26 1 0 3 0 0 4 18 6 0 0 21 0 0 21 9 0 0 0 2 0 8 0 0 9 25 8 34 0 0 0 0 41 
57 12 0 8 19 1 11 0 1 0 0 0 0 12 0 0 0 15 7 0 0 18 0 0 5 7 0 27 0 0 0 0 0 4 10 18 0 0 43 18 0 8 
27 1 16 14 35 46 2 18 22 22 19 14 3 10 44 11 0 11 16 21 0 0 0 0 0 0 1 20 0 0 0 27 4 11 3 23 27 7 6 24 0 0 
25 47 0 18 3 45 11 28 0 8 0 22 0 9 18 0 16 12 0 0 0 57 7 0 33 24 5 0 11 23 0 6 0 4 30 28 0 0 47 0 7 16 
0 7 17 0 15 3 0 22 0 8 0 22 0 0 21 0 0 0 0 35 0 20 21 0 3 0 0 5 0 22 14 0 0 27 0 0 2 0 3 20 0 0 
