42 24
0 19 32 0 23 1 30 0 0 8 4 0 0 8 5 0 4 4 17 0 13 0 8 0 4 0 9 0 0 5 0 0 5 1 47 0 0 6 24 5 0 0 
17 25 18 2 0 1 1 32 16 11 0 0 20 0 0 3 0 0 38 0 33 0 4 12 32 0 0 1 11 0 12 0 3 1 0 9 0 20 20 32 0 0 
0 0 0 0 0 0 0 8 0 0 0 2 0 18 0 6 10 0 0 4 0 0 16 0 11 3 0 0 0 14 3 7 0 14 0 0 0 0 0 0 0 28 
24 9 0 0 0 0 0 0 0 0 0 12 10 0 2 0 0 0 10 1 20 0 0 0 24 0 0 9 0 0 0 0 0 0 0 0 0 1 14 0 0 7 
0 0 0 44 40 0 0 4 0 11 8 9 3 0 0 4 0 14 0 0 6 0 18 8 0 12 33 19 14 0 0 14 4 0 1 6 62 0 0 2 33 9 
0 5 35 22 8 0 0 15 0 9 0 3 13 6 3 19 24 0 4 6 4 20 9 1 4 4 0 0 1 13 12 16 31 0 19 0 0 24 15 15 24 0 
0 0 0 19 11 7 17 0 0 0 0 23 10 0 0 7 0 0 6 0 12 13 8 15 18 0 1 0 6 27 0 0 2 0 39 0 0 10 0 2 4 35 
8 0 0 3 17 0 8 0 12 0 0 41 0 3 0 0 12 31 0 11 9 7 11 0 10 5 22 0 0 3 23 0 28 29 9 0 0 0 5 20 0 20 
0 8 0 4 0 34 0 0 11 12 0 2 70 2 9 0 14 0 20 0 10 0 0 9 0 0 22 9 17 20 2 0 10 25 0 0 8 28 5 15 0 31 
1 0 31 0 0 1 0 0 0 0 0 19 0 0 11 0 0 15 0 0 0 0 0 0 12 11 8 0 8 4 20 3 15 49 13 0 26 0 11 0 0 0 
3 39 63 0 22 4 51 0 12 17 30 2 27 21 10 33 1 48 8 0 13 14 2 17 14 7 7 33 11 6 10 0 15 3 0 7 0 5 5 48 92 73 
0 1 0 18 12 4 0 11 4 9 0 8 18 24 0 0 13 0 3 27 11 0 0 0 12 0 2 3 2 5 12 0 4 0 37 16 12 24 19 8 0 0 
0 9 4 0 1 1 3 0 7 42 15 0 15 4 6 0 10 9 0 0 7 8 5 0 0 0 0 4 0 0 2 1 0 12 0 0 0 28 0 30 0 0 
6 0 0 0 20 7 0 0 19 26 2 24 19 0 0 0 12 3 0 0 0 0 1 1 10 0 9 0 3 0 0 14 24 3 25 37 7 0 0 0 0 0 
0 0 6 1 2 0 0 5 50 18 0 0 0 0 0 0 0 0 0 0 1 12 0 0 0 0 5 19 0 6 1 0 0 0 0 0 3 0 0 31 0 0 
7 12 2 11 0 4 16 0 0 0 41 11 21 9 0 5 0 0 2 9 1 0 29 0 0 0 0 0 7 0 0 2 0 31 0 0 0 0 5 0 0 31 
0 8 5 2 51 0 0 20 3 0 0 0 10 5 0 1 11 14 0 0 15 0 0 7 1 33 0 0 2 0 2 11 25 0 6 0 0 21 0 0 36 0 
31 38 18 0 8 0 15 1 0 3 24 17 0 0 7 9 3 10 3 0 3 1 7 0 11 20 15 6 1 11 6 44 0 0 24 0 24 0 38 38 0 0 
33 25 8 0 29 0 18 15 6 7 33 9 0 0 9 1 15 0 23 0 22 8 6 27 9 24 16 17 0 0 0 0 10 29 0 0 0 0 4 0 0 23 
0 0 13 0 0 46 19 5 11 7 0 0 3 17 0 6 10 1 2 0 4 0 10 1 8 0 4 14 0 0 29 0 14 0 29 9 0 0 0 19 8 0 
32 2 31 10 35 20 4 15 0 21 21 5 0 7 0 7 3 13 0 18 16 0 3 6 0 20 13 17 6 0 0 29 49 0 0 0 38 0 26 30 0 30 
0 11 0 0 1 4 32 6 30 18 0 0 33 24 0 0 2 11 19 0 0 0 13 7 7 16 2 0 0 0 5 8 0 0 0 0 11 0 30 0 0 0 
23 17 0 0 5 0 15 0 16 0 0 28 11 0 5 11 21 0 20 0 37 15 0 0 16 11 9 1 16 8 0 3 2 0 22 10 5 9 2 43 15 4 
20 26 0 0 62 0 0 0 0 0 0 13 0 0 0 0 17 0 14 0 23 0 3 0 11 25 6 18 7 17 0 0 8 23 0 0 0 0 0 13 36 41 
