42 24
0 0 0 39 0 0 22 0 0 19 0 0 0 0 2 0 0 20 1 28 0 0 0 0 0 46 6 0 22 16 0 23 0 14 0 4 0 10 2 26 3 2 
22 15 0 0 0 0 11 0 14 0 59 6 0 18 2 0 7 3 0 6 33 0 33 0 21 2 4 2 0 7 21 23 5 0 0 1 27 8 43 16 10 2 
25 46 0 0 5 13 10 8 0 14 30 19 3 0 8 17 0 19 0 28 0 19 0 6 35 10 5 12 7 8 8 5 7 0 10 10 30 1 12 0 0 7 
11 0 36 0 7 0 6 11 0 3 0 16 0 6 5 2 0 0 12 23 0 0 15 0 0 0 0 0 0 1 0 2 0 0 1 0 0 0 0 4 1 2 
0 0 0 0 0 13 11 0 0 19 3 0 19 1 0 0 8 10 4 5 16 3 0 13 13 0 6 0 0 5 0 0 0 0 4 0 2 0 0 0 14 0 
4 0 0 0 0 0 8 7 0 17 0 22 0 0 8 0 29 10 19 3 0 0 0 0 0 9 11 0 12 0 17 14 5 22 0 18 4 24 18 0 0 5 
0 19 0 1 0 16 0 0 0 0 0 12 0 7 0 16 0 11 0 0 31 26 0 0 0 0 4 0 15 0 9 0 0 0 4 0 7 0 0 14 6 5 
23 24 0 1 3 2 16 22 0 7 0 20 10 11 9 0 16 2 4 1 0 8 7 6 0 13 16 0 14 0 16 2 20 26 12 0 24 31 37 43 18 8 
0 23 0 23 0 15 20 8 0 8 11 15 24 7 28 0 6 12 0 14 34 14 0 1 8 8 45 0 27 27 4 2 0 8 4 0 14 0 3 3 0 11 
27 0 0 14 19 0 6 0 5 0 1 7 1 25 0 0 20 12 0 0 13 0 0 19 0 0 0 0 3 9 17 7 0 0 0 0 13 1 9 9 0 10 
43 8 2 22 0 29 0 0 8 0 1 0 13 0 8 0 0 10 0 14 0 23 0 0 0 35 13 9 0 0 6 0 0 14 25 0 5 37 0 0 0 5 
0 11 21 12 12 0 0 11 0 0 1 16 6 8 0 13 0 0 0 0 0 0 0 20 7 0 5 23 0 0 0 7 0 0 0 32 0 0 0 11 0 10 
0 44 0 25 0 0 0 42 0 16 26 12 5 5 38 8 7 0 12 16 10 20 9 0 16 5 7 0 21 5 17 5 25 1 2 18 27 11 0 1 20 0 
0 0 0 0 0 13 0 22 37 13 29 8 0 0 15 0 0 13 5 0 12 0 0 0 0 4 1 0 0 11 0 2 13 34 0 0 0 12 0 30 0 0 
11 3 0 0 0 17 19 31 0 2 3 6 17 7 0 0 6 19 10 15 18 7 9 0 0 19 16 7 16 23 27 0 17 25 7 0 0 0 37 23 0 0 
5 0 0 0 13 11 0 0 0 0 0 3 7 7 2 25 3 24 12 0 14 0 0 0 0 0 0 0 0 0 0 0 0 0 34 16 0 0 0 0 27 1 
0 0 75 0 34 0 14 26 0 14 4 11 0 23 0 0 0 0 4 8 5 0 0 0 0 11 15 5 0 35 23 0 5 0 7 0 13 4 19 37 38 0 
0 5 0 17 24 13 5 12 7 31 0 0 27 47 7 7 7 8 0 19 1 2 0 13 0 7 6 0 42 0 0 0 7 18 13 6 0 3 0 37 32 7 
0 10 0 3 12 14 14 56 24 0 0 8 0 0 0 0 28 0 1 57 42 0 0 14 0 0 0 9 0 21 12 0 24 0 2 0 0 9 0 9 19 0 
27 0 16 0 0 0 0 0 0 0 0 1 0 0 0 0 7 6 0 2 0 5 0 6 3 0 15 9 0 2 0 14 0 0 0 0 2 2 0 13 0 0 
1 40 4 0 8 0 4 11 0 12 5 0 8 13 23 20 13 1 31 20 0 1 1 0 6 0 19 0 0 19 10 0 0 0 2 3 0 23 0 9 0 40 
0 28 35 3 1 0 9 1 0 3 0 44 7 0 8 15 0 6 10 14 13 31 35 6 0 17 1 5 5 12 41 11 0 0 0 6 7 38 0 20 25 66 
0 0 0 0 0 0 13 10 0 0 0 10 19 0 15 0 0 30 0 39 13 12 0 0 24 0 9 0 0 0 12 0 0 0 0 5 0 0 0 20 0 0 
22 20 17 0 33 3 16 18 23 19 21 0 1 6 0 0 22 0 3 0 0 23 38 0 4 19 6 0 4 5 0 29 0 0 7 3 0 17 21 11 8 0 
