42 24
1 18 58 1 8 15 27 17 19 0 0 0 46 0 0 0 3 11 0 0 14 34 1 0 0 9 0 0 0 0 18 0 0 0 32 0 20 14 0 37 0 0 
0 22 0 0 3 0 0 0 12 0 9 0 27 13 0 22 0 0 19 31 2 18 21 6 14 0 0 0 7 0 0 28 0 9 0 20 21 43 0 29 0 0 
0 0 3 31 0 10 0 0 14 6 15 1 38 15 0 12 3 7 13 1 0 0 13 0 17 29 0 12 0 24 0 0 9 30 0 0 11 11 0 21 0 8 
0 1 8 0 3 20 0 0 29 0 0 14 0 19 0 16 0 1 1 3 10 2 0 0 0 26 0 0 0 0 0 16 49 4 0 0 27 29 1 5 11 0 
27 18 18 48 13 0 16 0 0 11 0 2 0 9 0 0 22 0 14 0 11 0 3 5 13 3 12 7 8 0 5 0 0 7 0 0 0 1 37 0 7 0 
29 17 0 16 9 0 0 0 11 14 9 0 15 37 0 0 7 0 17 20 0 7 0 0 0 7 0 5 7 29 0 0 12 1 11 15 2 0 7 0 0 28 
0 0 18 0 3 0 0 32 0 2 11 2 8 0 0 0 12 6 6 15 22 0 0 1 1 0 0 3 0 0 0 5 11 1 0 61 30 0 0 0 0 0 
31 1 8 0 0 1 10 6 0 23 10 0 2 0 0 0 10 0 0 0 15 7 7 19 0 0 0 13 0 8 0 40 28 0 0 2 13 7 15 0 0 0 
16 1 10 61 18 0 11 0 0 11 27 45 0 0 0 0 16 8 0 16 17 0 12 0 13 14 21 0 0 18 0 28 0 23 0 14 14 61 5 1 8 30 
31 0 13 37 0 0 25 4 8 6 0 0 24 0 0 52 0 7 0 0 0 2 9 17 0 0 0 34 5 20 19 31 0 13 0 0 42 0 5 0 31 8 
11 0 0 8 0 8 0 34 0 0 0 0 0 0 3 0 0 3 0 14 0 0 9 0 14 0 0 12 0 13 7 9 5 0 0 3 3 0 23 12 0 34 
11 31 0 0 59 0 1 11 0 0 6 8 6 0 17 0 14 0 13 0 7 18 12 11 0 7 25 1 4 17 0 3 31 11 6 19 0 19 0 14 8 0 
30 5 0 0 7 3 6 17 0 0 10 9 1 9 4 0 20 16 0 3 12 12 28 8 26 9 0 1 17 29 12 21 27 23 0 0 20 0 15 0 10 23 
16 0 27 0 0 0 0 2 15 7 24 0 5 9 9 0 27 0 6 0 8 0 11 0 0 9 0 15 0 5 1 1 0 0 14 37 53 11 0 0 0 0 
5 10 0 0 0 10 0 0 0 7 1 1 25 41 0 0 0 7 8 0 0 0 4 0 0 15 4 0 0 16 0 0 0 0 0 0 9 11 0 0 19 0 
0 39 37 0 2 3 24 0 10 3 0 9 0 0 0 0 0 0 0 11 0 19 9 0 2 0 0 21 0 5 2 0 0 0 0 0 6 0 0 0 45 0 
7 28 30 51 3 19 12 3 5 20 0 28 5 5 10 10 0 0 10 15 4 28 13 0 15 23 3 26 0 6 0 18 41 0 20 0 22 12 8 6 40 0 
0 25 0 13 30 10 0 1 0 4 12 0 19 0 0 0 0 0 12 0 24 20 7 11 1 10 5 3 0 36 6 0 25 0 0 10 0 8 0 0 19 0 
0 6 4 0 8 4 1 0 0 0 12 0 32 0 33 0 14 12 19 3 17 0 12 3 0 0 0 0 6 15 29 0 18 0 6 2 11 1 0 21 18 0 
0 40 0 20 23 1 12 2 22 14 0 0 25 61 8 14 0 0 0 0 1 16 0 10 0 3 0 0 0 14 0 0 12 7 36 18 0 25 25 26 0 47 
5 0 0 0 7 19 0 0 0 3 0 8 19 0 0 4 0 0 0 0 13 0 23 8 0 0 0 16 0 11 19 19 1 0 0 17 3 0 0 19 7 0 
34 0 17 13 9 0 0 33 0 0 0 0 20 1 0 0 1 27 0 0 18 2 0 26 0 25 0 7 11 25 4 0 1 0 0 28 13 1 0 0 0 0 
0 13 22 18 0 6 7 12 12 11 11 23 6 44 17 0 0 0 0 1 0 19 10 0 7 3 5 60 15 17 2 22 3 12 23 4 17 0 24 0 9 11 
8 0 27 1 0 0 9 0 0 21 0 11 9 0 0 9 0 0 0 0 11 3 0 0 0 0 0 0 20 15 0 0 0 0 0 10 0 9 0 21 0 12 
