42 24
0 0 17 67 0 14 3 0 0 45 23 3 1 8 0 17 10 8 0 25 16 0 31 0 0 14 0 0 0 0 0 0 17 23 31 2 16 11 0 0 16 32 
4 0 9 34 0 2 0 7 0 6 2 0 25 0 21 5 3 0 11 3 0 16 0 16 0 0 0 0 0 19 30 0 0 0 0 2 0 22 0 65 0 0 
14 10 0 0 0 4 14 31 10 1 3 0 7 0 8 0 0 0 0 2 0 18 6 0 17 2 4 25 37 0 25 0 0 0 0 0 11 10 30 18 0 0 
52 0 15 2 0 5 4 0 4 0 14 22 0 0 0 13 14 45 15 0 0 0 0 10 0 26 0 0 14 0 0 0 0 6 23 4 25 33 1 0 0 16 
0 28 0 18 0 0 2 0 1 0 27 16 0 0 1 25 2 9 4 3 0 0 4 0 15 10 5 7 12 40 7 0 8 0 0 10 9 20 19 32 19 40 
10 31 38 0 10 4 36 0 1 0 20 0 6 0 0 1 21 10 0 19 0 0 0 0 0 19 9 0 27 0 12 3 12 0 0 6 0 21 0 3 35 0 
3 2 0 19 24 13 0 29 0 0 0 8 0 0 0 30 0 14 8 14 0 0 7 2 7 0 0 1 16 0 0 0 0 18 0 0 21 17 3 0 0 0 
0 0 21 0 17 20 14 0 17 34 9 8 3 0 3 0 23 13 9 0 10 8 0 21 15 0 14 0 0 39 0 0 1 0 0 31 0 0 0 22 31 16 
0 14 7 0 15 2 0 0 8 0 1 0 0 0 6 12 0 0 17 50 0 10 6 9 11 0 2 3 0 24 0 5 31 1 4 5 0 9 6 27 8 22 
9 40 11 0 59 26 34 0 18 0 9 0 0 11 17 6 25 31 10 2 9 0 0 18 0 8 17 23 2 0 30 23 4 0 0 0 19 4 14 0 1 66 
0 3 17 4 0 18 0 0 33 2 0 0 0 0 18 11 0 0 0 6 0 0 9 18 0 0 0 9 0 0 0 9 0 3 0 0 6 10 0 0 0 60 
1 0 0 11 0 3 20 0 12 0 17 35 0 25 0 2 0 0 0 0 0 0 0 0 0 8 20 9 11 0 0 6 21 33 34 6 0 0 23 11 0 0 
0 10 0 12 0 0 0 0 23 3 0 5 0 0 5 0 0 0 0 15 0 0 8 0 0 0 10 0 0 0 2 29 0 0 15 0 10 6 0 5 0 0 
40 3 1 1 0 0 0 0 0 28 3 0 2 0 0 16 13 5 3 2 17 0 0 13 16 2 14 0 0 13 0 0 0 1 0 35 8 49 0 25 1 0 
9 0 0 4 0 10 4 0 3 0 2 0 2 17 10 0 0 0 0 7 0 0 0 0 22 13 9 0 0 0 22 8 0 1 0 0 8 0 5 2 0 1 
0 33 33 0 10 0 0 6 0 2 0 3 0 15 0 20 0 5 3 0 3 20 17 0 0 10 0 5 4 0 7 6 0 9 33 34 5 0 0 17 12 28 
14 33 24 14 35 14 35 0 0 21 0 1 0 0 27 1 0 50 15 4 6 2 17 22 0 0 0 0 11 0 5 0 5 1 21 5 0 7 0 4 16 35 
41 1 3 0 33 0 59 0 0 0 55 10 3 0 14 3 27 4 0 4 5 13 0 23 15 0 0 15 0 0 20 0 22 0 28 0 0 26 0 15 0 26 
4 0 28 0 26 0 2 11 12 0 15 0 0 0 15 0 0 11 3 0 5 17 0 0 10 18 0 5 19 0 14 0 0 10 0 0 8 0 0 0 0 0 
14 0 0 0 0 0 0 0 9 0 0 32 0 0 11 0 2 13 9 13 0 0 11 11 0 0 6 9 20 29 9 2 28 2 31 7 25 2 10 46 0 0 
0 15 12 13 0 30 11 23 0 0 4 4 5 37 1 1 15 38 3 16 0 4 14 6 0 15 13 25 0 0 4 0 0 30 1 22 3 29 0 9 0 0 
2 0 61 24 16 0 16 20 5 24 40 46 7 6 3 8 0 5 18 15 1 0 13 0 15 0 10 0 17 12 3 27 25 0 8 23 0 43 27 47 8 0 
19 38 0 0 0 2 0 40 0 0 17 0 0 0 23 0 0 4 0 22 5 0 22 23 10 5 0 0 9 22 2 2 15 0 9 0 0 20 4 38 15 5 
6 0 9 0 21 0 0 0 0 0 6 33 18 0 16 0 6 0 0 15 0 0 8 7 13 21 0 27 0 0 10 0 16 10 15 49 0 48 0 6 0 8 
