42 24
43 0 0 15 0 3 0 0 25 0 0 0 0 0 10 12 32 0 15 28 21 18 0 18 41 0 9 14 9 13 27 0 5 16 0 16 0 0 0 0 0 35 
0 11 0 26 17 1 22 28 0 26 31 0 36 23 17 0 0 0 0 0 0 0 0 0 13 0 23 33 0 39 0 17 0 0 19 26 23 0 0 29 0 0 
43 0 0 0 0 0 30 0 8 0 0 0 0 0 1 6 0 19 0 0 0 0 0 0 0 0 0 10 0 11 0 16 0 1 0 14 13 0 1 0 11 15 
19 13 0 14 0 7 0 24 4 0 0 0 11 8 14 2 0 17 0 0 17 0 14 10 0 0 18 1 11 1 0 0 4 8 0 0 19 7 4 1 29 0 
0 0 0 26 4 6 15 0 5 20 19 0 0 17 10 0 0 16 0 10 0 13 2 7 7 0 13 4 0 24 2 0 8 0 0 4 7 13 30 18 0 0 
0 0 15 0 0 0 0 0 0 18 0 0 0 0 0 23 0 7 0 0 0 0 23 0 0 0 5 0 0 0 0 37 5 0 0 0 8 0 0 0 0 26 
0 0 0 23 4 0 2 3 0 4 1 0 3 0 27 0 23 4 0 16 9 4 0 12 0 7 23 5 12 4 0 7 0 27 0 4 10 0 4 0 0 27 
0 0 56 10 53 0 0 55 0 0 0 1 5 26 11 7 0 17 8 15 16 9 7 20 21 9 0 23 21 1 0 2 21 29 32 43 0 2 28 26 0 0 
0 12 0 0 10 19 34 0 0 38 28 19 0 0 10 9 16 8 0 0 0 8 0 0 8 3 0 2 0 9 2 0 10 19 0 2 31 0 28 0 25 8 
0 0 5 2 0 8 24 0 29 4 20 14 7 0 0 4 0 3 20 15 0 12 0 0 0 8 6 0 3 0 12 18 5 9 0 3 11 44 19 0 0 0 
0 36 0 21 15 33 18 3 23 0 0 0 0 0 13 4 18 0 19 11 7 0 11 0 0 0 5 16 10 0 3 6 28 1 0 6 8 2 0 0 24 0 
0 3 1 15 0 0 0 31 8 0 0 0 1 20 1 16 20 0 0 0 18 18 0 0 7 16 4 12 0 5 7 0 34 15 5 20 15 0 70 11 9 19 
0 11 25 10 24 0 0 0 7 11 14 8 0 0 0 4 0 0 0 0 3 0 0 3 3 6 0 19 29 2 15 0 0 0 0 3 7 1 10 0 0 0 
0 7 0 3 6 2 3 0 7 0 0 11 2 4 3 0 0 28 0 1 1 0 1 0 8 5 0 0 13 0 8 7 0 0 0 10 0 1 21 0 11 13 
0 3 37 12 0 0 3 0 1 16 6 0 0 0 9 5 20 8 0 10 17 0 2 0 13 0 0 6 0 25 2 0 1 12 0 2 20 18 24 0 0 39 
0 8 18 33 0 2 0 0 0 8 0 0 20 11 12 0 0 11 1 0 27 16 8 0 11 0 9 0 0 3 8 18 8 13 5 10 10 0 0 5 0 20 
7 4 0 0 7 0 0 0 0 0 4 7 0 6 22 4 0 8 0 14 0 0 23 16 0 17 1 16 0 0 0 5 18 8 0 15 40 0 0 6 0 8 
21 10 17 14 12 0 1 0 0 5 0 0 0 6 3 14 0 12 14 17 0 0 12 0 17 1 20 23 8 14 13 0 0 0 0 8 36 11 2 0 11 42 
0 24 0 0 0 0 12 0 15 30 0 0 0 0 0 32 32 22 12 6 0 0 0 4 0 49 8 0 0 22 0 0 4 3 5 0 16 22 14 62 7 0 
23 37 0 0 0 15 0 0 6 13 0 0 18 0 13 0 0 0 0 7 0 0 17 35 2 0 7 5 20 18 6 0 0 0 0 12 0 0 49 0 0 0 
28 4 15 46 18 30 3 9 7 5 5 7 0 0 3 6 15 11 0 12 23 14 7 8 23 0 2 35 31 0 13 25 0 4 26 0 16 0 0 0 0 29 
1 24 44 0 29 0 20 4 25 2 7 0 27 0 0 20 9 0 10 16 6 0 11 13 23 0 6 0 10 0 11 0 8 21 0 0 13 0 0 20 1 36 
12 0 0 0 19 1 39 10 24 0 0 0 0 8 8 26 0 10 15 16 28 0 0 7 16 4 0 6 0 19 0 34 24 2 5 0 12 0 42 32 0 18 
32 28 2 0 18 5 0 22 0 11 42 0 3 5 0 0 0 8 21 0 16 0 11 16 27 21 0 7 12 28 0 5 0 23 0 10 0 14 0 8 0 2 
