42 24
23 6 17 22 16 22 0 21 46 7 8 4 27 0 11 0 0 0 33 11 0 0 8 66 15 13 9 0 16 0 8 0 0 0 26 0 39 0 33 14 0 0 
11 0 30 0 4 32 0 0 0 7 0 4 0 0 1 5 7 0 6 53 0 17 0 0 1 0 0 0 11 0 5 0 13 0 0 5 0 32 0 16 17 0 
13 28 16 1 36 45 15 47 2 20 15 12 0 6 8 0 0 2 16 11 0 9 9 0 14 0 0 0 17 29 0 26 2 26 19 0 0 28 19 4 0 0 
0 48 0 3 0 9 4 0 32 0 0 0 0 0 15 0 0 23 17 0 0 0 0 3 0 0 0 9 13 43 0 2 0 2 0 0 5 14 0 0 9 0 
17 5 0 0 0 0 17 31 0 0 0 3 0 15 2 0 13 34 15 14 0 0 7 3 10 2 0 0 10 7 0 2 0 3 0 6 0 0 43 0 0 0 
16 43 0 17 0 9 3 26 0 0 0 37 0 0 10 1 23 18 11 7 0 0 0 10 0 0 14 0 3 1 19 5 0 0 0 34 0 0 0 22 0 10 
0 3 0 16 6 4 13 5 11 16 30 4 11 24 7 4 0 0 0 3 17 9 0 0 13 14 0 0 0 0 9 19 8 0 0 0 0 26 0 27 15 0 
0 0 24 0 30 0 23 10 32 9 0 3 0 16 0 0 3 21 5 4 0 0 19 12 15 0 44 6 6 38 1 4 0 3 75 1 0 3 35 16 21 34 
0 0 15 0 2 6 3 12 33 0 15 0 0 29 12 0 0 0 21 0 0 6 0 10 0 19 1 0 13 12 0 0 0 10 0 6 0 24 0 21 0 40 
6 5 8 0 0 3 35 31 0 3 13 1 19 0 9 0 4 0 1 20 19 2 0 2 0 13 23 0 0 0 0 0 0 0 0 0 0 2 22 1 34 0 
10 70 0 0 28 14 0 0 0 2 0 18 0 16 0 6 0 0 6 19 17 7 7 1 9 0 0 0 55 7 30 3 17 2 33 6 9 18 20 0 0 8 
28 0 3 24 31 2 0 0 0 23 0 29 11 1 5 8 0 12 0 24 0 10 17 11 0 5 0 0 26 0 21 4 5 28 0 5 32 4 0 0 30 0 
20 0 0 1 3 2 0 4 0 0 5 11 8 0 0 7 20 0 0 10 9 0 1 0 0 19 7 9 0 0 0 0 0 5 0 3 2 0 0 0 24 0 
2 14 40 0 32 40 6 0 29 7 0 0 0 13 25 5 0 0 7 33 0 0 9 0 3 28 0 9 3 7 0 8 38 0 0 0 69 5 33 41 12 0 
0 7 13 0 0 39 7 0 4 4 0 41 6 28 19 0 14 0 0 10 0 9 0 35 22 27 8 0 0 0 8 0 0 6 17 11 11 0 26 0 0 10 
6 21 5 0 11 5 0 0 2 1 4 0 0 5 26 4 6 43 11 0 18 7 40 6 0 0 0 0 8 13 5 8 0 0 0 3 8 14 38 0 23 10 
0 39 38 0 0 0 0 4 7 9 3 7 4 22 1 0 4 0 0 0 6 0 4 1 0 0 10 0 1 0 16 0 8 8 0 22 0 0 36 15 39 11 
0 0 1 0 0 22 4 17 18 0 0 0 0 8 1 0 10 0 0 0 11 20 0 7 0 2 0 0 21 0 7 34 0 0 0 30 0 0 0 0 16 20 
0 14 2 3 4 0 3 0 2 0 9 7 0 0 22 25 0 0 3 5 0 0 0 5 0 13 11 9 0 0 0 4 0 0 11 4 9 5 19 18 0 8 
21 0 0 21 1 20 0 1 19 0 24 0 25 0 0 5 8 5 34 0 0 21 4 0 29 17 14 0 0 24 5 0 3 21 17 32 16 11 9 0 15 3 
28 12 8 9 0 0 31 18 7 0 0 0 13 9 22 0 0 35 27 20 1 0 0 0 0 0 0 14 18 1 0 0 13 0 17 18 0 39 9 38 20 0 
70 7 0 26 21 4 10 0 12 31 24 26 11 13 0 15 17 8 17 0 9 23 13 7 20 8 0 0 25 0 9 4 8 17 33 29 6 9 50 8 35 69 
0 37 5 15 38 8 0 17 5 0 13 8 1 0 0 3 4 2 0 10 16 0 0 0 0 0 5 0 5 0 8 0 0 0 0 0 12 0 37 0 0 0 
0 0 0 0 1 0 0 25 0 0 13 20 0 4 0 0 0 41 0 1 12 0 0 41 4 11 0 0 0 0 8 0 25 0 0 9 0 0 6 0 0 0 
