42 24
0 0 16 25 10 26 33 0 23 6 15 0 17 0 0 11 0 5 0 12 0 0 25 16 0 26 26 0 34 1 0 29 2 11 3 0 10 0 0 49 37 38 
40 0 3 0 32 6 18 27 0 12 26 1 0 2 0 12 0 7 18 0 15 19 18 0 0 18 6 0 18 22 23 0 0 0 0 20 10 0 29 0 44 3 
0 0 0 0 22 0 0 0 49 17 19 0 0 21 10 0 0 13 13 0 0 0 6 0 20 0 5 0 19 1 0 0 12 13 0 15 4 2 30 17 0 0 
41 0 6 30 0 0 0 60 17 29 31 0 0 0 8 16 14 0 0 0 0 3 10 0 0 3 0 1 19 0 22 3 18 38 8 28 15 0 29 32 0 46 
0 0 0 16 22 5 25 5 29 12 1 12 15 0 0 8 0 24 8 0 5 1 3 0 18 12 18 48 3 51 0 27 7 0 2 0 0 0 0 0 0 33 
4 0 0 27 10 0 0 5 0 41 0 15 5 30 0 9 0 23 3 0 0 0 0 0 17 22 11 14 0 0 17 0 0 22 6 26 0 0 0 0 5 18 
35 0 0 0 0 0 0 5 13 14 0 0 0 19 7 0 0 0 0 0 7 21 1 1 9 0 0 5 7 2 0 7 5 0 10 28 0 0 5 0 0 0 
18 0 0 0 0 24 4 0 11 20 2 16 0 0 0 7 21 0 33 11 2 0 21 12 0 0 4 25 0 36 0 0 15 15 27 0 0 21 12 7 21 3 
35 0 0 14 16 0 0 0 63 0 0 0 0 0 5 0 11 1 2 0 5 0 0 0 29 8 0 0 23 0 0 2 0 0 0 35 0 0 30 0 6 25 
34 3 53 0 7 12 1 0 0 8 2 0 0 0 0 3 25 6 1 0 1 2 1 7 2 0 3 0 0 0 11 6 0 12 34 0 0 0 0 37 0 24 
0 0 6 0 10 10 37 0 3 0 29 0 6 46 0 0 0 0 13 0 5 0 0 12 1 0 0 0 0 0 24 8 0 0 21 8 10 0 18 48 0 1 
0 13 3 0 16 0 33 0 7 20 0 0 0 0 11 15 0 0 0 0 21 8 16 0 1 11 0 6 0 21 7 0 0 7 20 0 12 15 45 0 0 1 
0 9 0 0 0 0 0 0 7 5 0 0 0 22 10 7 0 0 0 20 0 0 8 0 0 24 1 4 0 4 0 0 0 0 0 22 0 29 8 0 26 0 
0 0 0 3 31 0 2 0 50 8 0 0 22 0 5 0 21 0 0 0 0 1 0 0 0 0 0 2 12 0 0 0 9 0 21 35 7 13 0 4 22 33 
2 6 6 21 0 0 0 8 22 5 9 5 5 0 4 7 0 14 4 0 7 13 0 13 21 3 5 0 0 21 30 0 9 1 0 1 0 0 8 1 7 0 
3 0 35 23 42 20 5 36 0 0 0 1 7 9 5 17 15 9 12 6 8 4 6 4 19 6 8 1 26 1 27 18 17 43 0 2 29 0 3 4 0 4 
0 0 11 4 42 7 22 7 0 13 1 0 6 0 11 0 0 12 0 12 2 0 3 0 8 8 0 13 0 32 0 2 14 2 0 3 32 0 7 0 0 0 
0 35 0 3 3 21 3 8 0 14 0 0 0 0 14 0 9 0 1 0 0 4 0 20 0 0 26 8 0 15 12 1 7 0 0 0 48 3 0 0 5 0 
0 39 2 1 31 8 7 5 0 1 21 4 4 11 1 4 10 11 0 0 25 15 0 0 0 14 0 14 0 0 3 21 0 17 0 39 12 33 6 0 18 0 
0 0 10 0 49 0 18 13 7 13 3 1 6 31 13 0 10 0 18 0 0 0 3 1 0 4 7 18 12 0 0 28 0 0 0 0 5 3 0 17 4 28 
0 48 34 0 0 10 32 22 18 43 0 1 1 2 25 0 0 0 0 0 1 1 21 1 2 11 1 9 2 15 17 0 0 0 0 0 11 0 73 0 0 0 
24 0 62 0 2 0 4 33 17 13 0 33 0 0 3 1 23 0 8 0 7 0 18 2 0 7 26 8 0 2 15 29 0 18 0 0 0 0 20 60 33 12 
0 5 35 64 16 0 34 27 16 8 0 25 0 14 1 0 0 18 0 19 16 0 6 12 1 12 15 2 6 18 0 12 0 20 15 61 22 5 22 0 37 0 
6 0 5 0 14 23 12 0 0 0 9 9 0 21 0 0 12 0 3 0 0 14 18 34 0 0 0 6 4 2 25 31 0 0 0 6 25 5 0 0 7 30 
