42 24
25 5 39 4 23 36 23 23 0 0 0 8 0 2 0 0 0 17 0 15 0 5 4 16 6 26 0 25 0 0 0 0 4 0 5 23 0 10 0 3 29 36 
40 15 0 31 0 0 16 1 7 0 0 0 0 27 0 0 8 14 0 0 1 14 5 7 0 1 13 0 0 0 0 23 12 6 32 0 0 0 0 0 19 0 
30 1 0 27 0 1 10 12 35 3 6 12 16 51 19 0 0 15 0 0 3 0 1 0 0 0 0 0 18 0 25 15 14 5 34 2 0 4 10 0 27 27 
13 0 6 22 0 35 0 12 15 0 9 5 0 13 0 0 0 19 7 0 13 0 0 0 2 49 10 25 26 15 0 0 18 18 0 0 1 13 0 70 0 14 
0 10 5 4 0 19 2 19 0 25 7 0 0 18 4 14 0 2 23 0 0 3 21 3 3 0 0 3 0 11 44 0 9 0 0 0 4 12 16 0 0 21 
24 0 0 26 36 35 3 38 6 10 14 0 12 20 8 2 2 0 5 10 7 6 8 2 29 0 18 0 5 7 8 0 11 3 0 32 0 5 0 0 33 19 
13 0 0 0 46 1 0 0 0 0 0 0 10 20 12 0 13 2 0 0 16 0 5 0 9 15 12 0 0 13 0 18 3 5 30 0 3 0 25 0 15 0 
2 10 3 12 0 0 38 6 18 0 0 1 0 0 0 0 0 43 13 0 0 0 0 0 18 22 0 11 0 3 0 13 0 0 15 4 0 4 0 0 6 9 
37 27 34 35 25 32 0 46 12 13 6 19 1 3 10 3 14 0 5 9 0 0 0 9 0 15 2 11 17 25 32 0 0 29 8 0 0 68 26 0 6 0 
0 7 7 0 0 0 18 0 0 27 0 0 0 12 13 0 0 0 0 0 19 14 0 0 21 0 0 30 0 0 8 3 4 10 8 14 2 23 8 8 13 32 
0 0 21 2 0 0 14 12 0 0 61 0 6 0 7 3 0 2 4 0 2 0 0 0 0 43 0 0 0 1 1 0 28 0 9 0 34 10 35 0 30 0 
0 0 0 0 23 15 36 0 0 9 7 30 0 0 0 2 0 17 6 0 18 15 2 3 6 4 11 52 0 4 10 2 2 28 28 23 0 0 21 8 0 54 
27 0 1 32 9 8 0 10 0 21 9 15 27 1 23 0 0 0 3 1 1 3 0 0 3 0 15 30 0 3 8 0 0 0 12 0 2 23 17 20 0 0 
14 0 1 8 0 22 0 10 0 8 25 80 15 0 10 0 6 8 9 1 7 0 0 0 0 13 0 30 0 18 19 0 17 0 0 11 0 0 27 0 0 0 
22 10 0 35 0 0 79 32 2 0 0 42 0 51 0 0 0 4 28 6 14 0 36 9 17 0 13 20 0 6 17 0 1 0 0 0 30 14 35 35 47 58 
0 58 0 3 0 0 0 0 0 26 0 0 0 14 0 0 20 0 18 35 0 0 0 0 0 0 0 6 0 3 0 1 1 0 2 8 4 0 0 32 0 0 
16 17 16 0 4 0 11 18 19 14 0 0 19 5 7 0 1 0 45 17 0 0 0 26 0 7 2 0 11 0 9 25 57 3 2 0 17 24 12 6 3 1 
0 2 35 0 0 0 16 3 0 0 0 0 0 6 0 19 0 42 0 0 16 0 0 13 0 0 0 0 0 0 10 14 0 0 2 0 23 35 4 0 0 0 
11 0 0 0 0 38 29 25 31 0 0 16 0 14 13 4 0 14 0 5 8 16 0 0 4 0 15 24 9 15 14 0 38 0 0 0 0 0 0 0 0 0 
0 3 78 24 6 1 37 0 12 0 6 0 3 0 0 16 7 16 16 7 3 0 0 19 0 15 7 23 0 27 9 16 0 9 0 29 0 3 3 36 37 0 
0 0 0 0 0 6 3 10 12 0 3 1 18 26 0 0 0 6 0 12 7 0 0 0 0 0 0 0 1 21 0 34 7 0 1 1 48 0 0 0 23 4 
0 33 12 32 30 0 0 0 30 4 0 16 0 26 12 0 15 0 10 7 0 1 18 0 0 11 0 0 0 0 10 0 18 0 35 32 18 0 17 26 7 0 
37 75 41 0 24 0 6 10 0 10 0 0 12 0 0 0 0 9 9 0 9 22 0 12 0 0 1 11 0 28 0 10 10 12 14 22 0 24 3 36 0 12 
7 0 44 68 32 3 21 5 4 7 0 0 16 11 12 0 0 23 0 0 15 22 0 0 32 35 0 15 8 0 0 12 0 2 0 21 48 0 36 22 0 5 
