42 24
19 21 5 4 0 36 14 36 0 0 0 0 3 10 6 0 0 16 0 9 5 0 21 0 0 28 15 0 0 9 0 0 2 13 3 14 0 9 7 11 0 0 
11 22 26 36 0 26 0 0 0 24 23 19 19 1 0 12 3 0 0 32 10 0 22 0 0 0 0 13 0 17 14 0 0 38 0 0 0 0 39 71 21 0 
0 42 0 6 0 20 0 0 0 0 0 24 28 30 0 12 0 0 5 16 15 0 0 0 4 5 18 18 0 17 5 0 0 42 0 24 1 24 0 1 28 0 
0 18 3 41 0 0 0 0 0 3 4 17 3 0 19 0 0 8 4 18 0 0 19 14 3 19 0 0 22 9 21 0 0 24 7 0 6 23 20 0 0 16 
1 8 0 3 22 3 0 9 0 0 0 0 0 0 0 0 16 13 0 8 4 0 18 18 9 0 0 24 19 1 18 4 0 5 0 6 0 0 8 0 6 13 
23 37 2 65 1 22 0 36 3 0 13 13 20 0 0 0 20 25 0 14 0 0 15 8 13 0 0 13 0 22 11 26 23 0 3 0 14 0 37 0 37 0 
40 4 0 11 11 1 0 23 13 24 7 0 26 6 2 9 25 2 0 9 0 23 16 9 16 3 0 4 0 7 0 0 9 0 0 0 19 14 13 20 39 25 
0 6 0 37 0 5 0 0 0 0 26 6 0 0 0 0 0 0 0 0 0 8 24 8 0 0 0 0 10 8 0 0 22 0 4 0 14 0 8 0 37 1 
8 0 1 15 0 3 26 1 19 7 0 0 0 0 2 0 2 0 18 4 21 0 6 0 2 5 0 0 5 9 24 0 0 0 0 5 0 0 0 2 0 34 
0 0 2 4 11 5 6 0 2 0 33 11 9 10 0 0 6 0 0 0 12 0 5 0 3 0 0 5 0 0 0 0 12 0 0 0 3 12 8 29 8 3 
0 18 9 20 0 28 0 0 50 10 7 7 10 0 0 14 12 41 14 8 1 0 8 33 1 6 0 10 29 7 22 0 14 9 33 1 10 18 1 25 0 0 
0 0 0 8 6 17 1 0 0 27 0 9 0 0 23 1 0 23 16 9 13 5 7 3 9 0 13 5 25 0 7 7 3 0 29 3 27 26 10 2 12 0 
21 10 0 5 0 0 7 20 0 20 20 1 12 5 0 10 10 0 12 4 1 9 0 0 10 0 0 24 1 2 20 4 0 10 0 0 0 32 0 27 8 4 
33 26 12 32 0 0 10 30 0 0 7 25 27 12 23 36 3 18 0 0 0 0 0 16 14 5 9 8 0 0 0 4 3 1 33 8 29 0 1 71 2 0 
28 0 0 1 0 0 24 4 3 9 0 38 0 0 23 0 0 0 9 0 0 0 8 0 3 18 0 0 24 11 24 0 0 4 0 14 0 19 2 0 0 30 
37 68 22 6 22 6 1 40 0 5 0 0 23 3 3 5 0 9 13 7 0 10 0 28 25 0 28 3 3 0 43 2 0 0 10 0 0 12 11 3 37 34 
0 0 39 0 0 3 0 0 41 0 22 28 0 3 0 0 28 14 0 15 0 7 5 0 0 6 0 0 6 0 6 9 27 0 0 0 0 21 38 65 9 0 
0 32 16 0 3 0 0 18 3 0 11 0 0 6 0 0 0 1 16 1 0 16 10 14 0 0 0 0 0 0 0 3 0 16 0 4 0 0 25 0 0 0 
0 0 51 25 26 3 0 0 0 25 13 0 0 0 0 4 0 3 8 4 0 2 7 0 2 0 7 22 29 35 7 28 1 0 25 0 0 8 0 32 13 0 
0 0 0 1 0 3 18 0 0 0 0 5 9 10 0 21 0 13 0 0 0 1 0 0 25 16 0 0 9 36 0 3 0 12 0 0 4 13 0 0 0 16 
12 35 0 7 3 2 0 2 0 24 33 13 26 0 0 13 19 0 3 3 0 6 0 11 0 20 18 2 14 9 0 1 4 42 6 0 61 23 9 12 0 0 
0 0 0 23 23 15 0 0 18 0 0 0 0 0 0 25 15 14 0 0 0 0 5 1 8 0 0 23 7 0 0 24 8 3 0 7 25 0 8 0 10 0 
8 35 0 0 7 26 18 43 8 0 1 3 12 6 0 0 6 9 8 21 2 6 12 26 7 11 29 0 5 10 4 14 0 0 27 34 8 0 1 14 0 0 
7 23 0 0 19 0 0 4 0 0 20 0 26 0 0 0 0 0 3 20 18 0 11 22 0 0 0 20 13 26 0 0 0 1 0 0 10 0 24 3 0 31 
