42 24
0 9 19 0 6 33 6 0 10 0 4 0 15 0 26 15 12 10 13 1 0 47 15 6 2 31 0 55 2 0 13 7 5 17 6 34 0 15 31 0 4 22 
0 38 18 0 35 32 18 11 13 0 7 6 0 0 33 8 0 12 0 0 0 0 35 14 15 8 22 8 0 0 6 0 7 10 0 34 0 0 0 42 0 0 
0 45 0 21 0 7 22 0 21 0 0 2 0 9 7 9 30 0 14 1 8 1 19 13 14 0 0 4 21 0 0 0 0 0 15 19 18 13 0 30 0 25 
41 5 0 2 19 7 5 0 0 0 4 3 7 0 34 0 0 7 0 9 0 15 5 19 0 0 0 0 2 11 1 0 0 7 0 16 6 4 0 6 0 48 
0 34 4 30 0 0 20 10 5 23 11 6 0 10 10 1 0 4 0 9 0 0 0 10 0 11 3 0 42 0 0 0 23 32 0 0 0 0 10 0 4 3 
0 0 7 2 19 12 0 16 1 1 16 18 35 2 0 3 3 8 6 3 0 10 17 35 0 4 0 3 12 0 11 0 0 23 0 0 0 20 26 0 0 11 
0 4 21 18 4 9 3 0 0 0 7 0 0 0 29 4 21 0 11 0 0 7 9 20 10 0 0 13 6 0 18 3 0 0 20 0 0 18 0 0 0 3 
10 34 1 0 15 0 19 0 21 12 25 0 7 19 0 5 0 12 2 10 0 0 24 6 0 0 23 28 12 16 0 21 0 0 2 48 30 0 1 0 12 28 
0 47 1 0 2 0 2 0 9 0 0 7 0 0 0 33 21 11 7 0 0 0 0 0 0 20 6 28 13 0 2 15 0 0 19 10 0 0 22 0 0 37 
18 6 29 31 14 20 7 0 2 22 35 24 16 28 0 0 4 11 16 0 15 0 8 0 7 28 1 10 11 0 0 18 0 6 37 1 2 3 0 6 12 28 
2 7 0 0 14 0 0 0 31 0 11 5 0 7 0 11 0 0 0 5 2 11 9 0 0 0 6 0 13 0 0 4 0 0 0 0 0 29 0 0 0 13 
0 11 12 25 9 12 0 7 35 0 1 8 0 9 41 0 0 12 0 16 0 8 10 1 1 11 12 16 25 2 0 0 11 0 23 16 0 5 0 11 4 33 
39 0 28 64 0 0 9 10 2 0 0 7 0 7 0 22 0 0 0 16 2 23 0 0 14 0 0 0 5 0 0 0 0 0 31 16 33 51 3 9 1 42 
29 0 22 36 19 27 6 20 8 0 0 6 0 9 3 12 9 4 0 8 0 0 0 0 27 6 0 21 0 31 0 6 32 20 0 0 0 0 0 0 0 0 
0 8 0 0 22 0 0 18 0 29 0 78 23 4 0 0 14 0 13 14 27 0 0 13 0 18 7 7 0 0 2 9 0 0 0 8 8 6 0 2 31 30 
0 6 35 0 34 0 0 0 2 3 22 7 2 25 0 0 0 0 6 21 0 0 9 14 0 0 6 0 13 0 0 0 4 0 0 8 1 31 32 0 4 0 
36 32 22 35 0 23 0 0 0 6 1 16 6 26 13 0 0 15 8 0 18 0 21 1 1 9 0 23 3 27 16 0 3 39 21 3 43 0 16 0 0 0 
0 18 0 2 4 109 0 34 2 0 44 0 4 7 14 7 9 4 29 1 0 5 9 0 0 0 12 7 0 0 8 5 6 4 54 25 3 15 6 0 3 2 
0 0 0 0 12 0 0 10 0 0 0 0 0 0 42 0 12 8 0 0 0 15 0 5 12 0 0 3 7 15 4 0 3 0 9 0 0 6 0 0 1 7 
0 20 1 0 0 39 16 9 0 2 10 4 0 0 0 12 8 0 0 6 0 17 0 0 0 6 0 22 7 0 2 0 0 17 0 0 0 0 0 12 9 11 
0 3 0 16 3 18 16 0 0 0 5 0 0 0 0 0 0 0 2 9 0 2 0 0 3 10 0 0 0 0 9 0 8 0 3 10 15 0 0 9 3 0 
0 1 49 36 1 0 0 32 8 0 0 34 0 0 11 0 24 0 0 6 21 19 8 4 0 21 3 16 0 18 7 13 34 2 3 19 22 0 0 23 23 31 
13 28 2 0 7 0 0 0 0 6 19 0 1 24 22 12 20 0 9 0 0 22 15 0 11 7 5 7 1 7 29 0 0 0 21 0 17 23 0 11 1 9 
23 0 0 0 0 4 29 0 0 0 2 0 21 0 0 18 0 0 0 5 0 0 17 23 5 15 10 22 0 0 0 0 7 18 4 27 3 2 0 7 50 0 
