42 24
0 0 9 35 0 0 11 14 3 2 2 6 21 0 0 12 0 20 15 18 15 4 4 0 18 0 24 5 20 0 0 7 28 22 0 15 1 12 44 18 16 3 
0 0 0 0 6 0 20 0 1 0 2 0 0 15 0 0 18 0 0 22 0 17 0 0 17 0 42 0 9 1 0 0 0 7 14 0 6 0 14 0 7 0 
0 0 29 0 15 28 0 26 36 0 50 12 43 21 0 0 11 0 2 0 5 0 19 7 3 0 8 0 0 0 9 0 0 17 13 21 0 31 2 0 32 4 
0 0 31 0 27 0 0 12 0 0 31 9 8 2 0 10 0 0 23 10 43 0 11 0 9 0 0 10 0 13 0 13 0 2 4 20 0 27 0 0 18 20 
0 0 38 0 0 0 0 0 0 10 22 0 24 0 0 0 0 0 29 9 18 0 0 12 14 5 16 4 0 0 18 13 0 0 40 0 0 12 2 14 30 11 
0 23 19 0 0 0 0 3 0 0 35 16 0 11 0 0 13 5 10 12 21 7 0 0 11 0 6 17 2 13 0 0 3 2 4 0 0 1 12 0 30 25 
38 0 3 0 3 0 5 8 3 0 16 3 4 11 0 0 15 0 0 0 0 0 1 0 11 0 0 0 0 0 0 0 1 0 0 0 0 0 38 0 1 1 
0 16 2 0 17 14 0 14 0 7 3 10 0 18 0 23 7 0 0 10 35 20 13 0 20 0 10 6 0 40 10 9 1 29 33 5 35 0 0 10 10 36 
0 39 14 0 2 0 32 0 0 0 0 0 7 0 0 2 39 2 21 36 0 0 9 0 0 0 0 8 12 14 0 20 5 2 0 6 0 0 32 21 11 0 
0 0 19 0 40 0 0 0 7 17 1 8 0 2 4 13 1 3 8 5 17 17 1 14 8 16 0 0 18 0 32 0 22 0 0 0 0 9 9 0 52 18 
0 36 0 0 23 0 0 7 28 24 3 11 0 0 0 17 0 15 14 0 13 0 4 0 12 0 0 0 20 0 6 0 10 11 0 18 0 33 0 0 3 0 
12 0 0 0 29 0 6 0 4 0 0 27 8 0 4 0 4 0 1 0 0 5 0 5 6 5 2 0 10 13 8 0 0 26 0 9 0 0 27 0 0 0 
0 12 0 0 50 26 8 0 0 0 2 2 7 3 0 0 0 0 0 7 16 0 17 0 0 0 22 20 0 0 0 0 0 7 5 0 0 5 3 0 13 44 
2 68 8 0 0 0 5 0 0 0 3 0 13 0 3 2 0 2 0 14 6 6 0 22 9 0 3 11 0 1 9 0 3 6 0 4 38 18 0 3 21 0 
53 39 6 8 0 0 22 8 26 45 2 2 18 13 0 10 0 5 10 15 0 0 16 0 4 0 0 5 28 17 0 1 46 0 2 34 7 2 39 0 8 0 
0 9 45 0 0 0 0 10 0 0 9 18 15 22 27 8 25 15 5 24 7 10 0 0 7 1 7 16 10 2 0 0 0 8 0 0 17 0 0 28 0 2 
7 0 0 3 7 44 33 0 5 7 7 30 28 42 0 0 0 0 12 0 42 2 0 0 3 16 17 0 3 9 7 17 3 0 0 15 23 53 0 1 24 0 
0 0 32 0 0 15 14 15 0 4 0 0 29 17 0 8 11 13 0 40 22 1 21 3 13 10 4 0 3 10 21 3 0 2 43 17 0 22 0 26 0 44 
5 42 0 0 35 1 2 4 8 9 0 4 0 8 0 11 0 0 6 0 9 1 22 0 33 0 0 0 6 0 6 0 0 0 0 4 0 0 16 59 9 4 
0 0 0 0 44 13 6 0 0 31 0 0 0 0 0 0 0 12 3 1 0 0 1 14 0 4 0 0 0 0 15 5 5 13 0 0 13 0 34 0 31 0 
2 0 0 0 0 5 27 57 0 0 0 0 0 0 7 26 8 0 0 3 17 0 0 0 0 0 0 0 3 0 20 10 0 26 0 0 2 0 0 0 0 2 
8 33 19 0 16 3 0 1 17 21 18 0 17 20 2 4 1 0 12 0 4 15 23 5 0 0 0 32 15 3 5 9 0 0 39 27 13 19 12 35 25 0 
0 0 17 0 1 1 0 7 0 6 36 0 6 7 0 2 14 2 3 8 18 0 0 0 34 0 0 0 0 12 14 2 0 29 18 0 2 0 0 2 1 6 
38 38 0 0 8 40 2 0 6 30 19 1 21 8 5 13 0 9 19 11 7 0 3 5 8 10 1 9 0 0 0 7 0 17 34 41 3 0 0 82 16 18 
