42 24
3 0 2 0 35 10 0 1 1 0 0 20 8 13 0 0 6 1 0 0 0 0 5 0 12 2 0 0 16 6 0 0 20 0 0 6 0 0 0 53 0 7 
2 0 0 1 18 0 13 2 11 4 0 22 0 0 0 6 20 9 5 13 18 0 13 19 12 0 0 0 20 33 4 0 11 0 3 13 0 2 26 0 0 0 
0 57 0 24 0 13 3 6 0 0 0 0 0 0 0 22 6 0 30 19 0 17 12 18 11 2 0 24 1 0 13 0 0 0 1 0 0 58 6 15 0 1 
20 0 16 0 0 0 0 0 16 0 0 0 4 0 17 11 4 0 36 0 13 3 2 1 2 11 7 0 15 0 1 0 2 21 1 1 1 6 0 0 0 0 
10 0 16 0 0 18 0 0 17 13 10 14 0 0 0 1 0 0 8 0 0 8 2 25 1 24 0 2 0 8 6 13 0 0 0 0 0 0 0 21 16 0 
0 0 0 52 0 0 17 45 1 9 5 19 0 0 0 24 2 9 7 11 0 0 5 0 11 2 23 9 13 0 21 0 29 0 12 0 0 30 0 1 0 0 
58 9 0 0 0 5 7 0 14 9 22 0 4 20 0 12 16 17 5 11 13 13 2 4 0 0 4 15 0 0 0 0 17 1 0 0 36 18 0 1 7 0 
0 0 24 0 3 13 0 13 17 21 40 14 4 13 0 18 3 12 46 14 0 19 6 6 0 1 24 0 9 12 21 0 0 37 0 17 0 29 10 29 2 7 
7 0 24 0 0 2 14 37 0 0 0 9 0 0 0 9 2 0 4 0 0 3 0 0 0 4 18 0 0 0 0 0 10 17 50 0 0 0 21 0 0 15 
23 18 0 11 0 0 18 0 0 36 0 39 0 0 10 13 14 3 0 7 3 6 0 12 7 0 2 11 1 0 18 15 0 39 11 11 0 0 8 9 10 0 
25 0 0 0 0 6 0 0 19 48 5 0 3 4 14 0 24 3 13 0 21 0 0 5 0 25 0 19 5 0 13 0 7 0 25 0 27 17 24 0 24 0 
0 1 7 0 0 0 0 0 0 0 0 7 0 2 0 0 0 20 5 0 20 0 0 5 0 0 2 0 0 0 0 10 0 2 0 0 0 0 0 22 0 21 
0 0 15 0 0 15 0 0 0 0 45 0 0 6 9 0 0 15 21 2 7 0 18 15 12 0 6 0 2 0 12 0 7 2 14 24 0 8 1 35 18 0 
0 15 32 0 0 0 26 5 15 3 0 0 3 30 13 10 33 34 0 0 14 0 6 15 12 0 2 13 0 12 8 0 0 1 48 1 64 0 7 4 7 24 
6 45 0 31 3 0 3 5 0 0 0 3 7 15 8 1 0 12 27 19 4 2 12 0 5 0 5 0 3 0 16 5 0 2 11 0 12 70 49 5 0 0 
0 0 0 11 0 17 2 31 5 17 0 6 0 0 27 26 0 0 0 30 0 1 17 5 15 0 2 0 0 0 10 6 0 14 25 0 21 7 0 10 8 25 
13 0 38 0 1 5 0 0 4 9 0 25 19 0 2 0 24 0 24 0 0 0 0 17 0 5 22 12 8 0 5 0 8 0 0 0 33 28 0 1 3 0 
26 6 24 0 0 0 0 29 0 15 0 1 3 0 0 11 13 0 0 11 0 0 0 2 0 0 49 12 5 29 8 0 0 0 12 0 30 0 4 4 0 3 
0 7 28 20 5 16 0 0 0 28 9 14 24 4 0 18 14 0 6 17 1 16 0 13 16 4 14 0 11 10 18 0 0 0 4 3 57 18 27 1 12 0 
34 0 29 0 5 0 14 30 43 3 21 5 0 13 0 6 5 8 24 14 3 16 1 0 0 10 0 6 15 0 1 30 0 10 12 27 24 31 1 0 18 0 
15 6 11 11 31 0 11 3 0 29 0 20 1 18 0 0 0 11 0 0 17 0 0 0 1 18 0 26 1 0 8 0 0 20 30 11 36 30 32 8 16 0 
37 0 31 0 33 20 9 10 0 2 26 19 12 0 17 12 36 26 0 14 0 0 11 0 8 42 0 15 7 0 0 31 0 43 8 10 98 0 1 0 0 24 
0 19 11 13 31 11 26 5 10 2 2 0 2 0 0 13 27 1 5 1 20 0 33 7 0 2 1 0 0 4 4 0 10 0 29 35 20 15 2 7 0 0 
2 0 2 0 0 0 0 0 0 8 30 8 29 21 1 20 53 8 7 7 0 0 6 5 21 6 11 8 0 0 13 9 0 0 3 11 20 5 6 0 30 44 
