42 24
0 36 0 21 0 29 70 16 0 5 11 23 0 0 0 10 11 16 5 0 0 11 16 6 15 42 0 9 18 0 8 0 21 32 29 0 3 0 15 18 0 35 
0 5 8 0 35 56 0 2 19 0 0 0 23 0 8 3 0 14 0 8 18 0 6 18 13 15 13 27 1 8 0 3 1 0 8 0 0 8 19 21 0 0 
0 23 17 33 11 0 27 0 0 4 0 9 3 3 0 0 0 9 53 22 9 0 0 0 21 1 0 12 30 8 0 0 0 35 0 0 42 2 0 0 0 45 
0 46 0 0 0 0 0 0 3 0 9 9 0 0 61 0 0 1 0 0 27 0 13 0 11 0 0 12 0 0 0 18 0 10 0 26 0 17 49 24 0 0 
0 4 0 5 0 26 8 9 21 0 0 4 5 23 18 0 20 9 11 0 0 0 19 0 21 0 0 20 13 20 1 4 5 0 0 37 43 8 24 36 0 19 
0 12 5 15 8 16 0 24 13 20 29 1 5 19 17 0 0 0 0 20 6 13 0 16 0 2 1 2 4 14 0 5 1 2 0 1 0 0 0 78 7 0 
38 5 19 0 27 52 0 32 3 21 0 0 0 30 66 0 11 0 17 27 4 11 0 14 12 13 0 11 8 14 2 36 0 4 0 22 0 0 44 53 0 10 
25 14 0 24 0 26 11 23 28 2 12 0 75 0 6 2 8 7 0 12 13 6 3 16 0 40 0 13 32 1 22 24 10 35 0 0 0 13 27 0 15 3 
0 1 5 4 0 27 0 7 0 2 0 0 11 14 21 0 0 0 12 6 9 1 0 13 6 2 8 14 0 9 3 0 27 0 13 21 0 0 0 0 4 11 
0 4 30 10 0 0 13 19 9 3 0 0 1 10 0 2 0 10 12 0 0 0 0 0 0 0 26 1 0 0 0 0 0 0 0 1 0 0 9 0 38 0 
0 0 0 3 10 3 0 0 3 26 8 0 0 1 1 10 0 0 0 13 13 0 0 0 13 4 5 0 0 0 6 13 9 13 11 27 0 13 7 11 0 9 
34 8 39 0 7 24 2 7 0 41 10 5 0 0 0 4 0 10 9 19 44 0 17 0 14 15 0 18 28 23 6 0 10 13 0 4 20 0 55 17 0 0 
16 0 31 0 0 0 25 10 0 11 0 23 4 0 0 28 16 10 0 0 0 0 2 0 2 14 0 0 0 0 0 25 0 32 0 0 0 12 0 21 40 2 
1 67 0 33 32 7 2 8 0 0 0 8 0 0 0 1 12 3 2 0 3 9 0 0 4 0 0 0 12 0 11 30 8 51 0 0 0 0 0 0 0 0 
0 0 0 30 8 0 5 0 0 0 0 20 4 4 0 1 18 12 0 2 1 19 0 0 11 0 0 0 7 0 25 0 2 0 24 0 0 20 0 0 10 2 
0 38 16 96 24 6 0 23 0 0 5 26 10 0 7 0 22 13 7 0 10 18 0 9 0 32 0 12 9 27 37 0 6 6 9 16 0 7 37 73 15 1 
0 0 21 29 19 20 0 12 52 0 0 0 4 0 0 4 4 16 0 14 4 0 20 40 19 0 7 19 0 16 0 0 6 19 31 28 0 0 11 0 0 35 
0 0 25 32 0 4 7 0 10 20 2 0 1 4 0 20 0 25 21 1 16 19 5 21 0 13 0 0 0 15 3 0 0 0 0 14 0 20 22 0 16 0 
19 0 7 0 0 1 3 25 39 10 8 2 10 3 22 0 13 1 4 9 17 0 0 0 12 0 0 9 18 23 0 0 46 0 10 0 13 15 0 0 0 0 
2 40 34 1 0 0 17 19 13 0 4 0 11 0 11 0 0 9 4 6 6 8 19 17 0 17 6 14 12 23 23 12 11 0 16 0 0 15 0 0 0 15 
0 0 0 15 72 0 0 0 0 14 0 22 0 0 17 10 0 3 0 0 11 13 4 14 0 0 4 0 4 4 16 21 24 10 6 1 31 5 9 17 0 0 
11 0 0 46 26 7 0 0 0 0 0 19 27 0 0 6 0 0 10 4 0 1 14 0 20 10 0 0 25 17 18 33 58 11 11 0 14 0 21 0 2 14 
0 0 25 0 20 5 0 0 0 0 0 0 0 16 0 19 0 1 7 2 3 0 0 18 20 0 8 8 0 11 0 0 0 22 19 19 0 0 0 0 7 3 
29 9 19 0 0 0 3 7 0 58 33 2 0 25 8 5 0 12 21 30 7 0 7 16 24 0 12 11 0 19 0 20 0 31 0 19 0 0 7 30 0 0 
