42 24
36 69 24 2 10 0 6 31 0 0 0 4 11 8 4 22 11 21 13 16 0 27 5 0 22 5 0 20 0 8 11 0 0 0 23 23 0 15 15 0 23 40 
29 22 0 15 5 27 5 0 15 9 0 43 15 2 20 15 0 23 0 5 0 4 0 17 2 14 2 48 0 14 22 25 27 7 12 14 0 0 0 6 29 20 
28 0 16 60 11 33 20 12 0 0 23 11 0 0 0 6 0 1 8 46 0 0 0 17 13 15 25 24 29 5 0 0 12 5 0 13 0 0 48 4 32 0 
0 0 38 37 15 35 0 0 3 0 10 6 0 24 0 0 0 0 0 8 0 0 1 9 9 0 7 0 4 7 10 0 17 10 0 0 1 3 0 26 79 0 
0 32 0 65 0 28 0 6 0 18 0 0 5 16 17 0 14 16 13 9 0 18 8 12 0 14 9 0 15 6 9 17 3 28 0 35 0 0 0 43 37 18 
5 15 6 0 0 0 0 5 13 21 0 18 5 0 0 43 15 2 0 9 8 2 0 0 6 5 5 0 2 16 6 5 14 0 6 15 2 0 0 24 0 0 
0 12 57 41 5 35 11 9 27 6 31 29 3 0 0 36 1 1 2 14 0 2 10 0 13 22 14 0 45 8 0 14 0 8 0 0 0 29 34 24 66 30 
0 20 0 2 5 0 0 0 25 3 2 7 0 1 12 9 0 2 15 0 2 11 1 4 0 11 5 0 0 9 12 2 3 2 20 0 0 0 0 35 1 32 
16 11 53 0 1 24 0 0 6 0 26 0 11 10 0 14 14 18 0 12 18 0 0 0 0 0 0 11 0 24 0 17 2 0 0 17 25 0 0 0 0 0 
4 0 7 2 0 6 26 15 0 9 12 1 9 3 3 0 3 3 0 0 9 9 15 0 0 1 1 0 0 23 7 0 0 0 4 0 34 0 0 21 13 0 
74 38 0 0 13 0 0 25 1 7 4 0 7 6 0 15 0 5 0 24 0 4 0 0 24 18 0 8 0 0 0 18 22 0 3 8 12 0 38 30 0 0 
0 0 0 0 8 2 26 13 19 6 6 21 32 12 0 0 42 3 12 5 0 0 0 5 0 16 0 25 5 4 10 13 5 4 0 2 33 0 0 0 10 16 
17 0 2 0 4 0 7 8 1 0 21 26 0 33 31 8 0 13 0 12 0 0 13 0 0 0 0 4 18 0 13 6 0 11 3 22 4 29 0 25 0 0 
6 16 8 0 25 0 0 0 0 0 2 0 0 0 1 0 15 7 0 0 0 7 0 0 10 0 0 0 0 0 0 14 28 0 9 0 4 0 21 10 0 0 
13 10 1 27 13 0 0 2 0 11 35 11 26 13 0 0 8 7 5 1 0 0 6 0 0 0 0 9 0 0 27 0 0 8 0 0 9 0 2 0 0 0 
0 0 8 0 17 6 0 0 0 0 11 0 0 8 0 0 0 21 4 0 0 9 3 23 0 0 0 0 1 12 0 0 4 0 0 0 4 0 15 0 0 18 
0 40 4 15 3 0 4 37 0 0 0 0 23 8 15 27 0 5 0 0 0 0 0 0 8 0 0 15 3 1 2 0 8 0 0 23 35 0 0 0 0 35 
0 12 17 0 0 0 0 5 7 6 0 0 1 0 0 7 9 19 0 0 19 0 4 0 0 13 4 0 0 0 0 2 15 0 0 0 0 16 0 8 0 0 
0 28 78 0 0 19 0 0 6 23 0 0 23 18 18 13 3 8 3 8 9 0 0 0 0 3 24 18 4 0 42 0 8 0 5 30 6 12 0 0 4 72 
0 6 0 19 18 2 7 2 0 0 0 0 0 0 0 0 15 16 21 0 0 15 18 0 0 12 0 18 1 12 0 0 20 10 16 0 2 12 33 0 0 18 
8 0 19 0 8 0 4 0 30 5 4 6 0 0 0 12 0 9 18 18 15 25 14 2 8 3 23 0 11 0 10 10 25 0 0 21 8 0 0 11 0 0 
63 0 55 2 8 14 52 18 0 2 22 0 8 3 21 0 0 25 0 7 20 2 0 0 24 15 7 0 25 2 0 1 0 0 0 20 16 0 36 27 18 0 
0 14 44 24 16 37 0 4 15 3 0 10 10 10 0 13 11 0 10 0 0 0 24 9 0 10 0 3 4 0 11 10 0 0 6 15 37 0 49 16 32 21 
22 22 0 0 13 0 0 7 12 13 3 11 22 53 0 15 0 22 9 14 1 0 14 0 5 15 13 37 1 0 22 0 0 13 6 20 12 0 25 23 23 0 
