42 24
0 37 0 0 0 0 0 0 0 0 29 0 0 21 0 51 0 20 0 22 7 0 12 14 0 20 0 4 13 53 10 0 0 0 0 8 0 4 37 0 0 16 
22 0 0 40 7 12 0 7 0 14 18 0 0 0 13 11 0 14 0 0 6 2 17 14 15 9 6 24 13 0 1 4 0 8 28 4 5 0 0 15 0 8 
10 0 0 0 20 6 32 0 9 17 0 28 24 0 2 0 1 0 0 0 1 0 12 0 0 25 3 0 0 0 0 7 8 0 8 0 0 0 46 8 37 0 
0 0 0 0 0 0 0 0 1 42 0 0 20 4 15 7 6 0 10 7 11 0 0 29 0 14 0 0 0 12 12 1 19 0 0 11 0 28 22 0 24 0 
20 20 0 0 0 0 0 0 0 0 18 0 0 0 0 0 0 11 0 1 18 1 7 7 0 13 7 4 3 0 4 33 7 0 0 0 0 0 0 0 0 19 
18 0 0 12 15 29 0 0 0 15 9 0 5 26 20 0 0 5 7 9 0 9 15 0 11 0 26 1 0 0 4 21 0 0 62 0 0 5 2 31 5 7 
53 0 14 0 1 21 2 5 6 0 0 9 9 2 14 0 14 3 1 9 0 0 14 3 0 14 0 1 0 7 12 0 15 5 43 5 2 1 0 59 0 2 
42 0 2 4 0 36 34 0 5 31 6 44 0 0 19 0 2 7 14 11 1 25 0 2 24 0 0 3 0 0 3 5 14 19 5 0 38 0 14 4 7 16 
25 0 0 7 11 38 6 0 30 0 0 0 3 15 5 0 0 0 0 0 16 0 0 20 7 38 0 26 0 0 10 19 0 0 4 1 5 24 51 0 0 2 
3 0 7 0 9 0 32 0 7 0 23 0 6 0 0 35 11 0 0 13 0 0 8 7 0 21 0 0 0 11 8 24 0 0 0 0 0 0 23 29 15 2 
0 0 0 0 0 0 57 0 0 0 16 0 7 7 24 7 5 7 15 7 6 4 4 0 9 24 28 21 0 7 14 15 0 20 0 21 2 12 32 0 0 23 
0 15 32 4 0 2 0 0 28 0 23 0 0 0 0 0 8 6 12 17 0 13 3 7 17 9 0 0 0 0 6 3 0 32 63 1 28 0 33 40 0 1 
0 35 0 0 27 0 0 0 6 0 7 0 2 3 5 15 0 2 0 0 7 18 23 0 15 6 0 13 0 0 0 27 0 0 0 0 35 0 0 7 18 0 
0 0 4 16 0 0 0 3 0 0 0 0 6 0 24 4 0 3 7 0 18 0 0 10 0 18 0 0 21 0 0 0 0 6 7 6 36 0 0 11 26 6 
5 0 0 19 0 0 9 0 33 14 31 0 0 17 2 8 52 0 15 0 0 0 19 12 15 9 0 13 13 0 3 0 8 15 8 4 0 0 23 23 25 58 
14 0 0 0 0 0 20 0 0 6 6 0 0 13 0 10 5 9 0 10 0 8 1 0 0 13 14 0 3 10 0 10 0 0 0 2 36 10 0 0 1 3 
0 7 2 15 20 0 27 57 0 3 23 2 0 2 18 16 21 1 3 21 8 0 3 2 32 9 33 11 4 0 0 0 4 50 0 0 22 11 31 0 21 16 
43 0 1 11 31 10 3 4 6 11 17 0 14 4 8 1 0 2 9 1 2 3 16 0 8 1 12 0 28 0 0 0 0 0 20 0 0 0 5 17 0 2 
112 24 2 0 0 7 0 0 10 28 11 0 0 15 27 18 16 0 18 29 1 10 22 5 24 36 24 6 2 29 5 8 1 6 12 0 5 24 3 0 25 20 
19 0 27 6 19 1 0 0 30 7 0 14 6 0 0 1 15 17 0 0 9 1 0 20 44 13 0 11 0 6 0 6 0 3 17 0 10 10 32 0 0 2 
0 0 0 6 10 0 9 17 13 4 13 0 12 0 0 8 3 0 0 0 18 19 1 0 17 6 0 0 7 9 0 6 0 13 7 3 13 0 18 0 18 13 
0 0 7 37 13 0 0 0 0 19 0 0 0 13 0 45 3 13 5 15 0 9 0 0 0 11 0 18 7 21 25 0 15 11 34 0 0 16 17 0 47 34 
28 0 35 2 5 0 0 3 0 0 21 0 0 6 11 2 0 3 18 21 2 0 0 19 13 25 18 0 0 0 0 26 25 2 0 0 18 36 1 44 0 11 
0 22 0 15 0 31 25 33 3 18 21 0 25 9 0 0 0 0 12 0 0 19 0 0 0 13 0 13 0 0 38 26 0 0 0 3 0 11 15 0 55 13 
