42 24
0 0 0 0 0 41 0 0 0 16 16 0 13 9 0 0 0 22 23 0 14 1 5 0 14 17 6 6 0 6 46 0 15 7 7 0 19 14 0 18 7 0 
0 0 0 0 22 10 28 15 0 20 18 9 0 0 0 0 0 3 0 0 0 12 15 11 0 0 22 0 0 3 1 5 0 0 11 0 30 0 0 13 0 0 
0 0 15 24 7 25 7 4 46 0 0 10 14 26 12 0 26 0 34 8 24 9 17 18 28 0 2 3 18 27 6 17 58 17 6 10 36 0 20 26 32 36 
0 5 0 0 29 3 24 17 0 53 18 24 0 6 0 0 3 11 12 8 19 0 4 0 0 18 0 0 24 0 12 0 0 17 15 10 20 4 0 0 0 22 
0 0 0 11 45 3 15 0 2 4 5 0 0 29 55 0 2 3 2 1 13 19 6 0 0 20 0 10 2 13 7 17 0 16 2 0 33 35 4 25 4 4 
7 0 29 0 10 30 0 0 3 0 6 11 13 0 0 0 15 22 0 2 0 16 0 6 3 0 11 0 5 0 6 11 0 0 0 0 13 0 0 1 0 0 
0 36 0 0 11 4 4 0 6 22 2 0 22 6 0 12 0 17 6 13 3 0 3 32 0 16 3 0 0 0 24 8 18 0 20 13 0 33 17 0 3 0 
28 0 29 32 0 24 29 22 8 7 34 0 0 0 0 10 15 12 0 0 16 10 0 20 23 19 11 0 21 46 3 3 27 0 0 5 0 45 8 0 0 17 
0 0 10 0 5 15 11 0 24 0 8 0 0 9 27 0 26 0 4 23 15 0 0 0 8 3 10 0 0 6 11 7 29 9 3 6 4 0 0 23 0 31 
0 7 0 5 27 6 0 22 30 0 10 6 0 18 0 9 0 1 10 5 10 22 0 0 9 0 0 0 0 3 0 58 25 12 6 0 0 27 4 0 3 0 
33 0 35 0 9 0 4 0 0 23 13 0 10 26 6 9 1 7 18 17 32 24 16 10 0 6 13 0 6 0 0 0 27 23 0 24 9 0 4 26 5 13 
26 25 18 25 15 1 21 0 24 32 0 21 6 0 33 0 0 5 26 2 0 7 0 17 10 3 26 21 24 17 0 2 14 5 0 17 10 35 9 0 26 35 
51 0 13 0 12 11 0 3 8 19 0 0 0 0 0 31 1 11 1 10 0 0 0 0 2 0 2 0 19 15 0 0 9 0 12 0 36 0 0 0 32 0 
17 0 0 0 31 0 0 0 0 0 0 0 13 21 4 0 0 17 4 2 9 10 0 0 0 0 0 0 9 2 0 0 0 0 17 29 0 11 4 0 0 1 
11 23 0 0 29 32 10 0 0 0 0 14 0 0 0 0 14 0 12 0 0 20 0 0 26 0 0 3 10 0 0 15 7 32 0 0 0 11 5 25 0 10 
0 11 28 31 0 0 13 16 0 1 9 6 5 3 0 6 15 0 17 3 11 8 4 16 5 0 4 0 0 0 11 11 0 0 52 12 35 35 0 0 0 0 
0 0 33 0 30 16 8 0 21 1 6 2 22 14 0 0 0 1 6 7 0 0 4 5 9 9 10 26 0 5 0 1 1 5 1 33 14 0 0 0 0 0 
17 0 1 0 13 15 5 2 15 0 0 49 0 7 13 0 11 20 0 0 31 10 1 10 10 0 20 0 0 11 0 16 3 3 13 12 0 0 0 0 0 30 
0 0 9 0 0 33 27 0 0 41 20 0 3 0 16 0 0 3 18 3 4 0 3 17 13 0 10 0 11 24 4 0 12 27 0 0 0 0 33 48 17 5 
0 7 14 0 29 0 4 0 14 0 18 6 17 14 0 23 7 6 0 0 1 0 0 13 23 0 0 14 17 10 9 8 0 0 0 9 23 2 23 19 0 32 
0 0 2 0 26 0 19 0 0 0 11 0 28 12 0 0 1 18 0 0 15 1 0 0 22 0 4 0 9 0 10 15 0 12 14 0 1 0 0 1 0 0 
0 8 0 0 32 35 12 0 1 4 48 6 28 0 60 5 31 0 0 0 5 7 0 0 1 0 0 0 17 1 0 26 0 19 6 15 55 5 28 24 28 25 
0 0 7 0 0 36 15 27 0 0 0 0 28 0 0 0 0 0 37 18 8 0 2 3 0 0 3 0 8 0 7 0 11 15 27 5 0 0 0 0 23 33 
0 0 0 0 14 0 2 26 0 22 0 0 11 3 0 17 0 0 0 16 16 0 0 17 0 0 6 0 0 12 8 0 21 45 25 3 0 0 12 0 0 33 
