42 24
1 17 1 2 13 3 6 0 71 4 13 1 46 12 0 0 0 35 0 0 12 8 15 0 22 26 0 0 20 30 22 10 0 0 18 6 31 2 0 27 13 27 
4 6 1 24 3 16 16 15 8 4 21 2 32 34 17 3 0 0 11 0 30 21 56 9 10 14 8 0 0 11 8 12 18 0 0 0 0 0 16 22 3 14 
74 0 20 3 18 11 0 0 0 0 12 0 21 26 0 0 30 0 16 0 1 7 32 4 0 0 0 0 5 0 0 7 0 0 0 23 20 47 6 14 59 0 
18 16 0 24 0 0 0 0 2 0 9 0 0 0 39 0 0 5 18 0 13 0 5 0 0 0 0 0 1 3 0 18 0 31 0 10 0 20 0 0 26 0 
10 22 0 16 0 15 30 0 9 27 25 49 0 5 0 0 12 6 21 1 0 19 2 35 11 0 3 2 11 0 0 13 18 0 3 17 10 5 20 44 0 4 
35 0 2 0 1 23 29 3 0 35 0 0 0 9 0 32 8 0 17 7 0 12 0 0 17 0 21 1 11 2 0 0 0 2 0 69 27 4 4 3 25 17 
0 39 73 0 0 27 58 0 15 0 0 0 6 0 0 3 9 12 1 0 1 0 4 0 15 0 20 11 0 3 0 1 0 0 0 0 34 32 0 6 56 44 
3 37 0 0 0 24 11 0 0 0 0 11 0 0 3 0 0 3 0 4 19 4 1 4 0 0 0 0 0 22 0 1 6 0 3 0 3 0 19 0 0 6 
0 13 0 12 8 0 0 0 23 5 6 13 10 0 8 0 1 0 0 4 9 1 0 7 0 0 0 0 0 3 11 20 3 0 19 0 4 15 0 0 0 0 
0 25 0 0 50 0 32 33 9 5 0 7 0 0 13 16 18 8 23 0 5 5 18 0 0 21 0 5 13 1 8 0 5 13 6 8 0 4 36 0 31 72 
0 0 0 13 3 0 0 0 0 0 0 0 2 0 0 0 5 0 0 0 0 0 0 0 5 0 14 7 0 5 0 19 0 4 0 5 3 0 0 0 14 14 
3 0 0 0 34 0 4 0 0 0 0 0 21 0 0 11 9 0 30 4 16 9 9 0 0 7 0 1 3 0 1 15 21 27 0 10 16 0 34 9 0 3 
34 21 39 7 0 0 5 31 30 3 37 10 4 0 0 0 11 0 7 7 21 34 21 35 10 9 7 1 0 0 0 0 0 0 28 19 15 2 61 10 6 74 
4 26 20 0 3 25 29 0 13 26 6 14 0 0 23 0 19 2 0 2 0 6 20 0 0 13 5 0 4 1 30 0 4 5 20 33 0 0 0 0 13 6 
3 5 0 0 0 0 0 18 3 0 0 0 49 9 13 0 0 1 0 0 0 0 3 2 0 17 0 4 0 0 0 0 0 0 22 0 0 0 12 2 0 29 
0 38 0 0 24 5 0 0 0 0 28 0 3 4 33 7 10 5 7 18 15 25 15 0 0 10 0 9 10 13 0 0 17 12 18 0 11 15 0 0 0 8 
15 0 15 0 0 0 43 13 0 0 0 25 24 26 5 0 0 26 10 0 0 4 0 9 7 0 20 10 0 23 4 8 1 12 7 0 68 10 0 24 2 3 
33 0 0 0 32 0 0 0 22 21 10 18 0 24 0 0 0 9 0 0 0 7 11 0 8 0 4 7 0 3 12 27 11 46 34 0 25 24 34 3 0 12 
10 38 20 56 22 17 7 1 51 0 19 19 2 4 0 0 6 0 29 3 23 19 33 0 0 0 16 1 21 23 0 2 14 12 41 2 0 29 0 62 21 0 
0 5 0 11 13 0 0 0 19 0 4 0 18 0 36 0 0 13 0 0 0 10 0 0 0 1 15 0 0 0 0 0 0 0 0 14 0 0 0 0 0 8 
2 36 0 81 9 16 9 40 18 13 11 12 3 22 56 2 0 12 10 3 8 10 19 16 12 0 5 8 0 12 33 17 18 11 31 6 29 8 0 19 10 38 
34 0 23 0 0 3 0 0 33 9 6 21 0 0 0 16 13 5 0 0 0 0 0 15 1 19 2 3 0 0 1 18 0 11 4 17 0 0 0 0 19 0 
6 1 34 11 0 0 25 0 22 0 7 17 30 17 0 14 0 0 17 0 0 15 0 0 1 13 11 0 2 23 22 25 0 13 0 24 1 8 0 11 0 0 
0 0 16 9 0 0 0 0 23 0 0 0 0 22 15 0 13 0 16 0 0 26 0 0 0 0 11 0 0 5 27 12 0 0 0 11 0 46 0 36 17 0 
