42 24
0 1 0 29 0 20 20 12 3 1 22 7 0 0 41 0 0 0 0 12 0 7 29 4 0 0 0 0 7 0 0 0 23 0 11 16 1 6 15 0 26 0 
2 6 0 62 82 0 34 18 21 5 27 39 30 36 0 18 3 1 18 0 0 18 23 0 24 17 0 0 0 0 27 0 25 20 25 0 11 46 20 25 34 7 
68 6 32 33 8 28 0 9 0 0 21 0 0 12 0 15 0 0 0 0 0 7 5 18 1 0 0 11 28 0 7 6 4 33 15 0 61 16 8 9 0 35 
0 0 7 25 28 1 0 0 5 7 0 0 0 0 18 0 8 1 15 18 0 14 0 0 0 8 7 0 0 0 0 0 46 69 32 3 0 0 12 0 10 6 
0 27 34 2 0 6 0 12 0 10 18 17 9 2 0 33 20 0 8 6 1 3 8 8 11 8 0 0 26 0 2 17 0 0 9 20 30 15 0 24 0 0 
17 3 25 23 3 0 0 0 10 0 18 0 0 18 0 0 3 0 35 54 0 4 13 1 0 6 23 21 28 1 0 1 12 2 4 27 9 2 0 20 9 23 
16 2 31 13 19 25 10 8 11 0 3 15 0 0 0 3 0 5 0 31 3 0 3 13 17 16 4 3 0 27 25 1 0 24 0 6 0 16 0 9 0 15 
0 40 0 0 24 0 0 0 3 7 9 34 11 6 0 0 0 0 13 0 0 10 14 17 0 11 25 0 30 0 5 8 0 0 0 24 0 10 0 0 15 0 
0 23 21 0 33 15 17 0 0 13 36 5 0 10 8 2 5 0 0 9 25 17 13 14 3 2 20 0 0 0 2 27 0 0 0 0 2 7 13 26 13 5 
0 0 6 32 0 6 1 1 0 0 0 3 13 0 0 2 1 6 3 0 0 25 1 0 0 0 0 0 0 0 3 5 11 9 0 32 0 15 7 0 0 0 
20 0 0 30 0 19 0 20 0 3 0 36 12 19 0 2 7 0 21 0 11 0 11 0 0 14 0 16 0 0 3 0 8 30 0 0 2 0 2 21 0 11 
0 0 21 0 2 0 23 4 4 21 7 24 0 0 12 0 1 9 0 7 0 12 0 4 0 4 0 3 0 3 0 0 0 6 0 9 0 0 29 0 0 10 
0 0 39 0 0 0 0 6 1 1 3 0 0 8 0 0 3 13 0 14 2 0 2 5 2 8 0 10 32 6 21 0 10 18 0 0 0 20 1 1 9 35 
0 39 45 11 0 10 0 0 1 4 13 0 7 5 9 5 0 17 12 27 0 0 4 13 0 0 25 0 17 0 28 0 13 0 0 17 18 7 0 11 10 19 
0 25 0 20 7 1 0 0 23 14 7 0 10 1 0 14 17 1 0 9 15 1 9 6 14 0 11 4 10 38 22 5 2 17 12 5 16 6 24 0 0 1 
62 5 0 4 0 6 5 21 0 5 8 4 0 1 6 0 0 7 0 0 0 0 18 0 9 0 6 6 21 20 0 6 0 27 0 0 0 6 3 26 0 4 
0 0 19 21 14 32 0 12 0 25 8 2 0 3 0 15 0 0 0 12 0 19 7 8 2 0 12 23 11 0 8 22 0 9 0 0 32 39 3 0 0 10 
0 1 5 0 22 17 0 0 6 0 0 16 16 22 0 0 0 0 0 9 0 13 0 9 0 0 21 1 0 0 5 3 38 0 0 0 0 15 25 4 0 0 
8 32 0 0 17 42 23 29 38 0 0 1 0 0 7 0 11 0 15 25 12 24 0 0 5 0 3 10 0 30 14 0 17 32 0 0 10 32 30 32 0 9 
13 0 23 0 32 18 10 1 0 29 0 1 12 7 0 0 10 0 0 17 0 2 0 0 0 13 0 0 26 0 0 2 0 2 0 0 32 15 29 0 0 0 
41 13 22 0 17 0 3 20 0 18 0 13 0 5 0 0 0 8 0 0 0 0 14 0 0 0 24 2 0 2 9 0 8 0 5 6 8 1 0 0 0 63 
20 0 0 20 16 55 2 0 5 0 0 20 8 5 25 0 0 0 8 17 22 0 0 8 0 17 0 0 0 0 0 14 0 29 43 31 16 0 0 29 48 0 
25 0 0 0 0 30 19 5 8 0 0 1 39 0 0 0 0 41 0 19 0 0 22 12 3 19 0 3 0 0 13 0 0 0 0 24 0 0 0 20 0 0 
41 23 25 10 11 1 3 0 11 17 21 1 0 40 0 0 12 0 9 18 9 21 5 0 0 16 0 11 6 1 0 5 0 2 6 2 33 17 0 0 0 41 
