42 24
0 21 19 0 15 22 12 0 0 2 6 0 0 11 26 4 4 0 64 0 18 3 0 1 3 0 18 53 0 0 16 0 0 39 0 0 16 0 0 39 0 0 
7 0 27 17 0 26 1 29 19 25 0 2 0 5 13 13 32 0 0 0 7 18 7 15 17 10 4 0 0 47 2 35 12 0 2 1 13 0 40 7 10 17 
20 37 6 0 24 0 0 0 0 2 0 8 5 18 18 9 0 0 0 10 9 27 0 0 0 0 16 2 29 0 0 10 18 2 6 14 0 0 37 13 13 14 
0 7 0 0 0 0 17 15 7 0 5 41 0 0 13 20 0 4 7 0 0 15 5 27 6 11 0 13 0 0 0 0 1 11 0 0 0 0 0 0 0 0 
0 0 0 0 49 0 16 31 0 0 0 4 14 3 3 0 0 0 20 0 0 0 16 33 0 0 0 19 9 0 1 18 0 0 0 0 5 14 35 0 0 0 
7 0 35 0 13 40 0 10 0 0 0 0 25 8 23 10 0 13 1 0 0 1 15 0 13 10 0 0 0 4 1 31 18 9 2 26 0 60 38 0 15 8 
0 15 54 29 17 0 1 0 2 0 4 16 0 0 5 0 12 2 0 3 24 18 0 0 0 11 1 7 0 0 0 0 31 0 0 32 5 15 36 6 7 4 
33 24 0 0 0 0 5 57 16 6 3 23 5 0 8 11 14 10 0 0 8 0 15 13 0 15 1 5 8 0 34 0 15 33 2 0 0 1 0 5 6 0 
44 5 31 1 11 13 8 13 0 23 11 24 48 1 0 3 0 5 27 0 18 17 0 7 6 12 0 26 3 12 0 8 32 10 9 0 36 0 4 63 28 7 
3 0 3 4 0 33 33 0 0 0 21 0 0 1 3 5 0 0 0 7 5 7 0 11 0 0 16 0 5 10 0 0 0 6 0 26 3 5 0 24 0 8 
0 35 0 2 40 10 0 11 0 6 15 0 11 29 21 0 0 3 5 0 3 5 18 11 0 0 17 10 12 0 0 8 22 24 0 13 27 0 8 1 0 28 
10 0 0 6 4 14 0 4 0 22 4 8 0 13 4 24 16 22 26 16 8 11 0 9 6 0 13 11 0 0 33 11 0 0 0 0 0 21 30 12 0 0 
0 0 0 4 0 0 16 0 0 5 2 4 8 0 13 10 0 0 4 1 8 14 27 10 0 0 0 0 10 9 1 0 0 4 0 3 0 1 9 25 0 0 
17 8 34 20 23 36 0 0 8 30 4 0 27 8 13 0 12 3 0 0 25 0 1 11 0 5 6 48 23 10 6 0 18 0 25 5 34 8 0 8 12 36 
0 34 0 32 44 14 7 0 0 0 3 0 0 7 9 1 0 0 0 0 16 12 21 10 6 13 0 0 7 0 27 8 10 0 0 34 0 33 19 14 0 18 
0 0 41 0 19 10 20 10 0 0 7 0 0 0 0 14 0 10 0 0 2 0 10 0 0 0 20 29 0 0 0 0 0 8 5 0 0 35 14 5 13 1 
0 0 19 7 0 0 32 15 22 32 30 0 0 16 0 0 14 0 0 0 0 19 0 0 0 0 0 0 0 0 12 0 0 0 3 0 3 0 0 0 30 46 
17 17 0 6 9 0 5 0 0 23 0 0 12 0 0 14 10 4 22 0 0 0 4 17 14 0 33 24 0 0 0 0 0 0 7 0 16 0 21 0 39 8 
32 0 0 43 3 18 15 4 0 0 9 26 17 8 25 0 12 12 12 6 10 4 15 0 28 23 44 0 8 46 15 4 40 0 2 3 10 45 15 0 0 4 
0 14 19 0 15 2 0 2 0 22 0 12 2 14 16 26 0 0 7 17 0 18 3 8 0 6 0 14 15 2 3 28 0 0 3 1 14 15 0 0 0 0 
8 0 0 0 7 0 0 16 38 0 18 36 0 19 0 0 0 14 15 0 18 6 0 8 0 14 0 30 18 0 0 0 0 12 0 27 0 0 2 0 44 0 
12 0 0 23 57 22 1 0 0 0 0 13 18 6 0 0 0 13 16 0 0 0 0 0 1 1 27 1 3 4 32 0 0 17 0 0 6 0 1 0 0 11 
9 9 0 15 0 44 6 0 11 0 30 3 7 0 16 2 0 0 55 7 12 11 17 3 9 7 0 5 0 3 0 0 34 0 4 0 0 0 0 21 8 9 
0 18 0 0 0 28 24 0 15 3 0 20 21 0 22 0 0 0 0 10 27 0 0 29 0 1 11 68 0 10 3 5 31 76 0 7 7 17 12 35 17 6 
