42 24
25 0 22 0 22 11 0 0 15 0 13 0 10 0 20 28 11 0 9 0 21 0 3 19 0 0 0 0 2 25 5 0 10 10 24 0 0 36 7 0 4 0 
7 0 19 0 41 0 0 27 5 7 0 0 0 5 0 5 0 10 6 0 0 1 0 8 0 21 0 13 20 30 11 9 0 0 0 0 20 0 15 0 58 18 
6 0 27 0 3 0 17 0 3 10 18 0 12 0 19 8 0 0 0 0 11 18 0 6 12 15 0 0 13 1 5 3 19 24 0 0 34 0 0 14 4 1 
0 0 39 64 29 0 0 0 0 23 31 2 8 18 5 0 2 12 8 0 0 5 0 11 21 6 11 0 7 0 0 23 7 24 4 1 0 0 0 11 0 6 
0 28 0 51 3 0 35 42 0 0 8 23 0 0 20 0 0 13 0 0 3 5 1 28 0 4 3 1 17 19 12 8 8 7 16 6 3 8 9 5 16 35 
0 39 2 0 3 0 10 2 7 10 1 5 24 37 23 7 9 0 13 13 0 21 13 16 0 9 0 16 14 0 24 14 1 0 11 1 0 21 0 3 0 0 
6 23 0 0 0 1 0 37 21 12 0 10 0 0 11 1 1 2 12 8 19 6 0 6 0 0 17 1 0 33 12 6 0 0 3 16 0 19 2 19 5 1 
0 29 1 8 6 30 34 5 5 16 8 0 0 9 0 25 0 2 29 0 8 5 9 0 6 0 5 7 8 10 40 0 23 5 36 0 7 7 7 0 44 6 
16 0 0 20 8 0 0 30 21 0 0 3 19 2 3 3 16 1 16 6 0 18 15 18 4 5 0 0 0 39 0 3 7 8 15 0 0 30 0 17 0 24 
9 0 52 48 0 29 17 13 12 0 22 0 0 53 8 0 0 0 11 3 12 0 25 3 22 0 21 0 0 28 4 0 19 30 0 0 25 36 0 2 0 28 
33 0 3 0 0 3 0 3 0 10 0 26 3 0 0 0 0 9 0 0 0 18 1 14 8 7 9 2 0 2 0 0 0 57 0 6 0 26 0 16 3 0 
0 0 15 38 10 12 3 0 8 13 3 6 0 0 10 0 0 6 6 10 0 4 0 0 8 13 9 0 0 17 16 0 15 7 25 0 0 4 36 22 31 42 
0 1 12 0 2 0 0 1 0 29 7 0 14 3 7 0 0 10 28 10 0 1 0 0 10 39 0 6 0 32 21 8 10 0 0 0 0 8 42 2 22 0 
0 32 6 37 13 0 0 7 33 0 0 7 12 10 0 14 7 2 0 0 8 17 10 9 3 5 23 4 1 17 0 0 30 14 8 14 0 0 0 0 34 45 
0 0 0 0 37 18 3 0 0 43 5 23 0 21 23 1 0 0 0 0 0 0 14 18 15 11 0 2 0 6 0 0 15 13 52 26 31 8 28 0 17 0 
3 10 0 0 0 0 0 0 4 0 27 0 0 0 24 0 3 0 0 0 13 8 0 4 0 8 0 32 9 8 0 0 6 13 0 0 22 3 0 7 0 0 
37 0 38 0 0 0 14 1 0 11 5 0 2 0 3 18 0 14 0 0 0 0 7 0 0 2 0 14 0 0 6 16 0 0 0 6 2 37 0 0 50 0 
34 0 0 1 17 31 0 1 0 1 0 0 0 16 11 0 7 0 0 0 4 13 0 7 19 0 0 0 0 8 0 0 0 0 81 0 25 8 0 0 27 0 
31 1 0 27 18 22 16 1 5 6 6 24 0 18 8 24 10 0 4 0 14 0 5 14 8 0 0 0 0 10 0 0 0 0 0 24 4 23 0 0 0 0 
0 36 0 12 0 2 1 14 2 0 0 6 14 0 0 0 0 9 3 0 0 0 0 0 0 0 0 3 0 0 0 0 0 0 0 0 3 36 2 0 0 0 
3 7 11 3 0 2 0 0 26 0 18 0 21 0 0 0 9 0 11 0 0 15 6 10 0 0 0 7 7 11 0 0 6 14 8 6 1 0 0 0 0 0 
30 41 0 34 13 0 5 25 21 0 0 1 5 0 15 14 23 10 0 0 21 19 14 20 0 0 3 0 3 25 31 1 16 0 0 0 16 15 2 23 4 9 
0 0 22 51 0 20 0 0 30 0 22 8 0 3 0 5 3 0 3 16 1 0 3 0 0 17 19 0 0 10 18 0 24 13 2 22 0 0 65 19 11 14 
5 10 5 43 10 1 0 6 17 39 0 10 2 32 48 13 13 14 16 17 5 14 0 0 0 72 7 18 0 35 0 14 47 21 0 22 5 17 0 0 26 9 
