42 24
7 39 9 14 0 0 1 5 44 0 6 2 20 14 8 0 7 0 0 33 0 13 0 28 0 29 0 6 14 1 25 18 2 0 1 15 0 12 0 0 39 0 
29 0 2 34 16 0 6 20 0 3 8 0 37 5 12 0 0 9 1 19 16 5 0 4 19 0 9 0 0 24 19 16 11 0 0 17 24 15 8 0 28 3 
2 0 2 0 53 0 2 33 15 5 0 4 13 0 14 7 0 20 0 0 0 0 14 8 57 24 9 0 17 5 0 6 9 9 16 12 11 4 42 2 46 23 
0 4 13 0 34 0 0 0 1 0 0 0 11 4 0 30 41 4 0 7 0 0 0 38 0 10 0 0 0 0 0 0 8 0 0 19 13 0 12 20 0 0 
0 0 16 11 16 13 15 21 15 27 4 7 29 54 0 10 20 11 11 15 2 20 29 13 16 3 13 2 41 4 6 0 0 4 0 6 47 0 0 39 0 14 
0 0 25 23 2 17 0 0 24 0 0 0 8 0 0 0 8 0 1 0 0 26 25 2 21 1 22 0 0 4 0 0 9 0 10 30 0 16 12 9 1 37 
0 17 21 6 23 0 0 11 0 3 21 0 6 5 0 37 13 0 8 0 15 3 13 16 10 17 0 16 2 5 6 13 5 0 0 26 0 24 1 29 12 0 
4 4 14 0 14 17 0 0 0 5 0 0 8 0 0 0 5 12 14 0 0 9 17 4 3 24 0 13 8 0 0 7 0 8 0 10 0 0 13 0 6 0 
40 8 3 25 29 0 0 14 3 32 2 0 0 0 0 8 0 6 0 16 0 12 11 9 17 0 0 24 0 0 13 0 0 29 14 0 2 37 5 0 21 49 
37 0 12 21 15 0 67 5 0 22 8 0 17 0 0 11 7 0 0 0 0 0 13 0 21 16 16 0 0 0 9 0 7 0 28 35 30 0 26 0 0 0 
6 0 29 0 8 6 1 0 21 0 0 0 10 0 0 0 0 2 0 11 0 12 0 0 4 13 0 0 0 0 0 0 0 0 0 0 0 0 0 0 0 0 
3 10 37 3 2 12 36 5 4 30 0 0 0 8 25 24 0 0 9 4 9 0 0 25 12 24 0 0 14 9 17 0 30 0 3 27 20 10 10 99 10 18 
0 0 2 0 17 10 27 21 0 6 6 4 0 0 0 10 0 0 0 16 17 0 0 0 17 24 0 38 0 9 11 4 9 0 0 12 0 19 2 13 0 6 
0 0 43 0 32 5 63 0 0 0 11 0 21 0 0 0 0 0 10 0 4 28 0 13 0 7 0 7 0 0 28 13 11 4 9 0 0 31 61 27 0 8 
0 20 27 17 5 33 0 8 1 3 0 2 0 21 0 24 0 0 0 17 0 17 10 0 13 9 0 0 0 14 0 0 27 3 99 14 0 9 6 9 5 4 
10 0 26 11 0 0 35 0 7 5 10 0 9 7 11 0 16 15 19 0 0 0 0 0 0 12 0 3 0 0 3 0 2 0 10 0 34 0 0 0 0 35 
6 21 11 0 17 42 0 12 18 0 0 26 24 5 13 17 3 0 0 0 0 23 14 0 11 0 0 0 9 25 0 0 11 0 0 0 37 38 0 0 3 30 
0 0 4 29 0 7 24 24 5 0 3 0 23 6 2 24 0 25 8 5 4 1 0 0 0 4 0 5 0 1 5 16 16 5 0 0 6 49 28 23 8 0 
38 0 1 76 0 53 6 25 2 6 4 0 31 1 0 0 0 17 13 0 4 0 0 0 4 0 0 0 18 1 26 18 96 0 9 17 0 14 23 36 0 19 
0 0 0 14 3 4 0 7 52 52 9 5 0 0 11 0 18 2 6 25 0 12 0 0 0 3 0 0 20 0 22 16 0 3 0 0 11 0 0 0 13 32 
13 11 5 0 7 0 0 0 5 5 0 7 2 0 0 0 0 0 9 14 0 20 0 0 16 0 0 0 10 21 19 0 28 14 16 0 0 0 12 3 17 2 
0 10 55 0 0 0 0 21 0 50 0 0 0 0 0 15 0 0 0 0 0 11 0 0 0 4 0 25 0 20 0 0 0 0 0 15 0 28 0 0 0 0 
0 0 0 5 0 0 0 2 0 23 0 19 21 0 1 1 17 30 0 22 0 0 0 19 18 0 0 0 0 0 0 3 0 31 10 0 25 0 0 0 0 0 
44 0 2 0 12 2 0 10 13 39 20 6 19 0 0 19 0 8 0 0 0 9 15 21 0 11 0 11 2 7 21 0 3 33 9 21 11 36 16 0 0 0 
