42 24
6 5 17 4 0 0 6 0 0 0 23 10 4 0 8 0 11 11 5 2 1 0 4 0 11 0 0 26 23 0 0 0 0 0 0 11 0 14 0 0 14 0 
0 22 38 14 7 0 6 9 21 0 0 0 14 7 13 17 13 26 1 16 13 13 0 4 15 0 12 3 0 21 13 14 0 0 10 3 0 3 0 38 29 0 
0 7 0 0 63 0 0 15 15 2 0 13 13 0 0 0 0 17 4 0 0 13 48 19 19 14 0 0 0 0 0 4 28 15 0 11 0 0 0 0 0 0 
58 0 14 34 0 0 26 17 6 23 0 0 1 10 0 18 4 0 0 3 0 3 0 0 45 0 5 0 0 13 17 0 6 35 34 0 0 34 0 11 9 0 
0 0 22 128 39 0 1 23 1 25 4 1 18 0 0 11 3 5 12 1 0 18 37 0 9 13 16 5 19 0 25 17 27 0 0 3 0 21 0 31 18 22 
0 0 5 0 3 0 0 3 5 0 4 3 5 1 3 11 0 18 0 5 0 0 0 0 0 5 0 0 0 0 8 15 0 0 0 5 0 0 0 0 15 0 
3 9 0 19 0 0 5 37 5 0 31 9 7 0 13 12 3 17 0 4 0 0 18 0 7 4 13 4 0 21 0 0 15 7 7 0 0 0 0 10 18 0 
8 14 0 0 13 5 18 12 11 0 15 0 1 0 0 14 0 16 0 1 2 0 0 0 4 0 0 0 4 23 13 0 13 0 0 0 0 8 19 0 0 0 
6 0 23 0 3 0 23 17 0 4 0 0 10 3 7 4 13 0 0 0 0 20 18 0 17 23 12 2 51 0 0 18 0 8 0 29 0 0 0 2 18 45 
18 0 8 32 3 0 0 7 23 0 0 0 1 7 0 11 16 0 11 7 9 0 0 27 0 21 0 5 0 0 14 34 15 0 0 36 0 2 0 3 36 10 
52 0 13 16 0 0 0 14 8 0 0 0 27 20 12 0 16 12 6 41 7 0 10 0 3 22 0 13 0 11 1 0 5 33 0 23 18 0 2 2 20 0 
36 0 41 1 0 20 5 48 0 19 18 0 5 3 0 0 9 1 0 7 4 0 6 18 0 6 0 0 24 0 0 10 0 1 0 0 25 0 31 14 47 18 
0 39 13 32 10 0 5 27 0 0 24 0 23 9 8 17 14 0 0 5 0 3 15 0 5 0 0 0 11 0 0 1 0 5 6 49 0 0 7 6 30 6 
26 3 18 6 66 5 0 0 16 7 0 0 11 3 26 0 0 0 16 6 2 11 20 0 9 13 25 12 10 7 30 0 0 7 0 0 0 0 34 0 20 37 
12 38 2 0 0 33 29 3 22 3 1 1 4 22 13 0 0 0 21 23 0 0 6 0 0 0 18 13 1 10 0 31 41 0 0 22 0 14 32 48 16 0 
26 24 0 4 0 0 0 11 25 37 21 17 12 6 26 0 26 21 20 4 10 2 0 0 0 0 7 15 17 0 29 2 0 33 3 0 6 8 2 23 0 32 
0 0 2 3 21 2 3 15 3 0 0 23 0 23 12 23 0 0 0 10 13 0 0 15 25 38 28 0 0 0 0 0 0 0 21 0 33 0 35 14 0 0 
34 0 25 23 0 2 19 16 23 0 1 7 0 0 17 0 0 42 16 9 0 13 15 8 3 37 7 0 4 0 0 4 8 10 34 1 0 34 5 0 0 24 
35 17 0 5 10 5 0 0 0 0 0 5 10 11 0 58 5 0 11 22 17 0 0 0 17 0 0 0 0 0 0 0 3 18 6 62 0 0 0 20 6 0 
82 0 0 19 27 19 0 14 0 22 8 37 0 0 0 12 0 2 0 6 0 0 11 9 5 0 13 0 9 2 13 39 6 33 0 0 0 27 17 0 0 0 
27 42 34 1 13 0 32 24 0 3 14 1 3 0 8 0 0 0 0 8 17 0 31 0 0 6 7 0 9 0 17 10 0 0 0 27 1 15 69 0 0 0 
31 14 7 0 3 26 0 15 0 15 11 14 0 13 0 0 5 0 16 3 0 14 3 19 2 33 15 0 17 0 4 71 19 7 3 7 0 0 0 21 0 16 
0 0 41 30 3 0 15 34 5 0 0 0 0 4 1 0 23 14 0 2 21 48 0 7 2 23 9 23 47 9 10 0 8 10 1 5 0 9 1 31 0 0 
9 15 21 5 0 12 0 12 22 21 22 0 4 13 15 0 3 18 24 0 0 6 0 0 9 8 15 6 68 0 19 0 16 17 0 0 18 0 0 0 30 15 
