42 24
17 53 70 0 0 37 0 12 4 0 0 0 12 18 32 9 0 19 0 2 7 0 19 11 20 1 0 0 0 27 0 9 0 19 32 0 27 0 33 31 9 18 
0 0 8 0 0 6 0 6 0 4 0 16 0 2 9 0 2 6 0 14 4 22 0 0 10 1 0 0 0 0 6 11 0 0 32 0 0 0 24 0 0 21 
0 0 0 16 0 18 14 0 0 0 26 0 2 0 4 5 0 0 4 21 0 0 19 17 0 0 15 10 17 0 0 0 0 0 18 0 33 10 0 3 0 0 
0 0 25 0 37 0 4 0 0 1 15 0 24 0 17 7 2 4 16 0 6 0 2 12 32 0 4 9 23 27 0 0 0 5 10 5 38 0 0 0 0 9 
0 4 0 33 0 4 0 0 0 24 0 27 0 0 3 0 7 17 14 0 18 0 0 18 8 0 0 29 1 1 21 0 14 3 14 5 10 0 56 0 22 19 
3 4 14 33 0 0 28 0 0 13 16 12 12 0 0 23 14 0 0 8 0 0 0 4 9 9 16 1 5 0 16 0 16 0 33 0 0 0 0 19 10 0 
0 0 13 7 0 0 4 4 0 0 0 0 4 0 9 15 19 7 18 0 8 0 0 0 14 13 0 10 5 0 0 0 0 0 0 0 26 0 3 22 0 0 
21 7 34 0 20 0 0 15 10 33 0 3 24 21 4 1 0 6 4 18 18 0 38 1 20 0 17 0 0 0 13 0 13 3 21 17 3 0 0 7 1 16 
0 0 28 7 0 7 31 49 40 0 93 0 2 24 1 0 14 0 0 3 25 19 0 0 14 0 6 0 0 0 26 0 4 0 0 23 12 7 1 0 17 0 
27 4 3 3 23 8 14 0 0 33 17 0 8 9 26 1 0 6 0 0 12 0 2 6 0 23 9 40 19 9 0 9 32 31 0 3 0 0 0 0 0 27 
0 56 0 0 0 0 2 3 3 5 0 0 2 0 18 0 0 0 0 0 0 0 0 0 0 24 0 0 25 4 0 0 0 9 0 34 0 0 10 0 12 0 
3 21 5 23 22 0 31 28 21 0 29 11 0 0 13 0 27 19 1 9 4 13 0 17 11 4 1 0 6 10 17 0 9 0 7 3 32 59 5 80 32 8 
0 8 0 11 32 0 1 20 8 0 0 0 9 18 4 10 4 7 1 12 0 9 15 0 1 21 0 0 0 0 8 7 0 0 0 0 33 10 1 0 24 0 
40 0 32 0 31 0 15 14 3 0 0 8 0 0 22 0 9 10 0 8 26 15 11 9 0 16 15 0 0 0 0 0 0 0 37 28 0 0 17 8 31 1 
33 0 8 0 0 26 0 0 28 0 15 0 14 0 13 0 2 0 0 0 8 1 1 0 3 27 0 9 0 4 22 24 0 0 0 0 11 0 2 27 0 0 
0 14 36 5 30 1 28 33 3 13 46 3 6 4 22 10 0 4 0 0 2 18 12 6 10 11 5 11 0 16 0 17 6 1 31 18 0 31 80 10 6 0 
7 0 22 0 0 7 10 13 0 0 30 46 23 7 14 2 11 12 13 4 6 0 0 1 22 15 2 21 0 13 8 5 0 0 37 0 0 0 5 3 38 15 
3 2 0 0 0 19 0 7 0 0 17 10 5 1 0 0 26 0 1 7 0 12 1 0 0 0 15 22 0 0 2 19 6 1 1 4 6 7 8 4 11 0 
3 0 0 30 0 0 32 0 1 13 0 5 19 9 1 3 25 22 1 0 0 5 0 0 14 0 0 0 0 12 0 10 3 0 17 0 26 0 13 8 1 0 
0 0 0 0 0 0 23 9 38 0 5 20 3 3 34 2 19 0 0 9 6 5 0 12 18 17 1 5 17 2 0 15 39 28 0 0 1 6 6 2 0 22 
0 0 0 0 0 34 18 25 24 3 0 0 27 13 0 4 4 16 13 8 13 0 14 0 2 0 2 8 0 0 28 5 0 3 34 20 21 13 8 14 13 17 
0 0 30 0 11 20 0 2 13 0 0 0 0 0 19 3 0 10 0 0 33 13 0 0 14 0 0 0 0 3 0 0 20 20 0 12 0 0 13 0 20 0 
0 0 24 0 24 0 0 0 4 30 0 0 0 9 10 15 30 0 0 15 2 1 18 0 0 3 24 18 3 0 0 0 0 0 0 0 15 10 0 30 6 25 
37 36 9 32 12 0 0 28 7 29 41 8 3 0 9 5 4 14 0 21 5 14 0 0 0 5 0 0 24 8 0 0 0 19 3 41 0 13 0 36 5 37 
