46 26
46 5 24 0 0 12 1 6 0 24 0 15 29 0 35 0 15 0 0 15 0 5 0 0 19 20 2 18 14 2 0 29 0 49 0 21 0 3 0 0 0 37 0 3 23 6 
0 19 1 0 6 5 15 28 22 33 1 18 0 0 0 0 21 0 3 14 0 9 18 9 0 18 6 0 20 19 0 0 22 0 25 31 0 0 0 0 0 0 0 18 28 3 
25 0 54 0 16 28 7 0 7 7 17 30 0 7 18 9 23 6 21 30 1 15 0 23 0 0 12 9 2 7 30 2 18 36 16 17 0 0 0 0 0 13 0 5 31 0 
86 19 0 0 0 0 12 19 33 28 18 29 0 82 11 0 24 0 18 11 13 2 0 19 14 8 0 12 5 21 10 18 0 24 43 9 18 5 38 15 22 41 0 0 10 0 
29 39 0 26 10 4 10 16 34 7 0 36 11 0 36 4 16 10 0 0 0 0 0 7 0 7 12 6 14 0 0 30 7 30 0 3 1 0 0 0 37 0 3 0 14 8 
0 44 13 0 11 0 28 0 0 0 15 4 20 2 12 9 0 6 0 77 15 22 0 22 3 7 0 45 8 9 9 5 2 16 14 2 5 6 0 0 25 0 23 6 0 26 
20 1 1 0 19 34 3 7 49 28 16 33 34 14 0 6 5 0 0 0 11 19 19 21 1 17 0 14 17 0 0 0 36 0 23 0 0 12 3 93 0 33 13 0 2 6 
61 0 0 0 23 31 5 0 17 10 44 0 33 31 0 12 15 12 11 10 0 0 0 54 0 30 14 21 34 28 3 17 13 0 12 12 2 0 11 0 0 31 19 27 0 35 
0 5 6 0 0 11 17 0 20 17 0 13 0 12 2 0 0 4 0 0 0 17 14 0 11 9 0 0 32 0 0 0 27 8 0 0 1 8 0 0 23 8 0 15 7 3 
31 0 0 0 0 0 28 28 0 36 12 0 36 18 0 7 18 15 0 0 0 11 7 3 0 0 0 0 14 18 4 27 0 0 26 0 0 0 3 0 5 0 30 13 0 36 
0 0 0 0 0 0 7 0 0 10 0 0 15 0 53 0 0 0 0 0 6 0 5 6 0 0 4 0 11 0 7 0 0 8 3 0 0 25 0 17 0 27 0 0 0 0 
3 0 0 32 0 18 7 21 5 4 32 0 5 0 14 0 0 8 0 11 0 0 12 4 0 51 8 0 27 7 12 0 2 0 13 2 6 1 0 0 0 6 32 8 0 0 
9 24 43 0 0 62 22 0 0 30 1 0 0 28 18 6 12 0 12 4 0 36 14 0 0 4 0 21 3 0 26 0 7 19 0 0 8 0 0 0 31 64 0 7 14 47 
13 1 9 21 20 8 0 16 34 7 5 12 12 0 5 0 1 5 1 31 8 30 5 16 12 1 2 5 0 10 3 6 32 14 0 0 0 0 37 0 0 0 34 63 11 0 
3 40 1 42 7 16 8 4 0 26 4 43 0 11 31 0 14 15 10 5 0 11 5 18 7 0 12 0 7 3 5 1 17 0 11 9 0 0 0 34 0 108 0 0 11 0 
0 0 3 25 67 0 0 0 0 0 3 14 26 3 15 0 24 0 2 24 32 1 19 2 12 6 10 6 8 15 0 3 28 12 0 4 0 0 6 15 0 8 3 38 0 1 
0 0 11 0 0 0 15 0 0 8 0 18 5 13 0 0 0 26 0 18 0 0 0 0 0 7 0 0 18 20 2 0 5 0 9 18 8 0 5 6 0 21 0 6 0 5 
42 4 9 1 12 27 18 0 0 32 0 9 0 10 0 0 0 4 0 2 0 13 0 2 32 12 0 6 25 26 0 0 27 6 0 0 0 0 0 0 0 0 42 0 0 2 
0 21 35 0 0 12 0 36 35 30 30 0 0 0 17 0 0 12 0 16 0 8 29 16 0 17 1 14 2 22 3 2 0 20 24 0 1 8 0 0 5 36 0 23 21 0 
0 0 43 0 9 1 0 1 0 0 17 0 13 25 11 7 23 2 0 1 0 0 34 0 11 2 4 11 0 10 0 6 0 0 9 28 1 0 0 0 0 38 0 15 0 45 
0 6 0 37 26 9 4 1 0 0 0 0 11 17 0 0 0 0 0 0 6 21 0 2 0 23 21 0 0 51 26 15 15 0 1 0 3 0 13 0 54 0 5 0 0 0 
14 0 0 10 15 0 5 11 30 17 41 19 12 0 3 0 10 19 24 16 0 54 22 13 12 0 31 0 0 0 10 0 14 2 1 25 33 0 0 0 0 3 15 26 22 0 
32 43 0 19 0 31 0 0 49 44 16 28 0 0 0 29 20 0 1 3 7 0 1 32 12 7 0 15 0 0 0 0 39 22 0 26 56 0 7 19 18 1 0 0 42 0 
0 21 0 47 1 33 2 0 22 0 18 0 0 13 0 12 0 0 15 0 3 0 21 3 0 31 7 12 20 0 0 14 0 12 40 0 0 0 33 0 0 8 0 0 1 1 
34 20 34 0 16 0 4 0 19 18 0 21 0 0 0 27 0 31 0 19 16 20 0 17 14 2 0 6 19 0 0 0 21 0 0 0 66 0 15 0 19 0 0 35 0 0 
19 0 29 26 29 0 35 0 22 2 0 0 0 9 0 0 13 0 12 0 19 40 35 0 0 0 5 0 0 25 4 16 11 18 29 4 0 0 0 23 0 0 15 25 11 0 
