46 26
0 22 18 0 0 20 38 16 24 0 32 26 6 5 1 0 0 0 0 17 0 2 0 27 0 32 0 0 20 0 0 0 0 0 0 7 0 25 28 0 9 13 32 0 71 2 
31 0 15 7 19 37 51 25 0 0 20 37 0 2 11 38 20 34 3 4 21 20 8 23 18 9 0 4 0 0 23 1 24 0 0 3 25 37 0 1 0 0 0 6 0 28 
4 3 24 12 4 11 0 59 8 0 25 34 0 1 5 0 49 0 11 14 34 15 0 10 26 1 3 16 4 13 0 34 25 14 0 0 15 23 1 19 0 10 2 27 10 2 
32 51 0 0 0 0 0 7 0 0 28 0 0 7 0 0 0 26 36 4 5 0 20 4 0 0 23 26 28 0 12 0 7 0 0 0 12 0 15 0 12 7 44 26 3 18 
0 16 0 2 0 27 0 0 0 6 3 0 0 12 11 10 0 25 0 4 9 9 0 0 18 11 18 8 0 0 5 0 0 0 0 3 0 2 0 13 0 0 13 14 14 0 
0 26 24 13 0 0 0 0 0 0 22 17 12 0 0 12 0 5 0 0 0 0 0 0 11 10 5 8 6 0 10 15 14 0 6 0 10 7 0 11 14 17 19 0 7 18 
13 37 0 12 0 30 0 7 0 0 35 49 39 0 15 4 0 7 23 11 0 0 0 4 6 2 13 12 28 16 0 6 24 21 32 3 12 20 18 25 0 20 0 14 23 33 
36 9 42 32 0 3 2 0 0 3 59 0 3 13 50 4 0 8 30 11 0 0 7 1 0 20 0 0 7 15 23 16 0 14 0 26 0 23 25 1 29 0 28 39 23 3 
0 30 30 39 0 3 8 31 10 0 0 0 0 2 8 1 7 0 9 19 0 5 9 18 0 2 8 1 0 0 12 30 1 0 0 0 0 0 50 3 0 0 54 41 0 0 
0 0 20 33 7 0 4 0 0 33 0 0 33 4 8 3 38 13 27 19 17 0 28 0 18 0 5 0 3 4 18 8 1 15 3 10 12 14 11 27 9 0 23 6 34 17 
63 0 3 31 30 0 0 0 6 23 12 0 0 20 16 8 2 5 0 13 0 6 3 4 0 19 5 0 0 0 29 0 20 0 32 0 0 0 0 30 0 22 10 0 44 0 
0 77 26 0 0 0 6 0 8 7 11 8 0 3 0 17 0 7 10 0 7 0 0 11 6 0 0 0 26 13 1 7 0 0 33 0 0 7 28 0 2 3 15 0 5 44 
5 12 0 14 0 0 0 50 12 0 31 6 28 1 9 6 0 14 0 0 20 0 1 15 0 15 0 12 10 9 0 6 25 2 0 6 2 3 0 0 35 18 35 0 13 0 
0 0 54 11 0 14 0 7 0 36 16 6 0 0 24 4 20 0 11 0 9 19 0 0 10 0 10 0 0 11 32 0 22 0 0 0 7 2 0 5 2 0 0 0 0 7 
0 0 40 0 0 26 0 0 0 24 0 10 0 17 8 0 10 0 0 2 0 0 0 8 5 0 0 19 26 0 0 26 3 48 0 3 2 0 0 4 2 0 0 4 0 7 
9 0 31 13 3 33 34 0 7 45 27 20 7 0 3 0 0 0 0 6 12 0 6 8 0 35 12 6 0 0 0 12 0 5 9 15 2 41 4 3 4 0 3 9 0 62 
82 38 18 4 38 7 0 9 22 0 6 0 4 0 3 0 4 28 11 7 0 0 0 0 0 33 0 14 0 29 22 0 8 5 0 33 4 0 7 38 39 17 42 39 5 28 
0 0 10 39 0 1 0 12 0 6 0 0 0 0 19 5 0 0 0 26 23 0 15 0 0 0 3 9 8 0 7 16 0 15 0 0 0 9 0 0 14 1 28 9 1 10 
32 0 7 17 4 16 0 0 10 7 13 11 0 60 4 2 4 5 20 16 1 22 17 44 16 0 23 51 2 1 24 26 9 0 19 38 0 18 0 0 2 28 2 31 61 10 
1 0 11 0 0 1 0 0 0 0 0 6 32 0 20 23 0 4 2 0 5 0 9 6 9 5 0 16 8 3 5 0 13 0 24 5 8 0 0 0 1 0 2 16 44 11 
4 0 0 36 20 0 0 0 0 0 0 45 0 0 28 23 13 0 0 0 0 0 2 1 19 20 0 0 0 5 7 19 18 3 0 0 3 0 10 38 0 5 3 16 0 17 
15 40 2 0 2 0 1 33 0 0 25 0 0 0 3 28 0 0 37 10 0 20 0 0 0 0 15 0 0 9 0 14 14 0 2 0 0 0 0 0 27 22 0 0 0 37 
0 32 1 12 0 0 33 0 7 30 39 0 0 2 24 31 14 0 9 3 21 0 8 6 11 17 0 9 0 19 12 0 0 9 19 24 22 2 2 42 34 17 13 7 15 0 
0 0 41 0 13 16 0 4 8 0 0 4 13 0 0 0 21 13 1 0 0 16 0 0 0 0 10 2 0 3 18 17 3 3 0 0 9 0 13 0 0 1 20 10 0 15 
2 13 19 0 0 0 14 0 1 17 27 24 0 16 3 0 14 11 18 15 2 0 0 0 4 1 24 18 6 0 14 4 0 0 0 7 0 19 2 39 30 0 24 0 7 86 
0 0 0 27 0 0 16 0 0 0 26 23 0 1 18 0 0 0 0 63 8 11 0 0 20 0 0 12 3 4 27 12 0 0 0 0 0 0 19 1 0 5 0 0 61 26 
