46 26
6 0 0 1 1 40 0 0 16 11 17 0 23 19 0 14 43 5 2 0 7 0 5 18 16 0 0 0 21 14 0 2 0 10 15 16 29 20 0 0 0 11 29 0 13 40 
12 0 0 22 6 22 3 0 3 0 2 0 35 1 0 27 5 0 0 0 0 0 0 0 0 0 0 22 25 0 8 0 19 1 1 0 0 33 0 0 0 0 27 40 14 4 
38 40 0 10 107 2 0 0 0 0 15 36 19 20 20 16 0 26 2 5 0 34 18 0 0 15 7 0 18 13 0 16 12 16 0 22 0 0 35 28 49 76 13 1 12 0 
21 0 62 0 0 0 24 21 2 40 0 0 0 21 10 0 3 0 17 26 51 21 0 5 0 8 4 9 3 0 12 0 1 0 0 12 11 15 48 0 0 1 16 1 0 75 
0 9 0 24 21 0 0 0 34 14 9 0 46 0 20 0 7 6 7 55 0 0 0 13 6 18 18 0 16 0 0 0 25 24 0 6 17 0 0 0 0 3 6 0 20 10 
8 0 40 0 34 12 0 11 4 0 20 1 4 0 8 29 0 1 0 0 15 18 0 8 10 0 14 0 0 0 0 11 0 0 30 8 0 0 0 25 16 3 12 4 16 4 
48 0 0 0 0 2 0 45 25 0 0 0 5 4 0 0 5 16 0 0 0 0 0 0 12 0 0 3 21 16 3 0 15 1 5 0 0 0 4 5 0 11 0 1 0 22 
0 0 18 34 22 25 3 18 29 4 0 26 0 0 0 0 15 20 0 0 4 0 18 20 4 11 0 25 0 6 0 42 0 21 6 17 0 3 36 9 25 0 4 20 13 0 
0 0 0 0 0 0 0 38 17 0 19 0 0 4 28 0 0 4 0 0 16 6 9 0 19 1 0 0 0 19 0 0 0 10 0 3 0 0 2 6 33 0 29 5 0 0 
3 7 2 55 0 0 0 0 4 0 0 11 11 1 0 0 2 11 24 0 19 5 8 0 16 17 0 0 11 0 15 11 0 10 0 0 0 6 1 25 0 0 5 30 0 5 
74 0 19 34 0 0 0 0 1 0 0 0 5 0 2 2 2 2 45 0 3 27 26 9 0 0 12 10 11 0 0 3 0 24 0 0 0 0 49 0 0 6 0 40 26 3 
0 5 32 0 0 0 38 0 0 19 0 5 0 0 6 0 4 0 0 0 22 0 3 11 0 11 9 0 8 0 10 0 0 11 37 10 0 9 0 35 0 8 0 7 3 0 
0 17 9 15 13 0 27 0 13 11 27 0 1 9 0 2 11 19 7 2 27 23 21 0 3 16 6 20 22 2 15 9 12 0 10 36 0 13 17 29 18 11 41 0 0 28 
8 0 49 0 11 0 1 8 16 2 7 18 30 0 11 3 0 4 3 0 0 1 0 18 7 0 0 7 20 33 8 0 23 6 0 50 7 0 3 0 10 45 28 6 1 4 
7 0 0 0 0 36 37 0 0 0 5 0 9 2 0 0 20 7 0 0 9 0 3 10 0 0 0 4 14 0 0 0 0 0 0 0 5 0 11 0 0 40 3 47 0 2 
68 24 1 64 0 0 34 0 0 0 14 0 1 0 0 1 39 0 12 26 16 0 0 31 7 22 17 0 25 0 81 7 9 30 0 5 15 21 38 0 16 0 0 17 30 12 
0 6 0 0 8 30 2 17 5 4 14 0 28 3 37 7 0 0 0 3 17 0 11 0 16 0 0 18 2 2 25 60 20 11 20 0 0 0 16 3 37 21 0 13 27 0 
22 6 35 0 0 27 3 26 18 0 17 0 6 27 6 0 5 8 23 0 14 12 13 9 1 0 13 0 0 0 0 0 0 21 0 0 0 39 0 0 27 13 22 23 0 0 
18 33 0 0 37 5 0 13 0 0 17 11 1 0 18 5 0 20 0 0 15 0 9 6 17 18 16 11 0 0 0 7 18 0 33 16 2 4 2 0 0 32 15 2 1 18 
0 19 40 0 0 31 0 15 0 27 8 0 6 3 9 0 47 0 22 19 19 0 19 9 0 0 15 10 0 0 0 0 0 0 0 0 61 0 0 12 3 12 26 0 26 10 
23 7 38 0 0 13 28 6 31 32 0 21 0 0 2 19 25 8 0 0 0 16 0 6 4 15 9 6 9 0 4 23 14 2 4 2 0 16 30 1 53 25 33 6 12 0 
7 12 12 33 0 0 58 2 16 25 0 0 36 3 13 0 0 7 0 16 15 0 3 0 5 0 0 9 55 0 3 9 0 10 4 13 0 4 9 3 0 2 39 37 16 0 
0 9 19 42 0 1 35 1 29 23 0 0 0 0 2 0 27 0 0 0 0 23 0 1 14 0 5 0 0 9 0 22 0 5 29 51 36 0 0 3 32 32 18 0 26 2 
2 22 6 42 9 1 4 20 4 0 4 0 28 3 0 17 17 0 0 0 7 35 0 22 0 18 0 0 7 0 11 0 3 0 22 0 1 0 0 0 19 0 8 0 0 42 
33 0 0 40 35 0 14 0 2 8 0 18 0 1 30 0 0 6 0 0 23 7 35 11 6 0 0 22 21 45 21 27 12 5 0 14 4 21 40 17 14 6 12 29 9 15 
14 21 35 0 0 0 0 25 0 11 51 3 7 0 14 12 0 8 4 0 36 0 21 0 0 0 0 0 4 0 0 0 4 9 4 0 0 53 4 5 0 31 0 23 0 31 
