46 26
0 31 49 0 23 0 9 0 0 0 2 4 0 25 0 9 0 9 7 0 0 0 0 0 16 0 0 0 0 0 3 14 15 5 0 20 21 0 36 22 39 0 0 13 0 30 
0 30 36 41 0 35 23 0 20 0 0 5 12 22 20 0 0 7 1 6 0 0 19 0 10 0 0 0 31 0 12 30 0 20 8 22 0 0 28 0 35 19 0 2 31 7 
34 0 0 0 21 2 34 12 2 22 16 19 0 0 0 15 10 0 0 12 8 4 6 30 13 19 0 2 34 9 13 0 0 2 15 2 0 13 9 0 0 40 0 40 0 21 
17 0 25 0 6 4 0 0 0 0 6 0 5 0 25 21 0 65 0 7 0 16 22 4 9 9 21 2 39 2 3 3 0 0 0 0 0 16 2 0 16 0 14 26 0 0 
0 48 0 0 12 7 1 10 0 20 0 0 0 23 8 0 0 16 0 40 19 10 0 0 6 26 10 2 15 16 42 3 7 0 15 4 10 0 0 19 2 0 2 25 19 3 
28 61 0 20 34 32 29 4 9 3 17 25 30 0 19 1 5 9 3 7 0 25 14 5 0 20 10 42 11 14 1 0 13 8 9 29 14 10 49 1 0 0 41 0 0 18 
35 26 3 33 1 11 0 13 20 54 49 0 0 20 33 1 0 2 3 10 0 10 16 0 0 0 0 31 38 0 16 9 0 0 3 52 2 11 0 1 0 11 12 0 12 9 
0 0 43 0 13 8 0 0 7 30 2 12 1 11 4 0 18 16 0 9 22 17 18 12 0 23 14 12 14 0 18 22 30 0 14 6 0 2 53 0 21 0 36 0 2 6 
36 8 5 15 5 25 0 45 0 9 0 19 13 24 0 0 0 11 15 19 9 0 2 0 0 12 0 0 0 22 61 17 8 6 0 15 0 21 20 0 3 34 0 30 0 40 
9 2 0 41 38 8 19 15 36 8 26 6 2 0 33 16 0 14 12 10 0 1 30 6 24 1 0 0 0 19 15 0 7 0 33 0 21 8 5 0 23 0 31 0 5 31 
6 0 61 0 16 6 6 23 0 0 7 15 0 15 31 9 0 9 30 7 3 11 20 2 10 0 37 22 9 0 1 0 18 23 9 5 9 6 0 19 33 0 24 5 0 5 
0 0 17 46 0 3 0 7 33 0 2 11 0 0 7 0 0 0 0 0 0 0 22 9 1 0 0 4 0 27 11 0 0 0 0 13 0 0 16 0 0 9 39 13 3 0 
0 54 0 0 36 29 20 38 17 0 0 0 5 0 21 11 0 29 5 5 16 27 0 2 4 24 0 8 28 0 1 30 12 0 29 18 30 17 2 6 53 14 0 0 0 44 
1 25 13 0 78 16 0 15 0 7 27 0 10 7 16 15 0 0 5 0 0 16 5 0 0 11 13 22 1 0 13 14 0 6 3 5 4 7 4 16 5 0 1 12 0 15 
0 9 0 0 29 0 0 5 0 11 12 2 0 0 0 7 0 8 1 7 0 0 11 0 0 0 2 0 6 0 0 18 0 35 9 4 0 0 0 0 0 0 6 0 0 0 
29 0 62 16 0 6 0 5 0 0 0 0 0 0 0 39 0 0 0 16 6 0 20 0 0 0 10 4 0 28 0 0 0 0 32 5 0 7 0 0 0 0 47 0 0 0 
0 0 16 34 26 1 65 7 4 23 41 12 32 2 4 13 0 25 10 7 20 0 19 20 43 18 43 9 0 25 32 0 19 0 4 0 0 68 13 27 0 23 51 18 7 14 
0 4 0 17 7 27 0 19 22 0 14 0 8 0 0 9 0 20 17 0 15 18 0 0 15 0 16 0 3 12 22 0 7 0 0 0 5 5 16 5 23 0 13 19 0 2 
14 5 0 7 0 37 0 0 23 2 0 2 6 9 16 28 0 0 0 0 0 2 0 0 10 0 0 0 4 1 13 30 1 1 3 10 0 0 7 5 0 0 34 28 15 0 
21 28 0 8 0 0 7 6 61 2 5 16 9 38 30 5 3 0 22 2 38 24 0 22 0 0 0 20 10 14 26 0 0 0 0 27 7 26 8 0 49 0 1 23 29 25 
10 0 12 0 0 3 0 14 0 21 10 0 16 0 12 0 23 34 0 10 0 0 0 4 0 19 0 3 14 0 21 0 0 5 7 2 30 0 9 23 0 0 6 16 19 0 
0 0 10 0 3 27 0 5 0 0 25 28 0 8 24 37 0 0 5 0 5 0 0 0 5 20 0 0 0 0 5 6 0 20 27 2 1 0 16 21 18 3 0 5 0 30 
0 0 0 0 0 0 8 14 7 0 0 62 0 0 5 0 18 14 0 0 4 16 17 0 4 18 5 13 0 16 0 20 0 0 1 0 0 1 0 24 0 4 0 0 0 20 
0 33 18 17 23 16 32 0 1 0 0 5 0 57 6 11 5 12 15 0 18 5 14 31 22 0 13 0 0 0 0 0 0 10 13 19 0 0 32 19 0 2 0 32 16 0 
0 0 0 29 3 0 9 20 5 17 0 34 0 10 40 0 0 25 0 0 8 0 0 10 0 0 21 10 0 0 4 8 34 0 0 0 0 21 29 10 0 24 0 5 0 34 
42 10 12 0 3 0 39 7 20 0 9 0 9 0 0 0 0 21 8 18 0 41 22 0 0 0 16 0 22 19 11 10 2 25 4 7 0 1 24 0 30 0 0 23 0 27 
