46 26
13 0 34 1 31 0 28 10 22 15 6 0 17 1 13 8 0 24 0 0 31 72 0 19 11 0 0 4 14 17 0 1 24 3 0 4 64 12 34 0 30 31 0 11 0 16 
22 0 15 36 18 2 26 13 12 17 0 2 0 9 0 0 1 0 13 0 12 8 19 17 6 15 25 11 0 23 18 29 6 0 0 18 20 3 0 0 0 0 28 21 38 0 
20 0 0 0 0 0 20 73 0 7 0 9 5 23 25 0 11 17 7 18 28 27 6 3 4 20 20 1 12 9 0 5 0 9 27 3 11 0 4 1 0 0 0 0 0 54 
0 57 47 21 0 0 12 2 19 11 0 17 0 0 8 0 13 19 6 0 14 0 0 5 36 9 0 9 25 16 14 0 3 20 0 11 0 0 1 18 0 0 0 3 30 0 
40 39 0 0 20 0 39 4 21 0 13 0 0 0 42 0 0 0 21 14 19 3 0 8 0 0 0 18 0 27 0 0 1 0 0 0 0 17 0 4 77 0 19 29 0 0 
0 24 0 0 20 15 7 1 2 3 2 0 10 3 0 29 10 0 8 0 15 0 0 5 0 21 11 15 16 6 0 4 11 0 31 3 6 0 15 0 0 0 0 0 38 6 
2 0 0 1 0 0 13 35 0 0 0 0 0 15 15 0 0 0 1 1 0 0 0 0 36 0 7 0 16 0 10 0 0 5 15 0 0 0 10 29 17 0 2 9 31 21 
0 0 0 31 0 0 4 0 0 0 3 25 6 3 0 0 13 0 12 16 6 0 19 1 2 6 0 3 1 7 12 7 0 13 0 10 13 0 0 19 0 3 21 40 22 0 
16 1 1 0 0 5 15 5 0 0 54 0 0 3 22 42 11 10 5 0 8 2 0 22 4 3 18 0 2 14 0 1 16 0 11 25 28 0 7 38 5 0 33 28 15 18 
0 11 0 0 0 33 2 8 10 0 4 0 0 0 0 0 0 0 7 10 0 0 0 0 1 10 18 0 0 10 0 0 0 9 2 0 2 0 33 0 0 9 0 0 12 0 
0 17 0 34 4 0 0 26 9 12 0 40 0 4 0 0 0 0 15 0 9 0 19 29 19 0 11 7 7 0 9 0 0 0 0 0 13 0 12 22 0 3 3 44 0 22 
0 14 3 10 0 8 23 40 1 0 9 0 17 44 7 14 16 37 0 0 0 0 0 13 0 0 1 0 0 15 24 18 1 0 0 4 6 24 0 6 3 0 35 3 0 6 
54 2 9 2 0 0 22 0 0 28 37 7 0 1 0 0 15 0 0 3 0 11 0 0 0 4 15 10 1 26 5 0 26 22 24 0 0 28 0 10 0 8 1 0 44 0 
16 7 0 0 8 5 10 39 0 0 0 1 7 0 3 0 16 11 0 0 0 12 10 13 9 7 0 10 15 0 1 0 9 12 0 10 0 40 0 5 5 9 1 15 20 1 
28 8 0 8 38 2 0 0 15 41 16 0 32 5 27 0 0 0 11 0 21 0 3 0 0 13 18 18 58 14 1 0 24 0 0 3 6 0 0 2 37 51 48 7 8 0 
0 38 33 41 13 7 0 15 8 0 0 8 0 12 19 16 13 6 16 1 13 0 18 16 5 12 14 23 27 0 0 25 0 4 25 0 18 14 0 38 1 1 5 9 41 6 
0 0 15 21 0 7 0 21 5 8 0 14 6 42 19 0 0 0 7 21 1 18 0 3 0 12 3 12 13 0 0 0 16 19 0 22 18 34 0 11 57 0 0 5 0 0 
0 0 0 2 0 13 27 7 0 25 0 0 35 0 0 5 0 0 6 0 39 1 25 0 7 7 3 0 7 1 0 0 12 27 23 6 0 0 12 3 1 0 30 21 12 0 
0 0 0 0 6 32 0 0 0 23 40 0 16 12 30 6 0 10 0 14 24 21 3 8 12 2 16 0 26 0 17 7 9 0 13 0 0 32 0 0 0 0 73 11 20 5 
24 0 0 25 20 0 18 38 5 0 0 4 5 5 13 0 13 8 21 0 6 0 6 0 32 21 0 0 1 5 26 0 12 8 0 49 26 35 0 37 15 4 0 0 11 0 
0 18 41 10 0 6 0 18 0 0 26 5 7 0 31 17 13 14 23 18 32 0 0 5 0 1 1 4 0 30 0 14 17 0 0 0 0 0 0 0 6 8 0 41 24 0 
0 0 0 0 0 24 0 0 5 19 9 0 15 0 0 0 0 6 0 0 0 0 0 16 19 0 16 32 2 13 0 1 0 0 16 4 19 0 0 4 11 0 0 2 0 6 
25 30 5 38 25 7 18 46 10 12 0 0 1 3 0 5 3 21 0 0 27 0 0 0 0 13 22 17 9 0 0 0 0 16 14 8 8 0 0 21 0 50 0 23 0 0 
91 16 0 0 16 38 6 1 4 21 0 16 15 2 10 8 7 2 22 35 53 38 18 6 5 8 15 15 20 12 0 2 80 31 7 16 32 0 0 0 0 0 19 50 26 42 
2 0 0 0 53 0 0 3 5 13 4 0 17 36 5 21 2 50 16 0 58 0 0 13 7 7 1 5 36 2 0 17 0 30 6 4 21 17 14 1 0 0 17 12 0 0 
23 1 22 0 2 0 18 0 0 22 12 0 0 0 0 14 8 0 0 0 0 25 0 21 28 0 0 0 13 0 0 22 0 0 0 0 0 0 0 1 0 0 24 0 19 0 
