46 26
11 0 0 0 0 16 0 0 0 0 10 33 24 7 0 0 43 0 0 0 1 1 68 6 23 14 13 26 2 14 0 3 5 0 8 0 8 3 22 4 1 0 16 7 22 0 
0 0 27 8 0 18 0 8 0 20 0 0 25 0 0 3 0 0 0 9 1 8 0 31 0 16 0 0 0 33 0 0 12 0 23 16 11 0 0 0 0 16 1 7 25 0 
39 0 0 0 0 20 0 2 25 30 0 0 0 15 0 0 0 10 0 9 0 0 0 0 0 20 0 10 32 0 0 0 0 25 0 0 2 1 0 4 0 0 0 0 0 0 
5 21 41 0 52 28 69 0 34 34 0 18 44 16 5 94 21 5 0 21 13 3 8 15 23 0 0 0 26 17 16 13 10 1 0 15 4 66 41 33 2 26 34 2 26 30 
26 7 22 0 42 4 13 5 29 10 0 9 19 5 0 0 4 21 18 11 0 20 18 0 18 0 15 11 0 18 0 0 0 8 13 0 30 0 1 11 0 3 0 39 0 0 
11 13 2 0 2 30 0 9 9 24 0 11 1 0 3 0 19 2 0 39 29 3 0 3 1 1 0 19 3 0 0 0 0 32 0 30 5 0 23 0 5 0 0 0 0 0 
7 1 2 0 7 20 18 1 17 0 3 6 1 1 0 2 0 14 2 22 7 7 0 23 0 56 21 43 0 14 26 14 5 0 15 4 13 8 0 0 0 14 0 30 3 0 
6 15 6 27 0 0 32 0 1 76 30 59 9 0 14 13 0 5 4 10 20 13 10 0 2 9 33 0 17 0 11 12 2 51 15 10 16 0 0 0 47 0 0 26 0 0 
0 10 0 36 0 0 2 2 0 0 0 11 3 2 5 1 22 0 0 22 15 10 29 0 23 0 10 0 11 0 8 0 21 0 8 0 0 8 0 13 0 9 0 16 0 35 
24 41 79 8 34 0 0 0 14 0 8 0 38 15 20 10 14 0 3 6 1 8 0 0 41 0 14 0 2 0 15 0 0 0 30 0 35 0 66 0 21 1 0 37 29 0 
0 0 0 0 0 7 0 31 0 0 6 19 22 27 0 0 19 0 15 9 0 0 0 0 8 5 0 11 7 15 28 0 0 0 22 7 0 0 32 9 5 5 0 0 15 0 
0 7 23 1 6 12 14 0 6 2 42 7 0 0 8 0 0 16 0 29 0 0 0 21 0 14 10 6 6 8 0 0 0 0 0 10 0 27 1 0 23 0 0 24 0 0 
6 10 0 8 7 0 0 0 7 0 13 41 9 24 7 0 19 0 7 0 9 30 0 12 3 7 0 0 17 16 0 10 0 0 0 5 38 12 0 0 0 10 5 30 0 12 
0 0 13 0 0 7 22 8 0 2 64 0 0 24 0 0 0 16 0 7 7 12 11 0 0 0 0 23 22 7 0 0 12 0 4 0 2 14 7 35 3 4 21 4 0 35 
0 0 0 0 0 0 0 11 23 0 0 0 22 0 0 7 6 0 0 7 0 0 0 0 0 0 0 10 0 0 0 0 0 28 22 0 3 0 0 0 0 0 0 7 0 0 
34 10 0 0 0 0 0 10 3 7 9 33 9 17 9 26 6 0 5 14 8 2 7 0 3 12 2 6 0 9 28 22 3 17 38 20 0 5 0 44 6 16 0 13 6 0 
0 3 0 0 3 16 0 32 36 0 18 11 0 0 3 16 0 0 5 28 0 10 0 5 18 10 8 0 0 8 0 0 4 0 32 0 0 16 0 32 1 0 5 0 36 0 
0 0 8 0 0 46 13 33 6 32 0 0 0 0 0 0 5 6 0 5 0 0 17 0 13 0 0 6 10 14 0 0 13 17 13 7 0 0 0 0 34 32 7 15 39 13 
4 1 30 16 9 4 0 0 3 21 0 0 0 25 0 0 9 0 0 16 4 22 0 0 8 7 7 0 0 21 0 29 16 2 0 0 4 0 0 0 0 22 29 2 0 6 
0 25 29 0 2 55 13 0 3 0 0 6 0 1 3 16 1 15 0 23 0 0 0 10 0 0 20 1 11 34 16 26 1 1 12 0 16 0 14 6 0 0 2 0 38 11 
49 22 46 16 8 5 0 9 8 13 0 6 0 8 0 31 2 19 0 3 7 1 1 24 0 0 2 8 16 6 0 14 12 14 15 0 36 31 48 2 17 0 21 41 0 7 
3 0 24 38 0 0 0 8 0 16 0 0 0 24 28 18 0 15 0 0 22 20 0 0 13 10 3 11 0 0 13 6 0 3 0 10 0 24 23 0 0 13 6 0 6 9 
0 49 0 15 0 0 6 0 26 10 18 0 1 10 8 0 8 11 1 21 18 6 4 14 0 0 5 7 33 5 3 5 15 2 22 0 13 41 22 21 6 7 41 42 0 0 
17 3 22 0 10 11 36 23 14 29 0 2 34 54 10 0 23 5 0 0 13 0 14 0 1 0 0 6 11 30 7 9 0 0 0 0 7 0 4 0 6 12 7 0 0 0 
0 36 6 0 0 30 0 5 17 3 9 0 37 0 14 1 32 4 0 8 0 21 13 0 0 9 5 6 15 7 9 23 13 11 33 53 0 27 0 0 0 0 30 1 0 3 
75 29 11 23 0 0 8 11 31 0 32 16 3 18 18 3 0 0 36 9 1 12 2 4 0 33 23 25 18 0 29 20 5 13 1 0 13 37 38 17 22 0 0 0 0 13 
