46 26
0 14 0 32 9 0 0 26 12 9 14 0 10 0 0 10 0 0 26 17 31 0 0 22 22 0 0 8 0 18 7 0 30 73 5 32 0 8 0 0 20 7 38 0 22 26 
8 22 0 0 0 0 0 0 18 0 18 2 17 0 13 5 35 0 0 0 0 0 0 8 0 0 1 0 1 4 0 0 1 18 0 19 35 8 0 3 15 14 13 0 14 8 
0 0 43 37 0 16 0 6 55 25 22 20 7 0 39 22 9 17 30 2 0 16 6 0 8 16 0 5 15 0 17 9 36 0 37 0 24 24 30 23 57 23 1 0 22 43 
11 41 19 0 0 6 0 39 9 38 34 8 1 6 46 0 7 10 8 3 0 0 19 0 17 0 6 15 26 0 0 30 12 29 32 0 0 15 30 0 33 19 9 42 32 0 
0 0 0 0 0 0 0 0 0 23 0 0 9 18 0 25 7 0 0 2 15 9 0 14 0 2 0 0 0 0 0 18 0 0 19 19 0 10 6 1 0 2 0 0 1 0 
39 43 1 0 13 7 9 0 1 4 27 0 33 0 0 8 0 8 7 0 7 0 12 13 11 1 0 13 16 7 1 1 0 3 0 0 3 0 0 39 0 2 30 12 43 0 
0 42 31 0 26 7 0 12 0 6 10 0 7 2 0 7 0 0 0 0 0 0 0 8 9 2 0 0 0 0 23 9 1 3 0 12 0 0 0 0 9 0 40 39 0 0 
14 0 0 34 0 0 26 7 0 0 15 0 0 6 2 0 2 10 0 0 0 0 6 17 1 0 0 0 16 0 7 0 5 0 0 0 0 21 7 0 0 0 0 20 16 1 
9 0 0 0 17 2 0 29 0 6 37 5 16 2 15 15 9 12 0 0 0 0 0 0 6 0 0 18 2 0 21 0 0 0 13 0 0 18 0 5 3 0 8 1 34 7 
13 30 32 0 0 0 33 0 26 13 0 0 31 0 0 0 16 15 7 19 0 0 0 8 24 7 5 15 26 11 6 53 7 0 5 33 30 25 0 13 13 0 7 3 36 0 
0 9 39 0 0 0 0 0 3 0 36 23 0 0 0 0 7 0 0 0 0 4 19 8 0 3 3 6 0 2 0 19 0 0 32 25 11 5 0 29 0 19 16 1 0 0 
39 0 0 20 0 24 0 28 2 0 17 12 0 10 23 11 0 0 9 0 7 10 8 18 10 29 12 18 2 23 5 6 0 2 0 30 8 0 0 39 17 4 0 0 17 19 
30 0 33 0 0 0 0 8 2 21 1 8 5 0 0 2 28 24 7 16 28 7 12 0 3 0 0 0 20 0 30 0 0 16 8 37 2 0 0 0 5 0 9 10 0 29 
0 14 0 15 0 4 0 4 7 0 0 2 0 6 0 8 0 22 32 0 13 0 13 0 16 17 12 0 10 23 11 0 0 13 0 27 5 0 0 0 0 7 41 0 0 0 
4 1 45 4 0 2 10 5 11 2 28 0 5 0 6 9 31 8 24 17 8 0 25 61 3 8 6 23 16 3 0 1 22 31 8 27 0 7 7 12 0 25 17 0 29 13 
0 1 3 0 0 3 1 6 9 9 0 14 19 0 0 2 0 0 12 0 4 0 19 16 17 14 13 10 0 2 28 9 0 7 11 26 0 13 26 3 7 37 0 19 9 10 
0 83 8 0 0 41 9 23 12 11 10 4 0 28 5 0 0 14 0 0 0 10 43 0 0 0 18 2 11 16 23 3 7 32 0 8 0 0 0 17 17 9 2 50 34 5 
0 0 12 0 8 50 0 0 0 31 23 0 20 20 6 0 0 0 0 14 6 12 20 3 20 0 14 22 0 8 17 32 17 32 0 0 0 0 14 0 31 13 0 5 18 0 
4 42 14 0 61 0 0 4 2 2 40 0 8 13 0 15 2 21 11 0 1 0 6 0 10 0 26 19 12 1 13 7 0 0 0 12 12 0 14 3 33 37 3 32 17 0 
0 1 0 19 39 0 0 21 10 0 67 34 6 0 0 0 15 10 0 0 12 0 9 6 0 0 0 0 0 25 17 10 18 28 0 0 11 20 16 0 0 0 0 70 7 34 
7 24 6 0 5 1 24 23 25 4 6 11 13 23 20 0 0 0 0 23 0 0 0 0 0 24 0 0 0 0 24 0 0 3 3 0 21 0 2 6 12 3 40 13 0 38 
14 0 17 0 0 9 9 27 3 5 0 6 0 12 3 6 24 3 31 24 2 12 15 0 16 18 0 9 0 0 0 1 0 20 0 0 0 23 21 1 57 0 7 0 0 0 
24 0 37 33 0 12 17 0 0 0 18 43 5 2 20 31 0 0 29 3 0 0 3 17 12 0 16 16 17 0 12 28 0 3 16 0 0 0 2 32 56 0 13 33 0 0 
28 23 0 0 0 33 33 18 0 0 2 0 6 0 3 24 0 0 0 0 12 0 7 7 0 18 13 18 18 0 6 6 12 40 0 0 3 0 26 16 0 3 1 0 20 12 
28 0 25 0 27 0 0 4 52 0 30 0 3 0 0 3 0 10 8 0 0 20 6 44 1 0 15 4 25 0 20 27 0 13 24 33 13 0 15 15 30 52 30 0 11 0 
14 9 6 0 33 0 0 21 0 16 15 0 0 13 0 7 71 0 17 6 16 0 5 0 7 14 1 10 24 14 10 0 16 10 9 36 35 0 38 17 0 24 40 10 0 48 
