46 26
34 1 16 0 0 0 59 0 13 21 0 0 0 31 15 0 0 0 0 22 17 19 13 0 9 0 0 10 31 15 0 0 0 0 18 4 0 2 0 22 11 0 0 0 31 39 
0 0 38 0 0 0 4 34 18 2 22 10 39 6 4 0 25 7 5 25 0 32 0 3 31 0 18 24 0 9 0 0 0 0 14 3 0 6 3 7 16 59 0 19 0 0 
0 87 0 0 46 17 0 10 25 16 6 34 3 0 18 15 14 3 0 0 6 38 0 0 21 20 0 13 0 19 0 20 0 0 0 33 56 36 0 0 0 21 21 23 73 47 
8 15 30 18 0 0 0 35 14 3 0 0 23 0 51 0 18 0 20 0 5 0 0 7 0 15 20 11 0 0 0 0 0 0 6 0 8 0 9 15 0 0 35 2 4 45 
0 1 4 9 18 10 0 4 4 0 0 23 21 73 27 14 0 0 0 15 21 0 23 7 0 9 17 0 13 0 19 0 7 21 8 4 0 24 0 5 27 27 14 15 1 27 
0 10 0 0 0 2 12 20 25 8 0 41 0 31 7 3 18 14 34 0 15 6 0 6 0 0 0 6 0 16 12 0 0 39 0 0 0 11 20 0 9 0 43 7 0 0 
0 0 67 5 0 22 27 17 3 43 0 13 0 5 3 13 1 0 10 34 0 0 7 2 4 0 0 30 9 14 1 0 0 0 32 22 0 38 0 0 0 32 29 55 15 10 
53 0 0 0 13 7 12 0 0 36 42 11 0 7 24 0 24 8 18 0 9 3 34 32 4 0 7 13 0 12 19 9 28 17 16 0 18 42 0 0 0 0 28 43 22 29 
0 0 32 14 0 0 8 0 4 0 0 0 7 0 10 13 11 22 0 0 0 9 0 0 0 5 11 0 0 0 0 0 0 0 32 0 0 0 11 7 0 2 0 0 6 22 
13 37 0 12 0 30 0 5 0 0 0 0 20 40 18 17 2 12 33 5 0 0 0 0 9 3 0 15 0 11 0 13 3 0 16 36 0 0 37 25 1 26 0 8 10 0 
7 27 3 0 0 19 10 29 1 0 24 4 0 31 53 31 3 4 5 8 15 0 13 33 10 0 0 4 28 10 15 26 3 9 32 38 5 14 2 0 14 34 1 41 37 3 
15 31 71 4 6 35 0 15 0 45 4 29 7 11 12 18 0 14 6 0 11 0 5 23 6 53 23 9 27 0 7 0 21 18 12 0 32 1 0 17 83 20 0 31 6 30 
0 17 17 42 24 20 12 1 0 10 0 5 40 17 1 0 3 12 1 17 5 10 5 3 18 23 3 0 39 5 11 22 3 7 16 11 4 0 10 15 7 11 3 34 0 54 
23 11 0 7 0 0 0 0 13 25 0 1 7 10 0 0 11 0 7 0 4 10 28 10 0 23 0 0 0 11 5 0 0 0 0 9 0 13 0 6 6 0 0 0 0 6 
4 19 0 0 33 30 0 2 0 8 0 7 11 2 0 12 26 8 16 5 0 13 0 25 0 0 0 0 0 0 0 0 0 30 0 2 0 26 1 0 30 4 0 0 21 0 
0 64 0 2 0 9 8 27 13 10 8 10 0 0 38 0 0 0 10 14 0 0 9 10 0 0 0 0 10 7 0 0 31 5 46 0 7 0 21 0 0 0 6 6 30 12 
0 6 22 0 0 0 23 24 0 23 6 0 0 0 49 0 14 10 0 0 20 4 0 0 32 21 26 0 0 5 2 2 23 2 0 0 4 12 0 15 46 0 10 9 0 20 
10 43 0 18 10 28 27 56 0 5 0 7 4 10 2 6 0 1 23 11 24 9 16 8 9 0 26 0 25 0 0 8 0 0 22 0 0 13 0 0 6 0 35 0 30 1 
4 15 8 0 0 0 30 21 31 62 2 11 2 4 34 0 0 2 19 2 19 0 0 0 0 1 4 7 21 15 10 0 0 8 1 0 30 0 0 35 0 0 8 0 0 36 
0 0 0 29 0 0 0 2 0 2 0 0 0 0 24 0 11 0 3 9 0 17 23 0 0 0 4 0 10 26 0 24 0 17 0 0 0 0 20 0 0 0 20 15 6 0 
25 0 26 0 0 0 3 0 0 7 4 0 0 3 0 0 0 11 5 41 7 19 32 19 0 25 0 14 27 0 0 0 30 0 20 0 0 0 4 0 0 0 20 3 42 0 
44 41 0 43 23 38 0 37 0 40 11 0 0 0 1 37 12 25 9 16 24 2 2 18 0 23 17 0 0 19 0 9 0 0 0 11 0 28 13 0 36 0 8 48 21 13 
0 0 0 22 21 0 0 0 0 0 6 0 49 6 9 0 1 0 5 37 18 1 18 4 21 0 2 0 22 3 0 0 0 0 4 12 2 15 13 22 28 0 29 52 0 0 
0 17 30 10 3 0 0 42 0 0 0 29 4 10 39 2 39 0 9 15 0 0 24 0 0 0 8 0 1 1 0 0 51 11 16 0 6 8 0 0 22 0 29 30 37 8 
0 19 12 0 28 0 16 26 0 0 1 0 0 14 7 0 0 32 0 0 0 0 15 1 0 0 0 0 11 0 13 27 15 26 0 12 0 0 17 0 1 10 0 8 0 0 
0 0 5 0 0 18 0 25 16 18 15 30 25 0 39 25 0 0 5 10 33 0 0 2 26 19 0 12 9 0 11 13 12 10 25 0 0 5 0 0 0 30 0 15 13 0 
