46 26
0 9 24 42 21 0 51 21 0 0 9 67 0 0 0 0 19 20 6 0 0 9 0 13 6 1 0 8 35 0 36 0 4 4 0 36 9 30 0 0 0 0 36 0 0 76 
0 0 31 18 58 0 31 36 12 0 15 0 0 0 26 1 21 0 13 11 35 0 6 11 0 1 0 0 4 18 0 42 4 0 11 0 24 31 0 1 0 16 18 51 0 41 
0 39 0 6 35 36 57 17 0 27 3 23 0 45 22 7 31 0 20 1 0 0 7 8 25 0 11 21 0 0 0 0 12 20 9 5 27 0 20 36 18 64 0 27 12 0 
34 41 25 1 3 2 36 0 0 0 4 25 0 0 10 0 22 0 30 0 27 14 0 19 9 3 0 7 23 11 0 11 0 0 49 0 17 19 54 8 10 0 29 0 0 0 
23 0 0 13 41 0 6 0 0 35 0 7 29 51 16 18 0 0 7 9 16 0 15 9 0 0 0 0 0 16 17 21 12 0 0 23 16 15 0 0 0 0 0 0 23 73 
42 0 0 0 41 3 8 30 2 18 3 0 7 13 11 11 0 0 0 17 45 0 21 2 24 53 10 30 3 0 0 1 5 0 5 29 17 1 0 12 37 0 0 37 0 25 
10 0 59 18 19 0 8 57 32 0 10 9 17 16 8 22 58 9 0 0 6 18 7 16 0 15 11 13 13 38 28 0 10 31 0 3 0 31 27 14 63 2 57 0 28 0 
0 8 0 9 31 45 0 0 0 0 2 6 2 10 0 0 0 39 26 0 0 0 17 0 0 0 0 3 8 12 3 0 0 0 3 43 0 0 2 0 12 6 9 0 106 1 
0 0 28 30 0 10 27 0 0 6 38 0 14 26 7 0 45 17 0 4 0 10 3 7 7 21 38 0 2 8 37 0 28 26 0 0 0 7 0 55 3 19 21 17 0 19 
9 4 44 1 0 11 2 0 2 9 30 23 6 30 12 0 33 0 0 0 10 9 23 0 3 19 0 0 5 19 17 25 0 0 0 0 0 0 38 0 39 0 0 0 43 34 
0 0 15 8 28 0 8 0 23 3 29 47 0 0 19 3 11 15 0 17 18 10 0 0 26 1 1 3 0 20 27 39 17 3 5 0 10 6 18 29 0 0 33 0 33 0 
0 0 0 0 0 0 23 9 5 8 3 12 29 0 0 24 5 8 0 10 4 0 0 12 0 0 0 0 0 23 0 0 9 0 9 0 6 0 0 34 0 29 0 13 0 0 
0 76 16 9 1 0 25 4 64 0 18 9 9 0 2 0 0 0 6 11 11 0 8 11 0 0 0 0 5 36 2 21 21 0 10 27 0 12 0 0 39 2 10 9 0 55 
9 0 13 7 13 0 0 11 24 0 12 0 3 25 1 9 0 0 0 33 0 6 1 0 5 15 11 0 0 23 9 0 24 1 6 6 32 3 13 18 0 0 17 1 1 1 
0 30 0 2 38 11 2 0 0 0 0 39 0 3 21 0 0 4 22 13 0 20 6 0 0 23 0 2 9 0 5 0 13 19 0 8 0 0 0 0 7 0 38 0 0 5 
22 41 21 17 0 23 11 22 7 9 0 0 0 0 11 0 11 0 0 0 13 0 0 7 22 0 26 0 54 0 0 31 0 0 0 11 35 2 0 0 5 0 0 0 0 43 
17 14 0 28 2 0 24 10 7 5 27 0 3 30 20 3 33 7 0 0 22 0 47 0 0 19 0 3 0 0 24 4 0 0 18 15 2 4 22 25 24 27 11 30 0 11 
5 2 40 52 14 0 8 18 2 6 25 0 6 11 21 0 0 8 14 6 0 9 0 0 7 6 13 0 2 0 0 9 0 0 0 10 4 6 20 6 38 23 39 33 23 0 
18 24 6 0 39 33 2 13 2 9 0 4 10 14 49 18 0 15 6 1 16 21 3 34 42 2 39 0 6 10 1 0 13 0 64 21 4 0 15 6 3 22 110 24 0 15 
0 0 2 11 10 0 0 14 4 32 2 0 0 0 46 28 0 6 23 7 0 14 6 9 6 0 0 0 24 8 1 2 14 0 0 27 33 34 6 30 17 0 22 22 0 5 
3 35 0 3 2 0 0 0 0 9 0 13 17 0 12 28 3 3 0 0 0 0 6 0 18 15 14 0 19 13 0 0 2 0 2 0 33 0 0 0 0 0 30 44 0 0 
0 41 0 12 0 57 3 20 0 11 24 0 2 31 14 4 6 12 17 17 0 0 13 0 0 1 12 26 3 0 31 6 0 8 43 4 17 6 11 1 0 24 0 38 45 0 
44 17 6 0 17 0 13 0 0 12 15 0 0 7 1 17 6 0 17 32 22 3 13 19 0 17 40 0 13 2 19 11 0 0 10 0 16 5 19 0 0 13 2 0 44 0 
0 2 23 0 5 0 12 0 8 6 0 14 17 0 4 0 5 0 12 0 0 0 0 0 0 23 8 0 0 0 0 0 0 0 10 0 0 6 0 0 0 0 0 6 0 0 
9 0 24 17 0 0 30 6 18 9 0 34 32 0 22 11 15 0 0 11 8 14 29 0 0 0 29 0 13 1 24 0 0 11 9 14 55 0 0 0 18 0 0 0 32 0 
8 0 0 0 36 31 8 0 73 17 79 23 0 20 0 0 6 6 0 0 16 7 22 11 11 15 18 18 7 43 0 21 15 9 35 28 37 0 9 31 36 0 22 14 34 0 
