46 26
0 19 42 0 37 0 0 0 0 11 1 7 20 0 3 0 4 3 0 21 44 5 0 0 14 0 5 17 1 1 24 5 0 14 5 0 0 0 0 0 0 0 3 0 12 18 
30 0 0 23 0 0 18 5 0 0 24 7 13 0 8 37 20 18 4 23 0 0 0 19 24 0 0 0 0 48 10 3 0 6 0 0 20 13 0 28 0 0 13 28 0 0 
0 41 34 0 7 10 0 27 0 0 0 22 0 0 0 38 0 18 1 0 14 0 15 0 15 0 0 0 10 0 0 0 0 0 27 0 34 32 0 11 0 1 41 2 13 0 
18 6 39 12 0 28 43 4 0 0 0 41 0 4 0 18 0 4 35 13 0 0 0 0 18 0 4 0 0 16 25 20 11 9 0 0 30 0 36 8 0 0 14 26 1 0 
76 2 0 3 2 6 0 0 52 9 0 33 23 0 17 5 0 0 11 3 0 0 0 0 0 0 21 26 0 11 40 0 32 12 11 19 0 0 0 7 14 0 61 1 32 29 
0 0 0 0 13 24 0 0 37 14 0 18 0 30 0 2 0 11 0 23 0 0 16 12 0 3 16 1 15 33 15 2 0 0 3 0 0 2 10 2 0 0 49 18 0 18 
12 0 0 0 34 0 0 7 0 0 15 3 2 0 3 13 0 0 0 0 0 7 0 0 0 0 0 0 1 25 0 10 26 0 0 5 0 8 33 5 15 10 4 0 0 0 
14 32 0 19 44 17 0 0 0 12 18 16 23 29 9 5 16 5 21 1 0 49 0 0 12 34 4 50 0 0 5 33 9 2 36 3 12 3 0 0 15 20 17 30 6 0 
1 0 0 9 0 16 29 17 6 18 0 0 0 0 8 0 0 19 1 0 3 12 0 30 3 4 0 0 0 0 7 24 0 0 0 39 0 13 14 3 16 6 0 0 0 0 
0 0 0 0 0 27 3 1 0 0 0 0 0 0 18 5 0 15 0 17 0 0 4 0 8 0 0 0 10 0 0 2 10 0 17 0 14 0 0 3 0 2 9 0 0 14 
0 30 1 26 3 0 0 25 34 0 0 17 0 28 0 0 10 0 0 0 17 8 0 10 13 2 16 26 22 14 27 0 36 27 19 10 0 7 7 0 0 0 24 10 0 5 
32 30 0 10 0 17 17 29 0 0 7 34 4 21 12 3 0 14 17 13 0 0 23 9 16 0 4 0 10 14 0 5 58 0 50 0 7 0 11 12 0 0 23 24 0 5 
8 0 0 9 0 29 22 7 0 0 8 4 14 0 31 14 2 13 0 0 0 10 17 0 0 0 7 5 53 8 36 0 12 6 29 6 8 3 2 14 0 0 12 32 17 7 
0 2 0 28 13 15 4 7 32 0 16 11 19 0 16 0 13 0 18 16 0 0 23 0 12 0 22 0 7 0 16 24 6 0 0 8 17 2 0 2 36 23 30 17 2 0 
0 7 0 0 34 3 0 2 6 22 0 0 11 22 0 7 38 0 59 6 14 0 0 0 14 8 4 0 0 11 4 16 7 0 23 0 0 7 14 17 16 0 27 1 26 0 
0 8 0 9 0 7 0 1 1 11 7 1 14 8 0 5 0 30 13 1 28 13 0 0 0 0 8 5 18 0 0 11 0 17 5 0 0 3 20 27 0 21 2 1 2 0 
15 0 0 0 8 21 0 0 22 0 0 0 5 0 16 0 0 0 23 7 6 7 0 0 5 0 21 0 0 0 26 0 0 12 0 6 0 0 0 0 0 23 0 3 0 0 
16 0 11 0 64 30 19 0 0 0 0 0 4 21 17 9 4 0 44 3 15 0 10 20 21 29 0 0 24 7 11 8 2 1 2 15 0 0 33 62 5 12 12 29 56 5 
0 0 0 0 0 0 0 0 15 0 37 0 0 7 0 27 35 0 16 0 7 0 8 20 2 0 2 11 5 7 0 21 1 5 23 5 0 4 3 4 0 0 14 15 0 29 
0 18 0 12 0 0 32 0 0 2 0 1 18 17 0 13 9 5 26 22 6 28 6 6 11 1 18 10 8 46 10 0 3 0 0 5 9 12 0 1 0 28 22 3 26 4 
0 25 0 2 0 2 0 0 5 25 8 13 33 7 2 0 19 0 16 6 0 0 12 0 0 15 11 0 0 0 31 12 0 0 21 0 11 0 22 23 0 31 40 0 2 0 
20 35 0 48 0 23 0 0 8 0 77 0 4 1 9 18 1 13 6 9 19 18 0 7 14 0 1 13 23 29 5 1 24 9 1 11 0 3 0 19 22 0 23 3 2 0 
26 1 2 0 25 0 37 0 29 0 2 11 0 0 0 0 21 11 10 0 3 0 0 10 16 17 22 4 0 0 0 0 22 0 7 0 4 22 14 15 0 2 9 2 0 0 
0 12 2 28 1 0 4 0 0 0 0 18 21 37 0 22 0 0 16 4 8 0 0 0 0 16 20 4 0 31 0 0 29 34 0 0 0 23 25 1 19 49 0 0 0 10 
12 30 26 17 63 0 0 0 31 38 0 37 15 18 0 0 3 18 10 0 10 0 8 17 0 0 0 4 7 27 3 10 18 6 55 8 27 10 0 40 21 4 10 109 16 7 
0 0 25 25 32 0 0 22 5 38 101 0 8 0 8 0 13 1 0 0 3 0 0 6 15 0 9 0 25 15 0 0 0 0 34 16 27 0 4 15 0 0 32 0 0 0 
