46 26
0 15 12 12 0 0 33 0 14 16 32 0 0 17 0 12 15 33 13 6 0 0 0 25 21 4 0 21 0 0 0 0 19 15 28 2 14 9 0 0 0 0 40 20 7 60 
0 26 28 3 21 28 79 5 7 0 3 10 2 0 13 0 0 0 12 0 14 24 1 1 16 24 0 2 0 0 10 29 0 4 0 29 6 0 0 18 20 35 2 4 26 10 
7 17 0 0 30 4 6 0 7 0 42 58 8 0 22 4 0 21 12 22 7 0 5 2 0 25 15 10 5 2 0 0 37 8 30 0 2 0 21 20 25 17 8 0 40 35 
44 0 0 0 30 0 31 3 14 0 22 1 0 0 0 0 28 0 12 0 2 0 0 0 36 0 5 6 20 0 22 5 0 1 22 0 0 0 14 0 0 0 41 7 16 0 
35 17 14 14 0 13 0 0 0 0 17 0 11 0 25 0 0 0 7 0 0 2 10 11 0 24 2 0 2 26 0 0 12 7 0 35 9 0 0 31 4 37 8 0 27 4 
28 1 27 15 2 36 4 0 5 27 12 45 29 0 7 25 0 0 33 9 5 7 0 0 0 18 0 0 9 0 0 17 24 0 14 0 23 0 0 14 25 49 0 36 14 0 
11 10 38 0 0 33 8 8 0 0 8 9 11 14 0 0 0 0 19 28 2 15 3 29 0 0 0 0 0 0 10 15 0 0 19 1 5 10 0 20 28 0 0 25 9 0 
22 1 13 0 0 0 34 15 1 26 10 0 32 18 7 0 8 19 13 15 16 0 20 17 8 6 1 15 0 27 0 0 5 7 0 26 35 0 0 0 0 9 0 0 0 0 
30 0 38 50 10 16 17 0 8 0 6 7 0 0 11 9 0 4 0 23 13 9 0 14 0 25 0 2 0 11 6 0 27 19 1 0 5 27 5 14 0 3 64 16 15 2 
6 0 0 32 29 32 5 14 13 27 0 1 0 10 38 18 12 0 8 23 0 11 0 12 14 0 11 0 0 7 0 0 0 58 0 0 33 32 14 8 37 43 23 0 11 19 
90 15 0 1 31 34 10 0 2 36 1 5 0 0 23 0 18 0 0 16 19 0 15 0 13 0 7 2 0 9 10 13 1 1 30 50 6 47 21 0 10 0 8 25 72 49 
0 0 14 0 0 0 0 0 12 1 1 0 0 17 1 0 0 1 1 15 0 5 0 0 0 0 0 8 21 7 17 0 3 0 26 0 7 0 0 10 0 0 7 0 0 0 
0 0 17 0 8 0 36 1 10 62 10 0 0 0 19 18 0 0 0 27 0 7 13 0 13 21 0 5 1 10 11 5 5 8 1 16 25 0 0 27 4 10 33 1 0 0 
5 23 0 0 36 0 12 15 6 6 0 5 0 10 23 8 0 27 14 30 2 5 6 11 23 11 19 18 16 3 8 8 17 24 0 22 7 10 19 13 0 9 0 7 35 32 
0 0 20 4 24 13 8 0 18 18 5 4 0 0 7 5 0 0 0 28 0 31 7 0 20 0 18 33 8 10 12 4 0 0 0 12 0 9 0 28 0 0 0 0 25 0 
34 3 0 0 0 5 0 0 37 0 0 30 4 0 2 0 0 15 18 7 2 0 0 0 18 2 0 11 0 11 1 5 0 31 37 2 22 0 0 3 0 21 9 0 5 51 
1 42 34 1 45 6 59 6 20 0 9 14 0 0 14 0 12 2 0 22 20 23 0 2 2 9 10 0 33 3 24 0 3 23 6 0 40 46 37 11 0 25 16 26 37 0 
2 35 4 0 2 39 29 0 0 3 0 1 0 0 5 10 0 2 9 10 23 12 12 0 8 0 4 23 17 10 19 2 0 0 0 18 50 0 0 17 26 4 0 23 39 0 
0 11 10 0 8 0 15 0 0 0 15 4 11 0 15 0 0 18 2 15 0 9 16 0 0 10 4 5 0 15 4 4 0 0 25 25 0 0 0 0 0 2 27 12 0 0 
12 0 0 0 0 0 0 0 10 0 0 18 0 0 18 0 0 3 7 25 0 10 0 2 0 0 0 0 0 13 0 2 0 0 0 17 4 2 0 2 0 0 2 0 41 0 
35 4 33 62 0 27 53 7 30 19 15 0 21 4 11 9 4 4 2 2 0 1 0 11 0 1 4 0 4 0 30 18 0 8 4 29 0 0 7 0 65 4 0 0 48 6 
11 31 53 11 0 38 0 0 20 0 0 0 0 0 11 0 14 0 24 11 17 0 0 23 0 0 19 8 20 0 25 0 22 4 0 0 0 30 0 14 4 39 8 0 2 2 
4 3 0 1 30 14 0 19 0 0 4 26 0 0 0 0 8 7 0 25 16 0 23 0 18 0 15 0 10 18 0 0 22 0 10 0 0 0 2 39 0 0 19 0 0 58 
10 0 2 20 0 0 0 0 0 5 0 0 0 0 3 0 28 4 1 0 0 7 0 15 0 0 5 0 20 21 16 6 0 0 0 0 0 0 12 2 0 0 0 0 13 0 
12 9 17 1 21 25 24 29 5 22 5 8 31 14 2 22 3 0 23 6 17 3 7 0 3 16 7 17 0 7 11 21 31 0 9 0 0 6 0 17 28 13 0 37 13 0 
20 0 23 32 40 0 4 0 0 0 0 20 0 35 0 8 0 0 14 15 10 2 0 0 17 0 14 0 5 23 17 7 0 40 5 39 0 31 0 0 24 15 1 1 6 0 
