46 26
0 0 14 1 28 0 20 0 2 0 0 0 0 0 0 0 12 15 0 8 5 8 3 0 10 0 17 2 0 54 5 27 6 0 3 0 3 0 0 0 0 0 26 19 12 0 
15 7 21 0 0 9 4 0 5 0 5 0 0 0 9 0 0 9 10 14 0 6 14 0 13 2 21 2 0 0 7 5 0 0 0 7 0 7 36 0 0 0 6 1 0 0 
25 48 0 0 19 28 3 0 3 30 6 20 26 1 7 29 5 0 42 7 3 23 17 20 19 15 16 49 0 4 10 2 0 2 5 20 0 1 38 8 13 23 11 0 2 44 
8 5 0 8 0 21 27 12 29 0 0 20 0 0 10 21 23 0 15 6 11 24 20 11 12 6 0 34 6 28 3 79 12 0 24 9 0 7 0 23 0 21 0 19 34 42 
39 0 14 0 3 0 0 3 36 0 16 0 0 11 0 19 14 0 0 0 20 0 0 17 0 0 3 1 9 0 14 0 4 0 32 0 0 0 9 39 20 0 11 1 0 37 
16 0 34 24 0 21 33 20 1 0 2 0 6 0 12 0 13 0 25 28 4 16 12 0 48 0 24 35 2 7 1 13 10 0 16 1 37 16 10 33 16 0 17 1 13 21 
107 0 0 45 0 0 19 18 25 21 27 0 22 2 23 0 0 9 0 0 0 0 4 8 5 37 13 19 1 0 16 4 25 30 22 12 9 23 29 0 0 33 4 4 0 9 
15 16 15 15 31 22 1 15 0 15 17 3 0 0 16 42 6 15 21 0 6 1 16 1 4 14 21 16 0 0 26 17 0 0 5 0 24 19 0 0 29 0 16 0 0 0 
18 47 0 4 0 24 19 4 6 9 0 28 12 0 9 11 7 3 9 3 0 27 0 0 20 2 21 15 1 16 49 0 1 0 13 0 0 0 29 28 0 49 8 13 17 29 
0 2 0 0 0 19 8 0 0 0 4 0 0 0 0 0 0 0 21 0 2 0 0 17 21 16 0 26 1 0 0 15 0 11 0 0 5 0 0 0 0 34 0 0 12 3 
0 0 0 30 0 0 0 37 0 3 0 14 0 0 20 0 0 13 0 11 15 0 8 7 5 10 9 3 11 0 21 1 1 30 20 17 0 5 5 0 0 0 0 5 56 0 
7 0 17 0 7 8 47 37 2 26 0 24 9 22 0 0 0 15 14 0 0 22 0 17 16 0 2 11 15 0 9 0 4 4 12 27 15 9 10 0 5 3 0 0 3 0 
49 2 6 0 28 10 0 0 26 0 11 45 12 0 5 28 6 0 4 0 13 0 12 0 16 0 0 1 4 0 0 0 12 0 0 0 1 47 5 0 29 1 1 23 0 0 
29 0 14 9 27 30 5 8 11 3 0 0 27 0 6 20 15 0 15 36 0 0 0 0 0 0 0 30 0 0 7 27 14 10 0 5 8 0 9 0 0 22 18 0 19 5 
2 2 44 0 0 0 5 2 0 0 8 25 3 56 0 11 0 0 7 0 0 8 0 0 4 0 11 0 0 8 3 0 0 20 0 9 39 0 25 0 0 0 0 0 46 0 
30 42 0 25 37 6 7 3 30 32 3 11 0 18 24 28 8 19 0 6 0 0 10 4 5 0 18 8 25 0 0 5 14 4 8 27 7 2 5 0 0 74 7 14 0 4 
20 5 23 2 0 13 0 2 0 11 0 24 19 0 0 0 0 0 0 0 11 6 31 15 26 29 0 6 4 0 0 28 0 1 7 24 16 0 16 15 18 0 3 12 0 0 
0 31 17 11 0 32 0 0 7 0 0 31 3 7 6 24 27 1 15 7 7 8 1 22 23 0 27 11 0 14 3 14 0 21 1 73 0 63 0 0 1 0 0 34 9 14 
1 0 6 14 0 32 2 0 5 0 27 21 0 5 11 12 13 0 0 2 5 15 0 13 14 0 0 3 25 0 0 3 45 0 0 0 0 32 0 0 40 38 0 0 3 5 
16 7 41 0 9 35 0 13 4 12 10 9 0 9 0 0 14 10 14 40 13 0 0 0 0 19 15 2 0 0 14 3 0 0 0 30 0 0 20 0 0 0 0 60 19 26 
6 15 19 22 0 24 20 4 0 6 16 0 11 18 0 0 0 22 0 2 1 0 0 0 0 14 1 18 16 21 14 0 15 13 0 9 4 6 6 22 0 8 0 14 30 0 
18 0 0 0 0 0 14 0 0 34 0 7 0 40 0 0 0 7 0 50 3 3 0 10 27 5 17 2 0 21 7 20 0 7 21 35 17 46 10 2 7 3 0 15 6 0 
0 0 18 34 0 30 0 0 22 0 0 31 18 0 0 12 0 0 0 24 0 9 3 39 13 20 21 21 7 2 4 19 0 0 0 0 7 20 11 31 15 0 28 16 46 0 
0 29 41 16 0 0 5 0 0 21 0 12 10 10 20 19 0 0 0 0 20 20 31 12 0 0 15 20 19 26 29 0 0 0 0 15 0 0 0 2 0 0 16 47 0 0 
42 0 0 11 12 5 0 14 4 5 0 31 35 16 12 1 0 10 23 0 24 3 8 10 0 0 4 19 4 0 0 18 14 0 19 0 4 15 0 0 0 2 73 12 0 2 
0 0 0 0 0 31 5 10 17 0 0 0 30 0 3 0 18 7 19 0 8 17 21 19 18 17 24 0 10 25 10 0 0 10 0 0 31 0 0 6 19 0 20 0 0 30 
