46 26
0 0 0 0 3 3 0 6 0 17 16 0 6 8 0 15 2 18 4 0 10 4 14 20 0 0 25 0 0 0 27 0 0 35 0 0 13 18 0 0 0 0 0 19 0 0 
36 0 33 16 0 21 0 11 0 0 31 4 24 0 22 10 16 0 0 25 0 6 8 13 17 15 10 23 0 0 0 22 16 0 0 50 37 22 0 14 0 31 2 16 55 20 
40 10 0 16 3 12 2 53 11 0 1 15 0 5 9 21 0 21 9 24 0 18 0 10 0 6 2 1 21 0 0 37 24 10 52 0 16 0 37 0 23 8 0 31 0 0 
8 14 16 0 15 35 0 17 25 1 14 0 9 22 0 6 0 23 0 7 0 6 6 19 7 7 0 0 7 0 0 7 9 8 1 0 59 56 0 0 12 10 64 30 0 0 
1 37 0 28 25 0 2 1 1 17 0 0 0 0 0 0 32 0 0 0 3 0 19 6 13 3 15 11 0 5 0 0 0 0 0 23 2 27 0 36 19 9 19 0 0 0 
0 0 11 0 0 29 0 3 8 0 23 1 0 0 9 0 7 5 0 0 0 13 1 25 0 0 0 0 19 0 0 0 0 8 23 16 0 0 0 0 0 0 0 0 2 11 
0 26 11 9 1 36 4 6 15 0 8 0 11 5 19 14 0 10 16 12 10 0 14 8 0 13 1 43 15 7 13 12 2 6 0 0 4 34 9 0 32 36 0 10 0 15 
0 5 42 5 7 13 11 0 21 2 10 0 0 0 21 22 15 0 20 14 14 5 19 7 0 8 23 0 3 0 20 18 9 17 10 24 0 5 0 0 25 0 0 13 54 0 
28 0 0 29 0 0 28 1 0 32 0 12 0 0 4 0 0 6 2 0 5 13 0 5 0 0 0 0 28 16 11 0 29 0 39 3 15 0 0 18 0 43 0 0 6 16 
44 35 21 0 10 40 20 20 13 30 62 33 0 19 7 1 4 11 10 0 10 0 22 33 13 3 10 1 0 14 24 7 5 14 26 31 18 48 16 5 3 0 0 14 0 72 
0 0 0 0 0 0 15 17 0 6 9 21 0 0 1 1 0 0 12 0 0 1 0 2 10 0 0 0 3 2 0 14 21 5 0 11 6 6 0 4 0 0 0 8 0 10 
7 0 23 0 14 0 0 0 10 0 4 75 5 0 19 2 9 14 16 0 17 3 18 3 12 48 1 0 8 11 0 23 13 0 2 0 0 1 0 19 7 22 5 8 24 21 
32 64 0 0 8 9 0 14 26 28 0 14 7 7 15 0 5 0 2 0 15 0 0 0 3 1 0 12 15 0 11 0 9 0 0 6 6 24 98 5 12 0 10 0 5 0 
12 16 0 0 4 34 31 38 26 7 2 0 15 5 29 0 33 11 14 33 4 0 13 0 9 0 0 0 21 0 0 0 2 37 19 5 5 15 4 23 3 19 22 5 0 45 
1 0 0 8 26 21 0 0 3 0 0 18 0 12 0 0 0 26 1 0 0 0 26 19 3 0 27 0 0 18 15 1 0 0 5 0 15 52 12 0 0 0 0 33 6 11 
1 13 0 13 30 8 0 1 5 0 6 0 8 12 27 1 22 9 0 0 4 6 0 27 13 8 2 6 11 3 0 0 0 5 0 12 0 17 15 11 0 31 0 36 3 0 
0 0 16 12 1 0 19 38 13 10 48 7 3 25 0 0 10 13 0 10 27 17 16 17 0 3 0 0 0 0 0 0 17 3 0 5 4 20 25 0 0 31 0 0 0 27 
22 14 7 52 29 10 19 0 83 7 10 0 14 11 0 12 13 10 0 2 3 0 16 1 28 0 0 0 26 0 0 0 13 49 15 8 0 0 0 0 0 14 0 6 36 18 
14 101 5 9 28 0 14 0 6 0 12 11 0 0 19 0 5 26 7 0 0 17 0 14 17 28 15 0 27 1 5 9 28 0 13 53 52 4 8 38 0 0 0 27 1 11 
15 4 0 0 24 77 6 0 6 15 33 0 0 0 0 0 0 0 0 0 0 0 0 3 14 10 17 0 22 0 25 0 0 13 0 7 7 0 0 0 17 8 0 62 39 0 
0 0 0 0 0 9 17 0 0 0 0 0 0 17 9 20 5 0 0 0 0 0 0 0 0 2 0 0 7 2 24 0 26 0 0 7 0 0 1 8 0 0 0 15 0 7 
30 0 5 0 2 36 56 0 10 0 0 0 0 29 29 2 0 8 9 0 0 0 4 21 3 6 0 9 2 0 18 0 2 16 7 29 0 34 2 25 8 36 0 0 52 0 
0 18 22 0 0 21 0 17 19 0 0 13 0 27 10 0 0 0 27 0 21 0 0 3 2 0 0 0 0 9 15 7 13 0 4 13 9 1 0 0 45 3 0 2 0 14 
33 19 0 25 2 0 0 0 16 0 0 14 8 0 14 9 0 10 0 19 0 17 0 2 0 6 0 0 37 0 0 17 8 23 21 13 0 9 17 2 8 0 19 0 0 0 
0 0 0 6 70 0 38 15 35 0 19 0 0 0 13 4 0 7 17 0 0 0 2 13 0 0 0 10 19 21 15 0 0 0 19 0 8 0 16 0 36 0 0 0 38 0 
16 0 12 8 0 40 37 23 19 34 0 2 0 27 34 7 21 8 0 8 21 4 0 0 22 13 7 0 42 0 0 9 0 16 0 8 5 24 0 14 4 1 22 48 0 34 
