48 27
17 3 30 0 14 0 0 0 0 43 0 11 5 0 4 12 1 0 16 30 23 0 0 14 0 0 26 0 11 0 0 0 35 0 0 0 38 0 5 0 0 0 0 0 0 0 0 0 
0 19 0 0 0 0 0 0 24 27 5 11 35 0 0 8 0 0 0 0 5 0 21 0 0 0 11 24 0 20 17 0 24 11 19 20 0 0 0 0 0 0 0 21 0 3 0 52 
0 21 11 0 6 0 0 1 32 0 0 8 5 0 0 0 19 3 15 19 1 0 4 0 0 6 0 0 16 11 0 17 12 0 0 35 1 0 0 0 0 0 0 0 2 0 0 2 
50 0 0 3 0 0 0 19 0 35 44 0 0 23 0 11 18 13 17 12 28 10 0 0 23 0 1 18 2 7 0 0 14 0 22 0 16 16 0 13 0 6 5 4 0 0 1 38 
6 0 58 0 1 7 0 18 0 14 0 0 11 0 5 41 0 0 0 38 11 0 13 0 0 40 10 3 31 11 2 9 0 13 0 0 0 0 47 0 15 0 13 40 55 0 0 30 
12 0 0 18 32 0 3 2 0 0 0 0 32 0 39 14 48 15 0 6 4 12 17 4 0 0 20 27 0 1 6 0 0 14 0 0 50 0 28 18 0 0 26 33 0 0 20 11 
0 19 5 41 0 6 0 39 0 2 29 34 0 6 16 24 3 16 0 6 0 3 8 0 7 8 0 23 6 2 6 13 10 40 0 6 4 25 33 53 13 30 17 0 44 0 31 0 
9 1 0 2 15 2 0 0 24 15 9 1 8 0 7 2 0 4 18 19 0 23 4 0 5 18 4 0 13 0 13 14 0 0 0 0 0 6 0 0 28 2 0 33 24 0 0 0 
0 46 0 3 6 14 20 30 0 7 23 12 24 7 2 0 14 2 0 18 13 7 0 0 0 16 33 0 2 0 16 16 0 0 21 0 2 0 0 7 7 34 29 5 31 0 48 14 
43 14 13 0 0 0 37 0 0 8 0 0 0 0 2 5 1 0 0 0 19 5 0 11 4 0 0 17 1 15 0 10 0 3 11 15 0 22 0 24 0 6 0 58 0 24 43 0 
0 6 0 0 13 0 21 6 7 0 29 18 13 0 6 0 16 20 0 0 3 0 0 13 11 1 0 21 0 17 10 8 0 0 0 0 6 0 8 61 0 14 21 0 4 0 9 0 
0 0 12 3 0 0 10 0 0 4 8 0 0 0 0 0 10 1 6 0 0 0 0 19 0 0 9 5 0 0 0 0 0 0 0 0 11 0 1 0 0 0 0 0 0 0 0 16 
17 2 34 75 4 0 4 36 0 4 3 0 27 16 61 0 8 11 24 0 20 10 4 0 0 1 11 0 0 0 34 6 34 0 9 6 6 30 48 27 0 0 75 25 12 31 31 17 
9 0 30 28 0 5 0 0 0 18 0 0 15 0 13 0 5 3 0 13 0 0 0 11 12 0 4 13 0 0 0 28 2 0 0 0 12 35 26 10 0 0 3 0 0 0 0 0 
16 5 39 0 0 25 0 0 20 0 74 7 0 0 0 0 0 0 2 4 0 11 4 5 5 10 16 7 10 11 0 10 47 9 0 9 17 1 34 1 4 39 5 15 15 35 0 16 
0 16 8 0 0 0 0 10 24 36 8 0 0 0 10 0 0 11 0 9 0 0 0 0 0 0 0 1 0 3 15 0 37 0 0 5 1 0 0 0 7 0 0 0 0 36 0 0 
20 14 0 0 0 53 0 1 1 0 15 34 0 0 19 44 3 0 26 13 20 0 0 0 10 2 18 0 23 0 30 0 0 19 24 40 8 0 0 27 0 6 6 8 78 73 0 14 
5 0 10 25 0 0 9 0 8 36 22 20 23 0 0 0 33 0 0 9 17 0 0 0 0 0 0 16 0 0 0 21 0 0 0 28 30 8 0 0 29 4 0 0 11 3 0 0 
0 0 6 0 0 40 4 0 46 3 7 6 8 0 14 23 24 0 0 0 12 4 30 17 5 11 0 3 2 3 22 21 7 7 9 9 34 6 31 17 86 0 0 0 15 39 1 0 
0 30 19 0 0 0 11 0 10 6 15 3 6 0 0 0 0 0 0 0 0 4 0 5 0 16 32 0 0 0 12 10 7 4 0 0 6 0 0 0 11 0 3 0 0 20 1 7 
0 31 7 0 25 0 0 0 11 9 0 0 8 0 11 0 8 0 2 3 8 0 6 10 0 0 13 0 0 25 10 3 37 0 22 5 0 6 6 10 5 0 0 42 5 19 0 0 
9 0 0 0 8 21 0 24 0 9 32 7 0 0 29 17 0 0 0 19 0 17 11 0 0 0 19 15 21 0 0 10 0 0 0 20 19 0 0 0 3 30 2 27 3 0 0 0 
18 45 21 17 35 18 12 15 0 0 0 14 10 0 0 0 0 9 58 16 0 0 2 0 0 14 16 0 0 10 0 0 5 17 16 0 14 26 18 25 0 23 12 10 8 28 45 14 
0 0 28 0 0 9 0 0 16 23 21 22 0 0 0 4 1 0 0 0 7 0 0 24 0 0 1 0 0 27 0 21 0 0 11 0 16 14 17 10 0 0 17 0 0 22 0 24 
23 0 3 0 0 4 38 3 0 0 1 6 0 0 29 21 21 0 25 24 23 0 0 25 0 0 15 0 0 0 9 28 0 23 4 0 19 2 9 0 5 20 6 106 22 19 2 14 
37 6 12 0 0 0 17 0 0 4 0 10 21 0 2 0 27 22 0 0 0 0 0 0 15 0 22 24 21 0 0 4 14 26 22 0 6 0 5 37 0 0 0 22 2 0 54 0 
2 0 20 6 5 24 22 0 7 15 23 9 23 4 6 0 16 20 6 13 22 0 0 21 48 9 45 17 0 24 20 12 0 0 0 30 35 0 8 6 14 5 36 0 23 5 23 0 
