48 27
14 14 71 0 14 8 24 4 41 38 2 13 0 7 14 14 8 5 23 0 0 0 43 1 0 0 3 10 0 62 11 25 8 0 0 4 0 8 37 6 7 0 0 10 0 36 0 22 
1 37 0 0 1 32 0 0 4 19 0 10 27 0 20 0 15 16 9 0 0 30 0 0 9 1 0 16 26 1 4 24 0 17 5 13 0 12 0 16 7 20 0 17 7 0 19 16 
40 9 0 0 8 35 0 33 0 15 14 0 0 0 7 14 7 14 0 0 0 6 9 18 5 10 11 0 0 18 0 16 0 12 0 11 16 36 0 0 0 40 0 20 18 0 0 16 
0 51 43 16 0 12 8 0 0 0 10 0 0 33 5 29 0 12 17 13 0 0 3 0 31 15 0 15 0 2 0 3 4 0 11 11 22 0 6 0 1 9 10 0 29 24 32 2 
9 4 0 0 5 0 0 0 0 8 20 11 0 15 0 0 0 0 16 0 2 2 14 0 0 0 0 0 15 0 13 1 0 0 0 4 0 0 15 0 0 11 0 0 18 8 1 2 
21 23 0 0 13 0 0 3 56 0 2 0 0 12 4 0 16 17 8 16 0 0 18 14 23 12 8 6 0 0 0 0 4 6 0 16 0 26 0 0 0 0 33 37 0 0 24 0 
0 0 0 0 14 0 3 0 24 7 0 34 0 3 57 10 14 13 0 0 10 11 0 0 0 4 0 0 0 2 41 17 12 0 39 1 2 0 0 0 0 0 0 29 12 36 17 33 
0 0 0 12 1 0 0 0 0 0 13 5 0 0 2 0 30 0 17 0 0 0 14 19 0 17 0 0 0 0 12 0 10 0 8 12 17 0 0 0 0 0 27 2 39 0 0 17 
0 22 0 24 7 0 0 6 2 16 26 8 0 0 0 0 0 0 6 19 17 0 0 4 10 0 0 9 0 0 0 14 12 14 18 4 46 0 17 8 19 0 0 7 33 5 0 8 
0 0 0 2 4 0 3 0 69 16 34 0 0 0 21 7 0 0 0 0 0 0 0 0 15 0 0 0 0 3 0 9 3 0 2 26 1 29 0 30 0 0 0 0 34 0 0 39 
0 6 0 0 8 0 0 8 0 8 0 4 0 0 0 0 0 0 0 0 0 0 0 0 0 0 17 0 0 10 13 0 0 0 0 5 0 5 0 0 0 1 5 0 9 0 0 4 
0 19 0 2 0 0 28 0 0 0 0 10 0 0 0 0 0 0 0 4 7 0 4 0 0 0 9 0 0 0 0 0 0 0 30 1 1 3 0 5 0 13 0 0 0 0 0 0 
0 0 0 0 0 11 17 14 0 18 4 5 0 7 2 0 32 3 2 13 0 17 12 0 12 9 9 0 0 0 0 14 0 0 26 16 5 21 0 0 0 0 33 9 0 2 0 12 
37 8 62 37 26 0 0 0 0 27 0 0 0 0 0 10 0 8 10 26 0 7 32 0 0 0 0 14 19 0 0 10 7 9 30 7 3 10 0 14 20 14 9 0 26 9 2 0 
14 89 20 9 6 4 1 46 0 6 0 0 0 0 1 8 26 29 2 0 19 0 4 10 7 0 6 12 0 0 0 11 0 39 13 8 0 13 31 0 6 0 0 26 0 12 15 50 
0 7 22 1 26 17 43 0 0 0 0 7 0 0 6 4 7 15 7 1 12 0 11 21 0 19 0 0 0 11 26 0 0 14 3 34 17 13 0 0 15 0 0 45 0 1 17 2 
0 8 0 1 1 17 32 29 0 0 36 0 0 11 0 3 6 20 0 0 25 0 3 18 2 0 0 0 0 0 0 0 0 10 0 15 33 8 0 33 0 0 0 0 3 0 36 0 
0 3 31 39 40 0 0 33 35 15 0 0 0 22 1 0 1 13 0 30 0 8 3 0 0 0 8 1 16 0 6 0 0 34 0 2 0 0 0 6 11 0 31 35 0 20 6 43 
0 49 45 11 0 22 18 17 0 0 0 0 0 49 19 0 3 1 0 23 7 14 0 3 20 0 29 5 29 14 3 9 16 3 0 14 0 0 0 38 3 22 13 55 15 47 0 24 
2 21 21 20 14 3 5 1 1 0 36 1 16 11 0 16 0 15 18 4 0 6 15 15 0 0 4 0 0 0 10 0 0 2 0 30 17 4 35 3 8 29 0 18 7 6 44 3 
37 0 0 0 21 0 0 5 0 6 13 18 5 0 18 0 0 0 18 15 0 0 25 15 0 0 6 0 4 5 0 0 7 29 13 13 0 32 3 0 6 1 9 0 22 0 19 1 
0 26 17 0 2 3 0 0 11 5 0 9 0 0 13 19 13 17 9 11 0 26 23 0 10 4 0 13 0 16 1 0 0 0 0 6 0 0 0 0 0 0 0 5 0 23 16 26 
0 14 0 19 0 4 0 3 1 25 3 0 9 0 0 0 0 25 5 15 0 31 0 0 5 0 0 0 7 0 32 36 0 13 0 21 0 9 0 23 0 0 25 0 33 14 24 0 
0 45 0 23 22 0 20 0 29 17 0 0 18 4 0 14 21 0 0 17 18 2 0 22 0 2 18 0 0 9 35 2 0 7 22 0 7 21 59 10 10 0 12 0 31 0 22 0 
36 41 11 54 11 2 6 21 19 17 0 0 0 6 1 3 14 0 0 7 17 23 23 0 21 0 0 0 0 0 9 16 0 0 0 0 20 0 2 0 37 0 11 0 27 0 24 3 
0 44 25 32 0 0 0 12 36 22 2 0 15 0 0 12 19 12 0 9 0 3 2 5 0 13 7 14 3 7 27 12 0 0 0 32 18 20 25 0 5 14 7 23 37 44 0 0 
3 36 60 3 24 0 0 0 0 62 0 0 21 18 0 34 12 20 0 13 0 11 0 17 0 25 15 25 50 0 4 47 47 21 15 25 35 8 0 26 0 0 0 0 0 0 0 0 
