48 27
8 0 56 0 21 27 0 0 33 25 0 0 31 0 39 13 0 0 30 0 0 0 0 0 0 28 9 23 0 0 12 15 26 0 9 0 13 0 0 0 0 0 58 38 0 37 15 0 
0 4 3 59 13 31 0 7 20 7 0 12 0 15 19 13 12 13 37 18 9 26 0 0 17 17 0 11 0 0 13 0 0 8 7 31 14 0 13 9 16 30 0 0 39 11 0 14 
64 3 0 0 5 3 29 24 13 19 0 0 0 1 0 0 0 0 0 0 20 0 17 0 0 0 0 0 0 1 16 24 0 15 0 0 27 0 0 14 0 0 0 0 61 0 13 0 
0 0 0 2 0 2 1 0 13 22 0 37 4 0 0 4 8 0 32 25 0 0 18 12 8 0 0 2 16 0 8 0 0 0 0 39 31 0 30 21 35 0 0 44 26 0 28 24 
0 0 44 34 0 0 0 15 4 0 0 3 0 22 0 0 0 1 2 0 0 17 7 14 0 0 0 0 0 2 8 10 0 7 0 19 10 48 0 0 0 7 15 0 0 0 43 0 
0 4 58 0 19 3 0 35 0 17 26 0 0 4 10 0 0 29 14 0 16 19 0 0 0 19 0 0 8 11 6 2 0 9 0 24 22 0 4 0 19 13 11 0 43 16 0 75 
47 37 78 0 0 5 33 13 0 30 45 34 0 0 50 0 0 0 82 0 2 20 13 0 4 0 0 0 13 0 7 13 1 1 1 7 0 35 20 62 26 20 0 11 4 50 28 44 
31 5 0 0 6 0 5 21 4 0 33 0 0 0 27 16 0 0 0 0 31 19 0 0 13 5 5 0 0 0 10 52 0 0 27 0 0 16 0 0 3 27 0 27 1 0 20 0 
46 0 9 0 0 0 0 0 0 6 0 32 14 0 0 0 0 0 0 0 0 0 0 0 0 8 0 24 5 0 2 0 0 9 4 8 5 0 4 0 0 0 0 46 0 2 46 0 
0 0 9 0 0 8 42 22 0 18 14 14 0 0 0 0 1 12 0 15 0 0 0 0 0 12 9 10 17 22 0 0 11 13 7 0 6 12 4 0 3 7 1 11 70 0 0 0 
18 10 7 0 6 17 18 15 0 1 2 16 0 0 4 0 14 17 18 0 0 11 3 0 18 0 0 9 3 13 3 8 0 0 1 28 23 0 4 0 0 0 28 9 13 32 0 2 
7 9 0 0 0 28 23 41 12 24 6 0 22 1 0 5 27 2 12 16 9 10 18 0 0 20 9 1 14 23 11 18 0 21 39 61 14 3 0 0 7 8 9 3 10 0 24 8 
0 40 5 0 4 0 27 16 39 0 0 36 18 0 0 0 0 1 6 10 1 14 0 5 0 0 0 0 2 1 9 0 1 22 5 0 0 0 1 1 0 35 0 2 26 2 0 5 
39 0 41 1 15 13 4 10 11 1 1 4 5 31 0 24 0 0 14 0 2 0 21 0 8 17 0 8 0 22 13 0 18 34 0 0 17 6 31 31 0 8 0 28 26 5 0 12 
0 0 0 0 51 0 0 0 7 2 12 0 2 6 0 7 13 0 7 13 0 50 0 11 0 18 21 10 6 9 0 0 7 21 18 6 0 16 30 20 6 9 15 0 0 7 26 19 
0 0 18 0 0 3 0 0 13 0 0 0 0 28 0 0 0 0 14 0 0 0 9 21 0 0 0 0 0 13 9 3 0 0 7 0 12 0 9 0 4 28 0 6 24 2 11 0 
8 0 0 17 0 0 0 0 0 0 4 0 0 0 0 0 0 0 0 9 17 0 0 2 15 16 3 0 0 0 0 0 0 0 0 0 0 0 0 15 0 0 0 0 11 3 2 0 
3 23 37 63 15 93 41 5 24 28 0 7 41 10 45 8 9 0 0 2 32 27 10 44 0 0 19 22 0 10 16 16 44 21 2 0 13 2 5 0 16 8 33 43 12 36 2 53 
1 0 30 0 35 18 0 28 37 7 4 2 0 0 84 0 54 0 0 17 19 0 0 2 0 14 7 18 0 30 16 12 0 0 0 49 0 0 0 49 2 27 20 11 28 7 0 0 
33 2 2 47 37 78 0 15 6 14 10 0 56 15 0 6 0 0 0 0 0 6 18 10 21 29 10 6 21 16 2 0 0 33 22 0 0 25 41 0 33 0 12 38 17 34 0 63 
20 37 25 0 32 0 0 6 0 0 29 0 0 50 27 32 0 0 0 19 23 0 0 0 3 0 13 21 27 3 0 0 7 0 13 0 32 0 3 39 0 29 0 54 3 0 0 4 
16 0 0 0 0 0 7 0 8 19 15 0 0 0 7 0 22 0 0 0 24 39 22 0 3 24 0 5 0 0 0 1 6 0 0 0 4 0 0 0 0 0 0 6 37 0 0 0 
0 18 0 0 17 0 19 0 0 6 1 27 14 0 17 0 4 46 2 0 17 0 0 0 0 41 13 2 27 0 0 0 0 0 17 0 19 10 6 14 1 0 3 0 5 0 0 14 
0 15 0 34 0 14 0 8 0 4 9 0 21 32 2 0 4 4 2 5 0 5 0 0 20 0 11 0 14 11 14 0 7 0 0 0 5 23 26 2 27 5 14 0 0 0 0 0 
1 0 3 27 4 2 3 55 20 14 0 0 0 0 0 0 2 0 0 0 0 1 6 15 0 22 0 0 6 22 21 13 0 0 0 0 0 0 0 0 33 0 0 0 13 0 0 27 
11 0 21 0 0 3 0 17 31 11 0 69 0 0 3 17 24 0 2 2 18 0 11 0 32 0 7 16 0 0 24 0 26 11 0 0 4 0 0 31 24 21 0 0 0 8 0 11 
27 0 0 32 0 1 16 0 0 17 16 54 0 0 0 22 37 15 0 1 0 21 37 0 16 6 0 36 0 0 13 0 21 0 8 0 9 22 7 28 16 0 73 0 22 0 0 37 
