48 27
18 0 0 0 0 0 0 0 13 2 0 1 0 20 0 0 0 0 0 14 0 19 0 14 0 0 0 22 0 0 0 39 11 20 24 0 0 30 0 0 0 30 0 0 13 0 0 0 
9 0 61 20 0 21 1 12 9 2 0 22 48 11 0 0 29 47 22 37 0 34 0 17 16 18 9 6 0 53 6 12 17 14 3 16 1 6 26 0 0 7 4 18 0 19 4 66 
0 11 0 0 0 0 37 9 36 4 3 0 44 38 20 3 22 0 0 0 15 22 0 0 0 0 0 0 0 0 8 0 0 0 33 10 0 0 25 0 14 17 0 22 74 21 34 4 
0 46 37 0 0 3 0 43 3 35 0 0 0 0 0 0 0 0 0 7 2 17 14 0 0 10 0 0 14 11 0 19 11 0 12 10 0 0 14 56 21 40 17 0 0 0 55 0 
0 22 36 28 0 11 25 12 1 55 1 9 10 0 0 0 3 0 33 5 4 3 22 9 0 33 0 4 0 1 0 18 3 0 13 0 0 5 0 0 22 0 5 0 22 13 22 0 
0 0 39 28 21 2 0 0 0 0 24 8 10 21 0 0 30 3 0 0 3 0 0 4 13 10 10 26 23 2 0 0 0 9 3 33 0 12 13 39 0 4 0 0 0 4 0 0 
0 0 18 0 42 0 33 12 0 0 9 0 0 11 11 9 1 27 5 12 11 7 5 2 19 1 0 0 0 6 1 23 22 19 14 24 0 3 0 30 0 0 12 12 26 14 86 0 
45 1 0 41 35 9 63 13 0 8 42 0 3 13 33 4 21 0 18 14 4 0 15 8 0 6 2 45 2 0 0 6 9 27 0 35 1 21 0 39 0 0 0 11 41 39 0 38 
12 21 38 0 35 18 0 0 34 14 0 0 63 17 0 5 1 17 0 2 0 10 17 24 1 18 0 26 41 28 0 0 0 28 11 0 13 0 0 105 0 7 0 49 16 0 38 0 
0 0 0 16 15 0 0 0 0 15 25 0 0 0 0 13 0 0 0 16 6 8 12 2 15 22 15 8 0 8 10 25 0 0 0 4 0 0 0 0 10 26 0 0 7 20 5 0 
9 0 0 30 31 0 9 31 2 0 0 0 5 54 0 0 6 13 6 22 0 0 8 0 0 3 0 0 0 0 8 9 0 48 23 0 0 30 25 0 7 3 29 39 0 0 16 0 
11 8 6 0 0 0 77 1 0 19 0 0 0 5 6 4 0 0 0 0 3 0 0 0 0 0 13 12 11 0 0 0 0 0 7 0 0 0 0 11 0 0 29 0 0 39 19 0 
0 0 0 37 0 13 0 0 2 5 0 23 35 2 27 2 4 9 0 30 0 18 3 0 0 0 0 0 9 0 0 0 17 14 0 0 13 4 1 39 37 19 0 1 0 5 0 39 
13 8 5 44 26 0 8 37 0 0 3 0 2 4 0 0 50 34 0 0 6 0 0 8 0 24 23 11 0 0 12 28 26 0 1 10 6 0 1 4 0 3 32 23 2 0 3 15 
0 12 13 0 9 8 0 0 34 12 8 5 40 30 22 18 1 0 0 20 1 7 0 0 11 0 0 0 0 17 0 2 0 33 23 0 22 0 1 3 0 0 3 0 1 37 18 0 
11 0 14 26 0 21 0 27 0 14 9 18 10 0 1 14 0 7 0 0 2 24 11 4 9 47 21 23 3 26 0 0 0 14 23 0 8 0 8 14 0 5 0 38 0 20 17 0 
0 0 0 0 0 0 0 1 0 0 0 0 0 4 1 8 0 2 20 0 0 21 0 0 0 0 1 0 10 0 0 0 5 0 16 0 0 7 0 0 14 4 23 0 10 0 1 4 
36 0 30 0 0 0 6 0 0 19 0 18 26 0 6 0 0 0 0 2 0 0 0 0 0 13 22 11 27 3 2 0 33 0 12 10 0 0 41 0 0 15 15 35 0 0 8 0 
22 25 0 0 0 10 0 2 26 0 0 0 7 0 0 0 0 15 0 0 0 10 0 22 8 0 0 19 20 0 0 0 0 12 0 0 10 0 0 0 0 5 7 36 0 0 0 4 
3 0 0 0 12 0 6 0 0 30 12 0 14 0 0 2 7 2 0 12 0 3 0 0 5 0 0 15 2 0 3 0 0 0 0 3 0 0 29 0 0 17 0 0 3 3 0 0 
0 12 19 0 0 0 13 6 12 1 0 8 0 6 0 0 18 0 5 21 0 14 0 23 8 0 20 0 0 0 0 0 8 3 12 6 0 0 0 0 2 13 0 3 0 14 39 0 
0 36 0 15 0 30 11 10 0 0 12 6 22 0 0 8 0 16 2 0 0 20 0 14 17 6 3 0 0 0 5 18 5 15 24 30 0 0 0 0 0 0 16 11 37 19 0 0 
46 0 14 0 0 17 10 0 39 67 42 5 4 25 20 42 47 22 26 18 29 18 38 0 21 20 0 42 6 19 11 18 0 17 5 40 8 0 0 3 15 0 39 0 45 25 30 118 
0 20 0 0 0 0 3 0 15 0 2 47 2 0 0 49 0 13 13 13 0 16 0 1 13 7 0 0 7 2 0 3 0 10 3 10 25 23 9 0 0 5 27 0 0 12 7 9 
0 0 0 21 0 0 2 38 0 0 10 0 0 26 27 0 28 0 0 0 10 10 0 0 21 12 6 10 6 2 0 0 17 0 11 0 0 1 0 9 0 27 18 0 44 38 8 0 
0 0 0 14 0 16 58 35 13 3 39 0 26 3 8 9 3 31 31 7 0 0 0 0 27 0 20 0 0 41 20 0 19 7 11 17 0 23 0 22 0 4 44 37 0 8 0 0 
51 4 0 30 0 0 29 24 6 11 0 7 25 6 0 0 0 11 2 8 0 15 24 0 6 2 0 31 21 19 26 2 26 45 16 0 0 0 30 0 0 0 0 0 20 0 29 14 
