48 27
0 0 15 0 9 0 0 0 19 9 0 27 0 9 16 0 0 17 19 5 14 12 0 13 0 0 0 28 4 0 39 0 62 12 6 0 8 15 27 22 21 0 23 0 6 0 12 21 
0 0 19 30 0 17 47 0 37 6 22 0 0 12 0 9 55 0 0 20 0 19 17 17 16 22 0 1 9 0 1 1 0 0 15 29 0 0 0 0 53 17 19 8 38 37 30 3 
12 18 0 0 87 0 0 0 0 0 0 11 2 0 0 3 0 2 16 0 0 4 0 11 0 21 0 0 21 0 0 14 6 0 8 12 3 3 7 0 55 0 0 7 0 14 0 0 
18 0 45 0 0 0 0 58 11 43 0 0 0 0 7 0 11 11 0 11 0 20 3 13 38 10 0 10 33 0 0 0 0 4 0 0 16 10 0 0 0 1 16 23 0 10 21 4 
0 44 29 38 20 27 3 4 20 0 3 16 34 2 0 14 21 12 13 10 0 0 2 8 16 0 21 8 2 1 0 0 18 5 10 17 15 0 23 37 3 12 0 0 39 44 34 21 
0 3 40 8 0 0 0 0 0 0 14 26 0 8 11 0 26 0 5 0 0 0 0 5 2 1 16 0 0 10 38 13 0 0 8 6 5 5 5 0 25 4 6 25 4 0 0 16 
16 28 29 0 49 33 3 30 0 36 0 1 0 28 22 0 0 26 27 0 0 0 10 0 2 17 19 10 19 2 0 25 31 16 4 0 51 0 9 26 0 37 0 39 2 29 37 0 
34 37 4 0 0 0 0 0 0 0 24 1 8 0 0 0 21 7 0 8 0 1 36 5 16 23 18 5 4 27 0 0 4 4 49 6 0 21 1 17 19 13 0 0 40 0 0 0 
2 16 0 0 17 0 36 29 21 0 0 4 0 0 0 0 11 23 2 0 23 6 0 5 3 0 0 23 3 25 13 1 10 0 0 0 12 0 1 0 11 34 0 70 14 0 0 4 
0 0 5 0 89 0 0 27 0 3 0 5 3 6 0 0 0 0 0 8 13 11 8 7 0 0 20 15 31 49 18 17 0 0 0 16 0 0 7 0 12 0 0 13 0 0 22 0 
0 11 9 7 0 0 9 58 43 0 17 0 32 0 0 37 0 0 20 0 0 0 1 1 7 21 4 26 5 19 23 2 6 1 16 9 30 14 6 6 38 21 0 0 17 4 19 40 
0 4 23 15 47 5 0 0 0 6 0 0 2 0 0 15 7 0 1 0 27 0 18 0 3 15 0 5 0 0 0 16 33 0 29 0 0 35 0 16 0 0 0 0 0 8 12 0 
0 0 30 0 0 15 72 0 0 12 0 0 0 0 0 0 0 2 8 34 16 0 1 24 21 0 0 23 13 16 14 14 31 7 0 0 10 5 0 20 0 18 6 11 0 21 0 20 
0 0 17 8 0 0 65 7 35 0 0 56 5 4 7 0 0 0 10 17 6 10 0 0 5 0 0 0 22 0 0 1 0 10 28 24 0 0 0 0 12 0 0 3 0 0 0 0 
0 0 0 0 11 0 26 0 0 35 0 23 6 0 0 13 24 7 16 4 16 6 16 0 23 17 0 0 0 0 12 1 15 1 3 0 0 0 13 0 0 17 28 0 68 0 0 12 
0 9 16 0 0 0 0 29 0 0 0 12 7 6 0 0 0 0 25 0 0 15 0 0 13 20 5 25 16 10 0 5 0 0 17 8 7 0 9 0 0 8 0 31 16 0 0 0 
15 0 7 0 11 0 0 0 15 0 35 20 0 0 33 20 0 0 0 4 4 0 0 12 0 14 15 16 7 0 10 0 0 4 13 0 22 0 0 15 6 0 4 19 0 0 0 0 
0 0 0 16 0 0 0 0 0 1 15 0 24 0 0 5 7 2 0 23 10 0 0 5 17 0 0 8 16 6 0 0 15 0 15 9 5 0 3 4 0 27 0 4 0 0 0 0 
24 0 0 0 1 0 17 34 0 0 0 0 20 6 0 2 7 7 0 0 0 8 0 21 17 0 0 5 1 8 0 13 7 1 8 8 0 0 0 0 0 26 0 25 16 0 0 0 
30 0 9 17 35 0 0 0 0 37 35 0 12 0 39 5 8 0 0 0 9 0 21 0 7 0 0 23 0 0 48 5 4 1 20 13 16 0 0 0 11 3 16 17 0 2 37 2 
11 4 19 40 0 0 0 50 0 25 0 0 42 0 7 2 0 0 8 0 1 17 10 23 17 0 0 4 17 7 0 0 10 0 41 5 4 3 0 0 33 0 15 40 0 0 0 0 
3 11 4 1 0 0 41 0 11 0 8 6 31 5 0 25 0 7 29 0 27 10 0 9 4 0 1 27 15 12 24 12 11 0 0 1 0 7 23 0 19 45 22 0 0 0 0 10 
34 23 11 0 0 0 0 0 0 16 0 0 0 49 3 0 15 28 10 30 14 15 0 0 25 29 0 8 10 0 12 17 0 4 32 8 37 0 13 3 0 0 25 18 31 26 3 27 
0 50 18 0 0 0 0 28 11 0 19 19 0 0 0 13 0 0 6 11 0 0 0 0 0 0 21 11 10 0 31 14 23 13 8 36 3 3 0 0 0 4 0 28 0 0 28 2 
17 4 6 17 18 0 3 0 17 3 18 11 0 2 1 19 0 27 31 0 30 0 21 17 19 17 0 3 32 0 15 0 0 5 0 24 0 0 0 0 0 13 25 0 0 0 21 29 
23 11 49 33 11 0 5 4 22 12 0 5 16 0 0 34 21 10 0 13 0 18 0 5 24 23 29 0 15 8 15 0 25 0 18 14 23 0 23 21 0 17 0 18 0 0 31 0 
0 0 23 12 24 0 25 25 0 3 0 0 0 17 0 12 16 0 0 4 0 0 0 0 0 4 1 0 3 0 12 0 41 4 18 0 0 0 10 0 21 23 0 0 2 0 2 37 
