48 27
5 8 43 0 0 35 5 0 34 0 0 35 16 5 0 25 0 31 0 3 12 19 11 0 0 0 5 0 11 0 0 0 0 0 0 24 0 10 0 13 14 22 0 66 26 0 6 0 
7 1 0 0 0 11 0 14 0 0 0 0 0 1 0 8 0 0 0 0 0 0 0 23 0 13 0 17 41 7 19 0 6 10 21 4 32 46 33 0 0 0 0 32 33 5 0 15 
21 25 7 0 3 0 3 0 0 0 28 0 0 16 0 12 11 0 4 0 18 30 2 24 0 0 48 4 2 0 27 7 0 3 0 13 0 0 3 0 27 6 47 0 18 0 0 0 
41 0 28 0 53 8 0 0 14 14 24 0 10 0 3 27 0 21 0 0 0 11 0 20 0 4 8 23 6 26 0 0 0 14 8 1 0 8 6 10 0 0 16 0 14 0 1 0 
35 0 20 0 0 0 0 3 12 16 19 0 3 0 0 0 13 26 0 0 0 0 20 0 19 15 17 17 2 0 0 0 12 53 0 25 1 0 0 0 0 0 18 26 2 0 34 0 
10 1 0 6 0 40 5 0 8 6 0 14 0 0 8 30 0 21 0 19 0 21 1 6 2 21 17 26 27 14 30 10 11 13 11 15 0 13 0 0 5 0 0 14 14 59 25 3 
47 3 1 20 0 26 1 15 14 20 0 4 0 8 23 0 11 0 10 9 0 0 22 0 24 0 21 0 10 5 0 44 0 0 15 0 12 0 9 4 1 0 0 4 5 5 0 63 
0 22 0 19 4 18 27 0 0 0 0 0 0 9 0 0 0 0 0 0 0 0 19 4 13 0 0 4 0 0 0 17 0 0 0 5 0 0 17 0 29 0 0 0 0 0 0 20 
76 33 31 0 0 0 41 0 0 0 0 22 0 24 4 0 0 0 23 7 0 10 0 16 0 12 0 0 0 0 30 2 0 28 33 11 0 36 12 0 0 23 1 1 0 0 49 40 
46 36 0 0 74 4 46 11 59 34 37 17 0 0 0 10 0 9 5 40 0 0 13 0 0 26 15 0 8 6 29 23 0 14 3 13 0 33 12 16 0 20 0 62 39 62 50 12 
0 35 16 42 0 0 0 0 0 20 3 0 0 30 42 1 0 0 28 0 0 0 0 0 0 0 9 8 14 20 16 0 0 0 0 0 35 24 6 0 11 0 0 1 16 50 28 0 
3 36 37 5 0 8 5 27 3 12 7 0 0 0 0 28 7 7 3 2 0 23 0 3 23 23 7 4 3 1 0 13 0 10 2 0 0 8 18 5 8 2 13 28 24 4 0 4 
0 29 8 0 0 11 0 0 0 17 0 0 0 20 7 3 22 11 15 0 0 0 0 1 4 0 17 11 2 7 18 10 8 35 0 0 3 12 23 0 4 0 13 7 7 0 0 0 
8 0 0 0 0 0 17 33 17 0 4 25 0 30 69 0 11 0 0 8 0 0 0 9 0 9 4 6 7 2 0 8 18 9 5 0 0 0 1 5 26 0 11 2 7 6 13 40 
42 0 3 0 21 0 0 14 3 34 0 0 22 8 0 13 8 21 5 0 0 18 7 17 8 21 17 0 4 4 0 19 13 0 14 0 24 3 8 3 0 28 33 0 8 11 5 0 
0 0 21 0 34 15 17 5 26 0 21 2 0 0 3 0 0 0 12 11 15 0 0 12 0 6 1 0 0 6 7 32 0 0 2 0 0 0 20 6 0 0 0 0 0 10 0 0 
45 91 0 5 0 0 1 0 41 8 2 0 16 0 0 0 0 4 0 18 26 14 0 6 10 0 0 8 0 3 0 6 8 24 2 9 27 60 43 0 31 0 0 0 5 53 38 22 
40 0 3 0 0 42 0 2 0 49 18 6 15 0 22 3 20 4 6 11 10 10 11 3 4 16 0 15 14 0 0 19 18 6 2 0 2 5 7 0 31 0 0 0 16 0 0 5 
101 0 0 0 0 3 0 0 0 0 0 36 0 20 0 0 0 3 6 0 3 0 0 0 24 3 18 0 0 0 28 4 0 0 1 0 0 37 8 5 0 11 0 4 44 0 8 36 
0 0 0 32 0 0 24 0 0 2 0 14 18 0 31 0 0 0 0 12 0 0 0 0 0 0 0 21 0 0 18 0 0 0 0 35 0 7 0 0 8 0 0 6 0 47 0 0 
0 0 18 0 20 35 22 30 7 4 0 12 0 4 0 5 25 31 1 5 7 35 0 28 4 0 4 0 45 0 45 3 14 12 0 0 19 4 5 0 8 47 30 17 14 0 0 67 
45 42 35 31 8 19 9 0 39 10 28 1 8 43 4 5 0 4 0 4 18 4 0 10 0 26 10 17 20 0 8 26 1 30 0 19 0 0 20 0 0 16 0 42 0 50 33 39 
32 0 0 16 2 0 0 28 24 34 35 29 0 8 0 4 0 0 0 35 0 0 0 0 6 14 0 0 17 0 25 22 0 0 10 55 0 13 8 0 0 22 0 34 8 54 8 2 
0 0 8 0 25 0 0 0 0 12 0 0 0 0 0 0 0 0 5 0 7 12 0 0 0 0 13 4 3 25 20 0 0 0 0 0 0 7 0 4 7 0 0 22 0 0 0 7 
7 21 31 0 2 28 35 29 18 0 34 0 34 0 0 15 9 7 22 24 0 0 18 7 0 0 7 0 9 0 13 27 11 39 16 34 0 3 19 0 18 11 5 42 34 66 84 0 
0 0 18 0 0 20 0 0 22 1 17 0 0 0 0 0 19 2 2 0 5 10 3 18 15 3 0 17 0 35 13 9 15 28 0 19 0 11 0 16 0 0 13 48 0 0 0 42 
21 0 37 61 0 6 0 20 36 20 0 24 0 10 6 9 0 0 7 20 0 5 9 5 10 21 7 1 45 13 17 30 1 0 3 32 35 47 11 36 16 0 13 0 10 36 2 0 
