48 27
41 15 0 36 33 22 0 18 3 0 33 4 0 31 4 0 15 0 8 0 0 56 0 20 0 0 0 23 0 0 0 0 5 0 0 0 7 62 17 12 30 0 0 0 0 16 10 6 
14 45 22 9 60 0 26 13 6 5 0 11 0 0 21 0 0 0 19 0 13 5 4 0 9 4 5 1 0 13 0 0 33 0 0 9 0 5 0 0 19 0 22 1 40 0 23 5 
1 62 31 25 10 0 0 7 0 26 0 8 16 39 0 0 14 11 5 22 0 14 0 2 0 3 13 8 20 12 19 0 0 31 0 26 10 2 9 0 0 0 0 44 1 29 0 0 
0 0 28 10 0 0 0 0 0 0 29 0 5 0 2 54 10 0 0 0 0 0 0 0 13 0 0 0 0 0 0 0 2 7 0 17 0 0 23 29 45 0 0 0 0 0 14 0 
19 1 21 0 0 40 0 0 0 4 4 65 1 11 36 17 0 14 0 0 24 0 0 0 16 0 15 0 0 0 18 15 35 0 0 0 5 19 0 23 41 2 2 0 86 40 6 20 
39 0 24 22 3 18 32 36 17 0 0 1 27 0 0 7 14 18 25 0 0 10 7 10 17 36 14 0 0 11 0 6 0 11 1 6 21 12 8 12 0 6 0 80 0 2 14 0 
15 23 0 25 12 0 0 0 0 0 4 24 17 20 0 15 12 0 2 0 2 0 0 0 3 0 0 0 20 31 0 0 11 5 7 24 0 0 0 0 0 14 12 11 15 0 0 4 
0 33 11 0 19 0 0 13 0 29 1 0 0 7 0 25 9 17 0 0 21 6 0 21 17 0 0 0 21 0 0 18 0 0 33 0 13 0 29 7 0 5 1 0 0 0 24 17 
28 0 45 35 0 0 0 47 0 0 11 7 5 11 0 18 9 14 4 22 31 10 0 0 3 0 0 0 28 10 0 0 0 0 0 0 18 13 9 0 55 0 0 0 0 0 0 54 
0 54 6 0 0 0 0 27 6 0 3 0 0 0 0 6 9 10 12 0 0 1 14 4 7 0 14 0 0 0 12 2 15 0 27 0 9 11 8 2 45 0 0 0 0 15 14 0 
0 81 0 1 35 49 34 5 40 0 9 6 4 19 16 7 12 0 0 18 2 16 0 0 16 5 29 31 0 0 54 12 8 4 24 7 6 12 0 14 41 4 6 48 0 5 48 0 
0 2 15 59 10 2 57 0 2 0 20 20 28 7 0 2 5 6 0 9 18 14 24 0 28 12 0 12 0 0 5 9 0 9 12 0 30 1 7 17 0 1 29 18 20 14 55 11 
10 31 0 33 0 43 0 13 17 0 0 21 2 12 0 7 6 0 14 5 0 25 1 0 10 11 0 0 3 24 0 7 54 12 0 14 0 12 0 12 5 4 42 0 4 12 13 0 
0 0 16 33 0 0 14 9 5 10 27 12 22 18 12 1 6 24 0 16 3 0 20 12 1 16 0 0 0 12 0 1 2 0 29 0 24 27 0 0 1 33 0 0 19 23 4 0 
11 0 0 0 0 0 0 0 0 20 21 0 0 0 4 0 0 0 0 0 4 12 0 15 13 11 0 0 0 33 0 13 18 0 0 11 0 3 15 0 0 0 0 0 0 0 0 0 
0 26 0 42 23 11 0 37 34 2 56 15 0 0 21 4 53 0 0 3 1 0 10 16 8 0 7 43 0 0 20 4 34 28 0 27 1 0 1 30 0 33 37 2 0 21 38 24 
33 4 5 46 0 38 0 0 0 15 0 0 16 14 30 0 0 1 0 0 0 10 0 20 3 0 19 6 16 0 0 0 0 23 31 0 0 0 7 0 0 0 0 44 30 3 7 0 
28 20 22 24 20 1 6 0 33 5 7 29 11 5 21 35 0 7 0 25 8 39 0 0 1 0 0 27 3 0 25 12 5 1 0 0 0 4 6 2 0 29 14 1 0 29 12 47 
0 26 0 22 0 27 0 18 0 53 15 6 0 0 0 0 6 18 14 5 20 16 11 2 0 15 8 0 3 0 2 28 13 0 0 26 27 0 0 0 20 0 25 12 0 44 18 7 
0 17 51 0 0 3 35 36 9 0 0 21 16 41 26 4 1 10 0 0 0 0 0 0 0 0 0 13 12 0 25 0 25 0 9 7 23 0 28 1 25 6 4 52 0 32 7 0 
0 18 0 0 0 15 56 12 0 0 8 0 0 0 0 7 0 26 7 25 6 15 0 30 5 6 6 21 2 14 24 10 0 10 16 29 2 0 0 0 0 10 6 27 1 3 0 0 
0 0 15 0 0 0 2 0 11 8 2 20 5 21 0 1 0 1 22 0 0 21 0 0 0 4 0 0 0 8 0 1 17 0 0 2 18 2 0 0 12 0 9 1 0 0 0 0 
22 0 13 30 3 0 36 10 3 33 30 24 0 15 5 0 0 0 24 0 11 0 14 0 17 0 4 22 0 13 24 34 2 0 32 0 0 22 0 0 30 0 73 0 0 0 0 45 
0 0 0 0 0 0 0 15 0 14 0 21 0 0 39 1 3 14 0 24 0 0 29 2 31 0 17 0 0 0 0 14 0 8 3 14 0 0 0 7 0 12 0 17 30 21 49 0 
0 15 21 82 19 0 0 28 0 6 0 0 0 8 0 22 0 9 0 22 16 9 0 10 13 0 0 4 0 0 0 14 14 5 11 28 0 20 0 0 37 8 0 0 0 59 0 41 
41 15 21 0 0 0 40 13 0 0 11 50 0 17 0 6 0 13 4 0 0 16 0 0 0 7 0 0 4 23 30 0 12 0 0 11 0 0 0 0 0 45 24 32 0 28 70 0 
0 22 0 0 0 6 0 0 0 0 0 9 5 33 6 6 0 0 24 0 1 9 20 9 0 0 6 0 0 7 16 5 0 18 2 0 34 15 0 5 0 7 34 0 22 0 3 25 
