48 27
3 15 16 37 14 0 7 18 0 13 11 0 0 46 0 27 38 0 6 15 0 18 8 14 1 11 0 9 11 33 14 6 0 0 0 26 0 0 0 16 15 20 2 36 7 0 1 34 
0 0 0 24 0 41 23 31 33 18 2 28 5 30 0 37 9 25 15 27 0 7 8 16 16 0 0 21 2 23 13 19 6 27 5 25 29 5 0 40 31 0 28 85 29 14 32 5 
0 0 0 11 0 2 0 40 0 0 0 0 0 1 0 0 14 0 7 0 0 3 15 37 17 0 0 0 9 9 41 6 0 4 0 18 5 7 0 9 0 33 0 1 20 0 13 0 
35 54 0 15 0 10 0 34 0 0 0 65 6 0 50 14 8 0 2 13 0 1 19 6 14 49 0 8 27 0 0 13 16 9 6 34 0 0 9 0 20 15 1 23 11 0 16 15 
12 19 1 2 24 28 0 0 3 25 5 7 2 0 10 32 18 0 6 0 6 1 9 0 3 5 5 3 24 10 0 4 1 0 44 48 21 0 0 0 18 28 3 2 0 13 22 0 
0 37 18 0 0 11 0 0 15 19 15 0 4 0 0 0 11 21 23 0 0 26 28 0 13 0 4 19 0 0 16 6 1 0 0 21 0 19 16 2 0 15 0 3 0 0 0 26 
25 0 38 28 10 0 0 22 0 0 4 4 8 20 0 39 0 0 0 0 0 0 5 0 11 25 0 25 0 0 15 23 0 0 0 11 21 5 0 0 2 0 2 51 5 0 0 0 
66 0 2 0 35 3 20 5 0 27 0 0 50 0 0 0 0 0 0 0 12 0 22 0 5 0 0 0 0 0 0 0 0 0 9 0 27 3 0 70 28 0 0 2 7 0 2 0 
13 0 0 0 0 39 0 0 2 0 12 9 0 0 0 0 8 0 0 0 11 19 3 0 0 0 2 9 23 14 7 2 0 0 11 0 25 0 0 4 9 6 0 54 13 11 5 0 
0 16 20 0 0 0 14 0 38 18 0 0 0 0 12 0 0 0 6 6 0 0 4 14 0 17 7 0 2 7 56 0 5 1 0 9 7 22 0 7 17 9 10 10 11 0 45 24 
0 0 0 16 14 0 9 17 0 37 0 2 0 0 0 33 0 0 28 2 26 1 9 0 9 13 4 0 11 6 14 0 19 9 0 13 1 7 0 0 33 0 0 0 3 0 35 0 
41 16 12 0 7 0 21 17 0 0 0 24 10 25 15 0 9 16 0 5 0 15 9 0 0 0 0 23 7 0 0 0 0 0 0 14 16 0 0 0 27 0 0 5 24 45 0 44 
24 1 89 0 29 7 0 1 39 49 0 11 0 0 5 0 0 0 10 2 17 0 12 0 24 0 0 0 14 14 0 0 0 12 0 6 0 28 0 0 0 4 12 6 40 0 44 6 
10 43 5 67 31 0 3 1 0 10 43 37 0 2 4 6 3 0 9 21 0 0 10 0 20 2 13 3 15 0 8 18 15 7 11 26 0 18 28 36 7 0 10 0 56 0 5 7 
6 0 0 0 8 0 13 6 0 3 3 0 3 14 13 12 54 40 0 27 0 38 9 0 0 0 0 0 0 0 9 0 0 16 13 10 21 4 0 0 11 47 0 0 28 10 27 0 
6 9 0 0 12 37 0 39 27 12 20 7 10 0 1 12 20 1 41 6 6 0 24 0 0 0 0 12 12 0 24 0 0 0 4 52 26 0 4 0 10 44 37 0 0 27 64 0 
19 0 7 14 0 34 3 22 23 0 2 0 0 0 0 0 0 0 0 0 0 0 35 0 0 0 0 3 0 0 0 13 27 0 3 0 0 3 3 43 0 0 0 40 9 0 1 0 
12 10 23 0 0 5 7 16 15 4 0 13 2 29 19 29 16 0 0 24 0 15 14 0 0 17 0 0 0 0 0 6 27 19 0 0 9 22 0 0 0 3 0 0 34 0 14 0 
37 44 5 0 0 0 0 0 17 0 0 31 34 0 5 8 0 0 10 0 15 0 2 9 1 13 0 0 0 0 0 0 0 0 0 5 0 41 13 0 0 3 31 23 0 75 10 0 
29 45 0 56 15 20 26 0 4 14 14 0 2 29 0 13 0 9 2 10 3 0 7 5 17 10 23 8 9 39 0 11 1 17 5 0 4 9 3 0 0 38 75 0 0 0 29 8 
6 0 62 43 13 0 52 0 26 49 0 2 0 22 0 3 5 13 7 25 0 16 15 9 0 0 24 0 0 0 8 12 46 9 32 2 0 0 0 5 0 0 40 24 0 0 62 38 
48 4 4 3 26 0 26 10 10 0 20 0 35 0 9 32 0 2 0 15 4 0 34 13 16 0 0 0 0 29 49 0 4 0 29 0 13 3 15 0 0 3 0 15 0 0 14 3 
0 56 0 0 0 0 13 0 0 13 0 2 0 13 0 0 40 0 0 4 0 0 17 4 2 0 15 0 0 0 0 4 0 0 1 18 0 0 0 38 22 2 0 0 0 0 0 0 
37 6 16 0 26 42 0 23 0 0 1 1 0 12 20 17 14 0 3 0 0 9 18 0 0 13 0 0 9 22 26 16 0 4 0 3 0 33 0 0 18 0 24 0 14 0 14 60 
4 2 0 0 45 50 0 49 34 22 0 0 34 2 0 21 0 0 5 0 20 0 0 0 1 0 0 21 0 12 8 24 0 15 0 5 14 13 0 17 35 10 19 31 0 38 83 0 
0 16 20 14 25 27 0 2 20 0 0 0 43 0 14 0 55 0 31 0 0 0 0 44 0 0 0 14 20 0 9 0 42 0 11 0 11 0 0 5 24 0 0 0 32 11 0 44 
0 6 0 16 0 0 0 13 0 18 0 20 0 24 6 0 9 0 41 0 6 0 7 0 0 17 0 0 0 0 0 16 0 0 0 35 0 19 0 0 17 0 0 25 0 0 0 0 
