48 27
11 12 0 0 0 0 0 0 0 6 3 0 0 36 0 0 11 31 5 0 20 25 21 0 0 19 0 20 4 1 1 0 49 20 0 0 17 0 0 22 11 0 0 0 33 0 25 0 
15 16 0 10 0 23 0 0 1 4 0 27 0 12 0 10 0 42 26 0 0 36 0 0 0 0 7 0 0 18 29 20 15 7 0 13 0 0 0 3 19 13 3 30 26 10 19 3 
16 16 16 0 0 0 9 0 17 0 26 30 0 0 8 15 0 0 0 0 3 0 2 0 1 11 19 4 4 0 4 0 7 11 0 0 26 0 0 31 2 38 9 1 16 0 20 0 
18 13 16 0 18 5 34 3 0 0 0 0 0 0 30 11 0 1 19 0 0 0 0 0 1 21 15 0 9 0 0 0 0 9 0 0 10 9 19 0 34 0 10 1 41 0 0 0 
27 0 38 24 29 0 9 5 21 19 15 0 11 77 25 29 9 0 3 0 0 8 0 13 0 7 0 30 6 18 0 23 0 31 0 12 23 0 0 25 47 11 11 0 0 0 14 20 
60 0 0 15 0 0 0 0 0 0 33 26 11 3 5 0 0 0 0 17 6 2 0 3 0 0 9 17 0 18 0 0 5 0 0 0 12 12 0 0 0 0 0 37 27 0 0 42 
26 0 0 0 3 0 0 30 0 6 0 0 22 12 42 0 3 0 24 0 2 1 0 0 23 0 0 17 4 0 26 10 16 9 12 0 13 33 0 0 7 0 15 0 0 0 32 0 
60 8 28 68 11 0 0 4 15 3 0 0 33 3 0 3 18 0 0 21 0 0 0 11 10 0 0 0 0 16 31 23 0 32 57 0 0 37 5 0 37 0 23 0 0 0 12 0 
1 0 39 0 25 13 0 0 11 0 8 3 0 73 17 15 18 0 0 27 0 0 0 10 0 18 15 19 0 44 23 30 0 24 5 4 23 0 19 5 9 7 26 41 0 0 0 31 
2 0 0 0 3 0 0 0 18 0 0 0 0 8 6 15 0 9 6 0 37 5 10 15 6 18 18 0 0 0 0 14 11 8 0 3 6 0 0 5 0 20 16 0 20 0 10 27 
0 0 21 0 27 10 0 21 0 0 0 0 9 0 15 0 0 9 19 12 16 16 24 10 8 1 1 3 9 0 4 0 18 6 13 0 23 4 3 0 38 3 1 16 0 9 0 0 
0 21 0 0 11 25 4 11 10 0 15 18 22 0 7 21 0 0 8 0 0 14 38 0 33 0 1 4 0 5 1 0 0 0 0 7 15 0 0 0 0 0 10 0 20 0 0 42 
0 0 0 0 3 8 35 5 0 0 0 0 2 18 0 0 26 0 17 0 0 0 20 1 9 59 0 0 6 6 12 0 14 9 0 5 0 24 0 14 0 22 59 0 3 0 0 22 
0 0 76 40 37 7 0 0 5 21 0 19 27 23 0 0 3 0 2 14 8 20 0 0 6 11 0 0 0 13 35 7 35 14 0 16 1 35 7 7 0 17 60 54 3 0 30 34 
0 12 41 13 0 5 0 10 25 27 16 35 0 0 0 11 0 7 15 14 9 0 0 12 6 0 2 0 0 26 11 8 0 38 0 24 30 17 0 14 3 16 37 0 58 42 30 0 
7 5 2 0 44 7 13 20 0 4 0 5 18 0 36 17 0 7 0 0 22 0 0 0 0 0 0 9 0 3 1 40 0 0 19 0 0 0 0 73 0 22 72 12 15 0 8 16 
50 0 0 12 36 39 44 0 14 0 0 8 0 7 11 0 18 0 24 16 7 0 0 8 0 0 0 20 0 9 17 0 0 6 11 0 17 7 0 0 70 15 4 0 32 2 4 20 
8 0 40 28 0 42 4 7 0 21 12 0 0 6 0 23 0 2 8 6 0 2 7 6 26 0 0 19 5 5 48 0 0 14 0 0 12 9 0 0 25 0 40 16 7 0 0 42 
52 24 15 56 59 17 20 12 14 0 0 17 0 0 0 0 26 27 6 14 4 3 0 9 18 19 15 12 8 2 13 0 0 0 0 0 31 34 0 0 39 25 26 0 56 37 24 0 
1 32 54 2 0 0 0 0 0 24 10 0 40 15 5 25 6 2 0 27 16 0 21 2 8 0 0 0 0 0 15 10 0 49 0 0 7 0 0 0 36 0 2 0 0 0 27 0 
119 0 0 15 14 45 0 4 0 2 0 4 0 14 10 19 0 0 14 15 0 14 22 0 10 0 0 0 19 0 0 0 32 2 15 0 13 1 0 0 30 0 7 15 0 14 27 0 
0 14 43 44 0 0 41 0 0 15 3 5 0 21 0 0 21 23 5 0 0 6 1 22 33 0 0 7 8 17 0 0 0 8 0 0 18 11 15 29 22 20 19 37 8 66 61 67 
12 0 0 32 0 5 4 35 20 22 0 43 0 14 12 12 0 14 0 0 0 10 0 27 0 17 0 5 7 0 1 1 5 25 0 2 0 1 13 0 0 1 35 0 6 33 1 20 
45 28 26 18 0 19 25 51 0 0 2 0 15 23 0 0 36 7 15 0 9 18 0 0 4 0 15 18 2 21 11 41 0 12 13 0 23 0 0 0 0 19 16 27 0 0 36 1 
9 3 0 37 12 18 51 17 0 8 0 0 0 43 0 12 8 3 7 7 0 0 0 53 14 14 17 0 0 0 7 0 0 7 0 29 0 0 14 0 37 0 0 0 22 32 6 0 
0 22 7 0 17 12 0 0 0 0 0 30 0 2 1 16 43 12 0 0 0 17 4 0 13 0 4 0 0 4 9 0 25 0 0 21 11 0 0 0 1 51 0 0 28 0 0 3 
32 61 0 1 0 1 0 0 0 0 22 0 17 0 41 5 0 4 0 14 5 0 0 12 0 18 0 0 0 17 25 30 9 16 0 0 22 0 0 0 9 0 0 38 0 0 0 0 
