48 27
9 27 0 20 4 41 35 3 0 5 5 65 9 28 29 7 22 44 0 28 0 0 22 8 2 6 0 10 15 27 13 34 3 0 0 34 0 23 21 0 2 12 4 15 5 0 0 42 
18 0 16 15 25 0 0 0 0 31 0 0 0 0 0 11 49 0 18 4 18 0 0 4 10 0 0 0 0 25 0 3 0 0 10 0 15 0 1 0 24 0 22 1 7 21 4 27 
2 0 0 0 0 1 0 0 0 0 35 0 7 39 0 2 28 15 0 37 7 21 17 0 26 22 9 15 10 1 12 0 29 0 22 16 12 0 8 27 21 0 50 26 15 0 0 35 
0 0 0 0 0 1 15 46 13 15 0 0 41 2 0 7 0 19 0 0 0 23 2 7 28 12 0 0 24 0 0 16 3 0 29 16 0 0 0 2 2 17 22 0 0 3 9 0 
30 17 32 19 0 40 0 1 30 0 8 9 0 0 0 12 10 0 20 3 9 19 0 3 9 0 0 0 0 10 15 3 2 5 30 0 0 0 50 0 0 12 13 0 41 25 0 0 
0 0 0 0 14 0 0 0 0 0 15 0 0 38 0 0 0 5 9 18 0 16 28 5 13 15 0 21 1 16 0 12 32 0 21 0 2 46 1 27 0 9 14 0 13 12 16 0 
4 5 0 0 0 0 5 5 38 3 26 0 8 2 6 6 0 0 0 0 5 0 25 7 15 17 11 0 16 0 15 0 0 2 17 1 26 10 36 0 5 6 0 0 0 9 0 21 
14 0 0 0 35 58 9 38 4 38 30 0 15 22 36 19 0 0 0 0 0 9 19 13 2 0 0 15 0 0 0 13 0 0 0 56 28 0 7 22 30 0 4 0 45 85 0 38 
35 41 0 0 11 0 0 0 0 0 0 0 63 0 0 0 0 0 0 24 1 0 8 8 2 0 0 0 0 0 0 3 8 0 0 40 19 25 0 0 0 0 24 12 0 0 0 17 
0 0 4 25 36 3 4 18 0 0 32 0 0 31 0 0 0 0 8 0 10 0 6 0 0 38 61 20 67 0 10 0 6 0 0 0 0 0 0 0 0 15 38 0 31 20 0 36 
60 0 0 6 18 15 0 13 3 0 6 44 8 0 6 27 0 27 20 0 0 18 0 7 0 0 0 0 0 0 15 0 20 0 0 0 0 0 36 0 0 0 0 0 17 21 50 0 
31 0 11 51 2 10 0 3 29 13 0 11 0 11 8 60 26 0 11 6 5 8 0 9 10 0 9 11 0 10 10 0 21 25 20 4 36 9 11 3 24 0 0 28 6 0 0 32 
0 34 0 0 10 0 9 37 0 6 45 0 15 0 20 11 0 14 0 0 0 0 0 5 10 0 0 14 2 0 0 0 20 0 20 39 0 0 6 24 0 0 0 0 18 0 0 37 
21 5 0 18 0 0 8 12 25 8 11 0 0 8 24 0 9 2 0 0 4 15 16 7 1 11 10 0 6 7 12 6 12 13 2 0 30 0 24 28 0 0 10 0 3 10 0 0 
19 0 26 17 14 19 0 10 0 0 34 0 23 0 46 0 0 21 14 19 0 0 0 11 18 31 0 0 26 17 16 1 11 0 11 0 11 0 18 0 26 0 23 0 5 0 0 5 
0 0 0 43 0 24 0 0 0 0 13 0 0 0 0 0 0 15 0 0 0 0 5 0 15 12 31 0 0 24 27 0 2 30 9 10 16 0 14 0 5 5 16 0 0 0 10 0 
10 0 22 0 6 31 3 0 8 0 0 0 0 58 7 0 0 15 8 31 4 9 0 0 26 0 8 5 0 14 0 8 23 0 6 16 14 12 1 0 6 0 23 0 0 0 0 34 
2 0 15 6 0 28 0 0 3 3 22 25 3 5 1 8 0 0 0 6 0 12 9 8 24 14 18 6 0 0 0 13 8 14 0 13 3 0 5 19 0 0 0 8 8 0 7 23 
31 27 11 39 6 0 14 18 0 21 0 0 0 11 0 0 0 19 20 0 0 14 29 11 14 37 26 0 9 0 8 0 13 0 0 1 27 2 20 15 0 0 39 21 0 13 2 0 
84 25 0 0 44 0 21 15 5 0 12 7 8 2 0 1 8 0 0 3 0 17 12 0 0 28 25 37 6 2 0 16 9 29 11 0 14 37 0 20 0 0 0 0 0 18 21 47 
46 0 1 34 0 18 0 16 38 0 0 27 6 0 0 24 24 0 0 2 12 35 26 13 3 18 10 24 7 7 0 2 0 2 0 19 2 28 24 18 55 21 0 4 0 18 38 7 
19 36 0 0 0 10 17 28 39 20 25 0 17 0 47 19 2 0 3 16 1 0 0 0 0 0 12 0 7 12 1 3 26 0 0 31 16 13 10 0 0 6 5 0 14 16 9 6 
11 34 0 0 12 15 0 0 0 12 0 0 14 0 12 3 9 19 0 24 0 4 0 0 16 0 17 6 26 16 0 0 28 0 0 34 4 0 24 17 4 0 38 0 20 8 12 0 
27 1 0 22 50 32 0 2 11 0 11 0 0 0 16 1 14 4 11 25 0 6 18 16 0 39 0 13 23 13 3 8 0 14 8 3 2 70 33 17 15 4 3 3 26 1 0 0 
5 0 12 35 2 6 3 10 18 16 2 0 5 15 0 30 0 14 3 0 0 22 0 0 11 12 43 6 0 0 0 0 22 0 0 21 0 47 25 26 0 0 0 28 12 2 0 21 
0 0 0 13 4 16 0 12 10 0 0 0 0 0 41 33 0 0 0 0 0 2 5 13 0 0 0 0 0 0 2 0 33 0 13 18 23 0 25 0 0 0 22 0 30 0 0 46 
10 46 2 1 0 49 75 11 24 0 0 0 0 0 0 0 35 10 0 0 0 0 0 0 17 0 9 33 17 0 5 26 24 3 2 37 13 4 16 0 0 28 5 37 64 0 0 46 
