48 27
34 21 4 0 0 8 7 0 10 0 18 0 35 27 7 0 5 0 0 0 0 0 19 0 0 19 1 22 3 5 0 0 0 19 34 13 0 19 2 0 16 0 0 0 2 0 38 0 
23 0 9 0 42 6 0 0 27 30 22 9 0 0 0 0 5 4 16 0 0 20 20 0 16 11 18 0 4 7 0 2 0 0 16 51 24 0 0 28 0 46 0 0 18 21 0 0 
30 0 30 0 0 3 11 0 24 0 0 11 0 33 19 14 21 13 13 0 13 0 1 13 4 0 0 0 0 0 11 13 45 0 1 34 0 0 22 8 0 41 0 15 0 0 33 11 
24 0 24 0 1 19 14 31 41 9 8 4 0 1 14 20 15 7 19 7 0 0 5 62 33 3 4 14 20 0 2 24 1 3 1 0 5 11 2 0 2 50 6 0 1 10 0 43 
0 11 0 0 40 0 0 0 0 3 0 0 0 20 12 0 7 0 6 0 0 12 17 0 0 11 12 0 0 0 10 19 0 9 8 13 2 0 26 13 0 0 0 0 26 5 0 21 
10 29 38 2 0 10 15 15 35 0 4 0 20 8 18 20 0 10 10 1 16 24 15 0 46 0 0 10 0 17 17 14 0 25 18 13 1 40 3 0 41 20 0 0 0 3 57 14 
13 0 41 42 0 0 1 0 34 28 0 0 1 5 7 0 6 3 12 6 0 13 22 0 0 8 0 0 11 0 0 0 0 25 0 0 0 12 0 0 3 0 7 47 22 42 25 0 
6 0 0 0 0 38 0 0 25 0 0 20 0 0 25 0 15 17 9 17 0 0 14 0 0 0 21 4 23 0 0 20 11 0 0 30 4 0 0 25 23 0 0 0 0 13 1 0 
2 0 2 38 22 12 32 25 66 22 20 0 0 34 0 25 1 24 28 0 6 16 0 16 0 0 0 15 0 14 44 0 5 27 0 26 32 21 0 0 0 95 0 0 13 0 29 0 
6 44 6 0 0 0 0 0 0 0 10 0 0 20 0 0 0 0 0 26 15 0 1 36 12 0 0 0 9 0 0 0 9 0 0 5 0 0 0 0 16 0 1 0 0 1 0 24 
1 38 0 43 13 0 0 33 43 0 9 0 0 0 0 0 10 7 6 18 13 0 0 24 12 9 6 1 2 4 2 0 9 52 34 9 0 0 0 6 82 0 13 0 36 5 30 32 
10 0 31 0 2 0 7 0 11 0 0 0 17 0 11 0 11 0 13 0 0 5 0 0 12 0 0 1 0 32 16 13 0 45 6 19 12 0 0 0 0 0 0 4 0 2 0 0 
0 7 0 19 3 43 0 0 1 0 0 0 0 0 10 0 0 0 0 6 13 0 19 18 3 6 0 21 0 0 0 0 0 13 9 0 1 1 1 0 0 7 0 9 0 18 16 0 
0 16 43 68 6 18 2 0 23 44 0 10 13 7 38 0 11 2 0 0 2 29 9 0 22 16 32 20 0 9 23 7 0 7 3 11 12 12 17 0 13 0 33 0 0 80 4 0 
0 0 0 12 0 27 9 38 0 0 13 20 0 0 14 12 0 10 1 0 25 0 0 30 19 5 0 0 14 0 0 20 33 0 0 33 0 7 0 0 17 0 0 11 0 25 0 0 
0 11 12 0 18 38 0 8 32 9 0 0 10 0 4 0 8 26 18 2 2 0 18 14 0 0 0 0 10 0 3 8 0 3 5 10 0 14 0 24 8 0 2 38 0 0 0 0 
7 2 0 0 0 0 5 33 4 19 0 0 12 17 0 14 8 23 9 0 0 12 2 0 14 33 0 0 18 16 15 0 10 12 12 15 0 25 7 15 33 0 8 22 2 20 3 0 
38 0 2 0 4 77 0 1 9 0 0 32 18 0 14 0 35 12 0 0 0 0 0 0 19 22 0 0 14 13 0 4 0 0 0 13 0 32 93 13 0 0 0 19 0 0 0 32 
7 19 0 0 0 15 0 0 15 0 0 0 0 5 33 0 5 0 7 11 15 5 6 7 9 2 0 5 21 29 4 0 5 1 12 0 0 37 0 6 0 6 5 0 0 20 12 20 
4 12 34 2 65 0 11 35 0 3 9 2 2 2 0 0 0 3 0 0 0 8 6 5 3 0 0 14 5 33 0 0 0 1 0 0 25 22 0 35 0 0 28 0 0 9 9 0 
23 9 0 0 3 0 0 9 13 0 20 0 3 20 0 0 4 29 0 0 17 38 0 43 0 10 0 14 19 0 20 0 6 10 0 19 0 16 0 16 0 35 14 9 0 0 37 19 
9 12 35 17 3 42 18 0 0 34 16 38 3 9 35 0 14 16 15 5 0 18 3 21 2 0 17 0 0 13 16 0 0 20 6 0 0 7 0 20 0 7 50 30 13 0 68 4 
41 0 0 0 3 0 42 29 0 0 0 29 0 0 2 9 11 0 0 14 25 1 16 0 12 31 0 6 0 0 0 11 0 5 7 0 1 3 0 0 69 7 22 0 38 15 0 17 
4 18 19 0 45 43 45 36 0 0 14 0 8 18 27 0 4 0 26 13 0 3 3 0 0 0 12 5 16 10 18 19 6 0 7 6 18 0 9 21 8 5 1 4 0 38 18 4 
14 26 0 0 37 0 18 0 17 3 4 0 22 4 9 17 11 35 0 18 12 13 16 21 0 0 25 10 15 12 0 14 29 0 0 0 0 0 0 0 0 88 4 15 0 15 0 0 
5 37 43 36 33 40 0 29 0 35 0 0 49 0 0 8 0 0 9 14 17 0 2 18 0 16 4 9 0 0 22 0 0 31 3 0 5 18 0 36 1 14 2 28 0 44 0 0 
25 0 0 0 6 6 3 0 9 3 21 0 3 34 0 3 9 0 7 12 0 0 3 24 0 2 0 18 0 15 8 0 16 3 24 27 23 24 0 3 0 0 7 0 0 20 0 0 
