48 27
0 15 18 3 0 20 7 15 2 0 0 13 9 19 0 35 11 0 4 7 13 0 0 18 8 2 4 6 5 0 15 0 44 14 24 7 0 11 26 36 29 54 63 3 2 30 0 0 
0 23 33 6 0 0 0 0 12 15 0 0 0 0 0 7 17 9 2 11 14 0 28 0 0 16 14 0 0 8 9 0 13 25 0 30 10 5 0 39 14 0 10 0 0 0 0 0 
15 3 0 10 2 0 0 2 0 0 14 5 3 13 29 48 76 0 7 0 12 4 0 0 12 2 0 0 13 5 44 24 0 5 18 20 20 0 11 7 35 3 26 60 1 0 19 0 
6 0 0 8 0 1 5 0 0 2 8 0 0 12 0 0 0 5 29 0 0 0 2 9 0 10 0 14 0 15 0 0 16 0 15 0 0 0 6 41 0 0 0 20 6 6 0 8 
66 11 15 14 0 26 24 12 3 0 10 0 11 0 0 0 14 50 12 19 12 0 0 0 13 7 8 0 25 3 14 12 0 0 25 11 35 0 0 32 0 5 0 0 0 0 5 30 
4 0 0 9 0 7 16 0 7 34 1 11 10 32 9 0 51 19 4 4 0 0 17 18 0 7 17 0 0 0 23 28 20 0 6 0 6 13 6 4 35 0 5 0 2 2 25 5 
0 0 0 0 16 0 12 9 0 27 0 19 3 0 0 8 0 2 27 2 0 15 0 0 12 0 20 0 17 0 0 0 0 0 0 3 24 0 3 0 29 0 0 0 2 0 11 6 
9 20 7 0 12 5 8 15 13 11 24 2 6 26 0 0 0 13 41 0 15 38 4 15 0 0 21 0 11 24 0 0 6 0 9 19 0 39 6 26 65 7 42 1 0 2 0 0 
0 32 0 3 29 40 0 0 17 0 0 0 34 0 14 13 20 3 35 0 7 10 0 1 20 0 0 2 9 16 0 0 24 32 0 0 20 6 8 0 0 0 3 0 0 29 25 0 
0 3 0 15 40 13 19 1 15 14 37 0 2 0 0 11 0 10 0 0 4 0 4 15 21 22 15 0 7 0 0 13 0 4 7 0 10 0 10 0 30 0 12 0 11 0 4 21 
0 3 0 0 71 25 19 0 0 31 5 14 16 0 0 0 17 7 0 9 12 16 0 16 0 1 0 0 0 31 25 3 9 15 7 0 24 14 0 0 0 7 0 25 0 0 1 1 
33 8 15 5 0 7 1 2 13 0 13 29 26 0 8 32 15 1 31 23 1 11 0 0 25 3 0 0 20 0 0 6 13 58 0 12 0 9 26 7 16 0 3 25 0 0 2 32 
6 6 10 44 4 0 0 3 0 0 25 12 18 0 0 0 31 2 8 4 16 26 22 4 5 2 10 0 0 0 12 0 15 0 0 1 44 0 0 1 23 2 0 2 22 0 0 45 
23 3 0 15 0 0 0 9 12 36 0 0 30 0 5 3 1 12 13 0 22 0 0 23 0 0 0 0 0 0 13 9 0 40 23 0 0 0 0 0 39 0 30 0 0 36 7 0 
6 12 21 1 37 32 0 0 7 1 11 0 28 1 0 0 0 20 0 8 0 7 0 4 0 0 0 22 0 0 0 0 0 0 13 0 0 12 0 18 28 26 0 43 0 0 0 13 
0 13 1 0 3 21 25 17 0 0 0 44 9 17 0 30 12 5 0 4 7 0 27 7 12 0 0 0 0 5 3 36 11 10 0 22 0 0 0 0 13 0 0 2 0 17 0 61 
9 22 1 0 0 9 2 0 25 14 0 21 4 0 2 0 0 12 12 0 10 3 0 10 7 4 0 0 10 4 9 0 0 15 0 0 0 9 0 0 0 0 15 16 0 0 7 27 
27 5 0 6 29 0 0 0 0 11 0 0 4 18 0 0 4 0 10 0 0 0 2 0 8 16 6 0 0 0 15 24 2 0 0 0 11 0 0 21 0 0 0 0 18 0 0 0 
8 12 0 1 0 21 25 17 0 11 0 28 0 42 5 4 0 26 0 0 9 10 0 0 1 0 4 0 28 15 38 30 0 0 33 3 0 6 0 0 0 18 0 93 0 40 3 0 
0 45 5 6 37 5 2 20 35 0 40 40 0 10 27 0 0 0 23 0 0 0 1 0 0 0 8 35 15 40 3 0 0 22 0 0 12 0 0 7 0 26 0 7 0 35 40 0 
0 0 6 0 0 24 6 0 15 3 0 32 6 0 0 0 0 0 0 0 14 0 1 0 0 0 15 0 0 24 23 5 0 0 0 5 8 5 0 0 10 15 0 45 11 0 0 0 
0 0 0 44 0 0 6 2 27 7 0 21 6 0 0 3 4 0 19 0 6 15 0 8 0 0 0 4 0 6 0 23 0 7 1 33 16 17 0 0 8 21 51 3 0 0 18 0 
0 0 10 0 0 33 0 7 8 0 4 23 31 21 10 1 1 0 14 0 43 0 0 13 11 25 16 15 0 0 4 7 0 3 6 0 2 3 2 27 0 0 15 0 24 0 0 0 
0 1 0 0 0 0 53 0 1 13 8 0 0 31 0 1 0 0 24 0 0 0 0 17 20 0 1 0 0 0 0 2 0 2 0 12 10 0 0 3 0 0 26 20 11 0 21 0 
30 53 0 3 0 2 0 0 36 0 27 14 18 19 26 4 19 0 33 1 10 0 0 21 3 14 8 15 9 1 28 70 0 0 0 46 9 9 0 25 13 2 16 14 2 0 0 0 
21 0 0 0 4 39 5 16 13 0 0 0 0 0 0 34 0 9 5 4 0 28 24 1 0 20 0 0 0 0 0 15 25 1 0 0 0 5 0 0 0 0 18 0 39 50 23 0 
0 12 0 33 9 37 0 3 0 0 60 0 0 0 0 0 0 0 0 0 4 0 0 6 15 0 0 0 0 0 0 25 0 0 0 19 4 3 26 0 23 0 0 0 0 0 36 23 
