48 27
22 0 25 0 34 2 2 50 0 31 4 0 0 0 3 8 23 0 12 21 13 31 22 17 0 0 0 1 12 0 0 0 5 0 0 0 14 1 0 34 121 0 33 7 0 9 0 25 
36 23 0 44 0 0 0 28 29 5 0 0 0 2 0 0 0 0 0 4 0 20 0 4 0 0 16 20 11 0 0 0 5 7 21 0 32 30 0 0 5 0 13 0 14 0 0 44 
31 0 2 25 25 2 0 26 0 0 28 0 0 6 7 0 20 7 0 0 17 0 12 7 0 0 0 0 28 26 20 0 0 0 24 0 6 7 0 23 33 0 9 7 0 13 0 5 
17 6 6 0 31 18 0 2 0 4 9 0 26 10 0 29 16 30 17 9 19 8 0 0 0 0 0 0 11 1 0 0 0 0 1 32 0 6 31 0 0 0 0 0 4 0 0 45 
23 1 0 0 0 11 0 0 0 11 0 8 0 0 0 20 11 0 0 0 5 0 0 0 0 0 0 13 9 0 0 0 29 0 12 0 0 17 0 53 7 0 0 1 1 0 26 20 
29 34 0 53 39 0 21 0 0 60 0 0 0 7 11 9 28 4 0 0 7 2 7 0 0 11 0 0 27 9 0 8 0 0 0 0 21 0 27 0 31 7 0 21 3 42 0 0 
55 40 36 16 0 0 15 1 20 24 0 0 0 0 0 18 0 14 8 59 14 15 0 0 9 0 0 9 30 0 0 31 10 0 33 0 18 0 36 0 5 0 0 14 25 0 29 0 
3 14 31 13 0 0 26 31 23 24 22 8 0 7 0 3 12 0 0 17 0 28 27 8 19 0 0 5 0 0 0 23 4 33 20 14 0 0 0 4 0 28 0 33 22 0 0 2 
2 53 29 50 0 0 0 30 0 0 0 13 6 21 0 14 0 3 11 10 3 23 0 53 22 20 19 0 27 39 9 0 25 9 41 8 0 9 14 9 0 0 16 0 5 54 9 30 
11 0 23 3 24 0 2 13 59 0 10 11 1 14 10 3 0 4 0 31 0 0 1 5 11 5 0 24 0 22 12 33 11 8 2 8 0 42 6 13 43 19 8 10 13 0 0 3 
37 14 0 0 38 22 1 1 0 0 1 0 0 0 31 10 0 12 0 0 0 10 5 3 1 2 6 0 0 5 0 0 0 0 3 0 4 28 0 0 0 0 38 0 0 36 0 0 
31 35 3 0 8 46 28 36 16 0 9 0 0 0 47 3 11 20 0 3 0 3 0 0 6 0 8 0 0 0 0 13 28 19 28 34 15 20 7 0 61 1 24 36 0 13 0 3 
18 4 0 0 0 30 17 7 0 0 0 22 4 0 0 6 0 19 15 0 16 48 0 14 8 0 0 0 28 23 0 5 0 0 0 2 50 0 1 0 0 20 0 0 0 2 18 3 
5 0 0 0 27 41 2 35 28 36 0 2 0 2 0 0 0 0 20 3 6 3 12 0 4 6 18 0 24 0 5 12 13 0 15 0 5 0 50 2 4 28 58 4 10 0 0 0 
22 0 0 0 0 1 0 0 0 1 57 2 1 0 22 15 0 0 0 6 0 0 26 28 0 6 0 0 30 0 15 0 0 0 0 0 38 1 0 16 0 31 0 0 16 8 0 0 
25 0 25 11 0 43 0 8 36 9 0 0 10 7 15 1 19 12 23 23 25 5 0 0 11 17 3 32 20 5 0 19 0 0 7 0 31 9 19 9 13 0 4 34 91 8 6 10 
42 13 0 8 4 25 21 6 33 6 0 30 22 0 0 26 5 11 0 4 0 8 12 0 0 1 0 0 11 7 39 0 13 1 6 0 0 6 26 28 34 70 42 0 40 0 0 0 
0 22 0 17 17 6 0 14 29 0 0 0 3 0 6 0 0 0 0 0 17 11 23 11 0 1 18 22 16 0 0 0 0 6 0 9 0 30 15 0 5 8 5 0 0 28 0 0 
32 0 2 17 0 3 36 0 10 11 26 0 0 7 1 0 25 3 25 0 13 0 6 0 0 0 0 16 0 0 1 6 10 3 31 19 18 0 0 0 0 0 32 4 0 0 0 21 
86 0 21 0 8 0 0 0 0 0 19 6 14 0 13 48 18 0 37 0 23 7 0 30 0 4 14 0 0 0 0 16 46 1 3 0 0 3 38 29 0 25 0 12 0 14 14 32 
18 4 31 13 2 40 8 85 15 27 0 13 1 18 2 0 35 16 17 0 0 0 35 9 5 0 0 0 0 0 8 0 23 39 18 19 0 13 0 0 9 34 0 35 0 40 4 0 
30 28 2 0 12 2 0 0 1 3 0 31 29 0 0 0 8 0 6 17 4 0 0 5 15 0 11 9 16 15 0 0 5 0 5 0 0 22 18 0 29 2 0 1 32 13 0 1 
14 15 0 0 0 11 19 4 0 0 0 1 42 0 0 9 32 0 0 0 0 15 10 0 0 25 0 15 0 17 0 16 0 17 24 0 4 3 14 31 26 13 0 0 0 29 0 15 
15 4 23 0 0 0 24 14 3 17 0 7 8 17 0 0 5 0 2 0 25 20 0 0 0 0 32 0 0 16 22 0 13 0 0 14 0 9 0 0 23 0 0 0 0 22 0 0 
0 0 0 22 0 0 0 2 31 0 8 0 0 0 0 0 5 53 14 3 19 0 12 0 0 0 5 0 0 13 0 8 0 0 17 1 0 0 0 31 13 0 25 19 22 28 4 25 
52 0 4 20 0 22 0 0 0 2 69 4 0 0 8 0 0 13 2 0 27 18 5 13 7 0 21 2 4 0 3 31 5 1 33 0 20 0 0 0 0 0 0 14 0 35 0 63 
0 0 0 12 12 0 0 0 0 20 2 20 33 44 10 12 0 13 18 0 0 18 2 2 0 0 15 8 0 21 17 20 15 0 0 4 33 0 0 39 0 0 0 0 0 0 0 35 
