48 27
40 6 32 36 0 0 17 0 0 2 6 0 0 0 0 0 0 22 7 0 5 7 0 0 0 1 0 0 7 15 0 0 0 0 0 10 0 9 4 0 21 2 0 0 26 3 0 0 
44 42 0 12 0 16 43 0 3 25 1 30 4 7 5 0 0 23 4 0 14 0 0 17 0 6 11 0 11 12 13 19 1 17 0 0 0 25 6 3 0 11 0 22 0 3 0 0 
0 16 40 11 19 15 25 0 0 13 16 9 0 38 35 28 1 23 24 0 25 20 0 15 25 15 5 0 6 4 0 5 7 0 31 0 7 0 0 0 5 8 12 75 0 7 25 6 
50 0 0 0 0 0 14 11 0 0 0 22 0 8 16 0 12 26 12 19 0 0 0 0 11 15 6 0 12 0 16 19 13 0 1 0 4 31 35 0 19 0 0 39 0 0 18 0 
19 0 20 0 3 59 24 44 0 26 25 27 0 14 2 1 0 2 3 0 4 10 4 23 0 0 4 0 0 5 3 8 0 0 40 31 3 0 25 37 14 14 42 0 8 3 0 9 
7 24 24 0 34 19 8 28 36 0 20 0 16 1 1 0 15 3 21 0 0 2 0 0 31 3 12 0 24 0 9 36 20 0 0 0 29 4 34 0 9 0 27 26 43 5 0 1 
0 20 0 0 0 6 0 34 21 2 21 5 0 34 26 0 0 20 10 0 0 20 17 1 7 0 0 0 0 29 0 1 0 25 10 0 10 24 14 0 0 38 0 0 14 0 0 33 
21 6 0 0 4 14 21 0 0 1 1 0 11 26 0 0 0 18 12 14 0 19 5 16 0 36 2 17 0 17 0 0 0 0 26 0 0 14 4 7 4 12 0 0 31 0 28 0 
0 0 0 77 27 0 14 0 0 2 0 2 0 31 0 0 45 0 15 0 0 0 5 6 0 0 0 12 0 0 23 27 21 17 3 0 6 25 1 17 0 4 0 32 0 42 14 15 
0 25 5 0 0 0 0 0 0 0 11 0 0 0 24 0 0 0 0 0 0 11 14 0 11 0 21 1 0 0 40 0 5 1 0 0 14 13 0 0 0 6 0 0 0 0 16 0 
0 0 26 12 0 0 0 0 0 0 1 1 0 1 0 26 10 0 26 0 0 1 0 16 9 14 0 2 0 0 0 0 25 10 22 3 0 15 6 2 1 1 0 3 25 13 11 0 
0 24 0 0 31 0 0 50 0 10 20 0 12 2 20 0 0 0 0 0 0 1 0 5 0 10 0 0 20 0 18 0 3 5 0 0 0 0 34 7 0 34 0 41 1 0 0 0 
0 0 31 23 24 0 0 12 31 20 0 7 5 0 0 28 0 12 0 40 12 0 2 21 7 12 1 0 0 8 0 0 0 0 0 32 0 17 0 33 5 11 32 28 0 10 0 28 
0 28 0 27 0 25 2 9 7 41 0 7 0 10 29 0 37 14 5 9 0 9 8 15 0 0 0 18 0 11 30 35 23 0 1 1 28 0 19 2 0 15 9 38 0 18 0 9 
2 0 2 0 18 0 32 35 33 1 35 0 0 0 0 0 0 4 27 0 0 0 0 16 12 9 0 0 24 0 0 0 24 9 15 44 10 10 32 0 9 26 19 0 43 0 0 0 
5 23 1 3 11 0 0 39 0 0 0 10 0 28 23 0 37 10 8 0 2 0 11 0 0 0 32 0 4 0 0 18 15 11 46 4 0 28 0 2 0 7 0 14 0 19 0 13 
15 0 37 6 25 0 11 1 0 0 10 29 8 0 5 0 0 6 4 0 19 12 0 0 19 19 2 6 16 2 0 1 12 0 12 9 10 11 4 18 11 2 14 13 29 0 1 0 
0 0 67 39 16 43 2 0 17 76 0 0 0 10 8 0 22 0 15 0 17 24 0 15 22 15 22 0 25 0 15 0 0 0 0 0 1 22 59 11 31 5 17 0 0 9 33 31 
0 0 4 0 0 0 16 1 11 0 0 0 7 14 2 0 0 7 32 12 4 0 0 21 8 0 0 0 14 0 3 0 3 2 0 6 0 0 0 0 12 8 30 0 0 0 0 0 
25 33 0 0 11 36 0 2 35 0 0 0 0 13 24 0 0 33 0 0 15 19 0 0 6 0 22 0 0 0 14 11 5 0 42 0 0 4 2 7 1 13 11 73 12 0 0 0 
0 6 12 2 2 11 0 2 0 0 0 0 0 18 0 0 34 2 0 1 13 0 0 0 1 0 0 0 0 0 2 37 0 13 24 0 0 0 23 0 3 16 0 27 0 0 0 0 
0 16 0 35 23 45 20 0 0 36 28 12 7 3 19 6 12 7 0 2 0 44 0 14 4 1 18 0 0 30 19 0 6 17 0 0 19 43 28 3 19 0 0 20 2 76 16 0 
3 0 0 17 33 8 14 0 0 0 8 0 26 25 3 0 0 3 8 16 26 21 0 13 14 7 0 9 0 6 6 1 0 0 23 9 8 9 34 26 9 2 12 5 20 1 3 0 
0 0 14 0 22 0 0 0 0 0 0 29 12 0 0 28 20 6 16 0 0 0 0 0 21 0 0 23 0 8 6 1 0 1 9 1 0 5 0 9 29 0 0 28 9 0 0 15 
0 0 13 0 1 7 0 0 0 11 5 18 0 20 5 5 0 0 10 14 11 0 0 0 0 0 3 0 0 0 19 0 6 6 0 0 0 42 0 3 7 5 6 0 42 0 0 7 
87 45 33 0 14 5 0 0 27 38 29 2 7 0 7 0 17 18 2 0 0 7 0 0 4 18 0 0 0 0 21 0 0 0 25 60 0 1 22 2 6 4 0 43 0 0 97 0 
32 0 16 0 2 16 0 0 0 0 28 47 0 0 16 0 18 16 0 4 0 16 9 17 8 19 0 0 13 10 24 8 31 8 12 0 0 44 15 0 0 0 0 0 0 0 4 36 
