48 27
0 0 12 0 25 0 2 1 0 3 35 0 25 0 12 15 50 0 0 4 5 8 0 3 21 0 7 10 0 0 0 12 6 6 0 0 38 0 0 21 13 0 0 10 0 49 45 0 
0 43 0 23 26 31 28 2 7 0 0 7 0 0 10 10 0 16 20 12 22 5 24 25 10 17 5 23 5 19 0 8 24 0 0 0 0 0 27 0 0 0 0 24 0 1 22 0 
0 15 0 0 0 0 0 0 7 10 0 27 2 9 0 0 0 5 0 2 0 20 9 0 4 0 0 0 0 0 0 12 24 23 0 4 35 0 27 15 3 0 0 3 11 12 0 0 
0 4 0 15 31 0 15 14 35 0 14 0 18 12 0 0 0 29 43 0 0 15 11 16 0 18 19 0 0 23 0 20 0 1 0 65 0 0 0 38 15 0 22 10 0 37 1 0 
36 46 0 2 0 0 0 40 19 0 0 0 0 2 0 2 4 17 3 14 0 11 12 0 1 3 15 0 14 0 0 9 0 7 5 16 7 0 0 0 6 0 22 0 0 0 7 61 
9 21 2 0 42 0 32 0 4 0 12 10 5 0 0 31 13 0 0 14 15 1 12 0 0 21 11 0 0 19 0 20 24 4 0 0 0 0 42 0 0 7 10 0 13 41 51 0 
0 40 0 12 51 0 15 9 4 0 0 15 16 16 16 12 0 47 33 6 0 0 7 28 14 3 16 12 28 0 19 19 0 0 7 11 35 15 3 35 0 21 2 0 3 0 0 30 
2 23 18 0 0 0 0 0 3 0 0 3 4 19 0 27 19 12 13 0 0 0 0 0 17 0 3 0 0 0 16 9 0 16 0 20 0 0 0 15 0 16 39 18 43 0 0 0 
0 0 15 0 0 0 0 40 21 0 9 0 0 0 10 11 19 14 8 0 6 24 7 34 0 14 6 12 15 11 0 0 0 4 0 18 11 0 0 10 0 0 0 25 21 24 12 31 
2 0 24 0 3 0 8 3 11 0 8 12 0 0 3 7 0 0 0 23 19 0 6 15 15 18 4 15 5 32 0 0 0 4 32 7 13 0 0 35 4 1 8 10 4 0 17 0 
0 0 34 0 28 7 14 1 0 0 4 30 25 0 0 3 28 11 3 0 0 0 0 0 8 32 11 0 0 18 4 9 22 0 1 8 34 0 0 0 1 0 2 49 16 0 30 0 
0 0 0 42 0 0 23 8 0 29 15 0 6 20 0 4 7 15 0 0 0 0 0 8 0 18 0 10 0 0 16 4 0 18 17 72 4 14 29 0 0 5 0 0 0 46 9 3 
0 0 0 0 13 31 42 0 0 27 0 2 12 11 0 6 22 0 0 0 12 0 0 17 14 0 5 3 0 0 6 30 0 3 0 0 31 0 0 0 0 1 2 0 0 0 0 0 
0 0 0 23 9 0 41 4 9 0 0 13 28 6 0 7 0 0 0 4 0 22 0 4 13 10 9 20 0 0 15 0 15 0 10 12 0 16 0 0 29 0 0 0 8 0 1 63 
1 0 0 0 0 0 0 0 10 3 31 5 1 0 70 0 0 7 0 17 0 0 9 0 0 0 9 14 9 0 3 0 16 6 0 0 0 21 0 20 0 0 9 0 0 17 36 5 
0 0 0 23 20 16 20 9 44 15 0 9 3 18 0 6 8 9 0 4 5 8 5 15 1 10 10 8 12 0 0 28 0 0 0 3 3 12 40 0 23 0 0 0 20 14 0 2 
0 13 24 0 3 0 6 27 0 0 0 0 19 2 28 0 20 8 2 0 9 6 0 0 7 0 44 32 0 17 10 7 2 7 0 11 7 2 5 0 14 5 0 9 17 18 0 33 
0 0 45 7 0 16 29 0 5 36 9 26 4 0 0 0 24 0 0 11 0 17 0 0 0 0 2 9 34 0 0 0 0 16 0 27 8 36 17 23 0 6 0 0 0 27 0 25 
0 10 33 0 0 55 14 17 0 8 0 0 0 29 6 8 4 0 13 9 0 0 24 0 22 0 5 17 0 14 0 0 5 0 0 39 0 2 33 0 19 0 0 0 6 0 66 40 
0 11 0 15 23 7 0 28 39 0 34 0 11 0 5 17 19 0 0 0 0 0 0 2 21 0 12 52 2 0 19 0 0 6 13 48 6 0 0 0 30 0 0 3 29 21 2 65 
0 14 20 32 0 0 0 0 0 0 32 0 0 36 0 0 0 0 0 6 26 0 20 0 18 0 3 0 0 13 0 14 0 30 0 10 0 22 0 0 0 8 14 23 0 0 10 16 
12 36 10 31 0 33 20 0 0 0 10 15 39 0 0 24 0 10 5 3 29 11 19 48 15 21 0 10 14 0 1 14 27 13 21 0 0 0 31 12 42 19 0 0 27 6 19 24 
29 0 15 23 0 0 19 0 0 25 6 0 16 16 0 0 6 15 0 0 0 28 13 0 1 69 23 0 16 29 0 0 0 8 27 0 3 0 0 14 15 13 0 0 0 0 0 0 
28 31 0 27 23 0 22 1 16 0 2 0 63 12 0 0 20 7 6 23 4 9 0 15 10 10 9 4 19 1 9 20 20 30 0 0 27 0 31 1 0 16 0 13 37 0 0 0 
0 47 0 13 38 0 26 8 0 20 0 9 31 0 6 3 4 16 21 69 23 23 15 0 11 0 2 22 15 25 0 0 26 24 16 10 0 8 37 37 40 8 3 32 3 34 0 2 
0 0 36 26 30 2 7 0 0 20 16 0 0 20 8 2 0 25 0 5 16 0 20 0 0 0 9 84 3 13 0 4 1 21 25 15 0 14 0 11 1 42 5 40 13 0 27 0 
0 19 0 0 0 7 17 0 0 0 0 17 29 9 10 0 51 18 0 6 30 11 0 25 0 0 0 3 15 23 2 11 2 0 0 7 0 0 0 0 0 0 0 15 5 0 40 0 
