48 27
41 9 0 39 0 0 3 0 0 38 9 31 0 0 0 5 0 14 25 11 0 0 0 0 0 45 0 0 0 0 24 0 0 1 11 0 28 7 3 0 7 54 35 38 42 31 0 0 
35 0 0 9 0 17 0 0 23 0 0 13 31 7 15 24 16 21 8 12 6 0 0 14 0 0 2 0 20 4 8 0 28 1 0 19 8 0 0 0 0 0 16 33 16 29 12 4 
0 0 0 0 0 37 0 0 0 12 22 46 0 11 10 0 6 6 0 13 1 0 0 10 0 0 0 0 12 18 0 0 13 7 18 21 13 0 0 7 0 0 40 0 31 3 0 0 
35 13 14 14 0 0 25 0 28 0 1 1 0 0 28 0 0 0 17 23 0 0 0 8 0 0 8 0 0 8 0 24 0 5 0 0 26 20 6 0 3 0 47 25 0 0 6 0 
5 9 0 36 0 42 5 0 0 25 7 30 21 6 0 10 52 28 0 8 0 35 13 18 7 12 0 3 0 19 1 12 0 35 0 18 43 0 0 36 39 0 9 34 25 9 45 3 
16 18 9 12 11 0 0 10 27 0 9 5 4 9 0 26 0 22 16 33 0 0 7 0 0 26 11 0 6 0 19 0 0 0 32 1 55 0 2 0 0 0 1 1 0 35 0 0 
9 10 0 82 0 0 0 0 18 0 26 2 12 0 25 1 0 6 2 18 3 9 1 20 12 3 0 1 13 0 0 0 14 5 10 0 26 0 0 25 37 3 26 0 39 0 0 0 
15 19 0 0 0 0 0 0 0 17 0 0 5 29 0 29 11 11 21 6 2 0 41 0 0 0 0 6 5 6 0 0 13 14 0 0 0 18 0 17 12 10 30 0 0 0 4 14 
38 18 0 0 0 11 0 4 0 26 20 0 0 7 30 10 1 9 8 7 15 2 3 0 20 0 1 8 0 8 7 10 13 7 0 26 7 0 38 0 0 0 0 1 47 0 0 9 
50 7 23 0 66 5 5 5 8 7 0 16 7 3 30 17 16 9 23 6 19 0 0 0 8 0 19 0 9 8 20 0 62 0 7 35 5 1 0 5 9 20 12 0 10 0 14 0 
48 0 14 9 0 0 0 30 0 36 0 19 0 13 2 0 12 2 7 16 0 3 11 9 0 0 15 0 46 15 9 0 12 4 8 0 0 25 14 0 20 0 23 3 25 31 15 47 
0 0 14 0 0 0 0 0 1 14 0 0 0 0 0 0 16 12 5 10 9 6 17 13 4 0 5 0 0 18 21 10 1 1 0 6 13 0 0 27 0 10 1 11 1 0 0 8 
0 0 36 27 0 0 0 0 6 36 4 0 0 33 10 18 0 10 0 8 7 0 12 0 0 13 0 1 0 10 29 0 0 12 0 0 34 5 0 11 25 0 11 0 23 36 22 0 
23 0 35 9 0 0 0 0 23 31 47 0 0 13 30 0 4 11 7 0 10 0 2 12 36 15 0 0 0 12 0 0 12 13 0 7 0 35 0 0 58 15 25 0 34 35 22 2 
4 10 33 0 1 0 0 10 16 12 0 19 21 33 2 0 12 0 7 0 0 28 9 14 45 9 10 16 7 1 0 0 0 43 0 7 15 18 0 7 0 0 0 19 9 0 33 22 
29 0 0 0 1 7 0 30 5 0 0 8 0 0 3 31 6 0 0 14 21 0 0 0 26 0 0 0 3 10 0 3 6 13 0 28 7 7 7 6 0 2 0 19 7 13 31 0 
35 13 47 0 0 35 0 27 0 0 26 0 0 0 15 13 0 0 0 0 5 0 14 21 0 12 0 20 28 2 0 0 22 0 17 0 23 7 0 37 35 26 0 0 38 0 0 0 
4 8 14 5 0 0 31 9 0 2 0 11 26 33 0 0 5 23 0 21 0 0 19 11 2 0 0 0 0 0 13 1 0 8 17 21 0 34 26 0 2 0 12 0 0 0 27 3 
20 18 0 0 64 0 0 15 36 0 52 10 0 0 3 0 6 12 1 0 1 7 21 0 24 8 22 0 0 0 0 10 3 8 0 2 0 0 6 16 30 6 5 0 36 0 42 5 
6 0 17 0 39 30 21 0 0 21 32 0 4 0 0 3 39 15 1 17 0 17 9 0 0 22 0 3 17 0 3 9 0 0 13 19 31 0 0 2 12 31 7 39 35 0 0 35 
0 11 6 14 0 16 0 0 5 19 0 0 11 3 11 18 23 0 20 0 35 0 0 0 0 0 13 7 19 0 0 30 11 0 0 15 0 3 20 24 0 12 0 0 16 0 11 0 
52 30 0 0 16 20 0 9 0 21 0 0 0 0 0 0 38 0 0 0 21 0 0 0 0 0 0 0 0 6 0 52 0 0 0 6 36 14 0 2 0 25 0 0 9 1 0 0 
18 0 17 7 27 1 1 0 33 24 0 22 0 0 3 25 7 33 15 0 0 0 0 9 4 0 24 3 12 21 3 13 24 0 0 15 22 32 0 28 0 22 10 0 0 9 0 0 
20 0 0 30 18 40 1 0 0 0 21 9 6 59 22 3 2 1 0 52 16 1 31 10 1 18 0 0 0 1 12 21 0 7 21 6 19 20 0 30 27 1 16 0 25 72 5 0 
0 0 10 0 35 27 0 9 45 17 14 19 0 0 12 0 0 0 0 41 0 0 7 0 0 14 4 2 0 8 11 12 48 12 27 4 0 53 5 0 29 1 0 0 0 0 0 10 
0 0 0 51 33 0 0 0 9 18 7 12 21 4 21 30 0 30 0 0 10 6 20 14 0 2 12 11 0 2 10 12 0 45 1 9 53 3 23 0 25 0 0 0 0 36 38 11 
9 27 16 21 3 38 0 3 10 9 14 0 7 0 15 12 0 4 0 31 11 4 21 20 0 0 0 0 0 15 0 23 24 1 0 0 0 0 0 0 0 0 0 58 0 0 0 0 
