48 27
34 0 0 10 19 21 2 0 0 7 0 16 18 21 0 16 0 12 0 0 3 0 13 3 18 0 32 5 0 0 21 0 0 0 6 13 0 28 0 10 14 0 4 0 0 0 0 12 
0 11 0 0 0 50 0 32 9 36 2 0 16 33 0 0 0 24 0 24 10 35 0 5 36 0 21 11 21 0 0 2 4 0 0 27 36 0 17 6 26 28 13 3 12 36 41 8 
54 0 0 0 13 5 0 39 0 0 11 38 0 30 23 0 12 13 8 14 20 0 12 0 16 0 2 19 0 16 0 0 47 14 12 0 0 23 31 8 11 30 4 14 5 0 23 0 
19 0 17 0 2 34 18 21 7 0 0 20 20 0 0 56 0 0 0 18 22 0 22 15 0 0 3 15 0 0 14 4 8 14 3 12 17 0 16 17 9 0 1 11 13 25 31 0 
44 2 11 44 3 4 60 5 5 14 5 0 5 0 0 0 15 27 0 17 32 25 21 15 21 2 20 6 19 0 0 21 0 11 15 17 49 7 0 21 0 35 26 0 20 0 19 0 
21 25 14 19 5 19 0 3 0 13 12 12 16 31 10 14 4 8 16 3 4 0 3 7 15 0 0 9 27 0 22 20 19 17 17 0 2 3 8 0 0 12 3 17 14 3 0 0 
0 0 0 25 0 0 38 0 26 21 0 16 0 7 1 0 18 14 0 6 19 15 0 16 0 29 0 7 0 0 17 0 12 0 22 5 9 26 0 0 0 0 19 0 38 9 0 0 
4 6 0 0 9 0 29 26 3 4 25 19 8 22 8 3 0 0 20 17 0 0 1 22 4 18 12 26 13 16 0 0 4 0 0 84 0 13 15 0 12 7 10 6 11 0 4 6 
40 7 0 0 8 36 0 9 0 0 0 30 0 33 0 0 13 0 0 0 9 20 11 0 0 3 0 0 0 0 0 0 0 0 1 12 0 0 23 0 69 56 0 0 0 0 48 6 
0 42 0 2 0 0 31 0 0 0 17 31 0 25 0 0 21 0 0 0 18 0 5 0 14 0 16 0 2 18 0 0 2 15 10 2 0 31 0 0 0 28 22 32 1 5 0 0 
13 38 0 26 20 28 29 3 4 5 0 25 1 4 0 0 6 43 0 2 0 0 0 18 0 0 6 20 1 3 27 0 9 22 13 47 38 0 22 67 0 0 12 11 9 0 6 30 
0 0 29 2 0 0 0 0 0 0 0 7 0 2 0 0 0 0 6 9 11 8 0 0 6 0 0 0 0 24 0 40 0 0 2 0 0 0 0 0 10 0 0 0 0 0 4 0 
0 11 0 14 7 2 0 9 26 0 0 0 14 3 0 0 13 12 0 39 0 0 21 0 0 0 0 15 9 0 8 0 0 3 26 0 7 0 0 19 1 6 8 14 9 0 0 21 
0 0 0 55 5 0 0 32 19 0 0 0 8 0 2 0 0 0 0 13 0 0 10 8 0 5 0 16 9 0 10 0 10 0 23 16 0 19 3 52 15 0 0 6 6 0 0 0 
0 0 55 0 73 0 38 23 40 7 36 27 7 0 21 23 31 6 42 8 0 5 6 6 23 18 5 26 0 0 0 2 12 2 26 8 0 33 63 0 38 29 17 31 47 0 16 48 
45 0 0 1 15 0 45 0 22 0 0 1 4 0 18 0 5 0 3 0 0 0 0 0 0 2 16 1 10 3 22 3 0 3 0 9 32 0 0 0 10 0 0 0 14 84 24 0 
39 0 5 42 9 21 4 1 21 0 0 7 0 0 0 15 29 8 15 9 0 6 3 2 0 14 11 0 0 28 0 0 11 29 0 4 0 0 1 52 0 0 0 11 6 55 6 0 
0 32 8 0 0 37 0 0 0 4 0 6 2 0 2 12 0 0 0 0 23 0 16 0 7 13 11 3 0 0 0 27 15 18 0 0 13 22 1 0 35 4 0 23 0 0 0 5 
33 17 13 25 7 7 38 15 0 0 0 7 18 0 8 18 0 0 1 7 13 9 0 13 22 0 19 26 0 12 23 4 0 40 16 8 0 0 0 0 7 12 15 4 35 0 0 20 
0 0 9 0 2 28 0 0 29 12 6 0 21 0 0 0 8 0 4 11 0 0 0 0 0 0 0 0 0 0 0 0 14 27 9 0 0 28 13 0 0 0 16 10 0 0 11 0 
32 0 0 8 22 35 5 0 0 28 8 5 7 0 13 0 6 0 32 0 0 0 14 17 0 0 6 31 14 0 17 0 32 22 1 14 2 27 1 43 33 2 30 2 2 0 34 0 
32 20 30 29 19 0 49 0 3 4 0 38 16 0 34 4 14 0 0 7 17 15 7 4 19 1 10 0 0 0 28 0 3 2 8 2 30 0 0 1 29 0 0 19 20 29 0 33 
0 0 44 8 7 77 22 0 0 0 27 27 0 0 1 25 0 0 0 0 0 0 0 38 0 0 22 0 22 6 0 0 0 5 0 0 21 0 0 0 0 32 0 17 49 18 3 0 
0 0 0 17 11 6 9 0 30 0 37 1 9 0 0 11 14 0 0 21 0 0 16 4 0 0 7 2 5 0 0 0 2 0 11 0 0 0 30 0 21 0 0 0 0 0 0 37 
0 28 26 18 0 0 0 0 0 0 0 15 24 0 30 0 0 0 0 20 0 0 20 12 0 0 13 0 16 28 0 0 0 0 0 19 47 9 0 0 0 0 0 0 33 0 0 0 
0 2 8 15 0 8 6 1 16 10 0 1 0 0 0 12 16 24 11 0 12 0 0 5 18 0 0 2 8 0 0 4 12 0 18 24 29 28 17 17 6 66 20 20 0 0 0 0 
38 11 0 0 11 0 12 0 27 16 0 22 38 0 8 0 20 0 12 16 26 0 0 0 0 27 2 8 0 0 0 12 0 0 26 13 0 8 38 14 28 30 0 0 0 8 26 16 
