48 27
31 20 6 0 11 37 0 23 13 26 29 19 10 16 10 11 23 26 18 34 12 0 24 0 10 0 0 0 0 0 27 0 0 0 15 47 6 25 1 0 0 12 37 19 34 0 5 9 
61 0 42 0 0 0 0 18 0 0 9 0 0 0 7 4 0 13 13 9 43 0 0 14 0 10 9 17 1 1 2 13 0 50 34 0 16 2 12 0 0 0 22 0 17 10 26 0 
39 7 17 27 42 25 4 8 11 0 0 35 0 6 0 8 0 0 5 18 5 0 21 12 9 5 0 0 11 19 60 5 10 4 33 24 0 0 20 50 0 0 39 21 12 0 72 20 
1 40 14 4 5 40 26 0 0 59 17 17 19 28 25 47 41 59 7 0 15 20 25 19 36 21 18 19 34 14 37 10 14 13 31 0 22 9 10 44 7 30 0 15 43 30 18 44 
0 32 13 20 42 50 0 0 20 6 0 0 0 0 0 10 12 0 6 14 0 7 0 17 5 0 13 0 6 12 4 0 0 32 0 0 0 0 0 0 5 36 33 17 0 29 39 4 
0 0 0 16 0 0 0 29 5 5 5 0 8 23 0 8 4 0 19 0 28 0 3 0 4 0 0 0 8 33 0 25 4 1 1 0 31 0 4 0 0 0 5 4 2 0 2 9 
0 70 1 42 8 0 20 13 7 0 6 43 0 0 0 11 5 17 17 0 3 28 4 0 13 14 11 0 8 0 29 13 0 4 21 17 10 3 4 14 0 0 0 4 0 0 26 44 
8 81 1 0 19 16 0 28 27 0 0 35 0 37 14 2 3 18 0 50 0 16 1 19 0 0 25 9 8 7 0 6 0 10 19 50 4 14 0 31 0 0 24 10 8 0 23 11 
0 8 11 28 0 26 16 13 0 8 5 23 0 6 19 0 0 14 18 0 0 3 9 0 22 0 15 7 0 0 0 1 14 8 23 0 28 0 0 0 0 18 1 21 0 0 10 0 
0 0 21 0 19 15 41 0 20 0 2 20 0 0 0 2 0 26 10 0 41 0 2 53 0 0 11 3 0 0 6 20 0 0 2 5 7 0 4 0 13 21 0 35 0 0 0 45 
0 4 28 0 0 12 0 6 0 4 0 0 0 0 0 19 0 8 1 0 0 0 0 12 0 3 9 12 0 0 23 0 14 11 27 38 5 7 13 7 0 0 0 0 19 0 7 17 
1 0 3 0 0 35 0 22 54 0 0 0 32 0 14 17 11 29 10 0 0 7 2 0 0 15 0 9 0 37 0 0 17 0 0 27 0 0 15 0 36 0 0 0 24 0 29 8 
12 35 0 1 13 9 0 17 0 0 9 19 0 30 0 0 10 0 0 0 15 0 12 17 9 0 19 0 0 15 19 2 9 0 6 0 0 26 55 0 15 9 19 30 0 0 12 20 
0 0 41 0 23 0 7 0 11 0 0 22 0 1 2 29 2 6 2 0 14 11 0 1 5 0 0 23 0 0 2 0 13 31 0 0 0 0 12 28 0 0 3 0 29 0 0 0 
0 0 3 0 5 0 31 0 0 0 0 2 0 22 7 18 0 19 2 0 2 7 0 24 26 12 0 19 0 25 15 2 0 18 0 31 11 19 11 0 2 17 9 10 0 0 0 21 
17 12 0 43 0 12 0 16 27 37 0 0 0 0 15 12 0 16 0 0 0 7 0 29 1 0 0 0 0 5 6 17 13 6 29 18 7 8 0 5 0 0 0 6 10 7 45 35 
23 0 10 0 0 0 0 0 0 0 0 0 24 16 0 4 0 0 8 24 0 3 22 8 0 0 0 0 5 32 6 0 0 6 0 0 24 0 0 10 0 0 3 38 0 0 0 0 
1 65 8 25 3 32 11 0 0 23 0 5 17 29 0 0 5 10 0 0 0 20 0 0 22 6 4 31 14 8 0 0 53 0 0 23 17 24 44 0 0 17 15 0 0 1 46 3 
30 62 24 0 5 16 0 2 12 29 8 22 24 0 0 0 12 13 27 0 7 16 12 0 0 0 0 8 0 26 43 2 12 17 22 33 86 0 0 0 0 0 0 0 12 17 0 13 
0 25 7 16 0 0 38 0 4 0 8 3 0 0 0 0 12 43 16 10 20 0 0 0 6 0 14 0 9 4 0 21 0 32 17 0 0 18 15 29 34 0 0 7 38 0 0 8 
20 20 21 38 11 16 11 0 0 21 31 14 0 9 0 19 0 18 19 28 7 2 0 4 0 11 7 3 15 4 11 0 0 0 0 14 0 0 3 13 4 93 0 15 4 0 10 28 
51 0 0 29 0 14 0 48 0 15 46 0 8 0 0 0 4 5 4 0 8 8 0 0 1 4 0 0 0 12 0 13 0 0 0 59 0 19 0 0 33 31 19 0 0 45 0 0 
22 0 0 0 29 12 0 34 0 3 3 13 0 34 0 29 19 0 9 0 0 4 0 0 48 0 0 17 0 13 6 13 0 29 19 0 8 0 11 26 0 17 2 0 32 17 0 0 
23 11 45 0 10 10 16 0 10 0 0 0 1 0 9 10 23 17 0 5 0 0 9 14 10 0 59 3 0 3 0 7 0 0 0 0 0 0 22 0 0 0 9 7 0 0 0 0 
43 0 18 7 0 52 18 13 6 0 21 1 0 20 12 21 5 0 19 0 0 22 0 7 13 0 14 0 0 19 24 13 3 0 0 0 0 16 5 0 0 0 16 61 0 0 12 17 
9 17 24 0 37 0 0 0 5 13 0 0 22 15 0 0 0 33 2 18 1 20 21 18 0 12 0 23 8 14 11 20 6 0 6 0 0 14 43 0 0 18 0 21 40 32 0 23 
13 0 10 43 14 8 0 25 0 23 65 0 0 8 0 4 0 21 0 17 0 0 23 0 70 0 0 8 28 14 0 13 0 0 4 35 61 0 11 7 0 13 0 0 13 25 15 11 
