48 27
34 23 0 0 58 32 0 0 20 0 0 0 30 1 0 0 31 8 0 26 0 9 0 0 0 32 7 0 22 0 21 15 0 23 34 22 1 31 0 35 13 0 30 0 0 0 15 42 
0 29 0 0 12 0 0 0 0 32 33 0 13 0 0 0 37 7 0 7 27 0 2 0 0 13 7 0 0 5 0 0 0 0 53 5 11 0 0 3 0 12 13 10 0 0 0 1 
5 0 0 0 0 5 0 12 39 19 7 28 29 15 14 12 0 8 15 45 0 0 0 4 0 16 9 1 50 0 4 0 13 0 12 21 8 0 0 30 0 45 0 0 0 0 12 9 
5 0 6 60 26 16 13 0 12 46 0 0 0 0 0 0 14 0 9 0 0 0 2 3 4 0 20 17 0 0 4 4 21 0 29 0 0 0 8 0 37 0 10 0 0 4 5 8 
0 31 0 0 0 0 38 0 20 30 0 0 2 0 0 0 0 0 23 0 0 3 24 0 0 0 0 19 0 7 18 13 29 0 0 0 0 22 0 61 11 0 0 0 38 0 22 0 
18 0 18 1 14 13 2 11 9 2 15 24 0 10 52 1 2 1 36 0 30 4 0 0 19 18 0 12 0 9 19 0 2 0 13 0 9 0 0 37 14 32 7 2 0 0 22 15 
8 3 15 1 34 16 0 0 0 20 0 0 30 0 0 0 0 0 18 21 21 9 25 0 0 27 14 8 16 0 3 0 9 24 9 12 11 0 13 0 0 32 16 54 0 18 13 14 
0 9 0 64 0 1 8 0 0 5 37 0 21 6 0 2 0 16 0 4 0 0 0 40 0 0 0 0 18 45 2 15 21 20 0 0 0 14 0 3 0 28 0 26 0 5 0 34 
15 37 48 5 1 24 0 3 22 0 16 5 14 19 3 0 22 43 20 0 5 0 18 0 4 13 43 9 9 0 7 15 16 1 16 30 9 0 37 49 5 5 4 0 0 16 30 0 
14 2 0 0 26 7 15 6 0 0 14 20 3 0 27 0 3 8 13 14 1 6 10 2 0 17 15 7 0 0 0 21 10 0 0 6 11 18 28 6 0 31 0 0 0 40 42 0 
0 0 0 37 9 0 0 0 8 0 0 0 0 0 0 0 8 0 28 0 19 0 0 0 0 0 10 16 0 0 0 0 0 0 0 7 10 0 0 10 0 1 0 16 3 0 73 12 
13 2 26 22 5 0 45 31 32 7 12 5 0 4 6 0 12 5 0 40 6 0 7 4 22 22 26 0 17 6 0 0 10 13 38 9 9 0 30 2 9 2 16 0 36 0 0 20 
31 32 4 8 4 69 46 14 0 5 0 0 8 12 15 0 12 24 0 19 0 15 3 0 9 18 0 0 0 0 0 44 10 32 11 33 4 32 0 55 5 24 34 0 0 0 0 0 
17 0 42 5 0 0 28 0 0 0 0 8 36 10 1 0 0 9 0 20 0 5 4 14 0 4 4 15 0 27 28 9 18 0 14 41 0 0 0 0 13 0 0 12 0 46 0 7 
45 0 0 0 0 0 0 13 19 2 0 0 7 0 0 0 4 8 0 0 23 0 0 0 0 0 0 0 20 0 5 0 11 0 0 5 0 0 6 0 0 0 0 24 0 9 0 68 
0 10 43 27 0 0 82 0 10 1 34 25 11 0 28 0 15 4 8 0 0 7 8 7 0 6 0 0 42 0 0 9 0 37 17 6 0 0 0 43 11 0 28 37 34 39 0 19 
13 0 2 6 67 13 13 0 0 0 0 0 3 20 18 10 29 0 0 0 17 0 9 0 0 0 0 13 9 0 0 0 18 0 15 31 0 17 0 35 3 0 0 12 0 0 8 0 
80 0 36 0 0 22 39 7 0 29 0 0 0 21 4 24 26 0 2 0 0 14 9 8 16 11 21 12 4 2 3 6 0 6 4 60 20 5 57 8 6 6 19 0 79 0 4 11 
1 39 0 18 2 7 37 0 4 0 1 0 0 0 0 0 3 0 0 0 0 23 3 0 0 3 14 0 0 0 0 5 0 0 6 0 0 0 2 0 23 35 0 17 0 0 0 0 
0 0 0 0 3 36 0 0 0 0 0 22 28 0 32 7 0 6 0 2 0 1 3 0 5 7 7 10 0 2 0 0 3 15 15 3 0 13 13 0 27 0 0 6 0 0 19 0 
29 0 0 0 39 11 0 11 0 14 11 0 0 3 0 11 15 15 0 0 19 0 0 0 0 0 5 0 0 11 0 0 17 26 4 0 13 0 0 28 9 0 0 39 3 11 39 31 
41 0 21 14 31 19 21 30 18 18 1 6 0 0 0 36 9 16 0 0 0 24 6 0 19 15 0 18 0 0 26 0 2 29 9 8 0 30 8 5 0 21 0 0 0 24 31 1 
14 19 0 2 0 25 0 2 4 49 0 3 10 0 51 12 4 28 0 0 12 9 13 0 12 7 0 11 11 0 2 41 42 17 25 2 17 2 26 0 0 0 10 10 0 31 1 4 
5 45 0 28 8 0 36 33 13 0 0 23 16 0 11 0 47 23 4 0 0 8 19 0 34 12 0 19 12 5 0 6 14 32 42 10 0 0 14 15 58 38 0 0 0 68 25 11 
48 0 0 0 0 0 6 0 8 0 2 19 27 21 0 0 0 5 0 0 0 0 12 0 0 0 21 3 9 0 19 6 0 0 14 0 0 0 0 22 0 14 0 0 14 16 10 21 
0 13 44 42 24 10 5 0 0 0 0 0 0 7 0 10 0 6 0 0 3 20 12 0 0 0 15 0 9 0 0 0 5 0 26 19 0 35 8 6 0 15 0 9 25 55 0 46 
0 0 0 0 0 0 14 14 0 12 19 13 0 0 4 30 10 0 21 26 17 0 2 0 33 6 0 0 0 0 0 0 0 10 9 25 0 22 28 19 0 0 0 0 20 30 22 25 
