48 27
6 19 15 0 0 0 0 0 22 2 0 17 28 0 6 0 8 24 11 30 0 57 2 8 28 0 0 12 5 2 21 4 24 9 28 43 0 0 0 17 6 0 1 37 0 0 52 3 
14 0 70 0 5 7 0 16 0 0 0 0 38 10 0 22 14 6 5 0 7 0 37 23 0 0 0 7 10 7 0 23 9 24 0 0 0 20 10 14 0 0 0 5 0 0 4 0 
0 25 9 34 29 0 25 48 3 0 0 33 11 9 0 0 22 38 0 13 0 5 15 14 23 0 25 0 0 19 0 17 0 24 0 26 0 62 5 0 34 4 18 0 0 32 2 10 
0 26 3 0 0 22 2 25 0 0 0 0 10 17 0 17 0 20 0 1 13 0 10 2 13 0 7 26 2 0 11 0 20 0 0 14 0 4 2 0 3 20 4 0 0 0 12 0 
36 39 0 18 0 15 6 34 45 0 17 6 29 0 0 0 0 21 8 5 15 18 19 22 14 0 4 0 20 12 13 0 14 5 0 18 36 0 14 21 42 12 5 7 4 0 0 30 
11 0 31 0 0 0 55 5 17 11 10 0 4 0 0 16 0 0 0 7 10 31 0 0 0 21 0 9 20 27 0 0 25 21 0 24 25 3 116 33 19 3 0 18 9 0 28 22 
1 4 0 71 2 5 27 3 0 0 15 15 9 10 0 33 0 3 0 3 0 51 25 22 0 0 34 0 0 26 27 6 9 29 0 0 0 18 0 6 0 0 13 6 3 22 25 11 
0 0 44 0 0 12 0 56 0 0 0 0 6 14 14 0 14 6 0 0 12 5 0 0 17 0 0 0 0 0 3 7 47 0 0 0 4 10 7 0 4 0 0 0 0 0 39 10 
16 29 1 41 0 0 31 47 8 0 0 0 7 0 4 0 0 0 33 0 13 4 3 8 25 12 37 15 0 26 0 2 10 7 0 23 33 32 12 15 0 0 0 0 6 0 7 10 
21 20 0 0 0 0 22 9 6 0 0 0 19 0 6 29 6 0 0 0 0 20 6 23 0 0 10 0 22 3 7 12 0 0 0 0 0 20 0 0 0 0 0 12 16 0 44 0 
25 0 0 39 4 0 0 0 0 0 0 0 0 15 0 0 8 0 0 0 2 0 0 0 0 0 3 0 0 5 0 0 9 4 34 0 0 4 0 13 0 0 39 3 14 0 1 0 
1 13 0 14 0 0 0 7 5 17 18 0 0 15 35 0 2 0 11 0 0 0 13 0 3 14 0 9 4 17 0 9 0 0 0 8 0 34 0 12 0 0 0 37 0 0 0 0 
0 8 0 0 30 4 24 0 49 73 13 0 27 17 0 0 0 0 29 5 9 0 0 0 0 0 2 16 13 0 40 37 1 21 23 0 4 0 31 1 0 14 6 0 0 5 1 0 
0 13 0 3 22 12 0 0 31 10 36 8 6 0 0 0 0 12 0 4 7 15 0 12 17 10 33 11 9 24 0 1 0 5 11 0 5 2 5 32 0 33 0 19 0 30 24 0 
21 35 99 0 4 0 0 5 0 0 0 3 9 0 22 8 12 0 0 0 0 31 0 0 28 0 0 15 12 0 0 0 18 0 8 14 33 0 0 2 19 0 0 0 0 21 10 45 
5 0 0 0 0 17 0 4 0 0 0 0 6 1 1 1 16 0 7 22 9 21 0 4 0 0 17 8 0 4 12 4 0 28 0 8 8 13 1 14 0 0 19 23 6 0 1 3 
1 0 42 0 0 0 0 17 0 21 0 0 0 3 14 24 9 5 2 0 17 13 0 14 36 9 0 25 6 4 34 11 0 0 13 4 0 0 6 23 0 3 0 0 0 4 0 14 
0 74 0 0 39 32 12 5 9 0 0 17 8 2 28 17 7 0 0 15 22 0 4 9 12 0 20 0 28 5 16 10 29 9 3 48 0 32 0 2 13 1 2 41 2 3 11 60 
0 3 47 26 0 4 50 5 17 9 0 9 0 0 0 9 24 14 24 0 9 30 41 2 3 4 33 1 20 42 0 0 18 20 0 0 14 0 32 11 13 13 24 21 1 19 6 49 
21 24 3 0 13 34 36 0 0 19 0 17 45 2 0 0 2 13 9 0 32 2 22 0 17 0 0 17 17 13 0 24 6 17 5 6 4 17 5 3 28 20 49 22 1 14 9 0 
0 15 0 36 0 26 36 14 0 0 0 0 32 0 24 17 23 11 0 3 3 14 0 0 20 0 0 8 11 5 0 26 0 0 9 4 0 0 0 36 18 0 22 12 0 3 0 0 
45 42 14 0 0 0 29 6 0 9 41 0 38 10 14 16 1 5 35 0 32 0 4 0 2 24 13 8 4 6 0 0 0 5 21 52 18 0 5 0 19 0 0 21 0 91 16 0 
13 47 21 25 0 0 0 0 9 11 0 17 2 0 0 0 15 0 0 0 8 0 16 16 6 0 17 18 4 21 0 0 0 0 8 0 0 0 0 16 0 0 15 5 0 37 0 5 
0 0 0 47 0 0 16 20 28 5 0 11 0 28 27 0 0 0 0 0 0 0 40 0 0 15 10 0 17 0 0 15 14 11 0 8 43 1 7 1 22 19 0 40 0 0 18 44 
92 13 8 0 20 0 0 22 12 0 20 0 0 8 4 0 27 3 12 0 18 0 0 0 37 0 0 14 15 1 0 1 9 0 34 0 6 0 5 0 33 74 42 25 14 32 12 0 
14 0 31 1 0 15 0 17 17 0 24 2 0 20 0 0 0 0 15 0 41 11 0 0 17 14 0 0 5 0 0 1 0 7 0 0 16 0 0 21 0 9 0 15 16 25 11 25 
4 32 0 0 0 1 0 23 0 0 53 7 0 0 0 22 15 0 15 0 0 0 0 22 0 0 0 17 9 0 0 14 12 32 14 0 21 22 0 0 0 0 0 0 0 0 69 0 
