48 27
0 0 0 0 17 42 0 0 0 68 5 33 0 32 20 0 0 0 0 0 7 0 0 0 0 0 0 0 0 19 2 5 2 6 0 26 11 0 6 0 0 6 0 0 0 30 62 25 
23 20 39 0 17 0 0 11 0 16 7 1 12 13 1 10 0 0 0 0 21 0 9 3 4 10 13 2 0 2 22 8 3 29 0 0 13 0 6 0 0 0 0 20 31 41 35 3 
0 0 46 10 0 23 20 2 0 27 0 25 0 0 52 13 0 0 0 0 0 0 24 19 22 12 0 0 0 23 0 0 5 0 0 0 52 16 0 0 3 0 0 0 0 0 32 0 
33 6 0 0 30 0 0 38 0 20 0 0 11 23 0 0 5 47 0 11 3 53 5 0 22 0 0 0 0 0 0 0 0 1 46 1 13 10 19 0 0 0 0 22 0 52 0 45 
61 17 0 0 0 42 32 2 7 2 0 17 17 6 0 0 11 0 18 0 23 0 0 0 7 49 2 11 0 23 1 0 6 0 44 15 33 3 50 3 3 0 16 0 0 0 0 24 
0 2 34 0 2 52 0 40 0 5 5 7 11 9 0 0 26 0 9 0 0 16 20 9 22 0 0 0 16 13 12 9 27 16 0 0 28 0 2 0 9 59 5 20 0 0 7 30 
11 0 16 57 0 9 0 20 11 55 1 4 4 16 30 25 16 12 6 14 40 5 17 5 2 19 0 9 6 25 0 52 0 8 12 0 11 0 0 19 16 7 33 40 18 34 0 0 
0 0 34 5 0 0 5 0 5 0 0 5 0 9 52 0 15 0 18 0 12 5 9 5 0 0 2 0 0 0 6 29 0 7 0 0 14 0 13 0 18 0 0 0 0 33 0 0 
0 4 26 0 0 39 29 1 1 85 16 2 22 0 14 13 0 0 0 4 5 0 0 9 0 11 2 0 16 0 11 3 14 0 22 23 6 0 29 0 5 18 33 16 3 0 13 0 
0 0 8 0 20 0 0 0 0 10 4 18 0 15 7 0 0 9 0 0 0 16 0 0 0 0 0 7 32 18 9 0 0 18 5 8 5 0 0 0 10 13 0 0 13 2 0 19 
0 47 57 0 16 1 30 11 4 0 0 0 6 37 0 26 17 0 20 18 6 6 15 0 0 0 3 0 6 5 37 0 31 9 0 20 0 25 18 0 0 34 0 0 27 43 0 15 
11 34 20 0 22 23 8 3 0 0 10 0 0 0 12 32 16 2 0 5 0 12 20 0 0 34 5 15 23 0 0 12 3 0 20 37 11 8 39 0 0 0 0 0 0 39 0 52 
5 12 0 6 27 0 11 21 0 26 0 8 5 6 24 0 0 19 36 7 0 18 8 0 4 0 8 0 16 2 0 6 2 30 1 0 8 3 15 2 15 30 0 0 0 0 28 28 
0 3 4 0 14 22 6 0 0 0 4 18 0 8 0 5 4 12 24 13 21 6 0 0 14 0 0 16 4 0 3 8 4 3 30 0 5 1 1 0 5 30 49 0 13 0 0 0 
8 8 24 0 0 8 1 15 35 61 16 6 0 33 30 0 6 0 15 0 16 0 21 4 4 1 22 24 3 0 0 35 23 26 25 6 3 1 28 0 47 0 29 0 33 0 9 37 
56 92 45 0 0 0 0 0 1 0 0 10 0 10 7 0 0 9 0 0 19 0 8 0 0 0 21 0 4 0 29 0 11 0 0 0 4 0 0 35 16 0 3 0 0 45 0 42 
0 25 45 0 0 0 0 0 1 29 21 0 6 0 50 0 0 0 0 3 13 26 0 0 4 0 0 0 0 28 0 0 22 0 4 0 13 0 24 0 26 0 2 0 0 0 4 71 
19 25 20 0 8 5 7 0 12 44 9 0 0 11 0 15 22 16 5 0 6 0 16 0 19 2 31 0 9 11 45 29 15 8 8 0 38 0 39 0 0 8 8 19 3 2 0 2 
62 0 58 8 0 0 0 18 0 38 11 0 0 61 0 27 0 9 0 0 0 14 0 0 0 25 0 0 0 14 28 12 45 5 0 11 3 16 5 0 4 0 1 0 0 32 0 6 
7 4 0 0 0 22 1 48 2 17 3 0 6 18 12 5 0 0 0 1 14 4 0 0 5 26 10 0 7 19 0 0 0 3 6 7 25 28 0 0 37 1 0 7 8 0 0 27 
0 2 18 8 14 12 26 26 0 23 0 11 4 5 0 0 3 17 6 12 12 10 8 0 0 0 0 0 25 0 0 0 10 18 0 6 8 0 17 0 0 1 0 0 0 14 0 0 
0 16 21 0 12 37 10 3 3 32 11 19 17 5 2 16 0 0 0 0 0 29 5 34 0 20 0 33 0 24 0 0 0 12 0 0 17 3 2 0 27 0 29 20 0 18 58 3 
7 18 44 0 50 38 20 23 0 3 0 0 21 24 26 0 0 35 18 0 13 0 17 0 0 0 0 22 27 7 0 15 18 47 3 4 0 20 0 8 7 36 44 16 13 0 0 90 
3 7 16 37 0 21 16 0 60 0 28 2 0 0 1 6 0 0 20 0 34 1 24 0 0 0 13 0 0 0 22 0 5 2 31 0 0 0 61 31 20 0 0 40 13 0 0 1 
0 3 11 0 24 41 7 0 10 3 0 0 4 40 0 0 0 0 0 0 0 8 0 0 15 3 21 15 0 4 0 23 0 19 0 0 31 3 9 15 10 41 9 26 0 4 0 0 
39 0 26 0 39 5 2 36 7 0 0 20 0 36 3 6 23 3 18 7 0 0 22 0 22 30 0 0 43 13 11 11 24 2 34 0 0 0 1 0 69 0 0 36 22 0 25 15 
11 41 0 52 2 26 16 29 21 62 0 33 18 28 17 8 0 0 0 5 12 0 11 8 20 0 0 12 26 21 47 58 0 0 0 0 0 10 0 0 0 14 0 34 74 20 0 38 
