48 27
42 11 12 0 0 21 0 15 32 0 19 0 0 0 3 0 0 8 0 9 0 0 31 15 0 20 11 0 0 21 0 0 0 0 0 4 10 34 11 0 0 0 42 0 0 0 17 0 
65 45 0 0 0 42 0 0 10 36 1 0 12 0 0 0 5 21 13 0 10 7 10 0 0 0 0 0 0 13 10 7 0 0 2 0 0 9 20 2 25 0 13 25 0 34 17 42 
41 0 19 3 42 21 0 0 39 0 21 9 0 0 33 6 7 0 10 42 3 23 0 7 0 7 31 13 16 2 20 5 0 10 0 21 3 1 38 20 1 0 0 0 34 31 4 0 
11 0 20 1 30 0 38 53 28 4 28 30 7 7 18 0 7 15 2 44 10 1 0 4 12 0 0 22 12 12 10 4 14 1 43 6 1 59 0 15 0 22 3 16 2 7 15 31 
0 6 0 34 0 0 20 11 14 14 31 0 0 0 22 14 9 19 0 0 17 0 7 27 0 0 20 10 8 19 29 24 26 0 13 0 83 4 10 0 18 0 0 22 18 0 17 13 
10 49 0 13 0 19 10 8 0 2 0 0 0 26 5 3 8 1 1 4 0 17 8 0 13 0 0 4 0 13 8 4 0 0 0 6 0 0 0 26 0 0 0 0 43 0 0 0 
0 0 0 29 0 0 8 0 0 9 0 0 6 0 8 23 0 11 0 0 0 0 0 21 0 0 0 18 16 0 0 0 8 15 0 0 0 0 35 5 0 10 0 0 21 0 14 0 
0 0 0 8 4 6 19 14 9 0 1 4 13 0 0 29 8 10 27 0 0 23 0 6 17 20 0 4 2 6 2 0 11 0 0 11 0 0 22 0 0 17 0 0 24 0 22 0 
8 0 20 1 0 0 0 38 8 0 2 0 6 21 0 5 52 28 15 6 0 0 4 0 0 0 0 4 9 0 13 2 0 2 0 10 0 26 0 23 30 0 29 0 0 62 5 0 
0 79 0 14 3 78 5 1 35 42 0 0 8 8 26 36 0 4 0 8 5 9 18 0 13 2 0 5 0 0 0 11 29 0 13 0 7 0 18 6 19 53 75 35 0 103 55 39 
32 0 7 86 8 12 0 17 8 0 7 0 9 0 0 0 10 0 13 0 0 8 7 0 0 12 0 20 0 8 2 1 30 21 24 1 0 48 0 0 0 0 0 6 0 42 0 13 
0 0 9 7 40 1 0 3 0 2 7 20 0 2 0 0 30 29 10 28 0 3 4 8 9 0 7 15 5 0 7 20 0 7 0 3 0 7 2 0 7 0 15 0 67 0 30 39 
0 2 14 2 5 0 0 0 0 0 5 12 16 4 3 16 0 12 3 8 24 3 0 0 0 23 4 0 26 2 20 32 20 4 0 0 10 13 0 0 12 0 0 0 30 0 0 0 
5 2 9 22 10 35 23 2 32 0 21 12 12 0 17 0 11 9 0 23 12 15 0 27 16 24 0 0 0 0 0 28 31 25 0 0 30 0 10 33 0 22 0 0 10 5 41 0 
0 11 9 1 2 20 43 0 0 0 0 17 11 0 0 0 8 9 5 1 0 12 0 2 0 21 1 37 0 0 7 6 0 7 4 14 0 22 12 22 1 3 15 0 28 0 0 0 
59 1 2 8 20 0 0 32 21 48 0 0 11 3 25 1 26 0 5 3 1 7 0 6 44 5 8 9 31 36 16 0 12 0 8 3 9 0 8 6 5 34 2 43 44 1 19 7 
4 46 19 27 41 31 0 0 0 6 27 32 8 0 33 6 3 5 0 5 58 8 10 2 8 16 0 0 0 21 70 0 0 0 33 30 8 53 22 0 24 40 0 0 22 25 46 6 
0 3 4 0 0 40 0 18 0 0 0 0 43 11 0 0 0 19 28 34 0 0 22 0 9 18 7 19 0 0 12 1 0 0 14 0 27 0 26 0 0 0 15 0 8 27 20 0 
3 4 0 16 8 34 0 0 0 6 31 40 17 31 0 33 15 0 12 9 0 55 15 0 0 0 13 4 13 5 12 24 11 0 10 3 0 20 0 22 30 28 6 6 17 10 0 0 
0 0 0 0 0 76 22 16 0 0 4 0 0 0 0 0 0 0 6 0 0 0 0 0 18 0 0 0 9 5 0 0 0 0 0 0 1 1 0 0 28 0 0 0 2 0 41 10 
0 23 1 1 0 0 5 0 0 0 0 5 6 4 7 8 0 11 0 0 0 6 0 5 20 0 10 0 9 0 8 2 0 17 0 0 0 15 0 0 7 4 0 0 20 0 0 0 
28 0 0 0 36 21 56 25 14 0 15 22 5 0 0 14 17 13 0 22 0 42 10 15 0 40 12 4 21 33 2 24 0 37 0 5 15 12 12 0 36 0 0 0 38 18 27 0 
90 50 2 32 69 35 1 0 0 0 0 15 26 0 0 0 8 21 10 0 0 17 0 20 19 0 0 4 20 0 0 31 28 9 0 0 0 0 63 0 0 49 0 0 8 45 0 11 
17 0 28 11 0 0 2 0 3 6 14 0 19 11 15 6 27 4 15 0 3 9 10 0 0 0 18 15 4 14 14 0 35 0 28 21 0 5 8 0 1 62 4 0 12 0 10 0 
0 28 38 34 3 0 0 0 0 0 11 45 3 8 21 0 8 32 0 4 0 3 0 0 13 0 0 18 25 5 12 14 4 0 0 24 1 25 0 0 26 0 0 0 0 0 0 0 
0 5 0 7 0 32 9 0 0 0 0 11 0 0 0 11 25 16 20 0 0 2 0 0 32 0 11 0 4 0 0 0 0 8 0 0 0 21 35 5 0 13 0 0 25 0 18 0 
25 0 0 0 14 0 0 0 0 23 0 4 0 2 14 0 0 9 10 0 0 14 10 0 1 16 0 0 8 5 0 0 23 0 0 0 0 7 0 23 22 0 0 22 0 23 0 0 
