48 27
0 0 10 35 0 0 0 16 0 0 7 0 5 4 0 45 0 0 6 0 0 0 3 0 10 3 0 0 23 14 0 0 0 0 0 13 0 0 12 0 0 0 0 0 9 30 0 23 
0 0 26 0 0 0 0 0 0 11 0 31 9 9 13 8 0 0 77 0 17 9 16 0 0 0 0 13 19 0 19 15 14 5 46 0 0 0 0 5 6 23 0 0 10 18 28 29 
0 20 35 0 0 22 0 7 0 45 35 17 6 12 0 0 0 8 12 15 0 9 37 0 14 4 17 0 21 28 6 0 0 10 15 0 0 71 3 12 0 23 20 35 0 0 0 24 
7 5 0 0 2 0 2 7 0 0 12 1 8 0 24 24 0 7 0 12 0 0 18 13 0 5 19 0 6 0 0 0 0 45 13 18 15 0 0 0 0 0 0 0 19 18 0 9 
31 32 0 16 0 0 0 0 0 7 0 1 19 26 18 0 28 0 0 39 0 0 0 0 12 0 9 15 20 11 0 2 0 35 0 19 2 2 21 1 0 0 23 32 0 34 0 0 
0 0 0 0 0 5 26 30 0 0 9 0 18 36 21 0 21 21 0 26 21 0 2 6 25 0 20 18 21 6 6 9 14 6 0 2 4 4 0 0 7 0 2 19 10 46 20 0 
2 38 0 12 0 10 65 21 6 0 7 0 6 0 13 0 2 0 0 27 0 0 6 0 30 0 0 8 0 0 4 0 6 23 28 0 0 0 14 65 20 0 12 0 0 39 34 16 
0 27 2 11 26 31 3 0 11 4 12 7 0 4 9 2 15 0 4 0 0 0 0 13 0 10 11 17 27 0 26 15 4 19 5 10 18 10 0 8 8 1 0 16 0 2 0 0 
7 9 0 0 0 11 0 25 28 24 17 35 53 0 13 25 11 0 0 11 0 0 0 14 1 40 0 15 8 0 2 26 2 0 0 0 0 0 7 0 3 1 2 0 0 0 1 0 
0 14 50 0 8 28 0 18 24 0 4 0 8 0 30 2 12 6 20 3 10 3 24 19 1 10 7 0 18 17 8 5 18 35 0 16 28 3 1 67 0 5 0 0 12 15 54 10 
0 22 0 32 81 0 7 4 0 10 0 12 16 14 0 3 0 0 3 0 0 8 11 21 3 0 7 17 6 14 0 0 0 2 0 21 0 0 0 13 42 0 0 50 0 0 42 16 
8 0 0 0 57 11 40 28 23 24 2 75 5 5 4 3 23 7 8 11 0 0 18 6 23 0 13 14 0 0 0 0 26 27 13 54 28 10 5 28 0 37 0 1 0 36 42 13 
53 0 27 30 0 37 6 0 19 0 0 0 0 11 0 0 0 0 12 0 1 0 17 7 1 2 5 0 2 1 7 29 7 39 45 10 3 0 0 5 0 0 9 0 0 24 0 9 
16 5 0 34 0 0 73 0 12 0 3 12 0 0 2 0 20 0 0 5 0 0 4 0 5 0 3 2 0 0 0 0 4 0 0 0 0 34 0 0 0 0 0 0 38 39 0 0 
0 59 7 14 17 2 1 0 19 0 27 29 19 30 0 0 1 17 20 15 2 0 12 35 27 15 0 1 10 0 0 19 39 10 0 0 10 33 4 15 38 9 0 64 17 13 44 4 
12 40 14 0 8 0 17 0 0 0 0 0 1 5 2 5 1 5 5 6 27 0 0 17 0 23 0 0 8 11 0 7 0 0 0 0 0 0 19 36 8 21 0 20 0 0 0 0 
0 0 15 51 16 14 13 9 4 1 2 8 0 0 8 0 16 4 0 0 16 18 17 2 12 33 1 5 0 0 1 16 0 17 0 7 0 0 0 14 4 0 0 0 23 13 43 0 
0 23 4 0 4 3 5 0 29 0 24 27 0 0 28 0 0 0 7 0 5 24 0 0 19 0 0 0 15 0 0 0 0 9 24 21 9 8 0 20 0 33 0 0 0 5 0 0 
0 11 0 17 21 13 5 0 16 10 34 0 35 22 0 22 18 0 49 35 17 2 12 2 1 21 0 18 0 0 0 0 0 0 18 23 15 22 0 0 13 7 0 30 8 0 27 0 
0 10 0 22 31 0 0 0 0 9 0 0 4 1 8 0 0 0 1 0 3 9 16 15 18 3 0 26 0 0 0 0 7 0 7 31 0 36 2 0 0 0 17 4 0 0 0 22 
0 0 40 0 0 1 10 40 0 0 0 0 12 19 0 19 0 0 0 0 0 0 0 21 12 0 3 0 9 0 0 0 14 0 19 0 0 6 6 0 27 1 13 0 0 11 39 0 
16 0 45 0 11 0 8 1 4 1 1 7 15 22 17 7 0 0 11 21 0 25 5 3 0 0 3 9 0 8 0 0 1 0 0 53 0 15 3 21 1 0 0 0 36 5 23 45 
19 32 33 43 0 2 16 0 0 0 14 46 0 0 11 0 16 24 5 5 29 7 0 0 15 21 19 21 0 0 10 7 1 62 0 12 0 18 0 0 23 45 0 1 13 34 86 16 
0 10 13 0 41 0 2 0 2 0 3 38 18 14 0 27 3 16 0 0 21 0 5 0 8 0 13 32 23 14 10 21 0 16 0 0 0 6 14 40 0 0 2 35 2 9 42 0 
3 9 40 0 5 40 18 18 0 18 0 0 0 0 0 0 21 0 0 0 21 30 0 1 13 1 7 0 8 11 9 8 0 0 3 2 0 34 29 11 2 21 53 0 2 0 0 0 
0 21 0 19 15 0 0 27 3 8 3 3 0 20 0 0 3 8 0 15 0 16 0 0 0 0 0 0 13 23 0 0 0 0 14 0 16 0 0 1 0 16 0 0 0 13 0 13 
0 3 8 16 18 5 9 28 0 0 6 14 8 1 52 0 34 0 0 8 21 18 18 2 21 0 0 16 4 0 0 0 11 11 18 26 23 0 30 12 4 40 0 0 52 26 0 25 
