48 27
0 76 56 0 0 32 29 0 7 0 2 26 17 1 17 24 0 0 49 0 0 0 3 0 41 0 18 0 16 0 16 0 11 31 16 0 18 32 37 0 17 0 0 28 0 27 0 25 
43 14 23 21 40 5 23 0 8 1 5 32 5 7 0 0 6 0 0 17 7 0 22 0 20 0 0 3 12 34 16 0 3 0 3 0 0 5 0 21 0 0 0 75 2 0 0 13 
0 0 0 31 91 71 0 0 7 13 4 0 0 0 6 14 56 6 0 0 0 7 25 14 0 0 0 22 1 0 0 0 46 13 41 31 0 7 0 34 36 0 0 0 28 0 9 0 
0 23 0 0 39 0 0 10 0 22 13 0 5 20 0 19 31 0 12 12 0 0 18 0 11 0 15 0 0 22 0 18 0 0 0 11 0 0 0 0 0 0 21 11 0 0 23 31 
0 0 0 0 0 1 35 0 41 3 0 0 45 5 0 14 0 0 21 15 0 0 0 0 6 0 12 11 0 1 1 0 0 16 0 23 0 0 9 5 22 37 11 1 31 0 11 0 
44 48 49 0 39 1 4 16 0 60 2 5 4 0 31 8 0 4 30 52 0 0 3 8 0 0 24 29 8 13 16 15 33 0 0 26 8 25 2 8 2 3 6 77 22 0 27 14 
0 0 13 59 0 4 35 0 0 27 20 0 0 22 12 0 0 0 1 22 0 22 20 20 16 9 5 0 13 29 20 5 13 11 27 37 27 6 13 0 21 11 17 16 11 0 32 6 
13 7 14 3 4 15 0 0 10 14 29 0 12 0 7 21 22 1 0 0 6 23 13 0 0 15 0 0 0 0 48 4 2 9 0 0 21 3 0 0 3 0 21 27 42 3 0 0 
0 0 0 4 34 25 8 0 58 9 0 0 5 22 6 2 6 0 0 0 23 1 14 0 16 0 0 14 0 2 25 4 0 0 0 25 12 0 4 0 0 9 0 11 0 0 0 11 
18 32 0 0 0 0 13 0 0 36 2 1 7 0 3 0 0 64 21 0 0 4 0 0 0 12 0 0 0 0 0 0 0 18 0 0 0 22 0 0 0 0 0 0 7 8 29 24 
3 3 38 15 0 4 0 0 0 36 35 6 8 12 10 26 5 10 0 0 18 14 0 0 9 12 0 1 1 0 14 0 0 13 24 35 0 17 4 0 38 0 0 0 34 43 0 0 
41 35 8 24 25 0 2 0 0 0 7 1 0 22 0 8 0 29 25 0 0 3 0 2 0 10 0 24 2 0 0 39 6 4 0 22 15 0 0 0 9 41 41 0 0 0 29 0 
0 16 7 4 0 1 4 0 4 35 3 0 0 0 0 7 14 30 9 17 72 29 7 0 0 14 0 31 0 16 15 9 2 25 2 13 7 10 9 11 4 0 0 30 31 83 0 0 
5 3 13 0 0 16 0 1 0 83 0 2 0 6 0 0 0 31 0 21 15 0 0 0 8 0 14 0 14 0 0 24 8 4 0 25 0 24 29 1 62 0 0 0 27 0 0 0 
28 0 7 58 42 0 36 0 36 53 0 0 13 8 28 0 3 0 15 11 0 0 0 7 22 11 0 0 38 0 15 7 28 9 5 3 0 5 10 21 0 6 67 11 2 39 40 13 
37 0 44 9 0 0 0 0 39 5 0 14 0 4 0 0 2 16 28 24 8 0 1 12 5 15 0 0 4 0 0 0 0 18 26 10 0 0 0 0 9 24 0 0 0 0 32 0 
0 0 34 23 7 15 25 0 0 0 53 0 15 12 0 6 24 0 11 15 4 6 6 7 22 10 7 13 12 0 0 15 30 0 8 2 0 13 4 0 9 0 0 33 10 6 0 32 
10 0 0 21 7 0 6 14 10 9 16 4 6 0 8 0 3 0 17 4 10 0 20 10 7 0 26 5 0 9 0 6 18 30 0 12 10 0 0 0 5 9 2 0 0 0 0 0 
0 34 10 0 0 0 9 39 9 0 0 0 1 0 4 9 0 5 0 17 20 0 0 0 0 2 32 12 20 3 14 5 0 0 0 34 0 29 0 13 34 0 15 0 14 2 45 0 
0 0 5 0 32 32 44 2 0 0 21 2 12 0 8 19 0 19 6 23 27 2 5 3 6 0 0 0 9 0 7 31 0 1 15 2 41 7 23 34 4 10 35 0 4 6 0 10 
0 3 59 2 46 2 19 2 12 13 31 22 0 0 0 1 2 0 0 10 0 8 20 12 1 0 0 29 18 8 0 4 15 62 0 0 34 0 0 0 11 0 0 12 0 0 0 15 
24 0 0 0 14 0 0 18 26 0 22 2 23 0 4 33 20 0 20 3 9 2 0 12 0 20 24 3 0 9 0 13 0 0 26 5 19 1 40 0 6 0 0 43 0 30 2 0 
35 48 0 29 12 0 8 12 14 39 32 3 5 7 4 7 12 8 22 19 11 26 7 25 4 4 11 17 0 29 0 14 12 14 0 35 10 10 0 0 25 38 11 0 24 12 19 0 
2 40 13 0 17 0 0 13 0 0 9 20 0 20 1 4 13 8 12 0 13 5 16 2 0 11 12 0 0 21 7 15 0 7 17 34 9 8 16 0 2 0 0 0 0 9 0 17 
21 43 0 0 0 0 0 19 0 0 0 0 0 0 0 12 22 15 27 0 0 21 22 0 3 0 16 50 10 12 17 0 6 0 0 3 9 0 8 6 9 11 25 16 43 6 6 0 
0 0 9 13 34 0 33 0 15 24 31 7 23 9 0 0 13 0 21 31 0 3 27 1 22 0 0 6 0 0 3 0 1 3 23 16 0 0 34 50 0 30 6 1 0 0 0 0 
14 43 0 1 0 0 0 4 0 0 20 2 22 17 10 15 0 0 0 0 7 6 26 10 11 26 4 0 22 29 19 5 24 0 20 22 2 12 32 3 23 0 14 1 0 4 33 0 
