48 27
21 40 80 10 0 39 9 5 6 61 0 0 59 45 25 36 11 0 38 6 0 19 22 21 0 0 0 25 0 34 17 0 23 0 0 0 0 36 0 0 0 40 0 0 24 0 34 0 
83 26 0 0 9 0 0 0 34 8 20 0 34 9 0 0 0 17 16 0 20 20 24 1 22 0 0 8 16 10 13 12 14 0 22 0 0 0 9 0 13 62 20 12 32 0 22 27 
10 0 49 0 0 0 34 0 0 36 4 0 12 0 19 0 6 7 14 25 0 24 12 2 7 21 24 1 20 4 0 0 18 0 6 0 15 17 25 0 50 0 4 20 0 24 2 0 
0 34 70 0 0 0 0 24 11 3 0 23 48 8 12 0 15 0 17 2 19 24 0 8 19 0 4 0 14 0 6 6 2 0 21 0 24 0 0 27 0 15 40 0 0 24 0 0 
0 51 76 0 0 0 5 0 0 0 28 45 2 16 19 0 0 7 4 1 1 0 13 0 8 19 2 11 20 0 0 30 11 31 7 0 25 6 0 0 0 15 0 0 0 14 3 20 
68 0 15 0 0 30 74 0 36 34 19 0 0 18 1 0 0 0 0 0 0 0 20 10 0 0 5 14 0 3 0 8 3 7 0 30 0 42 6 35 20 14 22 0 36 0 0 9 
32 14 37 5 5 0 96 0 0 10 16 0 7 5 12 13 25 13 0 10 0 33 0 0 18 0 21 0 4 0 0 31 85 18 0 14 0 53 19 70 21 24 1 11 0 18 15 20 
0 0 36 0 23 0 3 7 0 0 33 0 6 0 7 7 0 7 11 0 6 7 0 18 0 17 4 18 12 0 3 0 0 16 9 3 0 6 39 2 29 2 7 2 0 0 9 37 
45 0 0 0 0 1 1 0 19 0 24 13 0 8 0 5 25 8 4 0 26 0 0 0 10 12 21 28 2 11 0 3 0 6 3 0 15 10 30 0 0 0 26 30 0 45 26 23 
0 8 0 4 37 0 12 0 16 19 0 0 5 0 0 0 39 19 29 12 0 18 0 0 7 5 18 8 19 13 0 0 16 10 0 12 26 28 0 0 0 12 0 49 23 8 0 0 
0 7 40 17 0 0 31 0 7 11 29 0 0 10 0 0 0 25 24 0 45 22 3 0 0 11 0 0 27 15 10 21 0 0 0 0 0 33 3 9 5 17 40 20 26 2 0 6 
0 0 6 0 0 8 0 0 15 9 4 0 0 25 0 11 13 0 11 8 26 0 7 19 0 18 0 4 0 35 8 0 0 0 2 0 18 0 8 0 15 28 45 2 0 27 10 14 
0 54 2 19 40 0 32 0 13 0 0 0 0 0 4 0 15 2 52 0 19 13 0 0 31 0 8 0 0 10 0 0 0 8 1 4 0 0 35 0 22 37 0 0 3 0 0 0 
0 0 38 0 30 0 16 0 0 0 7 5 8 31 4 13 9 0 3 0 26 0 1 21 0 18 0 0 0 0 16 0 0 20 0 0 0 14 0 8 12 3 0 0 4 0 0 8 
34 0 40 38 60 28 8 28 0 17 27 8 13 11 0 0 19 8 7 32 0 35 0 26 1 15 6 0 3 9 0 0 22 11 10 0 31 27 0 23 5 0 22 41 23 9 43 0 
6 11 7 10 0 0 35 6 0 0 47 5 0 1 0 0 31 7 2 0 0 3 0 3 0 0 0 6 0 0 0 0 8 0 0 0 0 0 32 0 27 0 0 0 0 18 0 37 
21 0 1 4 3 0 0 11 0 44 17 0 4 0 4 0 4 0 33 0 0 0 0 7 13 0 2 17 19 0 22 0 3 5 0 25 0 10 0 0 0 27 14 51 0 13 9 0 
0 2 1 0 0 0 0 0 13 18 0 16 0 6 0 17 13 8 0 5 3 13 0 24 0 0 0 34 14 0 12 0 4 4 11 10 4 25 0 0 0 0 12 0 0 11 0 24 
0 0 8 29 0 0 31 0 13 18 7 0 0 100 7 4 0 4 5 0 0 14 18 12 0 13 3 14 0 16 28 1 0 0 0 0 2 79 40 0 0 1 13 0 31 0 0 44 
0 34 0 40 0 0 25 18 32 0 15 0 0 0 0 19 0 11 0 0 9 0 0 0 0 19 0 0 9 0 0 23 0 7 0 34 11 41 8 0 29 12 5 3 0 0 8 3 
20 0 34 5 16 0 18 0 4 25 7 3 0 12 4 0 12 0 13 0 33 8 0 0 0 32 4 0 12 8 0 18 4 0 11 33 11 28 0 2 5 7 0 0 0 0 48 8 
25 2 32 2 10 0 0 23 0 7 9 3 0 0 32 0 1 15 5 1 11 0 0 4 0 17 0 19 0 0 7 0 5 0 0 12 7 0 14 0 15 1 0 27 31 5 2 3 
6 21 86 34 41 26 1 12 3 0 16 7 9 23 17 4 40 0 29 17 0 0 0 8 0 11 0 0 26 15 0 49 37 21 0 0 0 34 0 0 0 21 28 0 0 41 0 14 
0 12 0 41 0 0 16 0 0 0 4 3 0 12 19 0 0 0 14 19 0 0 0 21 0 0 0 14 5 10 0 0 14 0 0 0 17 0 52 0 17 18 0 21 0 0 3 0 
0 0 16 18 2 35 14 0 25 36 19 36 21 10 7 0 0 7 4 8 0 27 0 2 50 7 4 17 34 23 0 33 0 35 0 1 0 3 8 0 43 0 0 0 4 42 23 56 
39 2 43 8 0 24 5 0 0 1 6 0 19 0 20 0 9 0 18 28 0 19 0 0 0 1 3 2 0 3 0 55 0 0 0 11 0 0 0 0 20 0 0 0 44 47 5 4 
6 1 0 33 37 0 3 0 30 8 21 0 0 0 0 42 22 0 5 24 13 0 0 12 0 0 24 0 0 9 2 6 16 19 3 17 5 13 0 23 22 37 0 0 29 13 0 0 
