48 27
0 0 23 0 38 5 16 5 0 11 30 0 5 0 12 0 31 0 0 32 8 0 0 0 29 0 29 36 10 0 0 0 0 7 0 0 0 0 16 0 30 0 11 16 0 30 27 8 
18 29 0 17 3 0 0 0 32 11 106 21 1 0 7 29 73 28 15 5 21 13 4 18 8 4 17 2 0 14 11 0 16 23 5 11 12 10 36 9 39 82 48 0 11 28 13 25 
0 23 3 1 19 17 0 0 18 0 55 0 0 0 10 0 0 0 0 33 1 1 8 0 33 0 21 1 0 30 0 0 0 0 8 0 0 23 0 0 8 0 24 0 0 0 14 10 
2 5 10 2 9 1 12 8 12 0 12 0 20 11 51 0 0 16 5 0 0 11 1 0 10 0 0 0 22 0 0 12 20 18 32 23 0 0 0 0 34 0 34 11 0 39 9 33 
40 21 0 0 0 0 0 0 0 0 0 3 12 0 0 12 27 0 0 19 4 0 5 0 1 0 21 4 0 15 10 13 13 0 0 3 0 8 8 0 39 0 15 27 17 8 19 25 
28 2 38 0 40 0 0 0 0 27 0 0 0 0 0 0 0 9 0 5 15 0 21 0 4 10 5 2 40 2 0 0 2 10 10 15 41 17 0 3 50 0 5 10 40 0 14 0 
0 6 45 0 0 36 7 0 0 8 21 0 13 28 31 0 0 0 0 0 0 0 0 0 0 1 0 0 20 0 0 1 0 7 0 0 0 2 3 8 0 27 5 0 0 0 3 45 
0 2 0 16 40 15 1 0 0 35 0 10 9 22 28 4 1 0 5 0 2 0 13 0 9 0 0 0 0 0 3 1 0 8 0 0 8 5 16 2 4 2 28 0 4 0 4 0 
39 3 0 18 0 19 4 0 0 8 4 19 0 9 4 2 16 0 27 0 8 13 16 0 29 0 0 0 14 6 0 7 0 32 0 0 45 0 7 32 0 0 0 0 0 0 38 4 
42 0 9 21 24 9 6 4 0 83 0 0 0 0 28 9 0 0 0 0 0 0 25 2 4 14 0 0 40 0 0 0 10 16 0 0 10 15 5 2 0 9 24 37 19 9 10 14 
0 37 0 0 0 0 0 0 0 14 41 0 10 3 12 18 12 0 0 6 8 0 15 0 0 0 0 5 0 0 0 0 0 0 0 7 0 0 0 3 47 0 12 0 0 59 9 25 
0 41 0 0 35 31 29 10 10 15 0 24 33 24 29 4 0 0 0 5 0 0 0 37 11 18 13 0 9 0 0 14 2 0 0 79 55 9 8 3 3 18 47 28 0 13 0 0 
65 14 19 6 7 0 0 7 41 36 0 0 12 9 11 0 0 11 44 4 0 19 0 11 17 14 8 0 11 11 30 18 12 6 0 17 41 0 0 10 16 24 45 8 33 7 2 0 
36 6 4 0 0 5 34 6 8 36 2 0 0 0 0 0 24 0 17 22 31 2 7 0 20 0 9 0 0 25 0 0 2 0 0 17 12 0 0 3 58 22 66 0 20 20 0 21 
0 0 0 0 0 0 0 0 0 8 11 0 23 3 18 0 3 0 4 7 0 19 0 1 11 0 7 0 0 8 0 0 0 2 20 23 0 18 18 13 0 0 11 45 0 0 0 0 
0 24 5 6 11 0 6 13 1 0 70 11 8 0 0 0 0 26 0 10 4 9 3 5 12 0 0 3 0 0 14 9 31 0 25 25 0 0 15 8 30 0 9 26 25 14 0 28 
0 0 40 0 19 41 10 38 33 9 11 8 3 11 5 17 17 13 6 0 0 9 5 18 16 11 28 8 0 4 0 0 17 2 9 6 32 11 12 24 10 48 40 0 37 0 5 0 
14 0 8 9 0 37 24 0 35 39 37 0 9 9 14 5 7 3 0 0 5 0 0 21 0 0 9 25 0 0 32 0 30 3 25 9 5 0 0 0 30 0 53 57 35 0 14 0 
0 0 0 7 15 5 0 0 0 0 39 19 51 0 8 0 0 30 10 0 0 2 0 0 10 0 0 11 0 0 6 0 0 12 0 7 0 52 15 0 0 9 7 16 0 0 13 30 
30 52 0 0 16 0 18 28 0 0 0 0 11 16 0 11 26 0 19 0 0 0 0 10 24 0 0 16 0 8 12 8 6 28 0 46 30 4 45 5 0 0 0 11 11 14 28 0 
25 0 0 41 22 4 0 0 18 1 0 3 5 0 14 31 18 3 0 6 15 15 4 8 0 25 16 20 20 0 3 24 6 25 0 6 0 19 7 7 24 0 38 8 52 7 24 16 
23 6 0 0 0 0 0 16 38 0 5 7 0 5 0 0 14 8 5 0 10 0 10 0 0 8 0 0 11 0 0 0 14 0 27 1 0 1 0 11 0 0 5 43 0 37 3 0 
0 0 12 0 21 4 6 0 10 4 0 0 0 42 0 1 16 0 10 13 0 0 41 0 8 12 0 25 14 12 0 1 33 0 0 0 4 17 0 0 0 12 0 30 3 0 24 0 
0 0 0 16 3 23 0 2 0 0 0 0 30 33 3 13 0 0 27 0 0 15 10 0 0 14 0 0 0 0 17 1 0 0 0 2 15 5 0 0 0 17 0 8 0 27 24 17 
0 0 19 0 24 4 0 0 12 2 41 4 0 0 0 34 16 0 0 0 6 11 13 0 0 5 0 17 16 5 19 1 17 14 2 10 0 10 0 0 30 0 0 6 9 20 26 10 
0 31 22 32 13 54 27 13 13 0 50 16 7 0 13 0 10 13 20 0 22 0 16 0 3 0 12 6 1 5 0 0 2 21 22 28 0 27 0 21 81 19 11 2 2 0 0 5 
2 2 0 42 0 6 14 33 55 0 0 15 14 0 3 10 11 0 0 4 13 21 0 14 0 9 0 23 62 0 5 0 19 0 32 29 0 20 0 25 1 22 47 9 3 0 27 0 
