48 27
0 0 46 7 0 9 38 26 0 9 32 24 5 0 22 0 7 0 24 0 29 14 30 4 0 0 2 4 2 22 17 3 0 0 7 14 0 4 0 17 22 0 5 0 34 7 0 10 
23 0 0 0 0 13 2 18 3 2 2 35 0 23 1 12 0 0 1 10 3 34 14 21 0 0 13 26 17 9 0 11 0 0 0 1 11 14 46 10 0 0 3 0 0 24 4 0 
24 114 0 13 0 28 13 0 18 10 12 32 21 3 10 14 1 55 20 21 25 25 14 21 13 14 17 10 5 0 19 0 0 28 0 6 22 36 0 13 14 6 6 0 27 36 20 0 
32 0 0 12 12 1 12 0 3 0 0 20 3 14 0 3 0 0 2 0 0 0 19 8 0 28 0 14 4 25 4 31 16 0 40 0 6 0 15 3 6 9 31 0 0 0 23 3 
1 8 19 11 14 12 0 0 16 16 0 0 0 13 1 2 2 21 31 0 3 0 0 0 12 24 24 3 0 0 0 0 0 24 0 0 0 0 0 21 0 0 3 0 14 30 52 0 
0 4 0 38 2 14 5 2 0 0 24 7 5 19 13 0 22 12 15 0 13 11 0 0 2 0 0 0 2 0 0 13 0 20 18 2 0 7 0 10 0 38 0 0 20 0 9 10 
2 14 30 0 0 3 0 0 0 29 22 0 6 0 0 19 0 0 1 0 0 17 19 9 0 0 0 0 0 0 44 0 31 0 0 0 0 22 5 0 3 0 37 0 0 38 0 0 
0 1 0 21 30 24 17 16 20 16 45 17 5 22 36 10 9 24 11 5 10 0 6 6 27 16 16 19 12 0 29 41 0 25 52 13 0 0 4 26 30 54 57 14 0 0 24 34 
32 6 50 0 43 34 14 6 22 0 0 13 8 14 15 0 0 0 11 24 29 21 2 16 18 0 9 14 9 8 0 0 6 0 0 0 0 9 1 24 32 4 47 29 0 2 0 43 
2 0 22 15 4 16 12 31 15 1 38 16 34 1 0 15 0 14 23 4 0 33 2 0 0 4 13 25 0 12 15 9 29 0 0 0 0 0 34 0 21 0 32 1 0 49 0 0 
0 12 1 6 3 0 0 0 0 32 13 37 5 25 21 0 18 11 18 0 0 0 0 13 0 0 0 0 0 0 0 0 0 0 25 21 20 0 0 30 0 0 0 1 0 0 0 0 
0 37 13 0 0 0 0 0 37 0 14 5 34 10 0 52 0 0 4 6 0 1 12 0 14 6 14 9 0 0 4 0 0 0 0 0 11 2 4 0 19 20 0 3 5 0 31 58 
0 9 0 0 26 0 41 0 8 23 5 11 6 5 42 0 49 5 0 16 0 0 0 0 4 0 1 23 4 0 25 0 23 0 7 30 35 18 3 0 0 12 0 6 0 2 12 42 
0 38 40 0 0 0 0 6 0 0 9 0 13 7 9 12 0 0 4 14 0 0 3 0 0 6 13 0 6 0 27 0 0 20 0 9 0 2 4 38 4 0 17 5 12 0 0 0 
35 0 0 10 27 13 6 19 0 0 0 43 12 10 3 0 0 0 12 0 9 4 0 0 17 16 3 12 16 14 0 27 0 0 11 2 0 12 8 8 0 58 0 18 5 0 32 0 
48 46 25 12 0 31 0 28 50 0 12 8 0 3 7 0 1 0 16 55 18 9 17 23 11 4 0 0 19 27 13 0 0 0 7 27 1 10 0 29 40 0 12 0 41 40 27 58 
0 34 0 0 0 2 43 2 0 0 0 19 17 0 0 14 1 5 0 0 8 17 19 0 0 0 0 0 14 6 0 15 0 0 0 30 0 0 17 4 11 0 5 0 4 2 40 7 
0 20 0 0 33 0 0 0 26 17 20 2 0 0 3 0 0 0 0 19 0 20 0 0 0 37 4 0 20 0 4 17 0 31 0 0 0 15 10 16 2 16 9 0 0 17 21 9 
21 23 0 4 0 0 2 17 10 20 0 0 27 44 14 0 0 7 0 51 0 13 0 9 5 0 13 10 0 20 9 0 15 0 5 1 46 9 2 2 3 16 18 0 95 2 14 15 
25 0 0 12 12 0 0 53 0 0 0 0 14 35 19 8 1 0 15 0 0 15 0 0 0 26 0 17 6 0 17 0 0 0 0 0 44 10 9 27 0 0 16 0 0 1 6 8 
18 12 0 26 29 3 0 3 4 0 0 17 0 10 0 30 0 0 29 0 0 0 30 0 0 0 0 9 12 12 10 19 0 20 30 0 0 0 0 0 3 0 0 0 7 0 31 25 
3 0 23 10 0 0 11 0 0 0 17 8 6 0 6 0 16 11 14 9 13 0 0 0 7 5 23 0 13 0 16 20 17 9 11 9 0 0 2 0 2 1 0 14 0 0 9 8 
19 29 16 26 18 0 0 0 0 0 22 2 0 8 28 5 5 0 17 0 0 20 0 0 0 0 7 0 0 26 16 13 6 0 7 43 11 0 0 0 16 0 21 4 0 0 11 11 
0 0 0 2 39 0 0 0 0 6 0 11 4 19 0 32 4 2 0 4 6 12 0 21 2 1 18 0 0 15 0 14 0 0 0 0 8 0 23 0 0 0 38 0 38 0 22 0 
3 29 49 41 26 0 17 0 10 0 19 10 32 10 0 29 0 0 56 11 8 9 0 11 0 0 0 0 17 0 20 0 13 18 0 8 1 0 42 0 1 8 0 2 9 13 0 46 
22 0 1 22 0 33 1 8 0 0 25 2 0 12 4 1 0 16 19 0 0 0 7 0 0 0 4 0 0 0 0 50 8 0 11 0 0 0 51 57 49 0 0 0 0 0 21 0 
33 24 13 0 0 0 24 0 28 1 17 4 0 16 0 44 15 10 21 31 11 17 5 0 18 22 8 6 0 18 0 19 0 46 0 25 28 0 9 24 0 0 0 4 0 0 13 0 
