48 27
9 10 0 0 18 65 0 14 27 0 9 7 23 27 37 25 6 2 17 22 26 3 17 6 12 0 4 0 14 35 0 45 10 0 0 5 0 0 2 34 4 0 35 23 22 26 17 9 
0 35 37 43 22 42 0 0 11 0 0 0 10 45 6 26 0 4 8 20 7 19 0 15 22 0 30 17 10 14 0 10 2 25 2 0 5 6 48 0 1 37 0 6 17 0 21 25 
11 0 0 19 0 0 5 4 0 0 11 20 9 30 19 0 0 20 15 0 0 8 18 0 0 0 0 10 0 4 13 0 16 0 0 0 0 10 0 0 5 0 20 43 0 19 0 26 
47 13 0 31 11 2 18 0 0 0 0 0 0 0 4 23 0 0 0 0 0 0 15 16 0 0 0 12 3 18 0 5 0 19 28 0 0 3 0 11 0 0 0 0 0 0 0 30 
15 0 0 36 6 12 20 15 0 9 18 0 36 7 1 0 0 10 0 7 27 11 19 0 11 0 4 33 0 4 26 4 11 4 7 0 0 0 1 81 11 18 0 1 1 33 0 28 
0 0 0 41 10 68 0 0 6 0 0 25 0 26 11 0 0 0 40 5 0 10 0 27 2 16 20 0 3 24 0 3 2 0 2 30 40 0 5 11 17 0 0 21 0 7 0 8 
23 12 22 21 19 4 0 2 18 10 16 10 9 5 6 23 6 0 6 0 6 33 14 55 67 14 0 22 13 9 13 0 11 2 15 2 6 17 64 3 19 12 5 0 0 42 16 6 
27 0 0 19 0 0 13 0 25 0 22 8 14 5 0 28 0 5 5 4 0 19 11 4 0 36 0 22 10 7 0 15 25 25 17 32 7 0 11 14 0 5 34 13 8 0 0 0 
0 0 23 21 0 0 5 0 0 0 13 0 0 0 0 14 7 14 13 0 3 0 6 25 28 23 0 18 0 0 0 8 11 10 0 0 12 0 0 9 0 4 0 21 0 14 0 0 
10 17 0 9 0 0 0 19 8 0 0 33 0 0 1 6 10 0 15 0 0 6 0 0 0 0 23 4 7 0 3 0 0 0 0 59 0 5 35 5 5 0 0 0 13 0 0 0 
0 0 0 4 2 0 0 0 0 6 0 0 0 12 31 4 12 3 0 0 0 10 0 0 8 19 0 16 0 0 0 10 0 0 0 0 31 11 0 6 0 0 0 2 0 0 13 33 
2 0 10 6 30 0 0 15 6 1 8 15 4 8 0 0 0 0 0 17 14 0 21 0 23 2 0 16 0 9 0 2 0 0 30 0 0 35 0 0 0 0 0 12 0 0 0 23 
51 3 42 3 21 0 33 5 15 0 56 0 6 0 0 25 9 0 6 0 7 17 8 26 18 25 6 0 1 30 0 15 8 11 13 0 2 0 0 29 12 5 0 2 42 0 21 50 
1 33 38 31 12 5 5 0 0 13 6 0 0 2 11 0 0 0 0 4 0 0 0 20 0 2 0 11 0 4 5 0 0 0 33 5 0 0 3 0 38 35 15 0 0 36 0 0 
0 7 0 0 2 0 0 15 7 0 0 6 36 27 10 0 14 23 0 3 0 14 0 17 0 14 30 0 0 0 14 2 0 0 9 12 0 0 26 11 32 0 0 0 0 1 0 16 
24 0 58 0 0 0 11 15 0 0 0 0 2 0 0 0 7 0 0 0 0 11 0 0 24 21 0 0 11 40 0 0 0 0 0 6 0 35 0 11 0 0 1 15 8 5 21 0 
21 47 0 16 9 41 4 0 0 6 41 16 11 0 0 5 0 0 9 13 25 20 0 12 0 0 0 0 40 12 11 0 0 12 13 3 0 0 15 45 16 40 36 14 17 27 72 28 
0 8 0 21 0 0 0 5 58 0 0 4 5 0 0 29 2 16 7 1 0 51 25 15 8 7 0 0 11 6 0 1 9 16 2 0 8 9 13 9 0 11 11 20 31 0 0 25 
5 7 6 12 18 0 0 0 27 24 6 0 6 17 0 27 0 0 4 6 5 0 26 2 0 0 0 2 18 2 21 0 18 24 0 25 13 0 0 0 0 2 7 26 2 22 0 16 
23 19 44 40 69 15 22 25 0 14 0 37 0 19 0 0 38 5 3 7 11 0 17 1 23 6 3 10 3 0 0 6 15 10 30 0 0 26 0 0 18 25 40 79 3 14 0 23 
33 13 0 14 1 19 20 0 0 38 35 0 14 18 4 0 11 13 27 4 0 0 6 0 0 14 0 0 12 23 1 39 0 33 0 43 17 0 4 15 0 0 4 22 0 62 0 57 
2 0 3 13 1 23 25 0 21 0 0 0 11 0 14 28 0 15 0 14 13 18 5 11 15 0 0 0 0 0 4 0 22 13 19 0 0 9 19 41 20 0 10 0 0 6 0 0 
14 0 27 2 55 10 0 0 20 0 34 14 35 8 0 46 12 40 10 0 0 0 0 0 0 17 19 0 20 31 0 3 17 19 16 0 0 0 16 0 17 12 16 0 13 3 0 6 
32 24 0 6 2 63 18 13 18 9 36 0 16 37 0 0 0 0 17 41 8 0 16 13 0 0 18 0 15 0 0 0 2 12 18 0 0 0 0 0 27 0 0 22 24 40 1 17 
26 0 29 6 0 0 0 0 18 14 19 0 13 8 23 12 14 0 9 23 0 8 0 6 2 7 36 13 0 0 41 1 7 16 0 0 14 0 8 8 30 3 0 2 0 2 8 2 
42 44 0 32 38 24 18 12 36 0 51 0 15 6 20 34 0 0 1 20 0 0 5 21 17 0 11 26 0 0 4 28 0 6 17 0 21 19 42 0 51 10 42 5 21 0 0 0 
0 0 0 31 0 25 0 24 0 0 0 0 0 18 5 0 11 0 0 3 0 0 2 54 2 0 0 27 3 25 1 33 0 31 32 0 0 0 5 5 0 0 0 0 0 29 23 32 
