48 27
0 32 36 44 39 0 0 0 2 0 2 32 2 0 2 12 25 0 6 0 4 0 0 15 11 23 0 17 17 11 0 0 7 45 0 11 0 24 36 0 0 8 0 39 17 29 0 74 
0 0 0 0 30 4 0 0 5 0 17 23 0 5 0 5 0 2 33 4 6 13 0 9 0 8 0 27 25 1 9 0 0 12 69 17 0 14 9 27 0 0 0 0 0 14 0 0 
31 0 38 71 29 0 0 15 39 9 0 0 27 0 0 8 3 0 17 15 0 15 0 0 0 0 0 18 0 34 5 31 9 32 0 4 15 0 6 2 18 0 0 19 25 5 0 2 
3 0 10 0 0 0 14 0 8 38 0 0 21 0 38 0 12 33 1 19 13 19 25 0 18 13 0 2 18 13 0 21 9 13 0 21 0 18 3 1 5 27 13 0 7 11 0 15 
38 0 5 10 44 20 10 26 0 17 4 4 24 10 26 8 14 3 0 0 6 0 0 0 8 1 1 0 21 0 0 0 0 16 29 1 23 11 72 0 21 0 0 0 8 0 0 0 
0 11 2 0 19 6 16 0 0 17 27 17 0 0 32 7 0 6 0 16 3 6 20 0 2 10 2 1 1 0 0 0 0 20 0 25 14 27 18 12 11 0 0 0 21 0 1 2 
38 18 0 2 0 5 19 18 3 33 18 12 0 5 10 0 26 16 17 0 0 2 26 12 2 19 0 6 6 13 0 20 0 0 6 27 0 0 41 0 0 0 19 20 0 10 6 15 
16 22 0 5 3 42 38 0 5 18 14 51 20 15 0 0 0 0 9 0 9 0 0 22 14 8 0 23 0 15 12 0 5 8 7 8 28 26 2 17 0 23 12 0 23 0 46 72 
13 5 0 4 8 0 12 6 33 31 1 28 45 15 5 0 8 10 0 21 0 3 21 15 0 30 0 0 15 3 16 0 3 0 33 0 1 5 0 0 10 24 28 21 0 33 14 0 
0 0 6 0 0 0 21 12 27 3 14 0 0 13 0 30 11 1 0 12 2 0 0 15 0 5 11 32 14 16 0 0 2 0 12 0 4 60 12 8 6 0 14 0 8 0 18 0 
30 4 5 12 30 65 0 2 10 1 2 12 0 19 0 2 3 0 0 0 6 10 22 9 14 11 18 11 7 4 3 0 19 37 1 30 11 33 0 34 11 0 0 0 5 2 0 0 
0 0 0 2 37 0 0 0 54 40 9 0 0 29 0 0 0 30 0 0 0 6 0 0 0 4 0 13 0 0 21 1 7 0 0 9 11 0 0 0 45 1 29 0 0 5 0 30 
5 15 0 38 43 17 0 14 4 23 12 0 1 6 12 66 40 13 9 0 2 0 4 2 60 0 1 9 18 0 0 1 9 4 38 23 0 24 9 33 16 24 0 9 37 19 61 44 
2 4 0 14 0 5 5 62 15 14 0 0 0 11 11 11 23 1 0 0 0 0 0 31 0 13 1 5 13 16 7 8 0 2 0 0 29 5 0 0 57 4 0 0 2 12 0 0 
12 1 0 6 0 0 10 18 8 10 28 0 0 29 12 2 0 0 23 0 0 4 18 0 0 31 0 13 0 0 0 2 0 0 0 10 0 0 66 0 8 30 0 2 10 5 5 0 
19 7 44 0 16 12 12 0 7 0 2 8 7 14 5 0 0 0 17 32 7 0 0 17 4 0 7 0 0 0 0 10 0 11 0 5 0 5 0 0 4 0 0 5 6 12 51 13 
2 25 1 0 20 0 0 3 4 2 0 0 4 0 0 0 8 4 17 21 0 0 12 20 0 0 0 1 1 0 0 29 7 34 19 11 0 0 0 0 4 5 0 20 18 5 0 2 
8 21 0 0 15 41 0 5 8 11 0 7 46 0 8 0 2 0 26 8 11 14 21 7 0 0 0 8 10 0 0 0 0 13 0 9 0 19 26 23 0 0 22 1 1 1 28 1 
16 1 26 1 0 15 0 0 0 7 17 0 4 0 0 0 2 0 0 0 24 0 0 11 12 0 3 17 2 0 10 0 32 9 0 0 0 9 8 0 0 0 9 16 0 0 16 0 
32 0 14 8 14 0 27 5 10 7 0 0 31 2 3 18 7 0 3 1 4 0 28 0 0 0 0 0 8 0 0 9 50 40 0 5 5 0 0 4 0 8 35 31 0 21 39 40 
0 0 0 0 2 1 23 18 7 0 9 0 5 0 0 0 20 0 5 4 0 0 0 0 22 4 0 0 10 19 0 0 0 16 10 13 7 1 0 0 0 0 0 5 0 0 0 0 
18 0 37 0 9 11 42 34 0 5 8 13 1 33 0 10 40 0 0 0 0 38 0 0 18 0 0 0 18 0 0 29 26 6 0 0 0 0 5 9 0 30 1 0 9 0 0 45 
0 0 0 0 20 24 0 0 10 8 0 0 0 14 17 20 0 0 0 0 23 0 0 0 0 0 6 0 11 24 2 13 11 19 2 20 0 0 34 11 0 0 34 0 17 0 0 0 
0 63 0 0 16 0 0 35 0 14 14 24 32 8 5 13 15 24 24 5 22 23 0 19 12 7 1 0 0 6 0 15 6 13 7 0 6 8 11 22 2 11 35 0 68 0 14 23 
0 35 0 9 19 70 22 10 18 1 26 0 9 7 43 18 7 3 10 12 0 0 4 19 31 2 14 18 21 1 2 12 1 0 20 10 30 32 33 17 10 36 0 0 3 23 0 0 
30 20 0 10 0 1 0 4 36 16 26 12 0 0 3 0 0 0 25 20 2 0 21 10 12 0 0 0 1 0 0 18 24 0 0 9 21 0 2 24 19 0 0 18 0 0 36 0 
47 9 14 6 43 0 17 39 0 6 9 0 0 12 0 24 16 0 13 9 4 2 0 4 12 6 0 0 37 24 2 43 29 11 0 0 44 0 8 24 24 5 0 18 11 27 39 3 
