48 27
34 0 26 43 11 39 18 14 8 3 0 0 28 17 0 24 2 16 0 21 0 16 0 18 0 24 28 24 0 16 17 0 0 1 63 9 33 0 18 1 49 9 0 0 0 5 0 19 
66 0 0 0 0 0 0 23 0 0 0 0 0 0 0 0 1 0 0 0 15 0 0 22 16 0 9 0 0 1 17 31 9 20 7 60 1 0 0 0 2 21 0 0 0 13 46 7 
0 0 0 0 7 2 0 0 24 21 12 0 35 11 19 0 0 7 50 11 0 0 15 0 0 0 0 0 0 0 18 12 20 6 1 29 1 19 0 6 0 0 8 0 24 0 0 29 
7 0 0 2 21 8 0 7 0 29 38 15 0 2 0 6 0 0 7 0 0 6 7 0 0 24 0 21 0 0 0 13 0 0 1 5 16 0 0 29 0 44 10 0 13 2 0 2 
0 6 0 23 15 0 0 11 6 0 1 13 22 9 8 5 8 16 0 0 0 13 0 16 39 54 5 9 0 0 0 3 21 4 23 0 3 0 0 0 0 11 0 27 19 42 0 0 
32 0 7 2 46 19 17 5 12 0 18 23 0 0 13 7 0 18 13 35 3 20 29 15 7 15 0 3 28 7 38 0 9 0 21 11 0 34 44 4 21 3 40 0 37 12 0 33 
0 8 8 27 5 0 14 7 0 2 0 0 0 0 7 0 31 7 0 6 0 2 0 0 19 9 0 8 6 13 7 9 0 0 10 19 0 4 20 0 4 10 0 0 0 0 0 31 
3 0 27 73 0 0 4 0 0 0 10 32 0 8 62 3 0 9 4 0 5 13 0 20 0 11 10 14 0 9 7 12 8 0 9 1 26 7 8 25 8 9 0 28 2 76 33 0 
0 0 7 3 0 69 3 0 0 0 6 24 0 0 29 28 0 41 14 0 20 5 0 16 17 0 0 11 0 0 18 0 10 28 16 24 19 0 0 3 46 0 47 28 0 0 10 2 
40 16 0 0 7 0 0 7 0 7 0 5 10 0 7 0 18 7 0 0 30 0 16 14 0 14 0 0 0 0 15 0 0 0 27 0 12 0 14 3 49 25 10 0 1 9 0 0 
32 0 0 24 0 0 27 0 0 4 5 18 0 0 0 21 12 14 8 0 0 19 0 16 0 17 9 10 12 10 0 5 32 14 0 6 0 4 5 0 12 2 9 0 28 5 0 2 
1 1 36 10 0 61 44 31 18 0 0 0 1 0 3 0 26 0 12 0 0 0 7 1 0 0 19 29 0 12 25 2 0 5 7 9 14 2 14 0 3 31 13 27 28 0 0 0 
2 0 15 0 0 27 0 0 0 22 4 18 1 0 2 13 13 7 4 0 15 7 0 0 0 0 0 1 14 14 0 16 39 0 23 11 0 1 0 0 0 11 0 0 0 14 0 5 
13 0 12 13 0 65 30 0 0 0 98 57 24 27 9 35 1 15 12 0 0 0 4 7 35 0 5 0 2 16 0 15 7 23 33 27 24 4 3 0 2 10 12 21 20 0 36 42 
0 0 8 0 0 0 0 0 0 0 32 0 29 0 0 0 1 0 0 0 0 0 6 0 0 23 0 12 6 0 0 16 0 0 14 2 0 7 11 0 0 3 32 0 7 25 0 1 
38 0 10 0 6 0 44 13 0 23 30 15 0 0 16 23 1 0 11 24 23 17 0 0 4 18 0 9 9 10 16 9 18 15 13 21 12 3 24 14 9 2 3 0 0 33 0 34 
3 7 19 2 11 56 0 13 17 17 0 48 0 1 12 0 0 24 16 0 23 0 0 0 0 18 18 0 5 0 30 15 24 11 3 0 31 29 3 0 0 14 7 0 44 27 15 0 
0 0 18 39 7 10 49 0 0 0 15 7 0 38 0 0 14 0 0 0 14 8 17 10 4 30 13 6 0 2 10 30 9 10 0 0 0 0 0 17 10 0 54 12 12 0 33 23 
8 2 12 3 2 0 13 0 0 0 7 0 0 12 20 2 0 6 0 0 17 0 25 41 3 9 11 3 0 18 4 0 18 0 0 13 0 17 8 0 0 11 3 37 0 0 40 8 
0 0 0 28 0 3 0 7 27 9 0 6 27 0 12 0 0 0 14 0 12 50 0 0 5 2 7 5 6 5 7 38 8 8 0 27 15 20 1 0 3 9 0 0 0 24 0 28 
47 0 0 0 0 40 4 0 0 0 0 0 0 0 4 2 0 0 0 19 0 0 0 16 0 20 1 0 0 0 0 0 32 28 2 19 2 0 33 0 5 19 2 0 2 0 0 0 
0 0 5 3 0 57 4 0 0 15 32 1 0 0 0 0 0 0 8 1 0 0 18 0 0 14 2 14 28 0 0 0 0 20 24 21 0 0 3 29 0 12 5 4 0 0 0 3 
0 0 0 0 0 3 0 0 29 6 3 0 0 0 0 7 0 23 10 0 0 3 11 15 0 0 0 0 0 1 5 0 27 0 0 11 0 35 12 0 0 27 11 6 0 0 11 0 
0 27 6 32 0 0 18 54 0 21 2 0 0 0 0 0 19 1 21 0 6 4 5 22 0 0 6 0 27 1 24 29 0 13 0 41 0 35 31 0 19 0 0 0 0 19 22 0 
27 0 44 29 0 0 8 0 0 35 0 0 25 2 0 19 24 25 5 13 8 8 5 0 11 5 0 12 0 0 5 14 2 0 47 19 8 11 38 0 24 0 0 0 35 0 0 7 
22 16 0 0 65 0 10 61 1 42 3 29 8 30 20 0 0 0 26 0 8 0 22 16 59 11 25 2 11 2 27 0 31 5 11 28 16 0 16 0 9 3 0 9 5 33 2 0 
0 0 9 2 11 26 84 7 25 0 55 0 12 3 0 5 0 0 6 0 11 11 0 0 26 29 0 0 0 0 38 39 13 0 21 11 2 0 8 0 0 37 0 0 65 8 0 11 
