48 27
17 39 0 9 26 0 10 0 0 22 42 0 38 0 4 3 5 5 12 22 0 43 12 0 0 0 0 17 11 0 5 6 12 23 6 0 35 37 11 0 19 22 0 19 7 49 0 14 
0 0 0 14 0 2 6 9 20 0 26 0 14 4 0 18 0 5 3 9 0 24 0 1 21 0 14 31 32 0 15 11 0 0 0 18 0 0 0 0 12 0 29 18 0 21 0 12 
26 0 59 52 12 32 0 24 24 13 0 35 3 7 0 17 5 0 0 0 6 13 26 1 24 0 34 0 20 0 8 18 37 17 0 15 20 46 30 0 38 0 7 7 41 8 46 28 
10 16 0 0 3 1 10 0 0 0 0 2 4 3 0 3 28 0 0 0 15 2 4 0 0 15 21 0 10 10 0 13 18 22 41 0 0 10 10 13 0 10 5 0 10 12 0 74 
0 13 10 38 92 29 0 21 39 33 0 41 10 25 22 19 12 4 0 0 0 4 18 0 0 0 0 5 25 0 2 8 24 5 19 1 29 17 58 27 6 27 33 0 36 41 14 17 
30 13 0 9 0 0 0 10 18 8 0 9 0 10 15 0 14 0 8 0 0 0 9 0 31 14 0 19 0 13 69 5 21 4 0 0 6 0 20 21 16 20 13 6 0 11 0 0 
0 13 0 0 35 0 17 0 0 15 0 0 0 0 5 6 0 0 0 5 0 0 11 0 3 0 2 0 4 0 0 0 4 40 0 0 11 0 0 0 0 0 0 30 29 6 13 0 
0 17 0 7 16 0 8 0 34 3 0 2 29 18 4 0 24 2 77 18 14 19 4 11 18 5 9 0 0 0 16 0 0 3 16 19 0 0 0 0 35 0 42 0 2 26 4 44 
29 0 31 11 2 4 0 31 24 25 0 0 0 0 0 0 0 0 15 11 5 0 0 20 13 0 0 0 0 29 0 7 0 0 57 3 0 13 28 0 2 7 4 18 0 3 9 0 
2 14 1 0 0 5 0 1 20 0 18 36 0 5 25 27 23 25 0 0 0 0 0 12 27 25 0 0 8 13 3 0 14 10 2 11 0 20 12 44 32 0 42 0 2 8 11 7 
87 18 5 0 0 35 10 5 0 14 3 0 0 0 9 4 0 14 12 1 15 4 16 12 0 0 0 0 6 67 0 0 8 13 10 46 0 0 14 0 39 0 6 5 25 0 0 0 
0 0 41 0 9 0 7 3 9 30 0 11 0 2 0 0 0 6 0 11 0 0 0 0 0 0 14 0 19 2 0 32 0 0 0 3 0 0 0 0 0 10 0 35 0 0 0 25 
0 0 6 59 0 13 0 11 0 8 0 22 0 0 11 38 0 1 51 0 18 0 1 0 10 38 10 0 10 17 0 25 12 0 14 0 0 17 12 28 37 0 0 0 6 44 16 9 
69 28 1 0 0 0 10 18 0 19 31 9 29 0 5 0 28 0 0 0 18 8 3 15 2 17 7 0 0 26 0 0 12 0 24 0 9 0 10 4 15 39 0 0 28 0 21 26 
1 5 32 0 5 0 0 3 9 13 27 4 5 16 0 14 0 0 0 0 2 25 0 0 0 0 0 0 11 0 0 30 0 0 0 17 0 36 3 49 0 8 40 0 2 0 3 0 
35 0 45 17 13 4 40 10 2 7 2 1 0 0 23 6 12 13 0 0 0 0 0 14 2 0 19 14 0 1 21 1 23 13 0 19 49 12 0 24 7 0 44 11 0 15 20 45 
0 37 0 69 16 0 52 0 4 0 30 0 0 0 0 0 13 0 4 0 22 0 0 21 6 19 20 0 14 0 2 0 10 0 16 0 14 0 25 33 0 0 14 0 44 42 36 0 
40 0 0 0 0 39 0 14 32 0 4 0 39 5 10 0 29 1 0 0 0 14 11 0 7 6 14 0 0 26 12 6 1 10 0 0 5 2 2 0 7 5 0 0 39 10 5 6 
0 25 29 3 0 2 15 2 0 29 56 11 25 39 0 19 26 20 0 14 0 16 11 6 0 15 25 0 0 12 0 0 1 5 24 22 0 35 29 0 0 40 46 28 0 1 4 0 
0 38 0 28 1 1 15 0 2 8 35 0 0 14 20 0 47 0 4 0 0 18 31 0 0 11 4 0 27 0 7 34 0 27 28 18 38 30 22 17 5 0 1 7 0 26 0 29 
0 23 0 40 0 22 0 0 4 30 0 18 0 17 0 0 2 0 0 0 7 0 0 0 1 18 7 15 0 18 0 0 0 0 10 0 0 0 15 35 0 0 0 21 2 0 0 3 
11 0 17 0 0 0 0 23 9 7 30 4 8 21 0 1 25 0 0 10 14 2 0 16 17 0 0 4 15 0 26 21 23 0 14 8 17 0 14 0 9 0 12 0 0 0 4 3 
24 23 2 23 0 3 21 0 13 58 0 11 3 5 0 13 10 45 16 10 0 0 11 9 19 0 18 21 5 0 23 13 29 0 51 5 0 0 21 5 32 8 43 9 13 23 4 15 
36 31 6 41 28 14 36 0 5 8 0 26 6 0 14 10 12 0 0 0 0 21 0 0 0 10 12 0 0 0 0 0 0 4 0 31 14 24 6 2 39 13 1 0 41 0 0 0 
21 10 39 0 0 91 29 0 0 22 0 0 0 0 0 13 0 0 12 0 0 17 0 0 0 0 0 22 7 0 11 10 27 0 0 26 0 0 22 0 5 28 15 0 12 0 11 50 
0 0 0 0 17 28 0 38 0 0 0 0 7 18 0 0 0 0 0 0 6 24 0 6 22 0 20 0 14 10 10 0 3 50 0 0 0 23 0 0 0 20 14 0 0 38 22 22 
10 0 46 0 20 0 4 31 37 53 7 2 0 4 0 15 4 2 18 0 4 8 0 0 1 16 0 0 0 12 19 0 18 0 1 0 36 0 3 0 11 0 0 20 52 37 0 23 
