48 27
12 0 0 0 6 11 0 11 12 0 8 1 48 23 12 0 11 13 3 0 18 4 6 2 0 0 13 1 2 25 46 3 14 0 0 0 29 9 21 11 8 11 0 31 0 16 32 7 
21 0 0 0 6 0 0 0 21 0 6 9 42 0 0 0 0 9 9 0 33 17 0 7 0 14 12 0 0 27 14 0 4 0 20 6 4 1 6 0 7 13 26 22 0 0 4 143 
11 31 0 18 21 1 0 22 32 0 25 0 0 0 19 0 40 0 38 0 11 0 0 2 0 6 10 37 0 22 0 11 29 14 11 3 26 0 35 14 0 14 7 0 0 11 14 29 
0 2 46 25 40 18 17 0 4 0 25 3 17 0 13 16 3 16 0 24 3 20 17 9 9 19 23 38 11 30 0 18 8 14 30 0 26 0 27 11 45 31 3 0 59 14 0 2 
40 29 0 0 0 33 8 0 0 0 0 0 0 0 12 0 0 0 13 50 1 0 6 4 15 0 0 4 27 9 10 0 8 0 13 5 3 3 31 53 39 0 0 0 0 0 3 13 
0 0 5 0 0 42 19 5 17 0 4 3 29 0 0 0 18 11 12 27 27 0 17 0 16 11 0 20 17 9 0 0 0 31 18 1 9 0 20 0 0 17 0 0 0 5 27 110 
0 26 10 26 37 0 0 3 4 23 0 28 0 20 0 0 3 0 0 0 10 0 0 0 4 0 0 0 0 33 0 0 23 32 0 0 6 0 37 12 0 14 10 0 43 4 7 15 
0 0 15 0 19 0 14 0 0 0 0 12 11 19 0 0 17 15 0 0 20 5 0 3 0 0 13 13 0 0 0 0 21 0 22 0 6 0 0 0 0 0 0 10 18 0 0 7 
67 29 28 1 0 5 8 8 58 3 9 9 5 6 0 0 3 7 0 0 0 9 2 11 0 2 24 18 17 0 65 0 7 0 5 5 28 37 38 5 14 0 42 13 0 21 72 13 
0 0 0 16 11 0 18 3 7 11 33 0 0 19 0 0 11 0 3 0 34 16 21 0 3 0 0 0 0 0 0 1 21 0 0 0 0 0 0 0 0 0 0 31 11 0 0 4 
0 0 45 29 7 0 0 37 8 0 27 5 0 2 0 13 12 8 29 28 15 0 6 0 0 0 12 17 0 0 0 0 29 0 31 28 19 7 32 0 31 4 0 33 8 25 0 8 
0 16 0 32 4 8 20 7 1 10 0 0 0 6 0 0 0 16 9 19 0 17 0 41 0 20 3 0 1 4 0 0 0 0 0 37 0 0 17 0 0 23 0 0 0 0 41 0 
58 5 0 16 0 0 7 0 10 13 20 0 18 6 0 4 25 1 0 0 12 4 7 13 9 0 0 0 0 0 28 0 0 0 0 26 6 0 16 0 0 20 2 0 24 0 46 0 
11 51 6 4 0 0 33 0 0 0 5 15 32 3 0 2 11 7 23 0 0 13 0 3 19 0 16 1 3 7 3 10 26 0 0 2 0 5 7 0 0 33 0 23 15 12 7 18 
0 0 0 0 30 0 1 0 0 0 45 18 0 3 0 0 0 0 0 0 32 25 0 0 8 0 0 11 1 18 0 0 8 12 26 4 0 0 0 0 0 27 0 0 0 0 11 0 
40 0 38 8 29 0 0 0 7 0 5 22 0 0 33 4 0 7 2 0 0 0 11 12 0 3 2 6 10 25 0 0 0 0 9 0 25 0 0 39 38 0 0 5 0 2 0 32 
20 20 26 45 6 41 0 0 26 6 0 0 12 23 26 27 12 2 8 5 6 35 3 8 4 4 18 11 3 50 32 7 8 0 32 1 59 0 36 10 17 7 4 0 6 0 51 20 
20 15 0 39 31 34 37 0 12 0 9 3 0 10 0 6 10 38 14 6 56 18 17 14 10 6 15 3 0 14 0 0 0 0 40 0 0 0 0 4 0 37 15 27 10 0 1 27 
43 14 0 22 0 0 4 0 38 28 0 0 0 0 38 28 4 0 10 2 4 13 2 0 32 11 6 0 10 0 0 28 10 15 3 35 5 28 0 0 15 0 0 12 2 3 8 0 
5 0 78 0 0 0 11 0 0 0 0 0 0 5 0 3 0 6 1 0 0 11 19 0 0 21 0 0 0 27 6 0 0 3 0 0 6 0 0 7 0 35 5 0 0 1 0 45 
28 22 42 19 10 4 9 0 3 14 0 0 7 6 0 31 0 0 4 27 6 15 17 30 0 0 0 13 42 17 0 0 0 20 6 2 15 0 1 18 0 0 13 0 53 17 1 0 
5 0 0 0 0 10 0 0 39 0 0 3 18 0 0 0 0 0 27 0 27 13 18 15 0 0 0 6 0 7 0 0 0 11 0 0 0 0 10 0 0 0 0 0 0 34 33 84 
0 32 3 53 0 14 14 0 2 0 19 0 58 7 4 0 0 0 0 7 27 0 19 5 10 17 0 7 19 12 0 13 8 3 21 6 36 25 1 0 0 0 41 13 7 2 0 71 
43 38 2 0 13 0 9 21 31 0 1 13 12 6 0 36 12 0 18 0 0 2 15 2 13 0 0 29 19 25 0 5 15 18 2 19 2 37 0 7 0 14 27 0 13 0 5 71 
10 0 2 29 0 4 0 21 0 0 10 9 0 5 0 15 41 0 4 0 0 0 1 23 0 5 0 0 39 0 24 21 0 0 15 0 0 0 2 0 30 0 3 0 0 21 23 0 
0 0 5 17 2 0 14 0 20 0 11 29 0 12 0 9 21 12 0 0 17 16 1 13 0 1 0 0 0 7 0 0 7 0 23 0 9 21 50 0 15 19 3 0 0 2 7 12 
5 0 18 51 39 11 0 0 9 0 6 0 29 6 0 0 40 17 0 41 15 0 0 6 20 17 0 19 0 11 5 0 4 0 1 8 0 8 19 7 39 48 0 0 3 0 43 0 
