48 27
0 30 20 0 9 0 26 16 0 0 12 48 34 0 0 15 25 45 23 0 0 0 3 23 0 2 5 0 29 5 0 10 0 0 0 0 0 0 6 0 10 11 0 18 0 0 11 0 
13 5 0 0 0 14 43 14 18 11 0 0 23 16 0 29 0 16 0 3 0 0 0 0 0 0 9 0 0 0 30 0 19 0 0 9 0 0 31 27 13 0 21 0 71 0 0 40 
9 18 23 30 2 0 0 0 10 6 18 0 34 0 0 2 20 13 1 0 19 7 18 12 0 3 0 25 18 24 0 0 1 30 21 0 0 0 0 16 18 9 18 2 0 29 19 0 
23 0 11 17 0 7 0 13 0 0 7 0 0 11 0 18 18 11 1 0 17 37 12 13 13 0 0 7 36 0 6 0 20 0 17 11 0 20 0 18 19 0 0 0 23 0 0 32 
2 4 0 8 16 0 0 15 4 16 3 0 11 29 11 15 12 0 0 25 0 0 38 15 16 15 10 18 0 0 0 0 32 0 0 16 0 14 16 3 9 39 3 0 15 44 0 0 
16 0 0 0 0 0 0 0 2 0 0 0 0 0 0 0 0 0 14 0 0 5 0 6 0 0 5 14 0 5 4 0 26 5 0 6 15 0 16 0 22 1 19 0 4 0 0 0 
0 0 0 35 9 7 0 25 0 5 4 29 0 0 29 1 0 30 27 33 22 0 13 12 0 0 0 0 16 22 16 0 8 5 3 5 0 1 23 20 22 0 11 0 0 27 32 0 
0 14 12 0 38 0 0 11 39 0 1 2 0 13 0 13 5 7 0 0 0 0 0 16 0 0 24 0 15 20 0 5 3 0 2 0 7 0 0 4 36 0 51 14 0 0 0 39 
9 17 0 0 24 1 0 0 0 8 10 0 11 0 0 8 12 0 0 0 19 49 5 19 0 4 0 0 0 9 2 0 2 13 0 0 15 0 13 0 0 2 2 20 0 0 0 0 
17 0 5 0 14 17 0 1 0 0 0 4 0 23 16 0 4 17 0 1 10 11 54 10 10 4 0 27 0 3 0 15 0 20 33 8 11 0 0 53 33 7 0 57 10 5 0 32 
14 3 11 30 41 3 0 0 2 16 27 0 34 12 0 6 9 0 0 0 0 6 0 9 1 19 16 0 21 0 10 16 5 30 0 2 12 3 0 4 0 0 32 4 6 21 33 10 
94 0 33 0 0 0 10 4 8 0 20 11 0 3 0 9 20 4 0 4 4 0 0 18 8 0 0 0 15 0 19 0 0 0 0 27 16 7 0 35 0 5 0 6 47 0 1 0 
0 0 13 21 4 5 0 13 9 46 0 9 0 0 0 13 19 13 17 42 0 7 14 6 0 0 0 0 1 0 20 27 2 1 1 13 0 0 4 0 33 0 2 8 34 0 0 28 
30 3 0 0 0 0 0 0 0 0 0 0 9 1 8 0 0 0 0 0 0 17 18 10 0 9 0 0 0 6 21 0 0 2 1 0 13 0 15 0 2 14 0 2 0 0 10 0 
13 0 0 0 12 33 0 0 0 34 42 11 0 9 0 11 22 31 24 0 0 0 16 0 0 0 30 5 3 16 23 3 8 0 0 0 12 0 14 0 13 24 69 41 0 16 0 0 
11 26 0 0 0 38 0 73 59 11 1 8 3 28 14 51 9 17 3 5 0 28 15 0 21 0 0 26 20 0 8 0 18 9 0 0 14 9 0 18 0 20 0 94 6 2 54 43 
0 0 0 0 4 0 6 0 1 10 0 10 25 0 0 0 0 0 0 0 0 12 0 7 0 2 0 0 16 0 0 0 11 0 11 14 27 12 0 0 0 0 10 11 7 11 0 0 
28 21 6 0 20 1 0 27 6 20 5 72 0 12 32 14 0 9 2 10 33 4 2 5 1 1 0 19 18 8 26 21 12 29 8 0 0 0 9 3 20 30 36 2 6 0 33 6 
44 0 0 34 0 0 0 33 0 0 0 35 0 0 0 0 0 0 0 17 0 1 0 15 0 0 6 1 0 0 0 1 0 0 0 0 8 13 15 0 20 0 0 0 7 9 0 36 
0 1 27 0 0 28 0 1 0 2 17 11 51 15 0 2 0 0 25 8 0 5 3 20 0 3 12 14 15 0 4 12 9 28 7 23 3 0 28 1 71 29 20 33 18 0 39 4 
14 33 20 8 0 0 15 9 0 3 29 28 0 0 35 33 21 3 6 0 0 17 2 0 0 0 14 0 0 0 0 9 0 12 33 21 0 0 0 30 3 20 51 0 19 42 0 0 
36 38 11 0 0 0 0 0 14 0 0 36 46 10 0 0 0 20 0 1 28 5 0 20 0 0 8 0 27 9 20 0 0 0 0 10 3 11 0 21 0 0 14 51 18 0 3 35 
24 69 0 0 0 0 12 0 1 0 34 0 9 0 9 12 4 22 7 0 4 13 0 0 24 0 0 12 9 0 16 3 8 32 10 11 20 2 36 1 1 11 30 10 34 2 0 0 
29 41 54 57 0 6 38 0 0 0 36 23 35 2 14 21 4 4 25 6 17 33 10 18 0 4 5 17 11 0 0 26 5 0 27 8 20 26 0 33 20 0 32 72 15 22 2 4 
14 26 0 0 56 0 17 0 0 3 10 7 0 20 0 17 0 9 7 19 0 23 0 14 5 0 30 26 0 5 10 2 1 0 0 0 0 9 19 0 11 0 19 0 9 41 25 0 
0 0 2 0 3 0 1 28 39 0 16 35 12 0 0 0 0 17 0 8 14 2 24 0 0 6 16 0 7 0 0 16 0 0 30 55 0 20 0 0 2 0 0 0 13 11 0 74 
17 41 0 32 2 0 59 27 0 5 3 0 0 0 0 3 34 14 15 14 4 13 3 10 0 0 33 2 0 22 14 0 26 10 21 32 0 0 62 0 0 0 53 0 0 24 30 0 
