48 27
0 10 0 0 3 0 0 26 0 33 6 54 12 33 21 43 8 0 9 4 11 14 0 1 12 0 9 0 0 0 20 7 26 0 0 0 0 3 6 0 3 0 33 28 18 0 68 0 
23 55 0 7 0 3 23 25 25 0 24 0 0 0 2 14 2 0 0 0 0 0 20 0 16 0 0 26 21 2 16 7 12 0 0 0 10 0 9 24 32 35 0 0 12 0 6 0 
40 3 24 0 41 0 53 6 11 0 39 39 1 9 0 15 0 0 0 30 18 0 17 0 0 2 9 28 28 0 29 0 0 0 0 0 10 3 25 49 0 0 0 29 51 47 36 0 
0 0 19 6 11 0 6 18 0 7 0 0 4 0 0 0 1 1 21 9 0 1 1 0 17 0 2 14 17 16 0 13 0 0 8 7 0 0 0 52 0 32 7 15 0 5 20 0 
0 15 0 10 0 0 21 0 0 7 0 15 11 0 0 21 4 0 0 12 14 24 0 13 0 1 11 26 0 0 8 5 0 0 0 17 34 13 0 0 5 0 0 0 5 39 23 0 
0 4 0 0 0 0 41 0 0 14 0 0 0 0 0 0 21 0 0 0 23 3 10 1 11 0 5 1 6 0 0 0 10 0 0 3 0 14 1 13 0 12 5 0 18 5 8 41 
9 2 8 36 16 14 22 5 42 38 9 45 51 0 20 0 3 0 2 1 22 19 3 18 10 22 24 0 28 18 12 14 0 0 20 10 4 31 15 0 25 11 37 38 0 16 9 21 
12 9 0 41 0 4 0 4 0 23 0 0 15 0 0 3 20 0 0 0 0 5 0 3 0 0 5 6 27 0 49 0 0 17 0 0 27 0 0 0 37 0 0 0 0 1 0 0 
8 27 0 18 13 37 5 60 4 0 0 31 33 14 0 0 3 0 0 0 0 13 0 0 0 0 8 0 9 0 0 0 0 12 8 7 51 13 35 4 29 36 12 2 5 39 0 0 
22 50 0 31 24 0 6 0 10 36 14 68 0 2 19 7 1 11 0 6 24 1 0 15 17 1 33 22 32 0 12 0 6 19 0 1 1 0 0 0 16 0 60 32 5 35 0 48 
7 2 12 0 13 40 0 0 16 23 44 0 0 13 0 15 0 20 0 2 0 17 1 17 23 10 0 36 5 1 9 12 28 1 6 0 13 6 3 5 12 15 0 0 22 39 19 7 
23 18 0 0 32 0 0 0 33 7 2 6 0 0 31 14 7 13 9 12 8 6 0 28 0 0 8 8 2 23 0 0 0 0 0 27 10 0 2 0 0 3 0 0 15 40 7 0 
19 2 14 0 0 0 39 21 6 11 29 23 0 0 6 0 0 35 0 39 0 24 0 0 0 0 6 21 7 11 28 8 0 7 0 0 9 0 1 72 33 14 0 14 2 0 7 0 
16 6 5 41 0 10 34 5 21 18 2 28 0 0 19 8 1 1 0 0 0 8 36 0 0 1 11 25 13 0 0 0 0 19 0 0 0 0 30 28 3 0 0 12 47 23 0 0 
28 2 8 24 6 0 7 13 38 0 0 58 0 0 0 4 0 0 2 11 29 3 5 0 18 1 7 5 0 17 0 31 0 5 9 3 33 0 0 29 1 30 30 0 12 25 2 0 
2 35 2 5 0 5 11 0 26 0 5 0 0 0 24 15 0 30 0 0 0 0 0 15 4 0 0 1 1 0 3 0 0 0 4 0 35 0 24 0 32 0 0 0 0 0 23 30 
29 15 45 4 25 69 11 0 37 2 7 10 8 0 0 11 0 24 0 0 0 4 0 1 0 30 2 6 8 19 26 2 0 0 17 9 7 0 33 0 35 0 0 0 19 6 22 0 
11 23 5 2 1 0 3 10 35 0 42 6 0 0 11 0 14 0 11 18 0 17 0 14 7 0 13 2 7 13 4 4 25 0 9 12 9 1 17 0 0 43 0 62 0 12 3 0 
3 0 10 20 0 0 6 0 0 0 8 0 0 0 9 0 21 3 0 0 23 1 1 3 0 17 7 31 0 0 11 10 0 0 0 0 0 0 7 0 0 15 0 0 1 0 26 20 
36 23 0 0 36 30 2 0 9 14 6 0 24 3 21 3 0 26 4 0 0 9 12 20 4 18 41 3 0 0 0 18 14 17 19 59 62 0 0 0 36 33 0 30 0 37 0 21 
24 0 0 4 0 6 7 25 2 0 21 24 11 0 0 3 12 0 2 11 2 0 0 6 32 6 0 0 17 25 0 31 0 0 0 0 11 0 5 0 7 17 0 5 29 9 0 7 
11 0 37 0 6 0 18 2 0 34 6 20 0 0 0 0 0 3 0 12 18 23 20 0 22 14 0 0 4 12 0 12 0 0 0 7 0 0 18 35 0 21 0 0 0 0 22 0 
13 0 44 11 6 4 14 0 0 4 4 0 12 37 0 16 0 2 15 9 39 0 12 0 0 1 0 23 21 11 0 59 0 20 12 1 0 0 20 0 0 0 0 17 10 0 0 44 
0 28 3 0 0 3 16 0 0 31 1 0 0 27 25 0 0 0 0 0 19 0 16 3 0 0 0 9 0 28 23 0 5 0 20 0 1 0 0 47 0 0 0 0 5 17 9 0 
10 16 16 0 0 0 0 4 38 1 0 4 7 2 0 0 0 19 13 2 8 0 0 18 22 8 0 0 8 0 0 0 0 15 7 0 16 0 21 2 6 18 18 22 16 0 44 14 
0 30 0 15 40 7 0 0 5 20 30 0 32 18 25 0 30 0 0 0 20 19 0 6 1 0 7 0 16 0 25 40 0 0 11 9 7 4 0 33 37 4 33 18 39 0 30 0 
71 25 14 32 1 1 0 69 33 24 11 28 3 0 0 9 0 0 28 0 17 0 15 0 9 40 19 18 10 21 39 1 58 0 0 7 27 7 24 75 0 0 1 1 16 18 62 1 
