48 27
17 27 0 23 0 23 0 16 20 25 20 5 17 2 44 0 29 29 6 19 0 0 19 11 16 12 23 0 23 14 0 0 0 22 20 0 0 5 19 0 0 9 0 7 4 4 31 1 
26 13 40 0 19 0 8 8 0 0 18 19 0 0 2 0 0 1 0 0 14 0 0 41 5 0 0 0 0 0 0 0 0 0 0 10 42 0 0 0 4 0 37 0 6 0 2 47 
0 0 0 5 0 27 0 0 21 6 0 1 1 0 6 0 13 0 19 21 0 9 1 2 0 15 0 21 0 0 0 0 27 0 0 0 9 0 23 0 17 0 0 3 2 0 0 0 
0 6 29 0 0 0 38 11 5 20 0 0 17 38 1 0 12 19 33 5 0 0 0 0 0 0 0 0 0 11 0 22 0 0 0 12 3 0 0 21 23 0 0 4 49 8 0 4 
11 1 0 0 12 39 0 0 0 21 0 4 0 3 0 4 12 0 3 0 0 0 21 0 0 0 22 0 0 4 0 0 0 14 34 0 1 1 0 4 0 0 0 4 89 36 0 0 
1 15 0 20 0 0 41 26 23 11 37 10 23 0 0 6 0 2 5 20 11 48 0 8 3 16 5 0 9 0 32 44 11 12 0 8 0 4 17 2 17 6 1 43 11 23 9 59 
12 0 0 5 0 3 0 30 13 0 0 60 0 4 0 21 35 37 0 16 0 16 0 12 10 0 2 16 0 0 0 2 0 1 3 0 31 8 0 0 0 0 31 32 11 23 0 0 
0 33 0 0 24 25 0 1 0 25 12 0 0 3 16 0 0 0 19 2 0 5 0 0 0 5 0 0 12 0 16 0 0 1 51 16 8 0 19 0 26 22 0 7 12 0 0 0 
40 10 0 0 0 6 14 4 1 9 0 0 0 11 29 13 0 0 7 0 14 6 18 13 8 0 2 0 25 0 9 9 0 16 0 13 3 0 0 0 23 0 0 7 0 18 0 0 
58 0 61 0 27 7 7 15 25 19 42 0 7 23 0 21 11 0 4 0 0 0 7 22 20 17 0 2 0 19 0 23 1 0 0 6 74 1 29 3 39 4 33 17 3 22 2 0 
0 23 54 0 0 3 15 3 23 15 1 5 0 14 0 0 30 0 0 18 0 34 0 0 7 0 62 0 13 12 13 2 0 0 0 24 1 0 0 0 7 60 0 13 18 0 0 14 
26 0 9 9 0 0 0 0 2 0 0 46 8 0 13 12 0 0 0 0 26 0 0 1 0 10 25 0 0 26 0 22 7 18 0 1 8 5 0 35 4 0 0 0 4 8 41 0 
4 2 19 0 0 41 37 41 8 0 8 9 0 13 0 2 0 0 1 14 17 2 15 23 0 0 0 0 0 0 0 18 11 34 0 0 1 1 0 19 5 0 36 0 7 6 41 0 
0 20 52 0 0 13 17 0 0 12 0 65 14 0 0 0 0 0 18 9 0 20 0 5 25 9 0 19 1 13 14 0 3 8 0 1 0 4 0 3 10 1 3 8 34 34 19 0 
0 67 0 0 3 19 0 38 22 0 0 6 16 13 9 0 21 6 6 19 25 2 17 9 14 2 6 3 9 50 28 6 13 32 5 1 10 21 33 0 4 0 0 0 35 31 0 27 
0 26 19 2 1 10 3 36 0 12 0 4 3 0 0 10 42 0 17 0 15 19 21 0 2 6 0 11 0 11 0 13 0 0 0 27 0 0 0 0 7 0 0 23 3 5 30 9 
43 23 21 49 6 36 0 4 0 9 15 8 5 18 12 16 0 19 6 0 0 14 18 0 15 6 0 0 15 7 0 36 15 8 65 0 7 31 0 11 39 0 0 0 12 0 15 0 
17 3 20 0 0 1 1 17 12 3 43 13 42 0 0 0 0 0 0 7 12 0 20 0 14 0 0 0 13 0 0 0 9 12 0 0 12 0 3 0 15 20 30 0 0 0 36 0 
18 19 0 0 0 0 19 8 46 3 0 10 0 11 33 0 15 12 0 13 18 0 14 0 25 0 0 0 0 0 0 0 8 46 11 0 4 36 18 8 29 7 17 0 0 0 0 12 
15 9 0 0 30 0 19 0 6 75 11 0 7 0 42 15 0 13 0 7 10 20 0 14 5 16 8 0 9 0 43 6 0 0 6 0 18 0 0 0 0 21 0 43 0 31 3 0 
46 2 0 33 0 0 3 17 0 16 10 0 5 0 0 6 14 7 0 0 0 15 0 18 0 18 20 17 0 10 20 31 5 0 0 10 0 0 5 0 22 0 13 19 2 5 23 0 
0 16 0 0 0 0 0 0 12 9 0 29 5 0 0 0 0 0 19 15 11 0 20 29 0 12 5 0 0 0 29 11 0 9 12 0 0 3 20 13 0 4 51 23 0 7 0 0 
0 0 0 4 0 23 13 1 4 3 28 20 19 0 0 7 9 2 45 0 26 24 0 13 0 17 10 1 10 0 23 45 0 15 0 14 34 6 7 21 12 31 0 3 0 17 26 0 
40 24 14 32 0 56 24 38 8 26 0 34 0 20 13 2 17 2 27 24 26 0 6 21 0 0 0 21 15 12 4 0 0 11 0 0 0 7 0 21 0 0 1 62 10 117 70 42 
1 28 33 0 43 17 0 40 0 47 7 0 13 10 18 0 16 25 14 7 0 14 10 24 40 0 0 0 0 52 24 16 28 18 2 48 2 0 0 0 0 24 43 0 0 0 0 5 
33 73 15 0 40 0 0 0 6 24 0 15 5 0 0 0 0 2 28 0 0 0 21 0 15 18 23 0 0 7 29 14 12 33 0 0 31 0 3 0 0 4 0 0 60 64 0 0 
0 73 13 0 41 25 15 1 4 0 0 0 23 12 1 0 0 0 28 27 19 17 18 17 0 0 32 14 20 12 23 2 22 0 0 0 13 23 0 38 24 23 0 14 0 35 25 43 
