48 27
70 28 4 25 0 22 4 24 0 0 4 25 0 0 12 17 7 46 26 0 0 10 44 10 24 22 18 5 0 41 0 0 17 15 34 0 0 0 24 0 30 16 4 0 0 28 0 25 
0 12 70 10 0 0 0 25 0 14 0 0 0 11 12 0 22 0 6 2 0 0 16 0 24 0 26 0 26 0 0 4 0 0 0 0 0 0 0 0 0 0 0 22 5 0 29 0 
0 43 0 2 0 0 0 0 0 0 1 0 0 9 0 24 6 58 18 9 14 0 11 0 0 0 8 0 0 0 17 0 2 25 15 0 2 1 0 24 7 0 3 0 43 28 0 25 
24 3 0 31 20 0 60 3 0 0 0 13 19 0 6 0 0 23 0 2 6 0 0 0 0 0 0 0 0 0 18 20 0 0 47 34 6 21 32 0 23 0 12 5 0 14 0 33 
0 29 19 30 51 1 4 37 0 5 7 1 0 13 3 26 0 27 0 0 10 7 14 2 0 3 10 0 17 47 7 5 2 11 21 14 32 0 0 29 0 12 49 47 47 0 29 0 
15 0 0 30 0 47 29 0 5 2 2 0 0 17 0 0 0 0 23 9 0 0 14 0 19 4 19 5 5 23 0 2 0 0 0 0 0 32 0 0 0 16 14 59 0 14 7 0 
33 31 0 0 0 21 8 0 32 0 35 0 5 0 0 0 8 5 0 0 0 0 17 0 30 0 21 0 8 7 0 0 25 17 0 27 0 0 0 17 0 0 0 12 25 45 10 37 
0 0 0 0 0 0 0 0 12 12 0 15 25 0 0 0 11 11 3 0 0 3 0 0 0 0 17 0 11 0 8 0 0 0 0 2 13 42 2 3 2 13 3 0 0 0 0 0 
4 0 11 0 1 0 22 5 0 4 1 16 0 4 7 0 30 11 0 0 0 0 21 0 0 8 0 2 3 41 0 16 7 0 5 0 19 0 0 21 0 4 8 7 0 0 0 18 
15 0 5 0 0 0 0 4 0 3 1 0 17 0 0 0 9 0 0 0 14 0 21 0 15 0 0 0 0 1 5 0 0 11 11 1 0 0 0 0 0 0 0 16 0 1 11 0 
10 35 44 0 4 0 22 13 1 5 0 7 27 7 0 11 4 12 0 16 7 1 22 11 0 5 6 15 4 4 0 17 18 6 0 17 0 0 0 19 3 1 14 17 0 14 17 19 
6 0 19 31 0 0 17 0 5 2 8 0 9 11 5 5 0 0 0 15 15 23 16 17 0 13 26 10 0 0 10 0 2 0 37 0 0 0 13 0 6 0 2 0 2 0 0 8 
0 0 88 12 10 16 0 13 38 3 1 0 22 0 25 2 19 24 0 0 0 0 42 0 0 0 8 14 0 7 0 0 0 0 11 45 9 35 16 0 0 50 0 26 8 0 11 0 
29 25 5 9 0 84 0 33 2 5 1 30 20 0 18 14 13 3 7 4 0 20 10 9 0 3 5 15 0 65 9 0 6 0 6 9 0 0 27 62 27 0 8 0 33 34 3 0 
0 0 26 0 43 7 4 61 0 36 1 1 1 0 0 0 10 0 0 0 34 0 5 21 0 10 0 0 13 0 2 11 0 0 0 0 0 25 0 10 58 1 5 25 6 51 6 3 
11 33 36 0 43 1 13 14 34 14 0 0 6 5 15 10 27 7 14 7 3 0 5 1 0 14 2 3 7 0 47 0 0 19 30 0 4 0 51 27 1 3 29 8 0 3 24 39 
0 16 0 0 10 46 5 33 0 0 15 16 0 6 8 2 1 7 1 29 14 0 2 0 13 13 0 0 0 12 3 0 0 8 3 7 14 7 41 0 6 1 8 0 9 0 11 42 
62 19 4 5 0 0 0 19 1 5 15 4 0 13 5 4 0 0 0 4 14 6 14 0 9 15 13 0 10 0 9 0 0 0 0 7 0 0 0 0 0 0 0 43 0 14 0 0 
12 6 0 0 22 0 5 1 0 5 2 0 0 28 5 7 11 24 0 28 0 0 2 0 0 15 30 14 0 0 0 0 3 0 15 3 2 0 0 0 20 28 0 10 44 4 12 24 
0 42 17 0 0 0 4 0 33 8 15 31 0 0 0 7 0 19 84 0 0 7 15 15 17 18 6 0 21 0 0 3 14 11 26 7 11 2 0 0 5 17 9 17 0 9 18 30 
10 17 0 0 0 0 0 35 7 0 0 25 0 0 16 20 0 9 18 23 5 1 1 0 0 8 7 0 0 0 1 6 0 17 12 3 1 0 0 28 0 41 21 0 8 0 1 0 
18 0 9 0 0 0 0 13 20 21 2 62 18 0 19 8 13 0 36 4 10 0 0 41 0 0 20 10 0 0 14 13 25 40 16 0 0 2 0 0 0 30 19 0 5 23 1 33 
0 0 12 11 16 22 7 0 39 0 0 10 51 32 3 0 0 0 0 0 17 16 22 0 3 22 0 24 0 0 3 0 11 0 0 12 36 0 7 0 0 0 0 32 26 12 2 34 
27 0 17 0 47 0 1 10 25 0 34 0 0 0 8 2 22 40 42 0 36 44 9 0 0 0 16 2 0 25 10 0 2 17 0 0 0 35 0 0 0 0 24 41 57 37 10 30 
16 14 92 8 0 0 40 0 37 0 0 8 0 0 0 2 0 2 0 0 5 0 2 0 4 0 18 0 11 0 4 26 11 0 32 29 34 21 24 34 17 0 0 0 20 19 26 48 
1 0 0 15 9 10 10 16 0 0 0 0 0 0 9 13 28 0 0 9 0 7 18 7 20 25 14 1 44 12 30 26 10 0 0 0 0 9 0 0 9 25 0 0 28 0 2 22 
15 0 22 0 0 13 39 0 0 27 7 0 0 0 0 7 0 30 26 13 11 0 15 4 0 22 25 0 8 0 22 6 0 0 11 0 15 5 25 34 0 0 5 27 20 72 8 0 
