48 27
7 0 13 0 4 69 15 29 22 20 0 1 7 0 0 8 7 0 44 3 12 41 0 15 0 7 8 0 34 6 8 0 0 9 10 8 9 3 9 21 16 30 0 25 2 40 18 9 
6 25 15 13 10 11 28 9 0 0 0 0 0 0 7 0 61 6 0 15 11 21 6 1 0 0 0 0 36 18 23 20 0 11 0 13 1 1 25 0 4 12 0 0 4 5 4 31 
29 0 0 0 18 48 0 0 22 0 0 0 13 0 10 0 2 2 21 15 19 5 0 1 0 0 0 0 7 41 22 0 14 0 4 0 33 0 4 21 0 0 0 0 0 6 41 22 
0 0 0 12 0 0 0 32 0 0 25 0 0 32 0 3 0 0 7 0 0 0 0 8 0 1 6 0 1 0 0 10 13 15 0 10 0 0 4 5 5 0 4 0 0 32 20 19 
0 0 0 1 1 0 0 0 13 0 8 0 14 0 0 11 6 0 8 0 15 19 0 0 0 0 46 28 0 0 0 0 5 0 0 13 0 0 0 0 16 0 0 3 7 0 8 6 
1 0 25 0 15 0 0 39 10 0 0 22 0 0 32 0 0 0 5 4 12 0 0 3 0 5 1 15 0 31 4 1 15 20 0 7 0 33 36 25 19 0 1 43 0 0 43 2 
0 0 3 0 0 41 0 0 12 0 33 0 0 0 0 0 0 0 0 0 0 21 0 8 13 0 6 1 17 0 4 0 0 0 14 27 0 13 0 0 0 4 21 38 16 11 0 23 
0 4 0 0 5 0 2 23 6 1 13 0 17 13 0 0 0 6 11 23 5 2 4 6 6 4 13 0 9 21 0 0 13 0 0 0 0 9 0 0 0 0 0 0 5 0 0 16 
61 15 39 106 0 0 0 9 0 21 0 26 7 11 16 20 8 10 1 14 0 15 0 41 9 22 0 24 8 29 10 23 1 0 7 28 14 26 38 0 32 11 0 40 59 10 0 40 
0 43 0 37 0 7 17 38 7 9 0 3 0 0 16 0 0 14 11 2 0 0 0 18 13 0 6 15 11 0 0 4 5 2 0 7 0 34 0 0 9 0 4 3 51 18 0 0 
0 1 1 64 13 0 14 7 14 0 4 12 0 0 5 0 69 8 4 0 0 0 6 4 0 0 0 0 2 9 0 15 0 11 18 2 0 0 32 4 0 0 0 0 1 21 1 41 
7 4 11 0 12 14 0 3 0 22 0 0 14 0 6 40 0 0 0 15 5 0 11 9 3 0 14 0 0 0 13 23 16 0 0 0 8 0 0 0 11 0 0 0 6 30 0 0 
15 0 21 7 0 0 2 42 2 7 8 7 12 6 10 26 24 0 1 9 23 12 0 0 0 10 0 25 5 0 23 1 0 13 0 2 0 9 0 0 19 0 12 39 5 16 0 14 
11 16 24 48 15 0 0 13 39 0 31 0 5 24 0 5 0 21 0 25 12 17 0 11 0 20 0 8 28 0 27 0 29 0 0 28 53 0 0 0 0 5 34 0 7 17 9 0 
0 32 4 0 9 11 0 0 85 3 37 0 3 75 4 0 0 21 0 6 0 18 14 16 10 11 3 26 0 18 0 5 3 44 12 25 9 37 46 0 6 0 6 0 31 28 0 22 
44 0 15 14 32 25 41 4 6 0 0 4 24 25 0 8 10 17 17 6 3 0 0 1 0 13 10 2 7 0 0 24 6 4 0 17 30 0 4 26 13 0 8 38 36 5 13 32 
46 0 26 10 0 25 15 3 0 0 27 0 0 4 21 0 0 0 6 7 0 3 0 3 18 6 13 0 0 11 25 6 7 0 0 28 0 6 0 0 0 0 13 0 0 0 36 37 
4 0 1 0 16 1 1 0 0 13 0 0 2 0 2 20 14 18 17 8 0 9 13 7 7 0 0 0 0 9 9 9 22 0 10 19 15 0 0 9 0 4 10 4 11 19 0 3 
14 46 39 0 41 0 0 5 0 45 1 0 1 15 0 13 0 10 20 17 19 20 20 32 6 19 0 0 68 4 10 0 0 0 4 11 0 0 20 0 4 0 0 1 24 42 20 0 
0 14 37 41 0 0 20 26 0 23 3 0 0 0 13 8 0 0 1 16 0 0 0 3 15 0 48 4 0 37 0 8 5 30 6 19 33 22 35 0 45 0 13 0 15 9 0 11 
6 0 65 39 2 0 25 10 0 0 0 0 5 0 0 0 0 0 0 3 0 0 25 15 0 0 0 0 0 23 28 1 7 11 0 32 0 0 25 28 22 3 6 41 7 3 2 0 
25 24 43 0 41 0 2 27 28 0 0 11 11 0 28 2 0 2 13 6 0 0 1 2 0 37 17 0 0 19 0 36 10 1 28 13 0 0 0 7 0 1 35 0 0 2 21 2 
10 28 6 0 27 0 2 15 0 12 0 15 0 0 0 0 0 0 6 42 0 6 11 0 24 10 16 18 14 42 11 0 13 13 34 9 10 2 0 19 0 2 0 24 15 0 46 1 
0 22 0 0 37 35 2 38 20 28 0 0 0 0 0 20 0 0 8 11 0 23 0 22 0 0 8 0 0 1 0 8 0 0 0 4 0 4 0 0 35 66 8 0 9 38 0 53 
19 0 0 28 48 0 56 24 23 12 0 0 26 0 0 29 7 24 27 33 0 15 3 23 0 0 0 0 0 15 1 28 3 18 0 0 21 19 58 7 0 13 0 0 23 64 21 15 
41 0 19 23 26 14 14 8 24 0 25 0 0 20 0 8 26 0 22 0 26 0 0 0 0 0 6 0 0 45 26 28 18 0 31 25 0 0 16 0 28 80 3 3 17 0 12 2 
6 25 0 14 30 0 0 0 0 0 32 0 0 11 11 0 23 0 0 0 0 8 8 27 0 0 21 12 0 0 12 11 31 0 38 0 0 0 11 43 0 0 20 0 41 0 10 15 
