48 27
47 69 0 2 26 2 0 54 35 16 0 0 0 11 11 29 0 7 25 0 29 60 12 0 4 5 0 5 7 9 5 0 45 17 1 10 0 26 6 8 0 6 21 42 16 16 0 0 
0 13 0 0 0 44 0 0 0 0 50 32 0 0 22 10 0 19 7 12 0 24 4 0 0 0 15 33 10 23 9 0 0 0 0 16 0 2 47 24 19 0 4 3 0 5 22 4 
7 8 46 0 0 49 40 16 0 0 3 0 43 32 36 20 0 1 29 22 18 9 21 16 0 0 0 9 0 13 0 0 15 0 0 19 36 23 4 37 17 28 21 0 2 17 78 14 
0 0 36 16 20 2 0 2 22 0 5 0 0 6 0 0 0 0 19 0 0 19 0 0 0 0 0 3 0 20 16 0 4 0 0 0 3 0 17 1 31 0 9 7 0 0 16 24 
29 0 6 0 27 0 0 0 14 0 54 1 18 27 0 11 0 0 19 0 16 10 14 0 0 0 24 13 0 17 11 0 0 0 0 0 0 10 0 0 15 0 0 0 0 35 0 0 
0 13 28 0 0 12 0 22 0 0 4 22 0 6 9 11 0 3 41 17 2 0 12 1 6 0 0 20 0 0 9 0 0 10 19 0 11 0 0 0 0 0 0 17 26 0 0 0 
25 19 0 16 0 0 22 20 0 4 6 0 2 13 13 0 4 0 18 27 4 6 0 1 13 0 2 20 20 0 8 19 13 15 2 0 0 5 8 0 0 0 9 0 0 3 27 0 
42 9 68 1 19 22 15 34 36 0 8 1 0 8 0 0 0 1 1 17 0 20 0 19 6 20 0 15 10 0 0 0 5 0 7 0 0 35 0 6 0 30 18 0 36 0 0 0 
0 0 1 5 5 9 0 0 53 4 5 30 0 20 25 0 6 5 10 12 0 2 11 2 18 11 8 18 0 9 37 0 6 14 9 0 0 0 13 46 0 0 18 0 4 2 0 6 
10 0 64 0 6 3 45 0 0 0 21 0 0 0 4 0 0 0 5 29 0 11 0 0 11 6 0 3 0 0 5 29 0 0 0 0 0 0 0 12 90 17 23 0 0 0 0 0 
14 10 15 0 0 7 6 5 26 11 0 0 3 0 0 0 45 19 24 0 6 2 25 0 0 2 5 2 7 14 1 0 0 0 4 7 39 9 3 12 6 0 31 5 10 29 0 36 
0 34 38 0 20 0 4 22 14 0 14 0 5 8 30 0 5 26 11 3 18 22 1 0 14 0 6 2 0 11 9 0 7 28 26 4 0 0 8 9 19 0 0 0 30 0 0 3 
3 1 0 21 0 26 32 0 38 2 0 2 29 0 21 31 0 0 24 0 26 20 12 4 37 5 0 14 9 3 11 0 12 0 6 9 18 0 32 0 0 9 9 2 7 13 43 11 
0 0 0 0 0 0 0 0 0 0 0 9 0 12 0 0 0 0 0 12 9 8 0 0 11 0 0 0 0 0 4 0 19 0 0 11 23 0 3 0 0 0 0 2 0 7 0 0 
0 13 9 11 30 0 0 2 31 0 12 2 0 11 0 20 3 0 0 21 6 0 30 0 16 0 15 22 14 10 0 4 12 0 30 32 12 17 0 10 3 5 30 0 7 6 20 21 
44 0 10 15 41 26 21 34 0 25 30 20 0 16 0 7 5 17 15 9 15 7 10 24 7 7 6 7 6 9 3 11 0 14 13 8 5 15 6 1 1 24 3 30 77 6 64 29 
0 0 0 0 0 3 0 2 3 0 0 17 5 24 0 29 0 4 0 9 14 0 0 0 0 0 15 0 15 0 0 2 0 0 6 0 11 0 41 0 0 28 0 0 29 26 0 0 
19 31 42 0 0 5 0 0 0 0 6 2 0 0 23 26 3 13 10 11 0 25 7 0 0 0 1 16 0 0 16 0 0 0 0 28 0 45 0 0 8 0 40 0 0 0 84 12 
0 0 0 0 15 21 37 58 0 0 0 0 0 3 0 18 0 25 18 0 0 0 0 0 3 18 41 3 23 14 1 3 0 0 11 0 0 0 12 2 0 2 25 51 0 11 0 1 
5 2 2 0 0 11 0 0 0 17 0 0 22 0 0 15 33 0 27 1 4 0 36 8 17 0 17 15 0 3 4 0 6 11 14 5 17 14 22 20 12 17 0 0 0 22 0 24 
1 0 0 0 9 44 11 20 32 0 39 4 29 2 0 24 49 45 28 5 5 4 14 18 22 17 5 37 15 0 17 33 17 0 11 30 34 6 41 66 9 4 0 128 34 0 22 22 
0 0 25 0 33 1 0 0 0 3 0 0 30 16 0 4 0 0 0 20 11 5 0 4 7 0 16 29 0 0 19 16 21 0 1 23 0 33 25 8 6 1 0 13 0 33 0 17 
2 33 0 47 22 0 0 22 0 22 5 0 21 24 1 52 0 5 63 11 12 12 5 0 0 16 17 18 0 6 2 0 10 0 2 0 19 1 10 12 22 26 0 69 12 0 0 34 
0 0 17 12 0 0 4 19 0 21 33 0 0 33 22 11 3 13 0 11 0 28 0 21 11 12 9 4 14 19 8 0 13 20 0 10 10 0 0 16 2 0 29 1 37 58 0 0 
2 26 1 7 0 40 0 44 0 1 7 22 16 34 25 0 0 12 11 5 1 20 0 9 0 16 0 33 25 24 2 0 0 22 10 30 2 0 23 0 0 0 9 0 10 0 39 34 
37 0 15 19 0 10 15 32 14 30 0 18 7 11 0 4 5 19 14 0 0 33 24 0 0 0 0 14 2 17 21 20 39 0 0 11 19 47 41 34 53 0 0 0 0 0 67 23 
46 0 11 33 1 24 0 0 12 21 0 42 0 0 16 0 26 0 0 0 0 0 15 0 14 0 14 0 23 0 16 6 12 0 0 0 64 11 0 0 0 15 0 32 0 0 71 0 
