48 27
0 4 27 0 18 22 0 0 0 0 13 0 10 0 28 10 0 40 0 19 0 5 0 0 20 0 0 22 9 14 13 14 10 17 21 3 16 70 0 18 0 41 20 0 7 14 7 18 
0 5 14 0 0 0 5 25 4 0 0 36 4 0 11 12 15 0 3 25 12 5 22 7 0 36 0 3 0 1 7 15 3 0 21 25 2 25 0 0 0 1 0 0 31 10 0 15 
0 14 9 0 6 1 27 0 10 0 9 0 20 0 0 18 15 22 25 4 19 9 17 5 0 0 39 9 0 8 0 21 19 23 8 0 0 0 0 14 0 10 2 0 2 0 22 0 
0 17 0 1 14 0 0 0 0 0 2 19 19 0 0 0 0 5 17 3 0 0 0 13 0 0 11 0 0 17 33 0 0 0 0 21 13 0 0 0 0 0 0 0 0 0 0 0 
0 20 0 26 2 0 7 0 2 4 0 0 14 55 30 1 2 6 3 0 5 0 6 13 19 13 0 17 6 11 6 14 0 10 53 0 30 10 36 15 0 0 17 8 12 0 31 0 
0 0 14 0 0 0 0 0 0 3 31 0 0 12 20 1 14 21 0 14 0 2 0 0 0 9 0 0 0 0 0 0 0 0 33 0 0 0 21 0 20 31 0 1 9 0 0 0 
0 18 0 0 10 0 0 3 0 15 16 37 15 2 2 31 18 25 0 3 0 2 10 0 0 11 16 0 19 0 0 9 0 0 18 0 7 0 0 38 23 0 25 25 1 0 0 32 
35 58 0 9 40 13 1 0 7 30 5 27 32 1 0 18 37 27 13 18 0 14 0 10 7 1 12 3 12 32 0 45 1 3 9 0 8 30 19 2 6 5 19 48 55 0 18 58 
0 23 17 16 17 40 8 17 0 1 0 2 18 34 64 0 30 7 14 45 26 0 0 13 9 0 5 0 12 71 6 15 14 0 8 3 7 31 13 32 0 25 0 0 37 42 43 34 
31 23 1 3 6 0 0 0 0 11 0 0 0 31 0 0 26 0 0 24 0 0 22 22 3 0 4 12 0 0 21 22 7 2 0 12 0 15 6 7 0 32 26 4 31 8 11 2 
22 16 0 0 21 2 0 0 0 17 10 0 47 0 0 13 0 34 17 11 5 0 0 4 9 41 9 4 15 20 11 25 3 21 0 30 16 0 0 0 39 2 12 0 0 6 12 4 
5 0 0 0 0 52 7 36 38 0 25 6 50 0 49 3 29 0 0 0 8 8 15 13 16 3 20 2 8 0 2 0 19 1 23 0 24 29 0 41 14 29 32 36 0 60 13 37 
0 0 0 0 0 33 0 0 0 23 0 0 0 5 0 0 0 0 15 20 0 22 0 2 6 5 16 17 0 7 0 0 23 4 0 0 7 0 33 9 0 0 14 13 10 0 1 0 
0 0 33 55 0 0 0 27 15 0 13 0 65 0 0 0 0 0 6 8 12 0 0 10 0 0 11 0 0 11 6 5 0 2 0 0 0 0 0 34 38 0 0 31 9 0 78 0 
0 4 0 0 11 6 0 0 0 6 0 2 0 27 0 0 5 1 0 28 0 0 30 5 0 3 9 0 0 15 0 5 12 5 0 7 0 0 0 23 6 0 0 7 56 4 11 32 
14 10 20 0 40 0 13 0 8 0 0 0 0 0 11 14 15 1 28 3 5 11 2 0 8 1 1 0 0 26 2 25 15 3 3 0 0 0 0 12 20 4 6 3 51 11 28 6 
3 0 0 81 0 10 0 64 0 17 14 10 0 0 22 10 0 2 20 0 20 16 4 1 0 9 7 0 0 0 11 0 7 30 8 23 2 0 24 32 33 10 0 0 12 0 41 44 
0 56 6 41 0 8 24 1 23 7 0 0 11 20 13 14 0 4 0 0 10 0 7 10 4 6 0 0 4 20 33 33 15 1 0 0 0 36 0 0 16 1 0 0 64 2 0 0 
45 0 0 30 0 0 0 22 0 7 11 0 14 1 30 16 13 0 0 21 0 0 3 0 6 3 0 0 13 17 0 14 0 33 2 0 8 0 0 0 32 3 0 0 27 49 0 7 
3 30 1 42 42 9 0 0 0 3 0 4 25 0 43 0 0 26 27 17 19 8 0 0 9 0 0 0 12 26 13 0 4 5 0 0 7 18 2 15 0 0 28 13 0 60 42 3 
15 0 38 13 4 0 0 0 30 27 8 25 14 0 0 18 12 9 32 11 9 10 0 35 21 25 0 16 0 0 0 10 4 0 30 15 22 1 20 46 18 4 22 27 8 18 40 0 
0 1 32 0 0 0 2 0 0 15 0 35 0 0 17 25 0 11 19 28 7 13 25 0 17 10 16 32 26 17 1 27 12 13 15 1 0 0 2 0 0 0 22 3 0 0 2 9 
0 26 5 13 0 0 0 1 9 8 26 0 0 6 27 32 7 5 0 9 10 0 0 0 20 26 34 0 3 22 41 0 0 8 0 2 0 0 2 10 0 27 6 0 9 0 44 14 
5 0 6 5 1 25 28 0 3 18 15 28 9 19 0 12 0 0 0 7 31 0 14 5 22 1 0 11 0 0 0 23 11 8 19 21 12 0 2 19 6 15 19 0 0 31 36 1 
13 20 0 0 38 0 5 8 5 0 24 0 0 5 0 0 0 26 0 2 9 11 0 23 0 0 0 0 0 0 0 0 2 0 1 2 0 14 20 4 0 0 38 12 0 0 0 0 
0 49 23 10 49 11 8 0 20 19 19 0 17 0 19 0 10 0 0 0 24 3 9 0 0 52 10 0 35 12 38 19 15 23 21 11 32 34 0 0 20 40 0 0 8 0 19 31 
0 46 0 0 0 60 0 25 25 0 0 45 0 0 0 3 0 0 0 0 0 11 15 0 0 3 10 10 0 1 0 4 2 3 0 25 10 32 0 0 0 0 0 0 11 0 1 82 
