48 27
34 0 50 0 29 8 39 3 0 7 60 26 21 15 1 73 0 16 68 37 0 0 10 0 32 0 11 9 12 12 14 16 32 5 34 8 5 21 19 56 64 29 0 25 14 69 6 23 
12 33 0 14 0 39 9 1 32 3 20 0 43 10 5 4 14 13 33 4 15 17 18 0 11 7 0 18 16 8 5 1 0 0 36 8 0 0 20 25 9 0 22 0 4 38 33 0 
0 0 15 46 3 0 25 2 3 0 19 25 0 0 17 1 31 0 0 15 14 6 25 0 0 0 0 11 0 23 14 9 0 0 32 0 6 0 13 36 0 0 18 0 27 0 0 27 
0 0 11 27 37 0 0 0 0 15 0 31 0 10 0 0 20 19 0 19 0 0 0 0 0 0 0 0 10 0 41 0 0 0 18 4 41 16 7 15 0 42 0 7 49 0 5 0 
0 0 0 0 7 0 37 9 0 0 27 6 7 3 0 5 9 0 0 0 33 0 0 0 0 0 0 0 0 0 16 17 0 8 0 8 0 27 0 0 0 8 0 14 14 0 34 0 
20 1 3 27 3 0 47 0 0 2 0 0 0 0 0 7 4 0 3 4 3 0 0 0 5 17 0 17 0 0 33 0 29 0 0 0 0 12 4 0 0 0 10 0 38 0 8 0 
71 0 0 11 4 0 0 0 4 5 22 2 2 0 16 26 17 16 0 8 10 0 11 0 0 15 2 17 19 0 10 3 0 17 36 21 9 37 0 30 5 26 0 0 33 0 0 0 
26 0 0 40 8 33 26 10 3 22 10 0 21 9 6 32 0 6 27 0 10 42 0 14 0 10 9 0 5 0 37 22 29 16 31 20 36 31 36 3 0 9 3 0 0 27 9 15 
33 124 12 9 0 8 3 11 0 2 7 6 27 3 0 6 3 5 5 13 25 21 0 2 23 12 44 3 22 0 3 8 0 22 13 15 0 79 0 8 0 0 19 10 13 33 31 19 
58 0 0 0 5 38 0 9 9 0 0 0 0 0 0 12 4 27 11 0 0 17 0 0 10 0 0 15 13 0 0 0 2 12 0 0 0 6 21 9 6 0 42 64 0 9 10 10 
12 0 1 14 0 0 1 30 3 15 0 11 3 0 0 32 2 5 0 19 5 5 0 3 4 0 38 0 0 0 0 6 0 0 2 0 0 15 26 0 0 0 1 0 9 0 20 0 
1 10 16 4 0 3 5 8 0 36 6 3 5 0 14 2 0 0 0 38 4 9 50 17 0 2 20 0 0 6 11 0 0 0 28 0 11 0 24 17 18 0 0 33 1 41 0 19 
23 0 0 0 30 4 20 0 0 0 0 0 26 7 0 30 0 0 4 8 0 7 12 0 8 0 0 0 0 4 13 0 0 6 30 0 0 0 26 6 0 41 12 11 0 28 8 39 
0 0 0 43 46 0 0 32 1 8 10 21 25 9 18 20 4 8 0 0 10 12 0 15 3 0 12 24 0 0 3 0 19 15 27 1 0 17 0 35 9 41 0 3 0 0 39 4 
71 13 41 2 17 3 49 0 0 0 0 2 1 15 0 0 0 0 26 25 0 20 6 50 19 12 22 14 15 29 5 0 0 10 11 23 0 9 0 0 0 5 49 28 17 0 44 24 
45 6 0 9 0 0 19 12 0 7 0 5 0 4 11 6 10 1 0 4 14 0 0 8 9 0 0 0 0 0 13 9 0 9 2 0 35 10 0 0 9 0 5 0 0 43 5 0 
0 0 0 43 0 28 0 27 0 0 0 37 30 26 0 8 17 0 0 31 23 13 0 31 0 8 25 0 0 26 23 8 13 18 25 5 0 4 15 0 3 0 7 1 24 0 42 0 
3 42 30 11 0 40 25 1 1 0 0 34 10 11 27 1 1 0 0 0 23 20 11 11 0 21 0 0 22 0 28 0 32 0 7 12 80 14 7 0 6 26 0 19 0 25 44 7 
0 30 20 15 0 0 0 9 26 0 18 21 4 15 15 0 0 17 15 0 0 0 20 0 0 0 0 0 15 7 13 30 18 0 45 24 15 5 0 9 4 0 0 17 18 9 0 0 
0 6 0 26 0 54 0 12 13 51 6 10 15 21 24 18 2 0 21 0 15 22 0 11 24 14 0 4 17 0 12 8 12 18 12 26 0 8 75 27 0 36 10 13 17 12 4 10 
42 0 0 0 0 15 3 0 18 0 16 12 12 0 18 10 48 5 5 8 0 0 4 1 8 0 18 1 0 0 2 0 5 0 2 0 0 3 0 20 29 7 32 0 0 0 30 7 
0 1 32 4 0 0 0 0 0 7 25 13 0 8 20 5 4 0 17 3 8 11 25 14 0 0 6 8 10 7 0 28 14 30 38 13 26 3 9 0 12 0 11 0 2 0 2 10 
0 0 14 0 28 18 0 34 1 0 8 2 4 16 0 31 0 16 13 14 0 0 3 3 5 17 0 14 0 11 0 0 15 0 0 0 29 0 0 0 0 0 0 0 0 18 0 15 
0 9 15 9 0 25 19 0 10 20 43 0 6 0 0 6 19 0 2 19 0 15 0 0 0 7 3 0 14 0 56 0 0 0 23 16 0 0 0 0 0 0 14 0 44 0 0 23 
0 13 0 0 0 0 0 0 39 0 4 54 0 0 13 0 0 0 5 0 0 0 12 5 2 0 0 0 21 0 0 14 2 0 30 0 0 0 5 0 16 0 11 33 0 19 0 43 
17 0 33 0 0 3 0 2 6 39 0 30 0 28 9 13 4 0 0 10 0 18 0 28 0 0 15 0 25 31 0 0 0 0 0 0 15 47 9 26 0 54 0 0 0 0 29 0 
17 42 0 0 4 0 0 0 0 30 6 0 18 0 0 21 0 17 20 0 6 25 16 23 1 1 27 24 0 0 21 0 0 9 33 0 9 0 12 5 0 0 8 0 0 0 0 0 
