48 27
0 44 0 0 0 0 24 0 0 14 0 0 42 0 0 0 22 0 27 25 0 2 0 14 0 12 0 20 0 17 27 3 0 8 0 23 0 16 0 0 39 0 24 10 25 0 17 35 
4 84 1 0 31 3 26 29 74 0 0 0 5 6 5 3 5 15 41 5 4 4 12 5 9 6 10 6 21 23 20 24 11 14 66 2 45 0 0 8 0 7 13 4 19 31 19 14 
21 0 0 3 26 0 3 0 1 0 17 10 0 10 0 21 14 24 32 13 0 22 4 10 0 0 0 20 16 0 42 13 14 2 0 0 0 0 4 0 0 0 0 22 18 30 21 16 
0 0 12 35 31 30 0 0 0 20 0 0 21 0 19 18 0 17 0 15 0 0 21 20 14 0 0 5 0 32 0 0 0 5 0 30 0 14 24 51 0 0 0 0 0 0 0 17 
18 30 6 29 21 31 33 17 16 9 39 0 3 0 0 32 1 8 25 14 0 8 23 5 28 21 23 7 0 0 0 28 0 21 33 16 0 10 0 67 14 0 0 0 15 23 0 1 
90 5 0 0 0 0 76 7 25 0 0 3 0 0 20 10 0 13 28 0 6 11 0 2 18 26 0 15 0 0 10 3 32 3 20 1 0 31 3 28 0 1 2 4 2 1 56 13 
40 0 6 0 0 0 5 23 0 0 0 4 0 0 30 5 0 2 6 0 0 0 18 13 0 0 6 0 6 0 40 0 20 0 0 0 0 0 16 0 14 7 0 0 32 0 24 0 
33 1 0 0 0 72 0 0 4 0 0 0 0 20 6 0 18 4 0 0 14 0 14 11 14 18 0 0 0 0 0 0 12 13 14 1 0 0 11 45 0 0 3 20 5 2 0 18 
0 1 0 51 1 32 0 8 26 0 0 8 36 14 26 0 33 0 24 0 17 0 9 0 0 9 0 21 25 0 0 2 0 12 4 22 0 22 0 31 24 6 23 14 2 31 6 10 
0 5 0 24 43 0 0 0 0 38 0 0 0 16 0 18 5 0 18 5 0 0 6 5 6 0 0 0 1 1 0 0 5 18 0 0 18 0 0 0 0 0 0 0 41 2 0 81 
0 0 0 18 0 22 2 10 6 38 25 3 10 0 22 1 1 5 0 28 4 18 0 0 27 0 0 22 0 0 0 4 14 0 0 25 0 0 0 5 0 24 1 25 18 26 0 42 
0 24 29 1 27 0 6 3 0 37 0 0 0 0 20 1 11 23 14 0 17 10 0 4 22 24 0 11 0 8 11 20 16 7 20 15 5 0 16 0 23 5 1 0 35 2 0 0 
52 8 11 10 9 0 6 11 81 0 30 50 34 7 25 1 8 17 5 17 11 8 2 9 11 0 6 0 14 0 11 0 12 4 4 9 36 16 30 51 26 1 1 29 23 5 34 36 
1 2 4 2 28 1 8 0 3 0 0 0 0 19 7 0 5 0 0 0 0 24 15 3 0 0 3 0 0 4 0 2 9 27 0 5 0 19 0 18 0 4 0 0 5 0 2 0 
0 66 15 36 4 0 7 5 25 0 44 26 29 30 0 7 4 0 6 2 13 6 0 0 8 2 8 1 0 0 17 4 36 21 0 35 24 41 0 58 0 2 1 42 12 0 2 17 
0 2 16 0 0 9 2 0 19 40 0 14 1 0 0 7 3 0 11 3 13 0 22 0 11 17 0 5 19 24 0 0 5 21 5 0 0 17 21 18 0 0 0 28 17 0 2 33 
1 42 0 20 0 0 5 14 34 0 0 0 28 0 30 12 0 11 0 0 0 0 4 20 0 0 0 20 0 0 0 0 0 35 0 0 1 0 38 39 30 38 5 42 0 0 0 39 
10 0 8 0 20 0 12 0 15 45 0 0 29 0 1 3 4 9 0 0 8 0 20 6 7 21 11 0 0 0 12 22 23 0 0 9 1 18 0 0 0 0 6 0 0 41 2 0 
26 0 0 1 0 0 3 9 8 0 14 0 0 0 3 22 39 3 17 0 0 0 0 11 21 0 10 4 16 12 12 0 13 3 0 12 9 45 3 11 2 27 0 0 5 34 0 24 
0 0 44 48 37 32 4 0 11 28 47 0 2 7 29 11 30 16 11 24 10 3 7 13 26 0 0 10 18 0 16 3 7 0 8 6 0 41 17 38 16 32 0 57 32 0 44 53 
0 0 0 8 0 0 33 6 4 25 4 8 0 14 16 0 11 0 2 18 0 0 4 0 0 21 0 14 0 0 0 10 0 0 34 0 0 49 0 33 14 35 0 9 17 4 2 0 
16 0 40 0 0 26 3 15 0 0 0 9 0 25 0 6 26 0 0 15 0 19 15 13 0 7 0 2 0 16 0 24 5 6 15 0 3 5 22 24 6 0 75 0 6 62 10 0 
0 0 14 21 0 0 8 0 9 0 8 59 31 0 0 12 16 36 7 26 0 1 0 2 0 0 0 8 0 0 11 3 0 8 3 0 0 0 27 0 0 8 0 19 27 43 0 3 
11 0 0 0 2 0 6 0 0 0 0 0 7 13 7 0 0 0 0 18 19 18 12 20 0 0 0 25 4 0 0 23 8 20 15 23 0 2 0 45 0 28 0 0 19 0 21 9 
0 0 1 1 2 19 14 21 17 30 0 3 0 31 8 0 0 0 0 0 4 0 21 0 30 13 7 0 21 0 0 0 2 0 13 11 11 16 13 30 0 0 0 23 31 0 0 29 
0 0 1 0 0 25 0 0 0 26 0 0 16 16 0 26 53 6 24 18 13 8 0 0 0 0 10 0 0 5 24 1 4 5 13 31 4 18 17 20 24 0 0 10 0 0 11 31 
9 35 41 17 2 0 5 6 21 10 0 0 7 0 3 21 2 46 27 3 0 17 7 6 22 6 0 0 7 28 1 3 17 11 3 6 17 12 0 0 0 40 9 0 14 27 0 0 
