48 27
43 20 78 0 8 6 6 5 0 0 19 14 26 1 0 21 26 14 0 0 1 20 0 0 0 4 0 22 1 5 11 0 0 19 4 31 0 20 6 49 11 0 7 18 56 4 1 0 
15 6 2 0 2 0 48 1 20 0 34 0 0 3 14 0 7 0 0 11 48 0 0 0 0 0 6 0 17 31 21 5 12 11 0 5 0 31 0 1 21 13 11 0 23 0 20 16 
14 0 34 0 13 4 80 34 0 0 0 0 0 28 0 0 0 0 9 0 25 14 1 0 19 18 4 18 12 0 10 15 3 8 0 45 52 13 0 0 4 0 32 37 38 11 47 8 
19 2 0 2 19 12 0 14 26 19 0 0 0 9 0 0 13 9 0 0 0 11 10 0 0 14 14 0 23 0 0 0 7 12 32 3 0 12 8 0 0 0 1 0 19 0 0 0 
0 2 6 0 0 29 0 53 11 0 7 0 20 10 2 0 22 7 0 0 5 2 0 19 15 21 3 0 13 19 0 3 0 0 31 6 0 0 32 14 6 0 0 4 16 0 0 0 
0 0 3 0 0 3 16 9 10 17 7 67 4 25 0 0 8 0 25 0 0 18 0 0 0 0 0 0 0 4 22 0 0 20 0 4 23 0 11 27 0 1 3 43 33 0 0 41 
0 20 7 0 0 6 16 32 0 4 0 13 3 14 13 0 0 6 0 0 14 52 0 17 31 0 15 29 0 11 12 18 43 0 0 0 0 0 13 17 17 0 0 0 0 0 18 0 
0 1 0 0 30 0 35 6 19 14 0 23 0 1 6 0 15 10 2 21 9 1 0 0 13 0 0 23 0 0 0 15 28 0 23 0 0 2 1 2 13 0 18 0 0 14 0 0 
0 45 0 0 25 18 5 40 0 6 0 0 26 0 18 0 0 30 0 7 15 7 0 0 6 20 0 8 0 25 0 4 10 17 0 0 3 20 50 0 15 0 0 0 0 0 49 96 
0 30 0 23 2 12 32 7 7 3 0 3 31 0 8 7 31 10 24 0 15 3 14 15 9 5 0 7 7 2 0 32 0 21 0 28 0 11 32 0 2 6 2 16 58 0 0 37 
31 0 3 11 28 0 0 0 0 0 6 4 14 7 0 0 18 9 0 27 0 21 18 6 2 3 3 0 0 10 3 34 36 5 9 2 0 5 0 4 37 9 0 0 0 23 30 0 
47 37 0 19 0 0 7 30 0 0 1 5 0 10 23 0 16 0 4 5 0 26 9 0 5 0 0 0 0 15 18 1 38 0 0 0 0 52 30 5 11 0 24 0 0 0 0 73 
18 28 0 0 86 16 0 25 11 31 6 3 1 5 10 14 10 0 18 11 13 19 16 36 5 15 10 11 8 17 10 8 6 51 8 3 25 0 3 9 10 0 3 42 0 4 23 10 
0 0 10 55 0 0 26 12 0 6 0 0 0 11 0 41 0 0 0 0 0 0 0 0 6 5 0 0 2 0 1 1 26 0 0 0 0 5 8 0 0 0 2 0 29 0 43 0 
62 0 0 0 0 41 31 0 5 0 14 18 0 25 0 0 0 0 15 23 15 13 1 0 14 0 0 1 0 30 0 11 0 0 0 3 0 20 20 4 0 12 19 19 14 25 15 0 
7 0 0 0 1 16 0 0 71 7 12 11 28 0 0 0 16 0 10 26 0 2 12 0 0 6 0 21 2 9 8 3 0 27 0 5 0 4 24 8 94 0 5 14 0 3 13 39 
38 112 0 36 7 0 33 13 23 15 22 27 15 22 5 31 13 5 26 23 1 12 1 1 24 5 5 7 0 10 0 36 29 0 2 0 2 0 6 69 0 7 6 42 5 34 31 0 
0 0 0 0 0 0 0 31 12 10 4 8 3 1 9 0 0 1 10 0 17 2 0 8 4 14 0 0 6 11 13 15 0 0 0 3 8 17 0 0 0 0 2 18 1 0 0 0 
15 28 0 39 10 0 10 0 35 0 0 23 28 32 0 22 0 8 7 0 25 0 0 14 13 0 8 0 0 28 5 12 8 0 0 0 0 28 15 0 5 0 39 47 0 34 10 6 
39 0 0 7 8 43 41 26 0 6 0 14 26 12 17 26 31 1 0 19 0 0 0 7 3 1 1 0 2 0 0 0 15 31 3 0 0 3 36 39 16 26 10 10 0 40 0 72 
2 0 0 16 16 19 19 31 5 0 0 19 20 19 0 0 0 13 0 29 3 24 5 4 32 11 0 30 2 20 11 13 75 9 0 6 0 7 38 6 29 9 0 0 13 1 17 18 
0 0 0 11 0 6 33 4 0 0 0 0 0 1 0 37 0 18 1 11 0 6 0 0 0 0 19 2 0 0 3 32 0 13 0 0 0 0 0 24 0 0 3 19 0 0 20 0 
19 0 0 0 15 19 0 0 0 39 0 0 10 31 0 3 16 0 0 0 0 10 0 0 19 4 2 2 0 0 0 22 13 14 0 7 1 11 0 7 0 0 28 11 1 0 0 0 
0 31 0 54 73 4 11 40 0 0 0 0 20 0 17 1 1 5 0 16 0 17 5 22 0 32 0 20 0 22 29 0 21 5 21 0 3 0 0 7 0 1 4 6 5 0 0 45 
9 0 0 0 5 0 0 33 13 0 7 18 6 0 1 2 14 10 8 0 13 31 0 0 3 0 8 3 0 0 14 0 1 22 0 0 0 0 0 0 33 0 5 0 0 0 18 0 
38 31 0 0 0 68 20 36 12 0 3 34 7 22 4 7 21 0 12 13 15 0 0 0 6 37 4 11 9 18 25 24 18 19 0 3 10 1 49 2 19 16 21 16 0 0 0 10 
0 45 37 7 26 49 0 22 40 28 0 13 2 0 15 0 15 9 0 8 0 20 14 12 0 0 29 0 5 16 72 0 24 0 22 3 24 0 20 17 0 0 57 0 0 16 0 0 
