48 27
1 0 0 41 4 9 34 0 0 0 0 34 21 3 13 0 0 0 0 0 3 1 1 40 0 4 0 0 0 0 0 0 0 21 0 23 17 0 0 16 12 0 0 18 55 0 0 24 
0 11 40 16 24 0 0 0 36 5 6 12 23 15 42 14 14 18 0 24 0 6 0 3 0 0 3 0 15 21 19 4 1 7 25 69 13 0 13 0 0 30 25 0 3 6 16 5 
0 0 0 0 0 0 1 17 10 0 0 3 6 3 3 0 22 0 0 0 0 9 0 0 0 32 14 0 0 0 0 0 11 0 10 0 0 0 0 2 0 14 0 11 0 4 0 0 
0 12 37 0 33 1 39 16 16 0 14 35 9 9 31 0 4 9 16 22 19 0 0 12 0 19 11 5 18 20 19 14 0 19 9 2 30 33 4 69 3 22 3 0 0 12 12 0 
0 21 0 0 37 0 12 12 0 0 0 0 0 0 0 0 26 0 12 0 0 0 42 0 9 4 0 0 5 11 12 0 0 41 18 6 5 0 11 0 9 43 0 0 0 2 0 0 
5 0 73 15 0 0 36 0 0 0 0 12 21 0 44 6 60 22 5 0 0 6 0 5 2 0 0 13 0 4 2 0 0 21 18 9 0 3 0 0 41 30 26 37 9 0 32 0 
0 22 0 0 0 15 8 0 0 0 3 3 22 14 1 0 5 3 0 0 5 17 0 0 0 13 0 0 0 0 1 9 0 0 3 0 0 36 0 0 3 0 0 0 0 27 9 4 
0 0 48 28 0 21 0 0 0 44 36 19 16 0 17 0 22 32 4 0 17 36 0 27 19 1 0 13 11 6 17 0 21 18 28 4 0 0 19 3 0 8 14 10 0 41 0 18 
29 0 0 2 4 20 0 0 18 2 6 10 6 21 0 0 0 0 9 0 3 0 0 0 0 17 18 14 0 29 0 2 0 0 21 25 0 0 0 0 0 7 17 16 0 14 0 0 
18 33 0 0 0 0 34 0 5 0 12 42 25 0 0 0 6 0 18 5 14 2 0 17 0 14 0 7 0 4 22 4 0 2 25 1 35 56 17 33 0 0 0 7 0 34 0 0 
39 4 0 11 0 8 0 0 0 6 0 1 0 0 4 1 6 11 0 0 9 0 0 4 0 0 10 0 29 0 7 2 0 0 7 0 0 6 0 39 32 26 0 8 0 0 0 7 
9 0 1 21 0 2 15 3 0 0 16 32 19 9 0 0 10 0 18 0 26 17 39 19 8 0 21 23 0 0 0 5 8 9 4 33 3 0 0 3 6 0 13 55 1 0 0 21 
13 13 32 0 1 5 0 11 10 0 0 0 29 13 0 0 29 0 11 0 0 20 0 0 0 14 0 3 0 0 1 0 5 0 11 0 0 10 0 14 0 39 0 6 10 31 0 0 
31 0 7 0 38 5 0 0 13 31 0 2 11 0 0 0 0 5 0 0 7 15 23 5 0 19 0 23 0 9 7 27 11 6 19 0 14 0 7 0 0 11 38 0 2 13 9 0 
32 28 33 17 10 54 3 24 9 31 22 42 0 10 11 0 37 1 30 19 7 0 4 0 0 8 17 6 14 3 5 19 0 14 33 26 35 0 45 52 18 35 36 25 14 5 28 58 
7 10 1 5 3 3 49 0 6 0 0 18 3 17 22 4 34 24 3 27 12 2 3 14 7 8 3 16 8 10 2 2 0 5 0 7 0 4 6 33 23 7 0 0 25 16 20 35 
0 0 30 28 0 0 0 12 38 0 21 7 0 18 0 27 19 3 0 0 0 11 4 0 0 0 24 3 9 13 12 29 29 1 5 13 10 6 0 17 8 40 58 2 6 0 2 8 
46 0 99 39 9 14 35 26 0 37 6 2 5 0 3 0 7 48 31 16 0 31 0 4 18 13 0 17 0 0 13 14 0 11 0 11 13 0 7 0 0 67 1 36 59 0 114 0 
0 0 0 0 0 16 0 2 17 31 30 0 0 16 28 27 0 8 12 4 6 28 24 0 0 0 6 13 0 6 25 4 6 0 0 0 4 0 0 0 5 1 20 39 0 24 2 32 
0 35 0 33 0 0 7 16 16 0 0 0 0 7 0 0 15 3 0 0 0 8 0 0 1 12 0 1 0 0 6 0 0 0 10 7 67 16 4 0 0 12 0 7 0 17 0 0 
37 19 0 11 0 1 19 3 1 0 0 10 0 0 10 4 0 17 3 0 0 2 0 0 2 5 17 0 22 2 14 0 0 16 14 0 0 34 11 15 0 0 0 0 0 0 0 0 
27 9 0 0 0 18 11 0 0 37 5 35 0 19 0 0 0 11 8 0 0 0 0 0 3 3 0 3 0 4 0 1 0 26 0 0 1 1 0 0 7 0 0 12 1 0 2 7 
0 0 36 64 0 38 9 28 0 37 0 9 0 0 22 0 35 0 31 0 12 12 0 0 0 23 0 22 12 27 6 8 12 3 7 77 0 0 1 0 32 0 0 34 46 53 9 0 
0 23 20 0 6 36 0 0 22 7 21 15 0 73 4 5 21 6 3 25 22 0 34 11 26 26 0 10 3 24 33 0 0 0 9 51 0 15 1 0 0 22 0 0 67 0 4 1 
61 33 0 0 27 14 4 7 18 0 8 0 18 8 32 4 0 19 9 0 12 14 17 0 7 24 12 12 0 6 4 0 5 12 27 0 28 0 0 0 48 0 0 23 15 33 10 31 
6 30 0 13 0 28 15 6 0 0 5 22 0 0 2 15 0 17 13 53 10 1 24 10 0 18 0 0 0 5 25 3 24 12 26 32 10 0 9 0 1 7 0 0 25 0 46 10 
38 0 18 6 21 37 0 7 17 13 5 15 38 9 24 13 0 19 0 0 0 12 0 17 16 19 0 0 0 0 30 0 57 2 45 32 0 0 60 0 1 30 0 10 0 0 11 35 
