48 27
0 3 0 23 2 38 0 0 7 3 12 23 23 28 0 24 5 0 15 10 25 0 0 25 0 20 0 0 9 0 0 0 0 10 6 4 26 0 0 3 0 0 0 49 21 0 17 0 
36 41 21 2 0 13 6 0 0 0 13 21 15 4 0 2 10 12 0 0 8 0 12 0 38 0 10 18 0 1 14 24 15 0 22 23 0 19 0 15 0 0 24 0 0 0 22 26 
0 4 29 0 2 22 3 35 0 23 1 7 6 1 4 0 0 17 14 5 17 3 16 21 5 0 3 9 9 5 0 26 10 20 18 0 2 0 15 32 4 0 0 0 0 0 0 4 
24 12 0 3 36 0 0 0 46 1 19 2 4 12 0 4 20 17 8 0 0 23 0 10 0 0 0 36 0 0 18 0 0 11 1 2 13 0 0 0 36 33 0 0 0 0 0 0 
0 23 49 7 0 46 9 38 25 0 3 8 25 2 9 0 15 0 2 24 30 0 14 0 0 7 19 3 6 3 13 0 0 31 2 27 2 46 3 0 12 3 37 13 0 18 8 0 
0 26 36 0 12 0 0 71 52 36 9 38 0 0 23 0 12 24 20 39 0 32 24 0 0 0 2 11 16 4 6 0 19 0 17 8 16 23 7 0 29 27 56 0 0 17 32 39 
0 4 0 0 21 0 0 0 0 9 33 0 45 0 19 13 0 0 0 7 9 1 7 3 0 9 10 13 5 20 0 0 15 0 0 0 2 0 0 0 2 0 5 33 0 3 34 0 
36 18 0 5 0 15 35 34 0 5 35 0 4 0 11 0 0 8 0 8 0 40 3 0 0 16 0 7 5 0 0 0 0 2 0 2 36 0 3 0 2 72 21 0 0 35 0 11 
49 4 16 31 14 11 3 5 9 0 2 0 5 30 0 26 2 27 0 20 24 0 0 0 21 25 20 5 22 0 0 0 8 0 21 0 1 0 0 39 27 29 2 0 40 0 22 11 
85 4 8 26 0 17 0 17 0 0 38 7 0 5 32 13 12 3 4 0 25 16 4 0 17 3 13 0 25 22 0 0 0 0 0 0 2 17 51 2 0 2 4 44 0 0 36 47 
5 8 0 58 0 0 0 0 0 0 0 24 9 10 0 29 13 15 8 7 8 7 0 7 5 0 0 1 25 0 0 0 0 4 28 29 13 4 9 27 0 0 0 0 29 0 12 12 
32 11 0 0 3 22 3 26 14 20 5 0 13 0 0 0 0 25 3 0 23 0 14 5 0 0 19 13 20 20 0 0 14 0 14 35 12 7 0 0 14 0 29 12 0 0 4 0 
0 0 6 11 2 6 20 0 25 0 31 2 0 0 27 6 4 8 16 0 0 1 0 12 15 22 12 0 0 22 20 0 0 25 0 12 14 0 2 15 0 0 0 17 4 0 19 64 
0 4 0 0 0 14 4 5 19 0 5 0 10 0 0 0 0 5 10 0 8 10 0 8 0 0 13 0 0 0 1 0 0 11 0 8 0 10 0 23 0 0 0 0 11 0 0 10 
3 0 9 0 8 13 0 4 0 6 0 0 1 11 19 6 0 11 20 0 9 3 6 0 18 10 8 5 6 0 26 0 0 17 8 3 32 9 19 0 0 0 9 0 0 21 0 0 
5 0 53 12 40 0 43 0 39 0 35 34 1 25 32 0 0 27 16 8 18 16 0 5 20 0 0 25 0 0 20 9 17 10 23 7 30 0 25 6 0 0 7 0 8 0 32 35 
39 0 0 30 36 62 19 0 26 1 30 0 13 48 0 11 0 4 12 14 23 8 12 16 0 33 25 47 0 16 0 26 0 34 13 7 10 0 0 0 22 90 0 0 17 40 6 0 
0 8 16 0 5 15 16 22 22 23 5 0 32 0 13 14 9 0 0 0 21 8 0 7 8 0 15 0 0 21 0 0 26 10 0 11 29 0 3 71 0 0 0 0 67 0 16 0 
0 19 4 6 0 0 4 38 4 0 3 47 3 33 25 7 21 3 12 2 23 1 42 41 0 18 10 7 0 0 1 4 11 0 15 10 0 7 0 7 33 0 0 0 9 8 39 47 
0 5 0 0 19 32 1 24 0 5 8 23 7 0 0 6 29 6 0 0 0 0 0 20 0 12 21 0 0 3 4 37 0 0 26 0 0 12 9 19 35 11 0 0 14 29 0 0 
0 0 15 0 0 0 29 0 21 0 0 20 0 23 0 0 0 0 0 0 21 0 1 2 18 4 5 9 0 21 0 5 0 0 0 21 23 3 0 19 0 0 0 11 0 2 21 2 
40 0 0 31 0 2 24 23 0 22 5 20 0 0 3 31 0 3 0 0 8 6 25 0 4 0 20 5 0 18 50 2 27 3 31 8 16 0 0 0 45 5 0 9 2 1 79 0 
33 3 46 0 6 22 39 19 6 1 20 58 18 0 3 10 0 13 0 16 1 10 0 8 21 6 19 0 14 0 0 12 20 43 17 0 0 0 13 0 0 39 0 0 0 26 8 0 
0 0 14 0 0 17 10 3 21 0 0 14 34 0 7 0 11 0 6 27 8 13 17 12 0 0 13 0 18 0 0 5 0 14 31 31 0 9 0 35 0 0 0 25 1 18 60 21 
0 0 29 0 0 41 37 35 18 0 0 0 0 15 22 0 0 0 0 29 0 0 8 0 0 8 17 6 0 0 8 16 14 3 1 7 13 0 0 0 0 0 58 37 0 0 43 2 
0 43 0 35 19 0 0 0 21 29 3 0 4 27 19 16 4 15 0 14 21 21 0 19 13 14 6 0 0 0 0 24 0 20 0 0 71 0 64 0 7 0 3 0 19 0 22 0 
45 0 29 4 0 52 0 27 1 31 2 9 7 13 0 14 8 12 0 18 12 14 0 2 12 23 18 19 26 30 0 12 4 13 19 0 70 0 31 8 7 16 37 0 39 53 17 2 
