48 27
6 8 25 25 13 22 0 16 31 91 0 19 0 15 25 8 0 17 0 30 0 0 0 15 8 0 0 12 10 20 19 20 0 14 27 12 2 0 0 72 54 0 0 34 10 9 37 12 
43 33 6 0 22 9 0 28 1 5 0 0 0 6 12 0 6 0 0 0 0 0 4 12 10 16 13 16 10 31 31 49 0 9 10 12 29 24 18 2 13 5 0 0 18 1 26 0 
77 0 51 8 0 22 0 0 28 0 0 5 5 0 0 5 0 25 0 0 19 26 1 20 2 0 1 52 0 29 1 0 0 13 17 0 66 0 0 49 0 4 19 4 0 59 0 20 
35 7 14 25 4 0 38 0 22 0 0 0 9 0 2 0 2 6 19 16 2 0 0 15 13 16 1 1 22 18 0 0 0 0 6 61 34 0 0 22 6 0 16 25 44 0 26 0 
0 3 0 0 0 0 14 3 11 0 85 0 4 19 0 0 0 19 14 0 0 0 7 2 3 9 0 2 0 29 20 3 41 0 0 0 19 12 0 29 12 1 0 0 0 0 0 0 
2 0 20 16 10 0 4 0 0 11 0 0 0 0 21 0 17 9 0 3 16 9 0 0 0 8 15 0 20 0 14 10 7 18 12 20 0 0 0 12 0 0 0 0 2 25 2 16 
12 19 0 0 24 4 0 49 0 9 25 32 49 10 19 17 19 3 9 4 0 5 0 3 0 13 19 4 17 3 0 0 20 25 30 0 0 36 14 26 12 25 0 32 14 2 36 0 
7 5 15 0 15 0 26 43 6 3 0 3 33 14 27 27 17 13 0 2 0 0 0 11 11 9 1 51 11 2 21 4 10 11 4 6 0 8 11 1 0 27 11 74 0 0 0 0 
2 8 0 8 3 0 12 15 37 0 15 69 2 15 0 0 0 0 15 7 0 0 0 38 8 17 34 21 11 0 0 0 0 16 18 0 0 4 30 27 0 0 0 32 0 19 0 36 
49 1 0 3 9 3 44 0 17 1 0 0 0 9 15 9 0 0 0 0 0 0 0 0 0 2 6 0 0 18 0 0 0 0 34 4 1 0 0 23 0 0 0 0 0 9 8 54 
53 20 42 34 30 22 0 0 6 0 0 15 52 3 0 15 26 12 0 0 25 12 5 10 0 5 11 8 3 0 13 30 12 6 22 0 7 8 0 39 0 4 7 0 36 3 21 42 
6 41 16 28 0 2 53 26 0 0 0 0 12 7 0 4 3 27 0 0 0 0 8 0 10 7 0 0 0 26 0 10 0 27 1 0 9 8 0 0 0 17 20 0 0 16 34 0 
32 0 14 0 1 4 0 0 0 7 2 0 10 8 14 0 7 4 0 0 0 0 0 0 14 3 0 27 0 5 0 0 0 0 0 0 24 0 21 0 3 0 0 0 0 0 0 0 
62 0 39 25 54 0 3 7 0 0 18 7 14 3 0 41 0 12 0 2 3 15 0 7 17 8 3 16 7 5 0 3 0 0 16 0 36 0 0 0 4 41 0 0 40 25 0 13 
12 0 24 40 0 0 0 0 7 2 0 29 13 6 19 6 26 8 0 0 0 15 0 0 1 11 10 0 7 13 4 1 11 7 0 0 34 0 0 0 27 0 0 15 41 0 8 0 
0 41 44 44 29 1 7 5 41 14 10 5 0 22 0 0 0 13 0 2 0 8 19 2 6 1 0 0 0 4 13 18 0 6 0 24 0 0 0 5 3 2 41 4 0 4 44 28 
16 0 13 0 8 33 36 44 0 24 21 2 22 18 25 0 0 24 0 20 6 18 15 17 6 27 1 0 0 0 14 22 5 0 0 1 29 0 0 4 2 30 51 0 0 32 5 11 
24 14 29 0 11 30 0 40 5 3 11 0 11 9 0 14 7 22 0 0 0 0 0 11 30 0 14 12 3 14 21 32 0 0 25 9 2 0 0 12 4 0 0 0 0 4 0 14 
66 10 13 26 1 33 14 0 0 0 13 0 7 7 0 9 0 23 14 6 21 11 0 0 20 2 15 0 0 4 4 12 0 5 8 44 8 37 13 44 11 22 7 3 20 0 2 30 
27 9 9 0 9 0 13 0 0 0 11 1 19 9 0 0 30 0 24 7 0 0 0 0 7 22 0 53 1 24 9 19 0 0 16 11 30 8 0 18 0 23 14 0 18 4 0 3 
0 72 37 0 0 0 12 5 35 17 0 7 9 44 0 0 31 0 1 15 4 0 0 22 14 12 17 0 5 10 0 38 0 0 0 0 9 0 14 19 2 28 0 7 14 14 2 31 
31 0 0 27 29 0 0 0 0 4 0 0 0 0 0 0 0 0 18 0 0 0 20 0 0 29 0 3 0 18 0 0 5 42 0 0 18 0 0 0 0 0 2 0 0 0 26 0 
79 0 35 38 0 22 0 28 47 13 6 1 3 15 2 8 13 30 0 12 22 16 22 0 15 0 15 14 9 10 8 0 0 25 0 16 36 5 8 0 12 16 28 6 27 21 8 12 
22 27 37 0 0 0 0 46 25 24 0 0 9 33 0 17 0 0 0 0 0 2 0 15 0 0 0 6 37 0 28 0 0 49 12 6 29 1 10 0 0 0 0 0 0 0 45 0 
13 10 5 0 0 0 4 0 37 0 8 31 0 17 10 0 1 51 31 0 14 0 0 2 6 16 0 17 10 7 0 4 21 0 0 21 0 0 0 0 0 15 0 0 0 65 0 0 
0 0 22 0 7 10 0 0 0 0 4 0 0 0 0 10 6 41 20 0 0 34 17 0 29 4 0 14 37 0 0 0 28 0 0 0 0 16 20 48 0 17 0 0 0 14 4 0 
19 26 10 37 0 20 13 35 0 34 11 0 0 0 28 0 0 1 23 32 0 13 27 11 24 4 14 26 7 14 4 5 0 0 6 8 5 0 0 17 37 1 47 40 2 0 2 0 
