48 27
17 0 17 47 18 0 66 22 0 0 6 23 0 33 17 0 0 0 0 6 21 0 24 1 14 0 0 0 7 0 0 7 0 7 34 25 12 0 8 35 27 0 0 0 0 23 6 9 
0 0 17 20 0 8 10 0 0 0 0 0 0 5 0 16 20 27 0 12 0 6 8 10 21 19 11 19 20 0 24 9 17 0 29 0 30 0 3 7 0 5 23 0 19 0 12 0 
13 12 5 0 16 1 3 20 0 0 0 0 6 0 0 3 11 14 8 1 15 0 18 18 39 13 1 52 32 0 0 23 0 0 46 55 9 11 14 0 0 34 0 19 0 0 0 12 
0 37 11 30 16 0 0 24 4 8 0 1 26 3 8 3 23 4 3 16 0 0 0 2 10 2 5 1 10 12 39 24 8 42 36 21 24 3 7 13 17 0 0 0 0 11 0 11 
88 7 14 4 32 23 0 0 22 0 0 18 6 0 1 0 14 17 21 35 34 0 17 18 1 12 26 0 30 18 13 12 9 0 7 0 28 0 3 60 16 18 0 43 0 22 26 30 
41 0 0 36 32 20 35 0 0 0 19 21 1 0 19 0 0 7 8 0 0 21 16 0 21 0 0 13 9 6 0 0 0 0 0 22 0 34 34 0 0 32 0 37 0 17 4 20 
33 6 21 0 2 42 6 5 3 0 24 2 35 20 11 5 0 0 11 25 0 10 27 1 13 15 2 0 7 6 5 8 0 36 3 0 0 45 8 20 0 0 14 21 39 8 27 0 
10 0 13 12 28 32 5 39 38 0 0 12 12 1 0 0 0 4 0 10 0 6 0 48 0 31 0 0 0 6 26 0 0 7 0 0 0 37 0 0 0 0 0 20 0 0 77 28 
0 0 44 0 2 0 0 0 3 11 9 0 0 10 0 0 25 7 23 16 0 0 0 10 7 5 0 0 13 0 0 0 0 0 0 17 13 11 12 0 15 34 0 0 0 0 44 0 
0 44 0 17 0 8 0 15 0 6 0 0 0 0 17 0 0 0 28 0 17 0 0 0 0 20 3 0 13 24 5 17 0 1 1 5 2 0 0 5 15 1 0 15 11 13 4 0 
9 0 53 5 0 3 0 0 37 12 24 3 27 10 10 0 3 25 2 7 11 27 18 15 10 23 27 0 0 0 7 0 0 34 0 10 9 0 15 13 0 5 29 0 0 10 0 45 
8 7 0 41 0 20 17 38 5 9 40 2 0 4 0 0 1 0 13 0 0 0 0 9 10 3 16 0 8 6 0 0 24 0 16 4 0 0 38 11 0 0 0 0 3 25 0 0 
0 0 43 0 0 7 0 8 0 0 12 0 13 0 0 20 0 0 0 0 0 0 6 0 0 0 18 1 6 0 0 12 0 9 0 0 6 0 23 0 0 0 0 0 0 37 9 0 
0 38 0 0 34 1 53 23 3 3 0 6 17 0 8 16 27 3 7 0 0 4 15 0 3 5 13 3 0 33 4 0 6 15 8 8 0 1 32 3 2 0 14 0 7 38 0 0 
0 8 11 0 1 4 27 2 0 1 0 2 0 16 5 14 6 1 0 10 18 0 16 24 0 0 0 8 8 0 0 14 10 27 0 9 4 11 26 2 0 9 27 0 0 14 0 1 
13 10 10 0 0 0 0 0 3 0 0 7 3 0 0 17 24 0 0 11 9 0 0 9 2 12 0 0 0 3 0 0 8 0 12 0 0 1 0 0 9 0 0 0 13 0 0 0 
0 18 39 1 0 6 45 8 28 5 0 0 26 0 27 31 27 0 14 54 1 17 0 4 0 1 0 18 29 5 0 6 41 1 13 5 4 9 14 44 8 64 0 20 0 11 9 9 
27 3 38 6 17 25 0 0 0 5 21 0 30 0 33 13 0 31 12 0 6 21 0 33 0 0 0 0 5 0 11 0 0 0 0 8 0 0 0 0 8 16 9 0 0 28 0 0 
6 0 27 8 0 24 22 6 0 6 0 40 39 7 9 5 0 0 0 12 17 20 0 18 0 0 15 5 22 0 0 0 17 0 16 29 6 0 18 28 6 38 7 0 48 0 6 51 
33 46 2 7 17 9 23 0 61 10 8 4 9 1 0 4 1 5 0 16 18 23 0 11 0 1 1 0 20 23 0 0 6 33 0 0 5 30 24 28 0 5 0 7 23 15 7 46 
0 81 11 14 7 5 24 0 27 0 0 8 5 38 0 0 6 0 0 0 0 10 6 4 0 12 17 0 30 13 0 0 0 27 21 27 0 0 25 0 29 0 25 4 2 0 0 5 
54 36 60 88 0 67 33 6 20 5 29 39 33 29 0 7 0 10 0 0 29 41 0 17 24 24 23 16 9 26 0 0 21 8 0 22 39 52 38 19 14 31 17 40 25 33 16 0 
0 15 0 0 3 25 0 7 4 11 16 60 33 13 0 0 4 21 0 29 1 14 36 15 0 0 4 8 0 13 4 1 2 0 0 34 0 13 9 28 28 22 0 21 6 27 0 0 
6 0 22 0 4 0 7 3 22 0 11 0 42 16 0 7 10 0 0 0 7 15 0 4 22 21 0 7 0 29 0 3 0 0 8 17 0 0 11 5 0 1 43 2 11 0 14 25 
0 3 2 0 3 29 0 15 0 6 7 0 0 4 4 11 5 2 11 2 23 0 0 10 0 6 0 0 0 14 0 0 0 0 29 10 0 7 0 14 4 0 4 19 11 15 17 0 
40 0 6 0 38 3 39 0 21 0 1 0 0 0 0 0 0 0 20 0 9 0 0 16 16 17 0 11 18 12 1 3 3 0 0 7 17 0 31 16 40 0 31 3 8 68 7 29 
37 0 44 25 12 0 0 3 1 34 7 0 0 14 1 25 47 0 0 0 2 0 16 0 21 0 0 39 15 23 1 19 0 0 3 8 0 43 7 17 25 0 15 28 28 0 0 0 
