48 27
0 23 3 0 0 34 2 34 0 0 0 0 26 12 7 12 0 17 0 0 0 21 0 0 0 12 0 18 7 0 15 0 0 2 25 2 9 17 3 0 5 60 2 0 0 33 21 0 
24 0 41 20 37 0 3 35 0 0 0 0 22 0 0 0 28 0 0 8 58 13 0 1 24 21 0 0 0 5 0 0 0 9 8 0 0 24 0 0 0 0 43 0 28 0 26 45 
26 0 0 0 0 18 2 0 13 0 4 24 5 33 23 18 1 30 10 22 15 10 0 45 0 0 26 0 13 0 16 0 13 2 0 2 6 23 7 1 29 0 0 0 36 0 0 67 
0 0 0 0 0 12 39 19 0 0 2 5 0 10 1 16 1 0 0 0 0 6 15 8 0 10 1 19 0 15 0 0 4 0 0 0 6 14 0 6 0 0 0 0 15 45 23 0 
23 0 7 5 9 32 30 27 4 29 0 0 22 9 17 13 24 36 20 17 15 25 21 21 0 0 15 0 14 0 4 12 18 0 24 43 13 14 4 4 3 0 45 63 7 0 28 30 
0 21 0 3 0 4 0 0 21 0 9 0 0 24 23 0 0 29 0 0 10 0 17 19 0 17 33 13 3 0 0 0 0 0 0 8 0 1 0 34 1 0 19 9 0 19 12 18 
15 0 2 23 36 27 0 0 35 0 8 11 29 12 0 5 20 0 0 0 22 0 33 4 16 14 36 34 2 0 0 31 0 0 2 0 0 0 15 14 36 0 6 39 14 0 0 6 
0 15 0 0 0 7 0 0 0 15 9 0 50 5 20 0 1 1 0 19 19 0 16 0 10 5 0 7 7 14 0 22 7 1 8 0 27 17 0 0 0 0 0 0 12 0 0 15 
18 18 0 57 0 10 36 4 45 0 2 0 10 4 0 0 28 11 10 13 0 0 10 20 23 10 6 8 14 0 0 41 0 11 24 0 4 13 24 0 36 13 0 10 41 0 15 28 
0 15 3 6 41 1 0 0 0 0 0 0 0 8 10 34 0 0 0 1 7 8 4 17 10 1 0 0 0 15 23 15 0 0 9 0 0 0 7 0 0 0 27 17 12 28 1 24 
0 14 0 34 21 0 0 0 30 27 0 0 1 14 0 0 19 0 0 24 3 0 14 10 16 18 0 3 17 10 1 15 0 5 0 0 27 10 12 20 0 0 0 0 0 6 0 9 
14 40 7 8 2 5 0 46 4 0 0 0 1 0 6 4 0 0 0 16 10 16 15 0 10 0 9 0 0 0 1 1 15 0 14 5 0 18 3 0 0 37 0 0 15 0 0 40 
21 0 0 0 0 38 0 14 0 8 0 0 24 10 1 0 5 27 0 25 13 12 0 10 2 27 0 0 2 13 13 7 1 16 9 0 2 16 0 7 0 0 0 51 19 13 13 22 
7 0 0 68 2 16 0 0 0 9 12 0 18 3 0 0 0 0 28 2 29 29 0 0 0 0 0 15 0 5 4 5 20 0 3 32 0 4 23 38 0 0 15 0 0 0 54 0 
0 30 13 34 45 17 6 3 0 11 9 6 11 19 6 12 20 12 1 6 28 2 13 7 0 11 2 9 5 12 3 14 23 13 4 0 15 27 7 21 10 0 0 4 15 13 25 0 
26 15 4 39 0 12 5 0 4 10 13 27 22 33 14 30 6 0 15 0 17 12 0 0 7 17 0 18 0 18 13 10 13 14 0 9 0 8 14 24 0 4 35 32 7 87 40 62 
0 19 0 49 0 16 0 13 62 0 3 0 4 0 2 0 2 0 2 6 12 16 0 0 0 10 8 9 0 5 22 0 12 0 20 0 0 19 7 0 0 0 0 0 5 0 5 0 
0 3 29 0 0 9 9 63 0 22 15 4 0 0 32 2 0 17 13 4 15 0 8 10 5 2 0 12 0 12 0 7 39 2 2 0 0 8 6 32 0 12 0 11 0 8 0 0 
34 3 0 31 0 10 0 0 0 0 7 0 31 0 18 1 0 38 0 0 6 0 0 16 7 7 1 11 0 0 0 0 11 0 3 0 11 9 0 0 23 0 14 48 0 0 0 11 
0 1 42 18 23 33 0 0 0 24 0 0 5 0 8 9 0 38 8 4 0 0 0 0 2 0 6 15 24 20 5 0 0 0 6 0 7 35 0 0 31 23 43 0 7 0 29 0 
0 30 0 0 0 0 0 7 1 1 0 0 0 0 13 0 3 2 0 15 19 0 0 0 0 0 14 13 27 0 8 5 3 5 1 1 6 0 8 0 0 0 17 0 0 0 0 16 
28 0 10 0 0 26 5 30 0 36 3 0 10 0 0 15 0 28 0 52 17 2 0 0 0 0 0 1 10 12 27 26 7 0 8 0 9 36 15 7 0 8 0 3 25 32 32 0 
46 15 22 0 0 24 38 20 2 28 0 0 8 8 0 0 0 12 13 19 1 11 0 8 5 10 0 24 31 0 11 0 0 28 0 11 0 9 0 1 13 0 20 0 0 36 63 62 
0 0 0 37 0 0 22 0 15 0 0 8 14 0 26 0 0 13 0 20 0 0 27 0 0 13 0 0 43 2 21 22 29 0 7 3 6 3 34 0 0 0 3 0 17 23 0 20 
0 63 15 0 0 51 0 11 7 0 0 0 3 6 0 5 18 15 1 0 5 1 0 0 10 5 7 0 34 13 30 16 9 6 27 34 3 10 0 0 0 0 37 15 0 16 21 19 
10 0 2 0 28 37 38 0 0 10 2 12 36 23 0 0 12 21 20 3 4 1 6 11 0 3 11 3 0 3 20 12 13 5 9 0 4 30 0 29 4 0 37 4 38 28 13 2 
24 8 22 31 21 0 53 0 38 1 5 0 0 0 0 43 19 0 3 14 7 9 0 0 0 18 22 7 21 0 0 0 15 0 31 0 0 8 0 21 34 0 3 11 0 0 0 0 
