48 27
0 0 5 21 8 21 0 3 0 7 13 0 0 0 0 0 0 7 0 20 0 5 0 0 0 0 0 22 11 3 0 13 0 0 0 17 0 15 7 0 0 12 25 0 28 0 0 0 
0 0 12 23 3 0 0 0 16 31 29 0 27 8 30 0 0 3 22 2 11 22 6 0 0 10 26 0 0 15 0 40 0 13 0 2 0 0 6 17 10 0 0 12 0 14 0 25 
17 0 5 5 35 13 23 0 11 0 19 0 17 1 5 0 0 0 23 13 0 0 0 21 0 0 31 37 0 2 0 40 0 2 0 3 1 9 0 33 14 27 6 18 0 0 3 8 
50 19 44 0 15 38 24 0 0 0 0 2 5 5 0 0 20 0 15 19 14 0 0 0 24 0 24 22 3 5 0 18 0 2 14 24 17 19 7 0 0 15 0 26 0 14 44 23 
0 0 10 0 83 0 2 16 0 13 33 5 15 0 10 13 21 22 0 9 10 0 32 16 0 7 19 0 6 18 0 0 0 31 31 0 19 33 0 0 0 26 7 41 0 16 70 0 
0 27 5 12 0 0 0 0 25 0 7 22 9 0 12 0 0 0 26 0 9 0 0 0 16 0 0 0 13 2 0 4 21 12 0 6 7 0 2 31 0 3 8 0 3 0 28 0 
0 0 25 43 0 0 0 0 0 0 7 0 35 1 1 12 5 7 3 0 4 5 0 0 0 2 5 25 19 0 0 0 13 17 27 0 0 2 22 10 5 17 0 49 0 7 8 21 
0 0 0 0 4 0 15 16 0 11 0 0 16 3 0 40 0 1 13 5 0 17 0 30 4 3 20 0 0 0 0 0 0 0 0 0 0 0 10 0 0 35 0 0 1 11 31 24 
10 14 0 47 0 14 0 78 4 26 0 0 37 1 33 11 0 0 0 14 6 13 6 0 13 11 0 3 6 0 11 0 0 0 0 26 0 0 0 13 33 26 41 0 32 0 32 44 
0 0 21 19 0 0 14 0 0 0 16 5 21 14 8 5 0 16 25 1 29 9 4 19 0 11 24 15 9 24 11 0 2 8 29 0 0 8 4 20 7 0 23 6 0 31 0 5 
1 1 8 0 36 24 21 13 0 0 12 29 4 4 0 0 0 1 2 1 11 0 12 16 0 0 0 7 4 24 0 9 0 18 0 2 0 0 6 12 7 6 6 0 6 0 0 0 
0 10 9 10 0 11 3 3 6 25 29 3 36 7 0 11 16 0 13 0 23 25 0 3 0 10 11 3 9 0 6 0 16 9 7 0 10 59 0 18 5 0 0 12 11 10 18 35 
0 35 10 31 9 43 0 0 0 1 0 0 17 0 0 0 0 5 0 0 16 7 0 7 31 0 3 0 2 24 0 0 20 3 43 0 36 0 2 1 29 8 0 10 0 0 22 0 
0 21 12 81 15 0 0 12 2 1 26 1 6 22 7 24 0 0 9 12 6 0 36 19 15 22 8 6 18 0 6 0 4 0 0 20 8 15 0 0 0 38 0 21 0 0 18 0 
0 77 29 56 0 0 0 4 0 11 0 29 12 41 10 0 12 7 0 0 12 0 2 3 19 11 0 0 12 0 28 10 3 6 23 1 0 31 18 1 0 38 41 0 31 0 6 0 
9 18 20 8 2 8 0 10 37 5 27 2 0 9 27 26 30 5 0 6 47 15 2 17 6 0 13 24 0 0 9 0 44 24 0 11 0 7 0 7 3 9 28 2 11 12 43 26 
0 6 0 12 0 1 0 16 6 24 2 22 10 30 0 12 2 4 15 2 0 8 35 17 8 12 15 0 2 20 17 8 0 0 0 13 0 2 0 15 0 6 0 0 0 32 6 32 
43 32 0 9 24 0 6 19 25 35 6 32 0 0 8 36 25 0 20 17 3 2 9 7 4 10 33 9 4 6 10 14 21 44 14 17 9 0 12 17 28 25 0 43 35 26 0 0 
10 0 14 16 15 0 0 12 0 0 29 0 10 4 0 0 14 2 5 72 0 0 3 11 16 0 0 0 0 17 0 0 1 0 8 3 0 16 3 45 16 24 10 0 0 0 0 0 
22 18 0 0 7 5 11 7 7 17 0 0 33 1 21 3 0 11 3 7 13 7 4 7 11 0 0 6 14 0 11 8 13 1 1 0 0 23 9 19 6 0 0 10 0 0 0 9 
0 2 7 14 0 4 4 0 7 3 72 0 0 0 7 0 16 33 0 17 0 0 0 3 0 15 4 5 9 0 4 0 0 23 0 5 0 0 21 19 0 18 0 0 34 0 0 14 
13 46 89 21 1 18 0 13 13 0 21 3 4 25 0 5 0 7 2 1 27 0 3 30 21 23 0 12 0 16 28 0 0 0 2 12 2 0 15 5 38 28 6 10 1 34 0 39 
2 62 0 20 0 20 4 0 4 0 0 12 0 2 8 0 5 6 62 30 3 10 0 20 5 25 39 49 0 0 0 0 0 0 16 0 20 4 7 33 21 14 0 34 15 1 30 0 
0 20 17 0 0 0 59 20 23 0 26 0 0 2 7 15 1 0 0 17 10 14 29 24 0 19 19 26 0 15 6 1 10 0 0 0 20 4 22 25 21 30 0 0 21 0 0 24 
0 50 40 0 14 0 0 11 0 0 14 17 0 21 23 13 0 0 14 0 0 0 0 0 37 0 0 0 0 24 11 3 0 0 0 1 0 23 3 15 0 11 67 0 43 0 7 1 
18 12 20 14 3 0 12 0 2 13 1 36 16 14 19 0 0 16 0 25 7 0 15 0 11 11 29 11 3 3 10 23 3 23 0 29 0 0 0 24 42 35 25 10 58 0 20 48 
36 2 0 44 0 0 6 0 0 0 18 0 0 0 0 4 0 0 0 4 0 25 2 16 2 0 24 21 0 5 0 25 0 16 30 0 0 0 0 36 0 5 42 0 41 0 0 24 
