48 27
0 0 0 23 43 18 0 12 4 16 13 0 0 0 0 0 18 4 0 0 17 4 0 8 15 0 0 20 0 11 0 23 0 31 23 22 4 6 7 0 4 0 38 3 0 0 3 7 
0 0 2 0 20 8 0 0 33 48 13 28 12 8 0 0 0 0 3 0 0 5 0 0 7 19 17 33 6 0 0 0 0 5 0 0 0 10 5 0 31 50 39 0 16 37 42 0 
10 35 0 12 12 23 0 94 0 0 3 8 49 28 1 11 7 0 0 10 0 9 10 0 0 8 0 5 39 10 19 15 0 2 0 0 7 0 18 0 0 24 59 38 0 0 39 15 
8 22 47 0 45 12 2 13 8 21 0 16 0 28 0 3 12 0 2 2 17 0 20 0 0 0 0 14 12 27 0 0 10 7 0 0 0 0 31 0 15 14 30 0 40 0 10 7 
0 44 31 8 39 0 2 21 0 0 26 3 0 27 16 12 5 0 0 0 13 0 0 16 11 21 0 0 13 1 2 6 9 18 21 12 44 2 0 5 0 0 0 0 0 102 0 0 
8 0 0 63 0 0 0 15 0 0 43 11 0 30 3 19 0 0 0 0 15 17 0 0 0 1 0 0 0 0 0 3 21 0 0 7 7 27 0 0 3 21 0 26 0 42 0 8 
0 47 14 29 0 0 4 0 0 22 36 45 11 51 0 1 0 49 0 22 14 8 11 6 4 19 4 0 0 5 10 31 20 8 8 0 0 0 0 22 23 9 5 0 11 14 33 28 
22 18 7 1 1 6 6 41 7 9 6 6 32 0 12 23 27 0 47 0 4 0 0 42 11 0 4 0 5 0 18 14 22 0 0 22 9 6 9 0 5 23 13 3 40 0 15 0 
0 41 0 33 1 0 40 18 32 26 0 0 8 9 5 29 0 29 0 16 5 0 8 0 5 23 3 0 0 13 42 5 0 0 0 0 18 0 0 30 32 0 12 13 29 0 11 0 
15 0 0 0 0 0 28 35 0 61 0 0 8 0 0 15 5 0 17 0 8 17 0 2 0 18 8 0 8 0 9 0 0 1 28 4 0 16 0 16 31 17 1 8 0 19 0 5 
40 19 10 21 2 1 45 0 9 32 15 6 10 12 0 38 3 9 0 0 10 9 0 11 4 9 0 0 0 0 0 17 23 23 0 0 8 0 14 26 129 41 11 0 38 0 16 27 
45 5 35 58 0 0 0 0 25 17 6 0 13 29 2 0 23 8 10 0 6 0 0 20 27 7 29 13 24 42 27 17 7 0 14 11 0 35 2 16 8 10 13 27 17 48 18 4 
7 0 0 25 2 0 28 42 18 26 24 14 1 0 30 31 10 0 0 0 8 14 41 8 0 0 26 24 2 0 19 22 7 0 32 0 0 0 11 0 0 4 4 0 78 23 35 0 
25 9 0 0 3 0 0 11 7 0 0 44 5 0 14 11 13 0 0 0 0 9 0 0 11 0 0 2 0 0 0 2 0 0 7 0 3 0 2 0 24 30 11 0 0 0 10 3 
8 0 50 0 16 24 0 0 8 12 30 0 32 6 16 0 0 2 8 2 0 0 0 0 17 31 13 20 0 24 0 0 0 0 0 42 14 0 0 0 4 3 8 6 35 0 0 0 
0 4 0 0 16 26 0 3 0 0 0 0 20 0 0 18 4 6 2 3 17 23 16 1 0 4 0 0 12 4 0 27 21 38 0 21 0 17 5 0 3 19 2 8 0 34 11 23 
39 39 16 0 51 21 14 25 38 16 26 5 18 1 11 4 6 8 4 24 9 0 0 6 5 36 27 13 0 9 0 14 26 13 4 15 34 1 0 44 41 4 0 1 6 53 42 4 
0 15 40 7 0 0 4 40 24 7 6 0 0 42 3 0 9 0 12 0 17 0 51 4 0 1 1 20 0 2 0 0 5 0 0 13 0 15 6 26 0 3 42 14 31 0 14 59 
0 47 18 1 0 14 1 0 4 0 0 0 6 0 0 4 18 0 0 15 2 21 43 0 0 2 7 5 2 0 12 7 5 0 0 0 10 0 26 0 6 29 16 17 43 23 0 0 
18 4 0 0 0 12 17 1 13 22 0 0 3 0 13 0 0 7 22 6 21 0 0 0 0 6 0 0 0 4 17 26 9 0 2 0 0 7 7 0 31 5 1 0 0 0 0 41 
3 12 16 17 19 30 4 19 44 35 0 4 0 0 0 25 0 0 0 0 24 9 8 8 0 22 0 5 0 19 9 11 0 0 12 6 0 5 26 35 25 0 63 44 19 37 3 38 
0 28 0 0 0 1 21 18 0 12 1 13 11 0 0 22 29 0 0 0 0 0 0 10 15 0 20 20 5 51 0 0 0 7 0 0 0 22 0 2 12 0 2 0 2 62 0 0 
1 19 2 20 10 41 1 0 29 0 60 0 0 0 0 2 12 0 0 6 0 26 15 8 19 8 9 9 0 0 7 0 0 0 0 11 0 41 0 0 17 0 4 22 39 10 2 0 
21 0 0 3 0 0 37 0 0 2 0 22 5 0 0 0 0 32 5 0 10 4 13 33 0 13 1 12 0 0 10 20 15 0 23 5 0 0 15 12 0 5 36 0 9 0 9 23 
0 5 42 10 0 5 5 0 0 3 0 0 12 11 10 49 11 0 17 0 0 6 7 22 16 13 0 0 0 5 15 0 0 0 5 17 0 0 0 0 0 5 0 0 49 8 0 11 
0 9 23 10 6 2 0 0 14 20 14 34 0 0 0 3 18 24 3 0 0 0 24 0 9 18 7 10 26 20 18 7 4 2 0 0 15 0 9 14 0 1 0 0 0 34 24 9 
0 19 12 11 13 0 25 40 0 2 0 27 4 25 0 0 20 6 12 0 16 0 18 0 2 9 0 0 26 17 24 33 11 21 22 5 2 2 72 6 5 42 4 0 4 15 2 0 
