48 27
90 14 2 88 0 0 0 0 0 0 0 24 1 1 2 22 44 27 15 0 20 21 0 0 14 0 0 20 16 0 2 7 10 0 20 0 0 0 14 39 4 28 2 0 16 0 90 27 
23 18 15 0 14 0 0 0 28 0 0 6 8 0 42 0 5 0 0 10 2 17 0 18 14 3 0 17 0 10 16 0 0 0 21 0 33 8 19 0 26 5 2 0 0 0 8 0 
0 67 11 7 15 31 0 13 2 20 11 0 0 0 0 31 0 0 0 0 49 1 0 0 0 0 7 0 0 0 0 0 17 7 12 0 31 15 0 0 0 26 41 0 0 0 0 0 
0 66 43 0 0 0 20 3 0 7 29 0 0 0 32 24 4 6 10 2 0 15 4 30 22 0 4 0 3 12 29 38 10 0 0 9 0 0 0 12 0 4 2 20 0 43 54 46 
39 26 25 0 17 38 0 18 31 12 3 0 28 11 0 3 44 0 0 17 11 4 19 21 0 15 18 25 0 0 22 5 16 31 0 3 0 28 9 39 0 48 23 38 7 18 0 13 
10 0 0 6 0 0 5 0 16 39 21 22 0 0 0 0 5 17 0 3 0 7 0 0 16 0 13 1 2 0 0 0 3 5 3 3 2 8 27 8 6 18 19 17 1 8 38 0 
13 0 0 2 36 0 38 3 2 10 2 0 0 5 14 0 3 11 8 10 16 0 0 10 16 13 7 5 11 26 28 28 0 36 6 6 13 1 26 16 0 0 0 6 38 0 16 0 
29 22 0 27 0 0 15 0 0 2 0 6 0 0 33 21 0 0 0 8 15 4 18 0 23 0 7 0 3 0 3 7 2 7 1 6 0 0 0 0 0 21 1 0 9 0 0 17 
0 4 0 1 0 2 5 2 1 0 1 1 0 30 39 0 19 0 3 7 0 20 0 7 10 6 0 4 0 17 9 9 1 0 1 36 7 0 16 3 27 0 9 29 15 0 0 16 
14 0 52 6 40 0 0 0 15 9 0 30 18 27 26 0 0 13 45 0 0 0 0 13 22 0 8 14 4 3 11 0 30 1 1 22 0 1 8 4 10 41 0 3 47 27 7 6 
7 9 6 0 20 23 0 0 32 0 19 0 29 2 17 10 2 23 2 0 0 0 0 9 0 0 11 0 20 3 18 7 10 21 1 17 0 24 6 12 55 10 32 20 0 0 7 0 
0 13 1 27 0 0 36 0 0 3 1 11 0 0 2 1 1 0 0 0 0 11 4 17 16 0 0 5 12 1 0 0 11 0 3 0 33 15 0 58 22 0 0 0 0 0 0 0 
13 13 1 0 24 18 0 0 0 27 13 5 11 15 0 51 0 26 0 2 14 22 3 18 0 21 12 4 19 2 4 0 3 11 12 5 14 0 12 9 13 40 31 0 28 0 0 50 
0 0 18 0 2 0 0 36 0 14 45 0 5 1 0 6 0 0 6 10 9 0 0 0 0 0 16 0 4 12 18 0 8 0 0 6 0 7 0 0 0 0 16 35 33 6 15 0 
0 8 22 23 0 29 0 25 26 19 15 0 33 0 2 5 9 0 0 6 0 0 0 8 22 0 7 18 20 1 2 18 8 2 1 13 0 10 0 0 0 0 0 6 17 76 0 0 
6 41 13 0 50 0 14 22 0 20 7 0 0 38 6 0 3 3 0 8 32 1 6 0 0 0 0 8 10 1 0 0 0 9 21 0 0 9 9 11 31 0 32 0 0 1 0 6 
0 34 15 34 15 0 0 0 4 24 5 0 0 12 6 8 0 27 3 5 0 13 2 0 2 24 0 29 9 1 5 13 16 24 0 7 0 70 9 0 0 0 0 0 50 0 1 9 
43 3 27 26 35 28 30 27 4 6 3 15 13 30 21 14 13 17 11 0 2 0 9 0 11 36 14 1 12 28 9 2 35 35 58 4 52 48 22 28 15 0 4 7 40 17 33 62 
0 0 0 20 6 0 0 0 0 0 0 24 0 16 29 6 0 24 0 10 10 0 0 20 0 4 3 17 8 19 2 0 0 3 12 18 0 0 21 0 0 0 0 29 0 5 0 13 
0 18 16 0 7 0 0 0 0 0 0 16 28 11 0 12 8 5 14 25 8 0 0 9 0 0 0 28 15 1 0 0 9 17 0 0 18 0 0 10 13 14 6 0 25 18 34 0 
15 0 26 14 30 36 72 0 70 13 15 21 0 22 0 2 3 6 1 0 5 0 16 15 0 1 0 4 12 14 0 9 0 0 90 22 3 0 0 0 13 69 0 0 0 0 35 0 
4 12 0 17 23 0 0 0 0 0 0 0 4 12 15 0 25 0 12 0 5 0 0 7 20 5 23 7 0 7 0 13 0 3 18 0 0 0 0 0 0 0 0 0 41 0 0 0 
0 68 0 22 0 0 11 4 0 19 0 31 22 26 20 13 29 13 7 0 16 14 0 0 16 27 38 0 6 0 0 14 8 0 27 4 2 0 0 21 9 0 31 0 0 11 17 0 
19 39 3 18 0 4 20 0 14 6 0 0 0 32 31 38 11 32 3 7 0 16 5 3 0 0 0 4 5 6 0 0 17 9 0 7 0 0 0 38 0 28 0 0 15 33 1 17 
41 39 16 0 20 22 0 0 13 0 10 0 15 1 27 30 0 29 36 0 6 13 4 0 2 4 14 11 0 13 0 11 17 32 0 0 20 14 7 21 0 16 15 19 0 0 2 0 
0 23 0 0 0 34 21 14 0 0 0 20 0 6 0 0 1 0 25 0 10 20 13 16 0 0 0 41 13 0 23 0 0 0 3 8 0 0 0 62 0 2 0 25 0 0 5 0 
21 24 0 12 8 0 0 0 0 8 3 0 5 0 14 17 27 3 17 0 0 0 40 0 2 16 0 0 0 0 26 1 17 16 4 0 0 0 38 0 18 0 0 0 0 0 9 0 
