48 27
0 21 0 12 0 21 7 7 29 7 0 0 50 29 7 7 0 11 0 4 0 11 0 0 13 0 0 8 0 5 17 13 0 0 26 0 6 0 48 0 0 33 0 0 0 0 0 15 
37 36 22 51 24 37 16 0 0 36 0 9 23 20 0 0 2 26 5 57 0 3 7 23 49 0 0 16 8 7 0 8 1 1 0 16 59 30 22 0 6 60 7 20 17 57 0 9 
0 0 10 0 14 12 0 33 0 0 0 27 21 0 14 0 1 12 0 8 0 0 0 0 0 18 13 21 0 10 14 0 20 0 3 9 0 4 16 23 33 6 0 14 23 9 19 0 
40 37 0 0 0 26 11 0 0 0 36 0 35 9 0 0 0 11 0 0 0 6 19 10 0 7 12 6 40 10 0 11 27 10 0 23 12 20 42 1 1 18 0 0 0 9 10 26 
43 12 62 20 0 10 13 22 0 26 0 11 2 43 16 19 2 2 19 11 0 5 9 11 13 12 11 16 7 22 16 0 4 1 40 0 7 0 22 0 17 28 0 7 0 24 30 5 
11 0 0 23 1 0 0 1 0 12 0 34 31 0 9 46 0 13 1 14 17 5 0 4 0 0 28 0 0 0 0 0 0 0 23 0 0 0 0 0 23 27 39 31 0 0 4 0 
5 0 0 8 28 0 7 0 3 26 20 8 0 9 19 17 0 0 15 6 21 1 9 0 11 0 17 9 0 0 3 20 0 0 0 26 0 0 0 0 0 1 0 13 0 15 2 8 
8 0 0 0 20 6 0 5 0 7 10 22 0 0 0 1 18 0 0 0 11 0 0 0 42 19 0 1 1 0 0 0 21 4 0 12 0 23 0 15 6 6 0 0 33 34 19 0 
0 37 0 0 0 33 0 0 0 0 0 34 6 41 12 16 14 0 27 26 13 5 1 4 0 0 0 11 6 0 11 4 4 13 0 2 0 0 48 65 29 10 1 0 0 27 0 4 
7 58 40 3 0 30 4 0 20 1 0 27 0 0 1 1 5 13 5 10 4 25 1 8 0 0 0 3 0 1 7 0 7 14 29 0 0 0 27 2 0 4 15 20 0 0 37 44 
0 34 0 0 0 0 11 0 10 0 0 0 0 0 0 0 0 24 19 35 5 6 0 0 0 12 0 30 0 1 0 9 0 11 0 32 0 0 0 0 21 0 0 0 28 0 0 9 
0 0 0 41 27 14 0 35 0 0 1 0 20 30 7 34 0 4 0 0 0 0 0 0 0 0 0 4 0 19 18 27 5 0 24 2 0 0 2 0 0 0 35 30 6 0 0 3 
5 11 5 12 0 74 0 2 21 0 16 6 5 4 0 33 7 29 6 19 3 19 15 13 1 0 29 11 7 0 0 4 0 0 29 10 0 15 2 20 27 10 0 0 39 9 15 19 
0 69 0 24 43 14 21 6 37 0 9 0 17 28 14 0 0 0 46 0 0 10 4 0 0 0 0 10 10 25 8 8 19 0 33 39 0 0 33 1 0 28 37 0 23 81 28 43 
15 0 0 4 0 10 0 6 8 0 0 27 0 25 9 2 25 2 6 22 17 0 9 0 4 0 2 0 36 3 0 11 14 11 0 0 3 0 27 36 5 47 5 0 11 0 14 42 
0 0 37 11 0 0 0 0 15 0 12 0 6 23 36 32 0 30 8 15 1 1 0 0 4 19 17 2 23 15 0 0 0 0 0 21 23 0 0 6 0 18 7 25 23 30 0 0 
18 94 100 80 44 1 8 2 0 16 13 47 0 0 11 14 0 28 7 0 6 9 8 30 23 0 0 0 0 13 9 0 0 27 14 3 16 0 36 37 0 85 8 39 21 14 80 0 
3 3 47 23 0 21 16 10 12 10 0 3 19 113 4 1 18 16 2 12 0 5 14 0 0 28 22 12 5 0 14 16 0 4 15 9 0 15 0 0 32 14 4 0 31 21 44 18 
89 0 3 0 2 0 18 46 6 9 36 0 0 26 10 14 16 11 9 0 19 1 0 9 40 0 2 0 5 14 0 0 0 37 0 13 18 33 56 4 11 8 0 35 8 5 39 19 
2 29 5 40 0 0 6 8 19 32 30 8 0 0 0 54 8 24 6 31 13 0 0 0 12 0 0 22 0 5 39 6 8 6 6 8 29 4 19 0 35 16 5 64 7 27 31 21 
31 3 33 0 0 0 0 7 18 21 0 0 3 0 31 8 0 0 6 17 0 0 0 0 0 0 18 18 5 0 21 0 0 19 0 33 0 0 0 14 0 2 0 0 0 0 0 28 
0 45 33 32 20 21 0 0 2 7 18 0 0 0 1 30 0 0 15 4 0 0 0 0 0 24 0 17 0 0 10 29 0 2 10 5 0 0 4 0 1 0 11 0 0 30 0 0 
43 26 18 25 0 28 0 0 19 0 12 13 0 11 4 33 3 16 7 0 14 0 0 0 0 22 0 31 18 2 5 0 0 5 2 0 9 0 0 34 0 0 30 66 0 2 0 0 
12 3 11 2 41 24 0 19 0 0 8 22 26 11 0 31 16 19 0 12 4 6 0 0 16 13 0 20 0 2 17 15 28 23 0 0 13 20 22 0 0 9 0 7 8 41 46 0 
0 0 0 0 31 0 0 1 0 2 0 0 9 6 0 0 0 6 9 6 0 0 0 29 0 0 0 9 0 22 0 2 0 2 15 29 0 0 16 0 5 0 15 0 0 0 0 0 
23 0 0 16 14 36 31 0 18 0 0 0 29 0 2 10 18 0 14 0 17 0 0 23 0 8 7 0 10 0 7 0 0 2 31 2 9 30 1 23 25 29 27 0 0 9 30 33 
0 11 8 33 0 3 0 0 17 36 37 0 0 34 0 0 14 11 9 20 0 0 4 0 22 29 21 12 20 0 15 12 0 0 0 1 39 23 0 8 0 0 16 0 27 0 2 23 
