48 27
18 2 38 3 79 6 49 26 34 3 0 33 0 5 29 0 0 1 15 0 0 0 0 19 7 0 11 71 19 21 0 15 0 0 0 0 7 35 0 82 50 1 0 29 30 0 2 0 
1 19 24 31 4 0 0 12 63 30 0 18 35 0 0 0 0 24 8 6 21 0 3 14 6 0 6 3 0 0 2 32 3 10 64 3 0 7 22 30 22 55 12 22 43 7 40 6 
1 0 11 0 30 23 0 3 1 14 36 0 0 18 5 0 0 4 2 5 20 4 6 0 15 0 20 25 0 0 0 18 0 3 30 28 14 0 31 20 23 1 16 0 4 0 0 23 
0 9 8 0 6 0 5 7 0 24 0 37 5 0 23 20 6 6 18 0 28 0 13 8 0 2 17 0 3 27 16 0 0 0 0 0 0 10 27 20 0 0 1 4 6 43 2 0 
0 0 91 0 0 0 0 36 9 30 0 0 30 70 8 3 0 6 16 6 21 0 7 16 4 6 0 0 20 0 13 0 0 0 5 26 0 10 25 40 3 20 7 5 4 22 27 0 
2 38 2 0 0 0 0 24 0 0 2 0 0 32 0 0 0 2 0 21 0 0 0 15 0 0 0 8 9 6 0 24 0 7 0 0 0 1 0 40 0 0 17 9 3 25 0 5 
0 13 25 1 0 51 0 0 0 0 0 0 0 11 2 14 21 0 12 0 0 0 8 11 5 0 40 4 15 11 8 7 7 0 42 2 5 18 0 7 0 40 0 18 0 0 0 0 
0 12 17 8 14 5 38 0 9 100 7 13 0 31 15 21 19 11 10 4 0 0 18 1 6 42 25 0 13 12 8 0 0 24 10 9 7 8 0 6 0 50 33 12 108 24 0 0 
41 35 42 0 71 17 5 0 0 0 0 0 32 42 2 10 8 15 3 6 0 1 0 0 8 12 7 0 7 0 15 5 28 36 0 2 36 5 25 0 0 41 37 39 30 11 24 21 
34 35 35 22 0 13 0 0 39 24 26 36 22 87 0 0 5 0 5 22 0 1 1 0 16 30 0 11 0 14 3 3 27 32 12 2 15 33 3 7 1 50 3 14 20 5 13 31 
0 45 0 0 10 0 0 0 0 30 0 36 11 10 4 0 27 0 4 7 0 0 1 19 0 0 0 0 0 0 9 0 0 9 0 0 10 3 8 36 0 6 0 29 0 9 34 21 
59 22 43 34 5 66 30 0 16 7 1 18 14 51 0 0 0 0 30 14 8 8 20 19 3 21 14 25 17 6 0 3 24 32 12 30 29 37 2 0 28 0 0 30 27 4 14 27 
43 0 0 0 29 37 0 41 11 0 0 10 7 0 0 0 16 3 0 14 0 0 0 5 6 0 0 27 14 0 0 12 0 16 0 0 1 7 0 32 0 0 3 12 1 7 0 0 
2 0 17 0 33 0 25 0 3 18 0 0 9 0 26 0 8 0 42 2 16 9 15 0 0 0 0 5 8 0 0 25 9 15 0 0 0 40 11 19 21 9 2 0 2 14 7 0 
0 0 0 0 8 18 7 27 0 0 0 0 6 0 0 10 0 18 4 6 22 0 0 20 1 6 3 14 0 10 0 34 0 0 27 18 14 0 18 22 0 0 9 9 2 16 15 0 
1 14 1 10 2 0 1 0 15 10 13 0 0 0 0 13 16 3 8 0 0 20 0 0 6 0 0 0 11 16 0 15 16 15 4 11 0 8 0 6 0 12 0 0 0 20 2 0 
24 0 32 0 1 4 18 38 0 0 0 34 0 31 0 0 7 0 26 0 0 0 10 16 4 0 0 18 4 0 15 0 0 31 0 0 5 0 0 0 34 1 1 1 5 37 0 15 
17 17 0 0 45 1 0 19 42 0 8 11 0 0 3 28 11 23 10 0 3 17 26 3 5 0 19 23 0 5 13 0 56 17 26 16 29 38 26 0 6 16 0 28 0 1 0 8 
18 18 0 6 26 18 0 0 27 0 0 5 1 0 0 0 0 0 13 19 2 0 0 0 0 0 0 20 0 24 26 0 0 0 14 35 0 1 7 1 20 17 0 0 0 11 0 0 
9 31 0 1 8 7 39 8 0 9 11 8 0 6 9 1 27 0 0 0 0 0 7 0 0 0 16 13 16 20 0 0 6 22 12 0 0 29 43 0 19 3 0 33 13 39 24 0 
0 22 0 10 27 30 0 0 27 2 42 11 6 24 17 0 0 0 23 19 0 19 0 15 0 9 0 0 13 0 11 17 0 10 15 33 0 24 5 0 19 13 0 46 0 0 7 0 
0 0 26 21 15 0 0 31 0 1 0 9 0 5 0 2 49 0 22 0 5 0 4 0 1 12 1 17 21 0 0 0 0 0 1 0 5 2 23 0 7 28 26 16 13 11 21 35 
0 3 18 0 31 3 0 36 13 0 0 13 0 23 15 29 37 15 11 15 3 44 6 0 22 1 20 7 17 0 3 8 18 0 27 9 26 6 34 2 0 5 13 55 29 12 9 31 
14 25 2 11 0 0 0 0 0 49 0 0 3 4 11 19 1 0 1 0 20 0 0 0 15 0 35 17 10 17 0 16 17 0 12 3 11 0 22 20 0 0 0 0 0 51 0 16 
14 38 9 7 22 5 0 26 15 0 10 0 0 16 38 8 0 0 0 0 0 0 0 16 16 0 0 0 46 1 1 0 0 23 18 9 1 27 24 31 24 54 16 0 0 2 27 0 
0 0 3 14 19 42 34 4 16 10 23 2 0 8 25 0 5 33 0 26 14 0 16 7 16 0 42 17 0 25 7 24 6 2 0 8 13 10 15 0 41 18 17 0 6 120 10 33 
0 0 18 0 0 9 0 54 0 0 0 6 22 0 0 0 27 3 0 18 2 0 0 0 0 5 0 0 16 0 5 0 0 0 6 26 9 0 0 0 2 0 2 0 0 2 11 0 
