49 28
0 0 0 0 0 17 36 35 0 0 16 0 35 0 23 16 15 0 32 0 13 0 0 19 1 25 16 0 23 0 12 15 0 23 0 0 16 0 0 6 33 0 88 0 0 0 0 0 79 
0 33 12 44 0 0 9 1 0 20 5 15 1 0 30 6 2 30 18 15 0 20 38 6 10 0 10 0 11 49 0 3 0 14 21 2 6 0 21 10 0 8 0 7 0 0 9 44 0 
2 11 0 0 8 26 25 0 24 22 23 9 8 0 0 0 0 9 14 0 15 0 0 0 14 6 11 0 9 0 0 34 47 23 13 20 2 22 8 11 12 21 17 19 0 0 46 13 0 
0 0 0 0 0 45 6 22 0 43 0 22 0 0 0 0 0 0 24 0 10 0 11 0 0 0 15 0 0 0 0 0 0 0 0 16 0 6 0 0 0 15 0 0 37 11 41 9 0 
20 4 7 0 9 0 14 38 0 29 0 38 0 22 2 9 29 20 47 0 19 0 3 12 0 0 2 0 0 18 0 0 1 1 13 13 0 0 44 36 22 0 0 0 28 38 0 14 0 
0 0 28 0 14 22 16 0 0 6 0 1 36 25 0 15 23 0 0 11 0 0 13 0 0 20 0 0 22 0 26 30 0 9 7 21 0 0 35 0 0 7 9 0 2 13 34 0 17 
0 3 0 14 1 11 0 0 0 20 21 19 0 0 2 0 1 0 0 19 0 0 9 0 0 0 14 20 0 14 13 0 0 6 0 16 0 0 0 0 0 0 0 20 10 0 0 12 0 
31 2 15 11 0 0 34 33 0 0 0 0 10 0 0 2 21 0 0 0 0 13 24 6 0 0 5 10 0 6 32 14 0 4 10 0 1 31 5 0 46 11 0 12 0 20 19 19 0 
4 4 0 26 36 0 21 20 0 0 0 1 0 0 0 19 0 4 4 2 10 32 24 4 15 0 0 5 0 0 0 0 11 0 6 0 31 8 13 15 6 21 0 33 1 1 43 18 28 
0 52 0 0 0 0 13 27 0 0 31 26 14 41 21 5 22 0 0 0 10 0 6 12 0 0 0 10 8 0 0 30 20 7 27 0 31 32 0 0 0 31 0 0 46 0 69 33 0 
10 4 28 39 10 11 49 0 12 0 1 32 13 0 13 7 30 5 6 0 14 4 0 30 29 19 5 7 0 0 0 14 31 0 16 49 0 0 0 1 1 0 18 68 0 36 38 4 0 
36 0 74 1 25 8 10 0 0 14 0 0 23 5 0 0 7 0 6 0 18 21 16 12 0 0 14 0 34 6 13 31 0 15 1 9 8 0 26 19 3 0 0 1 19 57 0 4 0 
50 8 39 22 12 0 22 0 6 0 0 0 10 0 34 15 0 0 0 0 2 0 6 0 0 30 22 33 0 27 44 39 18 6 37 0 0 0 31 8 7 39 8 73 0 14 5 22 0 
44 7 16 27 9 26 31 14 32 0 18 8 0 0 9 18 7 3 31 9 8 11 19 0 23 26 0 10 0 0 0 7 0 42 11 30 0 37 5 8 21 54 0 0 19 30 61 13 7 
0 25 0 0 4 0 0 0 17 35 36 0 17 0 4 6 0 7 0 21 2 0 15 0 3 17 4 0 0 17 11 0 10 0 0 25 4 5 1 10 18 9 1 1 50 0 14 0 0 
18 10 0 0 0 0 0 0 29 0 0 0 23 0 0 24 6 0 30 0 7 0 0 0 3 0 6 3 0 8 0 1 1 0 0 23 0 43 18 0 0 6 0 0 1 0 0 0 0 
0 43 0 10 0 13 33 27 11 0 0 9 21 5 13 27 0 5 44 21 2 20 16 34 0 0 21 20 5 10 24 30 14 20 4 28 10 19 7 15 20 0 2 0 2 22 0 21 1 
0 0 0 1 1 11 20 15 0 0 17 23 19 0 0 0 12 8 2 8 22 9 11 1 2 26 4 0 0 8 8 25 0 17 23 12 0 0 0 22 0 5 49 1 0 0 0 0 0 
21 0 38 31 4 0 67 0 21 0 5 11 35 9 0 12 5 25 18 0 7 37 6 0 0 0 0 18 0 11 2 13 30 6 0 26 12 0 16 15 0 2 23 16 1 46 7 96 55 
24 0 0 1 7 0 0 16 0 34 28 65 0 0 3 21 27 1 18 19 0 0 15 19 9 8 0 8 0 2 2 0 11 8 11 27 6 15 32 4 6 7 0 35 34 0 0 0 0 
0 0 0 0 0 30 33 19 0 5 0 32 0 0 0 4 0 4 2 26 2 13 2 0 0 2 19 2 13 14 0 12 0 0 3 40 1 0 0 33 2 0 22 35 6 27 1 0 7 
43 0 16 0 8 42 8 16 32 3 3 17 16 0 14 6 0 7 16 9 13 14 0 0 0 0 6 22 17 13 0 2 11 0 0 0 25 8 11 9 29 6 0 43 10 0 0 20 34 
0 0 15 14 13 0 21 0 0 0 0 1 0 0 15 0 0 13 0 0 0 35 0 0 0 5 0 10 1 0 0 0 19 0 10 0 0 16 0 9 19 0 0 0 0 0 0 15 0 
0 18 31 0 0 33 0 0 0 0 0 9 0 1 22 11 0 19 6 37 21 0 36 0 16 0 6 0 8 8 0 30 6 49 17 0 0 8 33 20 0 2 0 0 0 16 34 45 0 
0 10 0 18 1 1 6 0 19 0 7 11 0 1 0 0 14 16 9 24 45 1 0 3 0 0 0 17 5 0 4 0 9 7 0 6 0 15 0 0 3 0 0 24 12 0 26 0 0 
0 10 0 13 0 36 49 10 5 15 7 31 1 5 0 6 14 0 0 0 0 18 24 0 23 0 0 0 14 0 7 0 20 0 0 0 0 0 12 23 0 36 0 3 14 14 15 36 42 
0 12 70 34 0 0 25 0 21 38 0 0 0 16 0 8 0 0 0 1 20 0 0 33 0 26 0 38 0 21 13 0 4 0 0 21 4 34 0 37 23 8 0 22 0 0 3 18 25 
0 0 28 15 0 16 0 0 32 0 7 23 0 18 0 0 0 0 51 0 0 0 4 0 0 0 4 15 0 0 28 0 0 0 0 0 7 3 0 6 46 0 0 7 0 5 1 0 0 
