49 28
25 7 0 0 0 0 0 0 8 14 8 4 36 0 25 0 0 13 0 34 34 10 13 18 24 0 0 25 0 0 0 0 22 0 9 35 19 0 0 5 0 11 31 0 1 0 0 5 47 
0 0 12 25 0 0 57 12 0 28 0 0 10 0 0 7 5 56 0 0 0 31 2 0 12 7 1 5 25 13 0 0 0 0 6 1 0 28 13 22 17 0 0 22 62 0 52 0 0 
2 33 18 9 0 24 61 0 0 12 22 19 72 11 0 0 37 0 0 1 24 7 0 17 12 0 0 23 0 0 4 4 2 9 40 0 31 25 22 1 21 15 9 17 19 2 0 2 0 
25 46 0 0 8 0 0 24 23 0 37 8 0 23 7 18 2 30 5 7 0 18 0 4 2 24 9 0 23 0 9 22 13 8 5 35 52 0 23 11 0 18 0 2 18 2 2 6 0 
24 0 4 0 31 0 0 34 32 33 0 17 0 0 0 16 6 21 0 0 12 0 0 5 15 12 5 0 12 1 1 16 0 4 0 16 6 6 1 3 16 33 33 0 19 12 0 22 0 
31 30 0 62 13 0 24 0 9 0 13 0 9 3 4 46 0 18 0 0 23 0 0 0 6 19 23 9 0 0 24 14 0 14 0 0 9 0 0 21 0 19 0 30 6 0 13 41 0 
4 0 7 27 20 0 0 0 0 0 0 28 5 27 18 31 17 3 0 0 28 0 16 21 18 13 0 5 23 0 0 7 16 0 0 24 8 2 90 28 13 15 0 0 0 0 31 19 0 
21 0 44 0 0 0 24 0 0 0 37 25 0 0 0 0 0 26 9 13 0 3 24 9 5 14 8 8 5 0 24 10 0 8 0 24 9 0 0 0 0 19 0 0 0 19 71 36 0 
32 0 50 0 41 5 4 0 21 0 8 0 58 0 0 7 7 0 1 26 16 0 0 25 16 24 0 7 0 8 0 10 0 8 12 0 5 4 20 18 0 0 0 0 44 15 0 16 30 
30 0 3 0 0 0 12 0 23 0 16 0 0 0 4 17 0 0 0 0 0 0 0 0 19 17 18 0 0 0 28 5 0 0 0 0 0 0 9 0 0 0 0 0 13 0 0 40 0 
60 0 10 26 0 0 18 0 22 0 37 11 2 3 0 5 9 6 30 8 6 0 24 0 44 16 0 20 24 26 6 0 7 13 10 14 0 0 0 0 0 3 1 0 78 0 24 0 6 
29 22 3 54 18 3 19 20 12 23 0 9 15 0 0 0 8 0 0 0 0 23 5 15 14 0 5 34 0 26 2 8 23 15 14 0 0 0 0 36 0 0 53 10 10 21 0 11 0 
12 0 25 37 0 0 12 46 2 38 50 22 0 35 0 9 16 7 0 26 0 0 0 0 0 0 0 4 0 1 0 9 16 1 0 0 5 0 0 37 38 10 1 37 0 0 0 29 35 
0 37 12 2 0 5 0 4 3 30 11 31 20 0 2 0 0 5 6 0 9 25 5 22 21 0 17 17 0 0 0 2 30 21 0 0 0 0 0 36 0 7 0 0 0 0 28 21 7 
55 6 0 8 2 7 8 0 31 16 0 10 2 0 7 6 12 16 0 0 0 10 13 7 9 44 0 0 0 6 20 8 0 4 4 0 0 0 0 10 0 2 29 9 16 17 0 47 0 
0 0 54 12 30 0 0 24 0 0 0 0 25 21 0 13 15 20 0 0 5 8 0 0 12 15 8 25 0 4 18 20 0 7 51 0 0 16 0 1 16 3 0 26 2 0 14 0 18 
40 0 36 0 1 0 0 25 0 0 8 3 0 14 26 0 1 9 0 0 12 0 23 19 18 16 27 19 13 0 10 4 7 9 1 9 9 11 20 8 63 0 18 1 2 10 13 9 2 
0 23 0 32 0 0 0 0 0 17 0 0 0 0 0 14 0 5 9 0 9 0 25 2 0 0 12 0 0 14 0 19 31 8 11 0 13 8 1 6 0 0 6 0 0 67 2 19 0 
0 0 0 0 0 0 7 0 0 0 21 0 5 0 0 0 0 0 0 21 6 0 0 0 0 0 6 22 14 0 0 0 0 0 0 15 0 0 0 0 38 0 1 0 7 0 0 0 0 
0 45 9 30 0 18 10 0 0 0 0 3 0 13 0 14 25 0 13 0 6 0 0 5 0 13 27 8 0 6 0 29 0 44 9 28 0 8 15 0 14 25 0 14 5 0 47 0 0 
0 0 58 0 34 6 5 4 0 0 7 20 27 0 20 11 1 9 0 0 18 64 6 0 0 18 0 0 7 7 24 12 1 0 16 0 18 0 34 34 14 7 31 23 18 0 19 26 34 
0 0 0 0 19 0 5 11 26 11 7 23 30 23 15 27 2 7 0 5 0 0 0 21 0 5 13 0 2 0 14 2 0 0 26 5 13 27 0 0 0 1 57 0 0 0 20 0 0 
31 0 2 17 41 0 3 11 0 0 10 29 0 0 0 10 0 0 0 22 22 0 0 0 0 73 6 0 1 0 14 0 22 4 12 0 0 4 0 0 7 37 0 0 46 1 12 11 0 
32 43 0 45 0 0 44 1 0 0 0 0 14 8 0 1 0 0 0 0 0 9 0 0 0 0 22 0 1 0 9 0 22 0 0 0 9 0 15 38 0 1 16 22 0 49 0 6 45 
0 0 0 10 37 0 0 0 0 7 0 0 0 13 3 0 2 17 26 8 0 0 0 1 0 19 0 7 8 17 0 0 0 0 10 35 20 3 22 3 0 55 15 0 10 0 45 31 0 
0 23 15 21 0 19 38 0 39 0 0 0 0 0 0 0 0 5 13 0 25 0 0 1 2 4 0 46 9 23 7 7 41 8 0 0 4 17 17 0 0 4 10 0 38 0 0 55 0 
44 15 1 84 2 14 25 0 34 13 0 15 0 0 28 9 0 21 0 29 13 12 15 24 15 40 5 16 14 0 13 23 15 10 15 15 22 5 17 6 24 21 46 16 0 50 43 19 0 
3 0 1 4 16 0 5 6 36 0 7 5 0 14 3 0 11 3 18 0 42 22 0 19 0 30 0 22 0 0 2 11 0 0 0 0 42 51 0 0 0 0 30 4 29 0 0 27 0 
