49 28
46 0 10 24 6 0 27 0 10 0 75 0 18 0 0 29 6 0 6 11 27 23 0 12 34 0 25 17 0 6 18 0 22 23 7 4 0 0 8 15 0 0 0 0 0 14 0 32 0 
0 12 27 41 18 25 0 25 0 85 0 21 16 0 0 13 6 54 18 16 0 51 10 28 13 17 0 10 9 12 10 0 39 0 25 0 0 10 0 11 5 0 0 0 41 0 37 51 27 
65 5 22 7 12 0 0 0 6 0 40 15 1 10 28 61 0 17 7 1 10 10 0 32 0 2 0 6 51 19 0 9 0 10 13 0 38 0 13 0 0 0 9 0 0 0 4 58 20 
17 0 0 0 0 0 1 16 36 0 5 54 13 11 1 11 9 0 0 25 0 13 0 16 0 0 5 37 26 0 3 5 0 18 0 28 5 0 0 18 24 14 0 32 2 26 6 0 8 
17 43 15 0 30 7 0 6 18 9 12 3 5 4 1 0 12 2 0 21 16 0 20 19 0 16 0 1 12 0 22 2 0 13 0 9 0 0 0 0 0 37 19 3 0 44 9 15 2 
9 0 16 0 0 22 0 0 0 0 0 21 24 0 5 0 0 0 6 43 26 0 4 0 7 0 14 0 0 0 0 0 0 3 22 13 3 13 0 4 0 0 0 0 14 15 37 0 22 
1 1 37 49 0 4 38 3 21 0 0 4 0 0 0 6 7 14 6 18 0 28 20 7 8 0 15 0 2 20 2 15 0 16 0 0 0 22 35 0 0 35 0 0 23 0 0 0 0 
45 0 43 0 52 9 16 0 0 0 18 28 0 9 9 0 0 0 0 0 0 0 16 0 9 0 0 21 0 0 0 5 0 4 11 0 25 0 0 0 0 0 0 0 0 88 0 43 28 
46 0 9 13 0 0 0 8 22 0 0 4 0 2 5 39 8 1 5 0 0 0 0 8 0 17 12 0 0 12 0 0 0 0 0 23 10 0 4 0 0 12 0 8 0 22 15 12 0 
38 28 0 17 0 0 3 5 0 0 0 20 28 28 0 32 0 20 5 34 0 0 0 0 3 0 4 0 0 28 0 29 0 0 33 0 0 3 15 2 23 5 0 1 7 0 2 0 0 
51 35 39 0 11 2 0 8 17 15 27 10 0 39 0 38 7 2 0 19 0 10 9 0 2 10 0 0 19 1 4 4 0 0 26 0 0 28 9 0 9 0 0 32 5 0 46 45 4 
0 0 3 21 0 0 0 41 3 0 0 6 28 8 0 12 3 3 38 19 0 0 0 25 0 6 9 10 0 3 5 4 13 11 14 44 33 11 0 8 0 6 13 0 10 13 38 0 91 
12 11 0 0 2 0 23 40 1 0 0 0 4 10 12 0 2 0 0 0 0 11 0 11 7 0 0 19 0 33 14 0 15 0 0 3 0 0 1 0 0 8 0 13 30 0 0 40 3 
14 93 0 26 0 13 0 0 0 3 0 0 0 0 0 0 0 0 13 0 0 14 0 11 0 0 0 0 11 12 5 0 0 0 10 12 0 7 13 0 4 28 34 0 10 0 0 0 0 
0 0 12 5 14 0 24 0 0 42 17 0 15 13 0 23 11 8 6 10 0 22 11 0 18 0 0 6 2 23 4 20 0 15 5 1 0 8 0 0 0 0 0 34 20 15 0 14 12 
28 0 68 0 9 2 1 2 0 19 4 0 0 1 1 0 21 11 0 0 7 16 0 7 0 20 5 0 39 27 42 15 30 0 0 0 0 0 0 20 0 0 53 27 6 8 0 0 3 
16 0 0 0 40 5 0 9 0 7 20 3 0 31 9 0 25 14 18 0 18 0 0 0 10 0 5 10 5 8 6 0 14 0 0 0 0 0 18 5 0 9 0 0 9 0 12 0 0 
14 0 0 0 4 0 0 3 13 25 0 0 0 9 16 15 0 0 3 0 35 43 16 9 0 13 0 0 0 0 16 0 0 0 0 21 15 0 0 0 0 0 0 0 0 0 0 63 0 
0 36 0 0 5 31 30 4 34 48 13 39 27 7 0 0 0 0 0 26 0 0 6 22 18 2 3 19 15 20 36 2 0 39 11 18 21 48 30 9 0 32 0 33 33 48 0 0 0 
14 0 0 41 18 8 0 0 34 5 1 18 7 18 11 0 0 0 0 7 0 0 3 16 0 0 14 0 4 0 0 0 17 15 0 0 0 9 0 0 5 0 39 35 5 5 0 6 5 
70 23 14 1 16 0 25 50 1 2 24 2 5 26 5 43 9 4 19 14 4 10 0 23 22 18 0 20 14 14 28 20 23 6 9 29 30 15 0 5 6 9 26 40 38 18 6 0 22 
0 0 0 13 30 0 6 13 17 0 20 0 14 0 8 12 0 1 9 0 28 0 0 0 0 3 5 11 4 0 0 15 0 0 0 8 0 0 0 4 0 2 0 0 22 0 0 0 28 
0 34 1 3 35 0 26 7 64 0 0 1 36 29 6 0 0 1 1 12 6 17 5 21 0 13 22 0 1 23 1 1 6 27 0 34 0 12 0 0 32 33 29 16 14 25 1 21 0 
6 2 1 0 29 0 42 6 21 0 2 5 14 21 0 2 0 2 30 0 0 12 0 0 0 5 0 13 0 7 0 0 0 35 21 0 0 0 0 0 0 1 19 0 1 0 0 0 72 
0 0 28 0 9 8 0 0 0 24 4 0 0 0 0 0 0 0 0 0 0 1 38 5 0 23 0 2 0 0 23 2 3 0 0 3 11 0 0 0 23 10 0 0 8 0 0 0 26 
25 0 30 0 0 0 0 2 14 5 24 5 6 0 8 0 7 7 0 9 0 39 17 7 0 0 30 27 0 20 10 5 0 8 17 14 0 0 0 29 0 1 5 16 0 10 11 0 0 
6 0 30 0 0 24 0 0 0 0 26 27 17 0 26 13 29 0 0 21 43 12 20 4 3 29 0 4 13 0 27 4 0 10 0 0 0 7 11 0 16 3 0 6 12 4 0 0 0 
14 0 4 0 0 36 10 2 0 8 7 0 0 0 0 18 3 11 23 21 27 7 16 0 7 0 17 0 12 7 10 7 8 0 18 16 3 9 7 0 26 23 0 55 39 0 25 22 0 
