49 28
0 0 12 38 0 0 0 4 31 5 21 8 0 13 0 36 0 10 38 2 13 2 0 0 1 0 0 8 1 1 23 0 19 0 0 5 8 7 2 59 1 19 0 0 16 27 0 40 23 
14 0 1 0 6 0 0 36 0 44 8 13 6 5 0 18 30 6 37 13 0 2 4 0 8 0 2 12 22 0 4 4 4 6 61 0 10 0 0 42 22 19 14 3 35 0 5 0 17 
0 25 39 19 26 0 39 5 0 3 31 22 18 35 0 44 5 0 0 17 0 7 0 0 0 41 5 9 36 0 0 4 30 2 9 26 0 2 19 0 0 39 12 31 12 18 5 37 21 
12 40 0 0 3 0 6 16 1 0 0 23 4 17 21 0 10 16 23 0 10 2 0 0 0 13 0 0 2 16 34 3 0 4 8 11 6 0 10 21 0 3 0 0 11 0 0 14 23 
14 17 0 0 0 7 0 0 35 0 0 1 0 0 6 0 0 0 45 7 14 0 12 0 0 0 5 0 0 0 20 21 13 20 9 4 8 0 0 6 7 15 0 35 0 21 26 0 4 
0 0 0 0 0 0 0 0 3 5 0 3 0 0 9 6 0 0 21 4 0 18 0 14 1 0 0 0 0 4 0 10 0 0 26 6 0 29 0 24 0 0 3 0 0 8 0 5 11 
8 0 0 20 0 0 5 0 3 0 5 21 34 4 33 2 0 5 1 28 0 11 0 20 0 13 5 0 8 16 9 12 0 22 40 0 4 0 17 0 0 0 4 8 0 3 6 25 0 
0 0 0 20 6 11 1 5 0 0 0 0 0 0 0 1 1 0 0 0 0 0 0 7 0 18 11 0 6 2 11 0 0 0 0 0 0 0 0 0 0 0 0 0 0 0 5 19 2 
26 1 2 6 0 0 16 15 0 0 0 5 6 6 5 0 0 3 0 6 25 13 49 0 17 0 6 27 0 0 17 3 6 0 30 15 14 10 6 0 6 17 1 0 0 0 0 3 0 
0 0 39 0 42 0 2 6 0 3 0 0 0 19 0 0 31 1 2 0 9 5 20 4 0 0 0 7 5 21 0 0 16 0 0 0 6 1 0 0 12 0 13 0 2 15 88 0 0 
0 0 35 0 0 0 31 9 11 0 24 0 0 0 0 3 9 10 0 28 0 24 0 0 25 0 0 0 0 14 0 0 9 27 0 13 17 52 28 0 0 26 0 26 0 0 7 0 38 
0 28 7 0 24 48 0 15 18 0 0 0 26 12 0 30 12 16 10 10 7 1 8 11 11 0 18 13 20 6 12 10 0 0 15 0 0 33 44 0 7 0 0 2 0 9 41 15 0 
24 24 0 18 0 29 8 12 0 0 13 0 0 6 14 0 13 12 0 14 37 14 0 0 24 21 19 0 0 10 0 0 0 0 49 0 8 0 0 0 15 0 0 23 0 16 2 0 0 
0 3 0 5 5 0 32 0 9 10 0 0 5 24 15 9 2 0 30 10 14 13 22 11 1 0 7 0 2 0 7 0 0 0 0 0 4 3 15 0 3 0 0 0 22 2 0 9 30 
8 0 0 0 79 13 3 60 29 69 13 1 11 7 1 5 6 0 10 41 12 9 16 8 20 17 0 0 5 0 9 9 35 2 0 5 8 31 34 0 29 95 35 4 18 0 2 38 9 
18 0 19 3 18 0 7 14 8 0 0 1 0 0 22 1 22 0 9 0 14 26 22 0 0 0 0 2 1 0 9 0 0 0 5 0 22 10 6 0 0 12 0 4 6 11 11 0 0 
131 0 0 3 4 0 0 9 20 29 0 0 0 5 1 19 13 4 0 0 26 13 23 8 22 0 0 8 12 0 17 14 13 33 39 18 2 52 75 6 0 8 2 0 28 3 26 3 0 
0 0 42 11 4 5 0 33 17 3 0 0 10 9 14 31 5 1 29 13 0 10 0 13 0 17 0 1 7 0 10 10 8 20 32 0 6 21 6 34 32 1 0 4 45 0 47 50 0 
0 0 26 26 0 8 0 11 23 65 23 30 0 20 0 22 0 0 11 11 6 19 7 13 0 5 0 0 10 26 7 0 22 0 0 7 0 4 10 0 0 1 31 0 0 0 37 0 17 
4 0 0 1 1 0 0 84 40 0 0 27 0 14 0 6 0 31 8 4 0 27 6 4 6 2 21 12 6 16 8 0 23 0 3 0 0 4 20 26 0 0 0 16 0 13 8 37 54 
41 5 0 0 31 5 0 31 11 3 4 5 0 0 0 19 4 0 0 11 0 0 0 0 0 18 0 7 0 0 7 0 0 0 9 11 0 0 0 0 6 26 0 8 0 18 3 12 0 
0 9 0 67 19 0 0 0 0 0 21 19 51 40 0 11 0 0 5 0 2 0 0 0 0 14 0 0 26 0 0 0 10 30 0 11 0 0 20 8 25 0 10 26 0 6 11 35 0 
24 10 13 0 25 0 0 0 6 0 0 0 0 4 33 0 0 24 0 5 27 41 2 3 57 0 3 5 0 0 0 2 6 0 4 0 15 0 17 0 0 0 0 0 0 0 0 8 0 
4 3 28 7 16 0 29 18 0 0 27 0 12 0 34 0 0 0 0 21 13 0 8 0 12 0 0 0 0 8 32 0 0 20 21 12 4 15 1 4 0 38 0 0 41 0 0 27 32 
0 38 1 0 4 0 0 28 39 3 6 0 0 7 0 8 0 14 9 0 6 18 16 10 8 0 0 4 17 6 20 5 22 0 18 16 29 0 1 25 0 16 0 0 0 24 0 0 17 
0 13 28 0 12 26 10 40 4 0 2 9 23 5 13 15 0 16 34 0 0 0 1 0 21 12 0 0 0 18 6 21 0 2 17 5 32 0 0 24 38 0 0 0 0 21 0 110 2 
0 34 11 0 1 1 37 0 7 0 24 0 2 24 2 53 8 0 21 14 0 23 34 15 0 10 6 24 13 12 0 0 6 18 7 47 1 10 17 0 0 19 0 58 23 0 0 34 26 
0 25 37 25 19 0 0 0 63 3 3 0 22 1 2 1 17 25 13 23 1 0 22 19 21 0 0 14 0 0 46 0 0 0 4 10 26 17 0 44 7 12 0 35 14 14 1 7 0 
