49 28
0 10 0 0 0 0 38 0 31 0 30 10 7 0 4 0 0 31 10 14 0 22 0 0 22 0 0 11 8 12 0 37 0 21 8 3 0 0 9 35 32 1 3 22 45 14 30 0 0 
27 0 24 0 1 21 0 13 4 0 6 7 0 0 0 4 0 18 0 22 26 0 22 0 0 0 0 7 47 7 0 17 0 0 19 54 1 0 0 12 0 39 15 0 23 6 21 9 0 
0 34 36 9 0 16 0 0 0 0 16 27 5 0 0 0 19 0 0 0 25 0 20 0 0 0 0 0 25 11 5 4 0 18 15 0 25 0 100 0 0 14 8 0 0 0 0 0 11 
13 0 0 16 0 24 0 62 13 50 25 0 0 13 5 7 12 6 0 0 0 22 0 17 0 9 0 0 25 0 21 26 0 26 0 25 21 12 29 1 18 31 0 36 19 0 20 0 0 
6 2 23 0 17 24 10 0 0 0 16 0 34 0 4 10 11 0 0 0 0 0 16 0 12 0 25 0 0 16 0 27 0 11 21 20 38 5 2 23 26 28 12 19 0 33 0 16 0 
0 46 36 17 0 0 8 5 4 9 11 0 5 0 0 0 0 0 13 0 19 2 17 0 0 3 0 0 0 0 6 0 0 13 31 0 10 0 55 19 34 5 2 0 43 1 20 12 0 
0 0 1 1 0 11 0 0 1 0 13 0 7 0 20 0 0 16 22 5 9 0 0 17 14 6 2 8 0 11 0 10 14 0 9 0 5 0 0 0 0 0 0 0 11 0 5 1 4 
10 5 42 26 38 32 0 18 24 0 6 31 38 0 31 39 0 0 3 0 0 2 19 5 3 14 0 5 28 5 0 0 24 0 0 8 0 57 0 6 28 19 25 0 25 30 1 4 0 
0 3 38 0 18 0 32 18 0 23 0 25 3 1 22 0 30 1 15 0 14 9 12 16 9 12 18 0 24 48 9 17 5 30 4 12 36 3 47 23 0 19 9 5 0 6 30 0 19 
40 45 25 0 19 0 1 0 10 17 1 0 11 0 0 11 11 0 0 12 0 0 0 0 16 31 0 27 0 0 0 1 0 0 0 0 13 0 0 0 24 0 0 10 0 15 56 0 7 
35 31 2 0 36 36 0 0 14 0 0 0 16 21 46 0 3 0 0 7 0 0 0 0 0 0 0 8 16 29 0 7 0 14 21 1 1 0 3 0 0 36 0 9 7 0 42 33 4 
6 0 15 5 35 27 3 0 11 13 0 8 0 21 0 0 29 15 0 7 35 0 19 18 2 0 7 8 12 0 15 5 12 28 18 3 26 0 0 0 16 7 7 0 0 30 0 0 0 
0 0 6 0 0 0 5 0 0 0 19 0 32 0 0 25 0 45 0 0 13 0 0 12 14 6 24 0 0 12 10 21 0 0 0 22 34 0 12 0 42 0 10 0 5 0 4 7 0 
0 0 11 38 0 0 5 0 11 0 3 7 14 6 0 0 3 0 0 0 8 10 17 0 4 0 0 20 15 11 1 0 0 0 5 7 15 0 18 24 0 38 6 0 10 0 0 0 9 
1 0 0 0 30 6 15 5 0 5 37 0 10 0 6 10 0 0 16 13 0 12 0 0 16 13 18 8 0 0 0 4 0 3 22 7 12 10 13 0 14 0 3 0 0 35 0 20 0 
12 0 0 0 67 12 0 0 38 0 0 10 4 0 0 29 42 38 0 19 0 5 11 3 26 6 3 7 16 17 36 7 12 0 15 11 4 37 12 7 0 0 38 30 62 0 22 25 0 
29 37 48 0 0 0 8 0 0 0 23 10 0 0 4 29 27 3 0 16 0 0 12 12 0 0 14 0 0 42 9 0 0 0 0 33 1 0 61 11 14 26 12 0 27 31 2 0 46 
29 26 18 42 0 50 5 69 26 0 37 18 13 13 11 0 27 33 1 1 0 4 0 30 0 26 0 22 0 18 0 28 13 38 14 18 10 6 65 7 13 26 35 22 51 0 5 17 0 
0 0 12 0 0 0 0 34 21 0 16 31 0 0 12 29 8 29 12 0 0 0 0 3 0 0 0 15 13 21 0 1 0 0 0 0 0 5 13 0 0 34 45 0 0 0 29 9 0 
0 7 17 30 12 23 5 8 13 0 3 0 25 0 3 0 0 2 0 19 0 0 22 16 5 2 3 25 23 5 2 13 0 29 9 0 24 13 20 0 0 39 15 10 9 0 43 0 0 
30 30 29 32 4 44 32 0 6 12 7 8 10 0 6 0 0 7 0 5 0 20 12 0 12 17 43 0 10 7 0 4 18 30 20 3 10 37 44 36 0 41 0 0 48 11 33 15 0 
0 0 4 0 0 1 21 13 14 10 0 0 0 0 0 3 0 16 12 12 20 0 0 0 7 10 0 17 0 11 10 0 2 9 0 0 0 0 4 0 8 1 0 0 0 0 0 0 0 
12 0 14 2 6 37 21 0 0 8 9 0 10 18 0 10 13 17 14 5 12 0 0 0 25 1 0 11 22 0 18 0 14 0 0 25 23 17 10 0 0 4 4 0 0 0 0 0 9 
0 12 0 1 14 0 14 0 0 0 0 3 0 0 0 0 0 0 6 0 14 0 0 0 2 0 20 0 0 0 0 0 2 0 0 34 0 9 7 0 0 15 0 20 10 0 0 46 0 
7 42 0 13 0 0 21 7 10 0 0 10 27 1 21 19 12 4 0 13 19 0 0 1 0 15 0 0 0 26 0 24 18 0 32 34 2 5 10 0 0 21 6 6 17 15 0 12 15 
25 30 0 0 21 0 0 6 0 0 24 0 12 0 20 0 13 0 19 7 13 0 20 0 12 30 25 0 30 1 0 6 0 0 40 0 7 6 8 0 0 0 0 15 13 0 0 3 0 
0 13 0 0 0 27 0 19 3 37 9 4 0 0 6 1 17 5 10 0 0 0 12 0 12 0 12 17 10 0 0 14 45 0 0 25 2 11 0 0 0 41 0 11 0 0 37 0 0 
36 31 14 0 43 0 0 6 19 0 28 2 43 1 47 0 0 2 23 46 42 13 0 0 0 14 0 0 51 0 2 40 47 0 26 0 11 0 10 49 26 5 0 0 13 0 0 49 0 
