49 28
21 45 4 42 23 16 55 0 31 9 12 0 21 0 0 0 7 0 40 18 8 0 15 11 0 9 4 42 8 0 7 9 9 34 9 3 23 43 7 54 9 34 4 11 0 27 6 0 25 
46 15 0 7 0 0 1 0 39 0 3 0 9 1 0 0 9 4 3 26 2 0 22 7 0 0 0 0 0 0 15 0 4 15 38 0 0 0 18 0 1 5 0 21 23 27 51 39 11 
0 0 0 0 0 0 10 0 9 0 0 0 0 25 0 26 15 0 10 1 24 0 0 0 16 0 14 10 1 0 0 5 47 0 22 22 5 0 4 0 8 23 0 0 35 0 0 5 0 
0 35 0 0 0 0 0 0 0 0 24 0 12 3 0 0 0 14 0 1 2 4 4 0 0 4 0 0 23 0 36 0 0 2 0 21 40 17 11 15 0 0 0 0 21 0 23 0 0 
0 22 12 15 0 1 4 0 24 27 10 14 1 9 18 0 0 22 24 15 23 25 28 38 8 15 4 0 17 0 0 0 12 0 41 0 15 0 10 22 18 0 22 14 0 3 29 39 0 
6 0 57 33 12 5 3 0 14 34 30 0 11 0 2 15 6 11 16 20 3 0 17 16 0 17 0 0 0 1 15 12 3 0 0 0 14 25 0 15 37 3 19 65 42 0 35 0 0 
1 0 0 0 0 0 0 16 0 0 71 20 11 0 0 0 16 7 0 4 0 0 7 16 0 17 0 0 12 0 6 0 0 8 9 0 20 0 0 0 5 0 0 0 0 11 0 21 38 
13 0 20 0 18 28 42 0 27 0 34 6 12 2 0 2 8 0 0 20 6 0 1 8 14 10 9 0 2 0 6 0 5 9 0 40 4 0 0 0 0 0 0 4 34 0 15 1 66 
0 0 5 0 19 8 12 5 32 39 8 36 0 10 0 0 17 0 0 2 13 18 0 14 0 6 0 0 0 0 19 6 0 4 11 0 12 0 21 9 22 0 0 0 0 0 5 36 61 
6 25 2 0 24 53 7 29 3 30 11 0 0 5 49 0 1 17 0 0 3 11 28 5 2 0 8 17 2 13 19 0 2 21 0 9 14 28 13 8 13 11 20 66 0 0 6 0 12 
17 23 0 3 0 3 27 0 26 0 4 3 1 6 37 0 21 17 18 20 13 23 9 0 16 0 0 15 3 0 29 0 18 62 13 9 18 22 14 2 0 0 0 12 65 40 8 0 3 
11 24 25 0 34 1 2 0 6 5 0 13 1 0 9 14 27 0 0 0 0 7 14 0 15 16 2 0 6 17 2 7 0 0 10 0 0 0 4 19 0 0 20 27 0 30 40 0 88 
5 0 0 0 0 6 0 0 0 0 0 29 0 0 0 0 18 28 6 0 0 27 10 0 0 15 20 0 0 18 3 0 7 0 30 13 0 0 0 0 14 4 0 0 0 34 1 18 16 
0 0 20 32 0 19 0 0 3 0 11 1 7 0 0 18 4 0 0 12 0 11 27 0 19 0 0 0 10 0 0 7 6 0 4 32 7 4 17 0 0 0 0 0 0 1 0 2 0 
21 50 5 0 0 28 0 0 8 0 9 34 31 0 6 5 0 24 9 4 19 0 3 15 0 16 4 0 0 4 0 3 1 4 12 0 0 6 19 0 45 7 0 37 0 34 10 0 0 
8 3 36 5 3 1 0 0 0 0 11 15 0 32 0 0 0 0 0 13 12 0 0 11 6 0 0 7 1 27 24 11 23 11 0 4 0 0 4 0 9 0 11 0 33 32 7 1 2 
5 15 42 5 29 11 5 0 27 5 7 0 6 0 0 0 13 4 26 0 0 0 0 0 18 0 6 1 7 5 22 0 14 9 0 0 7 35 45 0 0 0 0 0 0 0 0 8 0 
12 0 23 0 0 24 9 9 18 8 0 11 2 0 0 15 10 21 17 8 0 10 8 3 8 15 12 26 20 18 7 5 16 33 32 0 1 0 0 6 0 0 33 8 1 5 0 3 11 
25 3 0 15 32 30 16 38 31 0 0 14 0 0 0 0 3 0 0 0 1 16 39 23 0 0 0 22 0 0 1 0 1 0 0 7 34 0 0 22 6 2 0 14 1 15 2 0 48 
15 0 10 0 19 0 0 0 14 17 0 28 30 11 0 35 14 0 15 2 16 2 0 0 3 12 36 0 0 14 7 0 21 0 0 13 8 9 50 0 0 0 4 0 0 0 4 0 0 
4 33 0 0 29 7 7 12 11 0 0 6 32 0 0 13 18 4 14 30 8 0 13 28 0 0 0 0 0 2 6 9 9 0 48 15 25 33 0 6 0 22 0 0 0 0 0 0 0 
0 0 0 25 0 17 1 0 17 0 9 11 0 0 9 0 11 0 16 0 0 11 24 6 11 23 7 19 5 7 6 0 15 7 0 30 4 18 0 0 0 0 0 11 0 10 24 35 25 
0 73 0 0 24 0 0 0 0 37 0 10 0 0 11 0 12 0 0 0 0 17 0 0 8 6 31 0 6 41 19 6 18 0 2 0 0 0 24 0 12 2 0 32 14 19 22 0 0 
23 83 1 30 0 69 32 14 8 0 30 15 34 20 2 0 7 47 2 0 10 0 0 0 0 4 15 0 0 0 4 6 5 0 47 10 1 0 69 0 0 3 0 24 20 35 50 16 6 
9 0 0 0 16 43 0 0 7 0 20 13 21 3 30 0 0 0 0 0 1 0 0 0 0 0 0 0 3 0 0 0 0 0 22 0 19 0 7 0 0 0 0 19 30 7 0 15 43 
0 23 0 0 11 0 0 0 0 17 0 0 0 0 16 15 12 0 0 0 0 6 0 0 29 8 17 21 0 0 0 0 0 0 0 0 0 0 0 0 0 0 0 16 28 25 10 0 0 
55 0 3 8 9 10 9 0 15 0 17 1 0 18 17 19 16 0 10 13 1 3 0 6 28 20 0 4 17 0 1 10 16 27 0 0 0 7 4 5 0 38 2 0 4 20 0 16 25 
18 0 0 0 0 1 6 0 25 0 37 5 0 14 21 0 0 0 0 28 37 0 0 6 13 0 0 4 0 0 0 31 0 27 5 41 0 0 11 13 0 0 0 9 0 0 0 21 0 
