49 28
12 1 0 26 0 26 11 0 12 16 0 10 0 0 0 0 0 13 3 0 3 0 5 0 0 9 0 0 0 12 0 21 7 0 15 0 30 47 18 40 0 12 0 0 0 7 0 1 47 
10 0 0 4 36 0 0 0 0 0 33 0 73 13 24 0 12 3 15 0 0 0 14 0 0 3 0 0 3 0 0 0 4 28 10 0 4 0 26 0 49 4 30 9 4 0 14 2 0 
0 0 25 5 40 5 0 0 2 25 57 0 0 10 11 1 21 4 7 16 0 2 13 0 0 0 0 25 16 0 0 24 4 8 1 14 0 29 0 0 23 8 0 33 67 1 12 0 0 
30 0 0 0 21 11 29 0 11 3 18 0 41 28 3 1 13 13 3 14 0 6 6 0 16 0 0 6 14 0 17 23 7 36 0 19 30 24 0 31 0 0 0 0 0 13 6 2 34 
45 3 0 55 1 12 1 7 20 8 49 7 19 2 22 0 0 22 0 17 0 0 0 0 23 23 0 10 0 0 0 0 29 0 7 0 62 26 0 2 4 29 0 25 7 66 43 36 0 
10 0 6 0 0 0 0 0 9 0 0 29 0 21 0 23 0 25 10 0 11 1 0 0 15 0 0 0 2 9 0 5 12 3 14 1 8 9 0 21 29 0 25 2 0 2 0 11 0 
8 45 0 0 13 0 0 29 7 3 27 0 8 31 0 1 0 13 0 9 10 0 0 10 0 0 0 14 0 0 15 5 14 15 13 7 40 27 4 0 7 14 4 0 36 1 46 14 12 
10 1 27 0 0 14 3 0 16 2 0 4 0 21 8 16 0 14 0 20 0 21 13 0 15 0 0 0 0 5 0 0 17 6 10 11 8 2 0 15 4 22 5 3 18 0 40 0 1 
47 79 29 0 3 0 0 16 4 0 5 0 0 0 0 0 2 5 8 0 0 0 0 0 1 0 36 0 0 0 0 1 0 4 8 0 0 0 0 9 0 40 9 0 0 0 18 47 0 
12 11 32 0 36 22 38 0 0 42 7 0 0 0 0 14 7 7 17 0 12 17 0 0 0 7 0 22 5 18 0 0 0 0 18 6 5 0 46 35 0 6 0 4 37 1 39 18 5 
0 36 41 27 32 22 0 23 0 0 3 0 2 0 20 0 20 6 22 17 0 0 0 3 0 2 6 32 11 23 7 16 8 0 18 2 6 62 0 9 28 0 7 1 0 15 2 0 0 
56 0 1 0 0 0 11 7 20 9 37 0 13 22 14 12 0 10 1 1 0 0 0 10 0 0 18 13 0 0 0 0 30 0 16 22 0 0 0 0 4 0 0 43 14 10 38 37 9 
0 8 0 0 0 36 5 8 16 31 15 0 35 0 3 9 0 3 9 0 0 0 0 0 9 9 17 2 6 5 0 22 0 0 5 12 0 0 12 1 1 39 12 5 11 0 0 39 13 
0 0 0 13 6 1 29 0 0 4 14 0 0 0 0 0 24 16 0 28 0 0 0 1 15 2 0 0 24 0 9 0 0 0 0 29 0 20 39 0 28 0 0 0 0 0 0 22 24 
0 46 3 29 23 42 0 0 5 1 65 26 17 16 7 0 0 3 0 5 3 10 7 4 18 0 0 46 7 3 31 0 0 20 5 3 9 29 0 0 0 4 0 0 42 0 0 9 0 
10 0 35 0 0 13 0 0 0 31 0 0 0 5 0 2 14 3 0 4 26 0 14 0 19 8 7 7 10 0 0 0 0 0 3 0 23 43 10 5 0 4 0 0 0 0 45 0 18 
32 0 0 6 11 0 0 0 13 0 36 0 0 2 0 9 8 8 15 8 0 2 30 5 32 0 0 2 10 2 10 0 32 11 2 9 11 20 10 10 0 0 24 0 0 9 36 0 0 
0 42 43 0 0 8 60 0 0 0 8 0 31 8 0 10 0 0 0 2 23 3 0 0 21 0 9 1 0 16 0 0 4 6 28 0 4 0 32 33 0 0 0 2 3 64 7 0 0 
67 24 0 0 5 0 0 0 4 3 0 0 0 0 0 9 4 22 0 15 3 0 0 22 13 25 1 4 21 0 0 11 11 12 3 35 19 17 5 11 3 18 0 32 27 0 0 0 0 
47 44 0 1 0 30 33 0 1 0 0 0 0 0 3 0 0 14 0 0 0 14 0 0 3 0 0 13 0 0 13 4 31 3 11 23 15 0 20 43 0 4 3 6 0 43 0 51 16 
0 0 0 7 0 29 3 24 12 1 20 0 16 5 7 0 0 0 2 24 16 0 0 0 20 2 5 0 18 7 5 20 0 7 27 5 63 9 0 0 16 31 0 22 9 2 5 26 9 
7 49 13 0 13 0 0 5 18 28 1 3 20 14 0 1 35 10 12 20 25 0 4 14 0 14 0 0 27 7 0 30 20 15 0 34 20 0 5 6 31 0 0 0 0 10 14 47 0 
30 15 0 18 27 0 7 0 4 19 0 4 19 54 0 0 25 0 8 7 0 10 0 0 11 1 9 50 3 0 45 64 0 3 0 0 6 3 3 11 2 0 6 12 0 2 0 0 12 
0 0 0 0 0 0 34 40 0 0 20 16 19 32 21 8 32 0 30 14 17 14 0 32 1 27 5 11 0 7 2 0 0 14 0 31 0 0 0 7 30 0 0 4 4 42 0 0 55 
0 0 46 15 21 0 0 30 0 20 9 0 20 10 23 1 0 4 8 8 26 45 5 0 4 0 0 5 10 0 21 17 0 15 3 0 0 27 14 0 13 0 12 0 0 31 79 0 64 
0 0 21 20 0 0 0 0 0 6 8 0 5 0 22 0 17 29 0 0 0 0 2 37 0 0 0 9 0 2 9 2 5 0 0 0 22 8 3 7 0 18 0 0 0 0 29 0 0 
1 28 16 10 35 87 13 5 0 0 46 4 11 21 0 0 7 14 30 24 0 24 5 7 0 28 0 0 10 16 1 7 0 15 0 0 0 0 50 56 0 22 0 0 14 0 41 0 30 
1 0 0 0 5 38 0 0 66 36 29 0 26 10 20 38 39 0 14 0 0 5 22 4 8 23 4 0 8 17 10 16 6 1 4 15 8 27 0 0 10 0 10 77 1 36 17 0 0 
