49 28
5 27 0 10 0 5 0 0 0 27 0 1 24 10 0 9 0 17 0 10 2 0 0 0 11 0 0 14 0 30 1 32 0 9 10 11 5 0 23 3 14 8 3 0 0 18 0 65 15 
4 0 0 0 27 33 0 0 0 0 15 23 0 0 0 22 12 0 17 14 22 17 8 0 1 2 0 6 0 0 8 27 0 0 0 1 0 0 41 28 0 0 0 0 0 20 0 0 20 
0 14 0 19 0 0 0 0 0 0 1 0 2 22 0 0 0 0 0 0 3 1 0 0 5 0 7 11 0 5 3 0 6 7 0 27 14 0 4 3 7 1 3 0 2 3 0 11 0 
0 4 6 4 82 26 20 0 6 0 7 0 18 25 0 7 5 28 30 28 16 7 0 0 16 18 19 36 12 0 15 0 0 11 12 11 8 20 25 0 0 20 0 39 8 28 33 53 20 
13 14 0 28 0 24 15 26 8 0 19 13 17 12 16 18 0 0 0 0 17 56 0 13 23 0 26 15 0 43 12 31 46 2 4 0 0 15 0 0 19 0 0 22 8 3 0 23 1 
68 0 0 25 0 0 0 10 26 28 0 41 6 3 15 21 0 0 0 4 19 11 14 4 15 25 0 0 46 18 2 1 11 11 0 0 0 21 0 55 0 0 0 0 11 37 0 11 39 
19 6 0 2 0 0 12 0 0 0 0 8 14 0 0 5 0 22 0 0 15 12 0 0 0 0 0 14 8 0 0 0 0 4 0 2 19 13 33 10 0 0 0 0 14 17 0 0 10 
0 0 0 4 0 0 7 3 0 6 20 6 4 6 9 18 0 0 1 0 40 0 0 11 0 0 0 0 31 0 20 21 18 2 0 3 0 7 5 1 0 18 22 3 0 0 0 0 0 
14 0 0 0 60 14 0 0 0 0 8 0 8 3 46 0 16 0 0 0 0 0 0 10 0 0 10 13 1 0 0 1 0 0 13 0 27 6 0 25 0 0 0 0 0 41 0 27 0 
36 40 31 0 18 18 0 26 1 16 2 7 12 4 4 25 0 0 19 19 1 16 0 0 0 0 13 0 2 0 0 30 0 3 0 0 55 15 19 9 12 6 0 3 0 21 15 0 9 
12 19 42 0 9 70 10 0 7 2 31 23 0 0 30 10 5 0 2 0 4 31 0 8 0 15 3 17 27 10 0 8 0 0 13 0 31 0 0 0 0 31 0 0 94 0 15 26 0 
20 15 0 0 4 0 0 36 0 9 0 0 2 21 45 14 0 25 15 0 28 17 17 18 0 6 0 8 2 15 3 9 0 0 21 2 6 3 0 26 4 5 0 36 40 0 2 10 7 
35 18 15 0 0 0 0 0 9 1 20 4 32 12 0 15 0 28 16 0 5 6 0 0 0 0 2 12 0 14 7 7 0 32 1 0 0 0 7 0 3 12 0 3 24 0 16 0 0 
15 0 7 0 0 0 0 35 1 6 11 8 20 6 18 12 12 16 25 5 0 5 11 20 0 0 26 15 4 0 0 0 0 16 0 0 0 0 0 5 0 88 0 5 0 1 0 8 0 
27 36 0 0 56 0 0 0 0 2 14 22 10 0 10 18 35 18 57 15 0 15 0 7 0 25 14 0 3 5 12 12 7 11 24 3 9 73 23 0 21 37 0 12 4 10 1 2 32 
66 0 10 42 30 0 6 20 0 28 0 0 16 22 16 0 21 5 6 16 34 0 0 0 0 0 6 0 2 14 0 17 48 0 8 26 7 43 12 25 0 0 0 1 0 0 16 0 3 
10 0 0 61 18 14 22 11 0 14 21 0 26 8 31 5 8 7 6 8 3 8 0 33 10 5 6 4 0 0 7 28 12 16 23 0 19 10 31 3 6 0 0 0 72 0 8 10 18 
0 34 45 44 0 0 0 34 5 26 25 10 15 47 0 0 1 17 3 16 0 0 0 13 0 6 0 12 13 0 6 17 0 0 21 11 0 2 0 15 0 34 0 0 3 0 0 4 0 
26 10 0 0 36 0 13 29 0 13 0 0 11 29 0 4 0 20 0 27 16 4 4 2 2 14 2 0 0 9 5 0 0 0 0 12 33 22 4 8 3 34 29 52 38 13 15 0 0 
0 3 27 31 27 0 0 0 36 0 13 13 0 0 13 15 9 0 10 0 16 19 18 2 0 26 14 0 4 52 4 0 0 0 31 2 1 1 9 0 8 0 17 0 36 9 0 6 0 
0 0 46 33 0 0 34 1 0 9 27 0 9 4 15 7 17 15 0 0 20 16 1 2 0 0 0 18 24 12 28 34 0 17 7 0 33 67 0 50 19 19 0 0 14 0 0 0 27 
16 3 11 1 3 0 9 0 0 0 0 0 9 19 0 14 24 0 12 27 0 11 0 2 0 9 9 5 1 9 7 18 7 0 4 0 0 15 12 0 9 5 21 0 0 12 40 0 3 
12 0 0 0 0 43 0 4 0 13 0 9 22 0 0 12 0 0 19 25 0 0 0 0 0 10 9 35 0 22 0 0 0 8 51 0 0 4 0 0 13 0 0 0 25 0 0 14 21 
29 7 0 0 11 0 31 8 11 0 0 0 23 0 0 0 0 12 0 0 43 4 1 0 20 0 18 0 11 2 0 1 0 12 0 17 12 11 8 8 0 0 0 12 12 10 0 0 5 
30 22 2 0 0 23 37 0 0 29 32 0 3 15 3 25 0 0 0 0 2 6 7 0 0 0 0 0 52 14 10 1 32 0 0 1 16 27 29 0 3 12 0 22 0 6 46 41 0 
19 2 5 10 19 0 28 0 38 11 0 29 0 10 0 3 6 19 0 0 7 1 7 20 0 5 0 10 6 0 5 0 21 9 34 0 3 5 0 0 30 0 9 2 0 0 23 0 0 
111 23 40 12 3 0 19 37 0 0 3 0 19 10 44 14 0 0 1 0 0 29 23 2 33 7 22 0 0 0 0 6 10 0 0 12 12 54 0 3 38 15 0 55 42 2 39 23 23 
0 29 0 0 29 14 38 12 11 27 0 5 21 0 0 30 0 0 0 20 17 0 0 22 0 0 6 26 20 9 13 0 0 0 13 0 6 49 0 5 0 0 14 11 38 30 0 14 0 
