49 28
13 16 82 44 26 0 2 0 5 14 0 20 0 13 30 27 1 11 25 26 0 15 13 1 0 6 25 19 2 17 10 4 1 14 0 11 7 21 24 46 22 13 86 40 42 0 34 21 0 
0 0 0 1 0 0 23 32 0 27 11 5 8 9 17 0 2 7 0 0 0 5 0 0 45 19 4 0 8 7 31 16 3 0 0 10 49 0 29 32 8 17 17 1 0 21 0 34 0 
27 47 18 0 0 0 0 1 24 6 23 8 23 38 0 0 0 0 17 20 25 0 0 9 11 22 7 34 0 33 0 27 9 38 4 36 24 7 27 21 26 20 15 4 10 7 0 5 60 
0 22 33 12 8 21 0 26 25 1 7 4 34 0 0 9 26 6 0 1 20 0 17 3 24 0 3 4 16 7 0 14 40 32 13 85 1 0 6 12 34 13 16 0 16 23 25 5 0 
40 11 0 8 33 0 3 1 1 0 22 1 11 2 25 21 4 28 37 0 4 18 11 0 9 0 0 0 0 17 24 0 0 0 0 17 39 33 22 22 7 0 0 1 14 0 0 0 19 
7 0 2 0 35 0 0 9 0 13 8 17 6 0 4 0 6 0 27 25 8 43 14 4 27 3 0 9 19 10 0 0 0 9 0 0 8 0 0 10 0 19 19 1 10 35 19 0 0 
0 0 0 0 21 0 0 0 0 12 31 22 7 11 0 3 0 10 0 8 0 13 11 7 24 7 0 0 0 1 39 3 3 7 4 0 4 0 7 0 0 31 0 0 7 0 24 0 24 
0 30 0 28 0 15 12 0 0 0 0 29 0 6 0 17 0 0 7 20 34 6 0 0 0 16 8 0 0 0 0 36 4 33 8 10 30 4 16 0 25 12 15 0 0 8 25 2 42 
0 12 0 1 0 0 23 12 30 0 0 8 0 12 42 4 6 0 0 12 44 0 12 21 0 0 0 0 0 11 21 0 0 11 0 0 46 0 45 10 26 3 39 3 0 22 26 26 18 
45 23 1 0 12 20 16 7 2 13 1 23 8 0 0 0 21 0 0 0 18 15 5 14 0 0 6 0 0 17 0 16 23 7 0 6 0 11 34 0 0 3 0 14 0 132 0 39 16 
0 47 52 0 0 19 29 0 0 0 1 0 30 0 0 0 6 0 0 2 0 2 22 0 19 0 0 0 0 0 0 0 0 0 2 0 0 6 38 6 2 0 27 1 46 0 0 10 47 
0 0 21 0 4 2 0 0 27 0 0 0 4 0 0 0 4 0 0 0 0 0 3 30 3 2 0 19 8 5 0 0 11 0 26 0 9 13 5 0 0 5 0 0 11 0 11 0 0 
6 25 0 0 0 15 18 2 9 11 0 8 1 0 4 0 1 10 35 0 0 0 0 0 22 0 0 19 13 14 0 0 0 0 0 34 11 0 0 21 12 0 2 14 0 0 6 4 0 
0 0 0 0 0 4 34 0 0 9 0 16 7 34 1 0 7 5 7 12 0 15 6 0 10 0 2 0 16 0 9 0 26 12 0 0 13 0 12 12 9 17 0 0 7 0 0 0 10 
0 18 0 0 9 6 0 2 0 2 27 0 8 7 25 5 0 0 0 18 5 0 10 12 0 0 25 0 0 0 10 9 0 0 12 21 14 27 0 0 14 0 2 12 0 0 8 0 0 
20 0 0 0 77 41 40 18 27 9 0 33 3 1 0 0 4 23 24 19 22 0 5 17 14 22 20 11 6 25 0 6 0 15 5 25 30 7 19 0 8 2 40 39 44 0 3 21 13 
22 17 0 0 0 32 0 48 22 0 47 0 0 7 11 43 15 14 0 16 0 6 36 0 0 0 0 6 0 18 16 40 1 0 13 0 5 32 5 28 11 51 0 0 0 0 0 37 41 
0 3 0 0 11 0 0 0 0 0 0 29 0 31 0 0 0 17 0 0 3 2 0 3 0 20 0 6 0 17 0 31 5 0 0 8 0 0 0 9 39 0 0 5 0 20 0 34 0 
0 39 0 11 4 37 0 14 0 27 0 0 0 0 80 0 0 8 0 0 0 14 17 7 0 20 0 0 0 14 0 3 33 0 0 9 0 0 0 18 47 7 18 0 30 0 32 0 0 
19 17 28 24 14 5 27 0 17 24 32 17 0 0 0 28 0 15 0 23 0 25 6 0 3 17 0 0 42 10 29 0 8 3 6 0 4 9 9 36 0 10 0 0 0 0 0 43 0 
0 0 41 36 25 0 0 18 0 0 0 29 0 26 7 18 20 0 0 0 28 14 0 3 0 0 10 0 0 25 16 20 0 18 0 0 10 5 0 94 3 2 5 38 17 3 0 0 25 
0 0 29 1 23 0 0 0 0 0 0 0 0 0 0 16 0 0 0 0 1 0 2 0 20 0 6 0 4 2 0 10 4 0 0 0 0 0 0 0 0 12 0 4 0 0 0 0 0 
30 46 19 0 29 0 0 24 1 0 0 18 20 5 0 0 2 0 0 0 7 19 0 0 19 8 22 0 8 0 44 11 18 0 0 0 52 33 5 0 0 10 15 9 9 0 0 15 22 
39 35 6 0 25 0 27 1 34 8 3 5 0 10 22 8 25 0 0 0 4 0 13 0 4 0 14 12 5 7 29 0 16 25 2 40 36 0 1 39 0 16 1 3 0 21 12 14 0 
14 0 0 0 0 24 0 0 0 0 0 0 6 0 16 7 2 0 6 5 0 0 12 0 20 9 0 15 19 20 0 0 32 8 0 0 0 0 0 0 0 17 16 0 14 0 65 0 0 
0 0 0 0 34 0 16 23 0 45 76 0 34 0 0 25 35 0 18 12 18 20 8 0 23 24 12 10 13 9 37 23 3 25 6 5 4 0 4 6 25 0 0 37 0 23 8 0 0 
62 0 54 0 23 34 36 0 0 30 12 0 24 0 21 0 17 0 21 0 35 17 0 12 18 4 0 0 0 32 1 7 1 3 3 2 45 1 1 48 38 7 8 4 0 23 0 38 48 
39 0 24 0 0 0 0 0 0 21 0 14 5 0 0 0 0 0 12 0 4 14 17 0 0 17 24 0 0 0 14 0 6 1 0 0 19 0 0 56 0 3 18 1 3 2 0 0 0 
