49 28
0 27 0 0 0 1 44 0 14 19 15 8 0 7 9 0 25 0 0 4 4 0 14 6 0 15 0 0 21 16 0 22 0 0 5 0 0 0 0 0 0 2 0 6 0 6 28 4 1 
4 10 15 0 5 10 0 20 9 0 21 7 0 6 21 14 0 15 35 8 40 29 9 0 7 0 13 12 2 7 2 0 0 0 0 10 18 0 21 0 0 15 0 38 50 0 0 12 58 
0 14 6 0 0 43 9 10 4 15 0 1 14 6 0 0 11 24 0 12 18 0 20 0 15 13 25 0 0 24 0 16 0 0 17 4 0 0 33 0 11 28 7 4 0 0 9 4 13 
5 21 0 0 0 0 0 0 0 0 2 8 0 18 0 0 20 8 0 0 7 2 0 6 0 13 19 0 0 13 5 0 0 0 13 2 0 3 25 13 9 0 13 0 0 0 0 0 0 
45 5 0 8 0 9 40 0 3 0 0 0 22 2 0 12 65 0 17 4 0 4 3 27 0 4 0 42 15 0 10 4 0 7 9 20 0 32 0 10 12 37 2 6 32 12 114 31 0 
0 7 11 0 0 24 0 0 7 0 3 36 0 26 0 0 12 0 9 0 0 15 0 23 12 0 5 0 12 9 0 13 0 0 2 14 9 0 9 0 16 36 0 10 0 0 0 36 0 
42 19 27 7 18 18 29 4 28 0 7 0 0 5 0 9 0 0 5 0 15 1 18 21 0 0 24 10 83 28 0 11 0 0 0 11 46 0 33 8 0 8 42 2 16 0 58 8 37 
21 6 0 0 3 3 3 13 0 1 0 18 0 7 20 13 24 5 0 16 11 23 14 0 23 25 0 6 49 18 15 0 11 0 7 5 0 9 29 0 24 0 6 34 4 9 14 0 3 
1 0 44 0 13 47 29 0 0 0 2 0 10 0 15 0 4 0 0 0 22 0 0 3 0 0 0 9 0 3 0 0 0 0 13 29 1 1 3 0 0 2 17 2 0 50 44 0 0 
39 28 7 36 52 13 0 1 0 3 0 0 22 0 2 0 0 17 13 0 8 0 0 6 2 0 0 10 11 7 6 30 0 15 0 8 0 23 5 5 0 31 2 12 19 0 9 0 0 
2 47 65 1 56 35 16 36 0 0 6 0 35 0 0 0 6 17 9 13 0 10 12 43 10 28 12 7 6 0 0 9 0 13 4 0 6 0 13 6 0 39 41 27 0 16 21 8 17 
16 5 44 41 1 12 9 0 55 0 0 8 0 7 8 0 12 0 13 0 31 0 0 34 8 10 0 13 15 26 0 5 0 10 0 1 13 0 0 0 2 0 34 15 2 5 38 45 0 
46 18 13 12 0 21 0 0 0 7 0 11 0 13 0 7 0 2 29 37 2 2 0 3 0 0 13 8 7 0 0 0 0 0 19 34 12 18 0 0 0 6 0 3 8 0 57 9 0 
42 19 7 0 0 0 24 0 5 0 8 5 2 0 1 0 0 9 0 0 19 5 0 13 0 1 13 0 0 11 24 3 0 0 9 0 19 0 0 0 11 0 36 0 0 18 0 0 0 
2 26 0 3 21 3 4 2 24 28 4 2 10 9 0 14 51 36 32 14 0 2 0 15 0 35 15 19 8 24 12 0 0 0 0 0 16 21 0 33 0 8 0 0 0 0 30 0 31 
45 1 15 0 3 1 5 32 12 2 22 17 5 0 33 21 0 18 1 68 38 0 0 5 0 29 4 13 0 16 9 24 6 7 18 0 7 0 13 34 30 6 45 12 9 30 7 0 3 
42 41 7 0 10 6 17 17 0 13 15 0 0 6 33 0 6 26 7 0 8 0 3 14 0 4 39 27 42 38 10 2 28 12 6 7 36 12 16 9 17 15 6 41 0 12 0 33 0 
18 0 0 1 10 3 7 0 0 1 0 0 29 6 1 0 0 0 0 0 16 5 0 2 12 27 0 7 19 3 0 17 11 6 0 11 0 14 0 9 6 45 0 1 4 0 15 0 16 
0 0 4 1 12 22 0 34 16 38 21 1 15 10 0 0 32 13 22 11 9 3 4 1 22 1 8 6 26 25 0 14 0 0 25 1 0 0 7 8 22 0 0 0 37 10 25 0 20 
12 17 0 0 29 0 43 0 0 27 0 0 22 14 22 9 4 0 25 0 0 0 7 0 0 20 0 16 8 0 0 2 0 31 0 0 14 7 0 0 0 0 0 16 4 4 19 0 0 
3 0 0 0 0 0 0 0 2 12 7 0 0 0 0 0 0 0 13 0 0 36 0 5 0 2 18 0 0 0 0 17 0 0 13 0 0 11 0 0 0 14 4 0 11 0 0 0 19 
0 0 37 0 10 82 42 3 17 47 17 6 0 14 0 0 0 18 9 0 19 0 0 0 7 17 17 6 61 33 9 0 0 2 0 0 9 29 0 46 16 0 5 55 14 17 0 18 36 
0 0 23 0 0 0 16 0 0 2 0 3 31 6 28 0 0 6 0 6 0 0 12 17 22 31 37 7 0 0 0 5 0 7 7 17 0 6 0 0 0 0 7 31 0 0 37 3 16 
7 41 0 0 0 0 0 0 0 0 0 0 0 12 0 1 20 0 13 0 20 0 0 11 8 16 0 7 17 2 0 27 25 6 15 0 13 1 0 0 0 0 41 0 0 0 8 27 0 
0 12 40 19 0 32 9 1 17 0 0 11 0 3 16 0 0 2 0 0 0 0 12 0 0 15 0 23 29 12 1 0 4 0 0 7 22 41 0 1 34 34 36 36 2 5 0 0 0 
19 1 13 0 30 3 0 7 3 0 0 0 6 20 20 0 13 43 1 7 20 7 0 36 16 0 6 0 0 0 6 0 0 0 22 0 16 6 8 0 16 0 25 20 10 12 8 3 0 
0 35 0 0 25 9 0 0 0 0 0 0 0 0 33 0 77 31 29 42 0 0 0 0 18 0 0 0 0 25 12 0 0 0 0 0 45 14 19 13 0 0 41 27 2 29 0 33 18 
41 10 0 20 2 0 40 11 0 8 25 4 0 13 0 27 0 30 8 12 9 0 9 1 0 13 0 23 0 26 0 0 0 0 0 0 0 0 0 0 0 0 59 3 82 0 3 30 17 
