49 28
23 5 0 26 0 0 50 0 15 6 20 21 9 7 28 0 0 0 12 5 0 0 21 54 5 27 0 0 10 10 0 19 21 0 12 15 2 22 17 5 6 0 30 0 19 7 12 25 0 
10 0 0 11 29 8 0 2 0 15 3 0 8 6 11 19 31 7 15 25 44 0 0 32 7 0 0 12 0 16 7 4 21 32 0 4 0 3 13 1 13 21 0 0 0 24 0 0 26 
24 0 0 11 0 0 0 0 5 45 5 16 56 0 14 0 39 5 0 0 0 8 0 32 24 23 21 8 36 3 5 0 20 1 1 0 31 14 17 7 1 24 23 0 0 0 0 2 19 
0 0 10 0 0 0 0 0 0 24 0 1 10 5 0 0 1 0 15 0 2 8 2 0 0 14 0 1 0 0 0 12 0 40 1 19 0 4 0 4 0 18 0 25 1 0 0 0 1 
21 12 0 8 11 9 0 2 0 1 5 8 8 12 0 0 0 22 0 8 8 0 0 0 0 0 0 20 6 0 0 0 0 7 8 27 0 0 2 0 2 5 8 22 1 0 0 0 1 
0 0 8 0 0 0 0 35 13 24 20 8 15 27 33 0 0 0 0 29 18 16 18 0 10 16 0 29 21 0 11 14 7 23 0 23 0 0 5 11 10 5 0 0 0 23 36 33 0 
36 0 13 23 0 31 0 41 0 6 0 0 0 0 0 0 0 0 14 0 0 0 19 0 14 3 22 19 3 9 0 0 14 31 2 0 60 8 14 0 0 0 3 7 0 12 4 0 19 
0 4 35 0 0 12 1 0 0 0 0 0 0 5 1 10 3 0 40 26 0 16 9 7 9 23 7 14 23 0 7 23 5 15 2 17 2 9 0 7 0 0 14 0 13 38 0 0 1 
31 23 6 0 0 30 5 2 0 6 0 8 8 30 0 7 18 0 4 0 1 21 0 17 47 0 26 59 13 35 46 0 46 13 18 0 0 6 10 5 46 14 0 0 0 2 3 0 1 
0 4 0 21 0 4 0 0 54 0 31 0 1 1 1 0 0 4 0 0 0 0 25 0 21 0 0 0 0 0 4 6 9 3 4 4 23 0 0 1 0 0 16 0 36 0 0 0 0 
16 0 0 0 46 6 0 0 23 24 0 0 6 7 43 22 27 13 10 7 15 13 3 15 0 17 4 0 6 25 3 26 0 24 0 0 0 7 6 13 28 37 0 30 6 28 21 0 13 
6 33 8 3 0 3 3 1 41 4 0 0 0 4 0 0 0 39 0 0 0 7 0 0 0 8 0 33 5 0 11 14 6 25 0 0 4 0 50 0 0 14 0 0 27 0 2 0 12 
2 32 0 43 0 6 0 4 0 40 0 0 0 15 3 7 31 26 13 8 2 2 7 4 8 0 0 4 19 0 0 0 2 6 2 0 6 0 4 26 6 32 3 45 13 9 83 69 68 
5 12 53 0 0 0 0 9 15 0 27 17 0 0 0 0 21 10 3 0 0 0 0 0 0 9 0 1 1 16 8 0 0 0 32 0 0 53 12 3 0 39 0 0 1 3 0 0 0 
9 98 50 3 0 41 38 23 22 21 1 1 41 0 2 14 27 11 0 10 0 3 5 0 3 7 0 22 1 21 69 23 23 5 37 13 0 0 26 6 18 14 27 10 0 47 0 15 61 
19 1 0 0 11 15 1 0 12 1 23 0 18 14 0 15 1 2 0 0 0 0 0 27 10 14 0 0 10 0 5 0 0 20 0 0 4 7 9 11 0 0 0 13 0 5 0 0 1 
5 1 13 41 0 23 32 0 11 0 0 15 15 0 2 11 1 2 22 5 0 0 18 2 11 6 0 4 1 17 16 6 0 0 0 0 0 0 32 3 18 4 0 16 41 9 16 0 0 
0 0 51 0 0 0 10 0 18 0 10 0 50 37 0 24 0 0 7 8 0 12 1 2 18 33 11 8 7 12 18 37 0 0 26 0 0 11 28 41 0 12 0 0 18 14 0 45 0 
0 5 53 26 0 21 0 0 0 7 17 37 0 0 21 30 7 18 0 0 0 0 13 0 19 0 0 0 13 24 5 0 26 0 32 15 12 9 36 0 0 0 0 3 0 28 3 34 58 
4 18 8 22 0 13 0 8 0 0 0 1 7 0 0 2 5 6 0 18 14 5 0 0 0 20 0 0 0 0 4 11 0 22 2 6 0 4 0 0 18 13 11 9 23 0 0 0 4 
0 19 0 8 0 0 22 15 0 5 32 22 11 0 1 4 43 18 0 0 18 12 15 0 1 9 12 0 32 1 1 0 0 8 0 0 31 0 54 0 20 16 0 0 0 5 0 0 3 
25 9 28 0 0 0 0 0 0 2 4 21 4 0 8 16 4 32 0 0 0 6 12 4 6 1 0 0 1 0 47 16 16 0 0 14 0 0 0 0 12 18 17 0 2 9 46 0 0 
0 0 0 35 0 0 0 29 5 0 0 0 0 5 0 7 0 0 0 0 0 0 40 0 8 0 0 0 17 0 0 0 8 0 0 0 27 21 57 22 0 5 0 21 0 2 0 0 0 
0 11 0 22 0 5 0 10 10 0 0 27 0 10 2 0 2 43 5 0 22 0 17 10 0 9 9 20 0 17 10 0 5 0 9 13 0 0 4 0 0 0 22 0 33 8 2 20 6 
0 0 18 31 36 13 0 0 0 10 7 45 0 14 0 2 10 0 29 10 26 23 14 7 13 0 10 0 0 6 0 0 12 10 0 20 18 0 2 0 9 1 10 32 21 8 26 0 8 
21 2 2 14 44 5 0 18 0 31 0 0 7 0 27 0 17 18 0 25 0 5 13 1 0 20 14 19 0 0 13 0 6 17 0 11 0 0 8 31 31 36 16 0 1 65 8 17 23 
57 37 0 15 26 36 0 0 0 41 0 2 24 43 0 2 0 1 20 46 25 0 7 25 0 0 9 0 37 0 21 0 0 24 30 0 0 0 14 11 0 57 0 22 9 13 0 19 0 
4 48 0 21 50 3 27 38 12 15 3 31 13 0 0 0 0 4 11 23 0 0 4 25 38 29 0 23 39 0 5 28 5 0 27 36 33 0 0 0 19 16 8 0 8 29 0 0 23 
