49 28
16 0 26 0 0 0 0 0 34 37 0 24 0 0 18 0 16 17 51 1 5 2 11 22 0 2 0 0 79 0 0 0 18 0 0 2 27 17 2 0 0 0 2 20 26 0 63 0 20 
30 16 27 36 40 10 40 13 0 32 15 18 0 28 0 20 18 6 0 0 7 0 13 24 0 0 0 0 0 27 27 0 0 16 2 45 0 14 3 1 20 31 0 0 58 0 51 0 0 
0 9 0 0 8 1 0 0 71 0 19 0 0 29 2 0 2 23 6 27 28 0 0 0 0 0 0 0 2 19 6 0 0 13 0 22 0 0 0 17 1 0 2 29 36 0 0 0 28 
0 34 38 1 1 52 0 0 0 21 0 2 0 21 0 0 0 0 26 18 0 18 3 17 16 0 7 0 0 0 9 3 0 24 37 34 10 48 0 20 7 0 0 0 5 24 41 21 11 
4 39 0 0 16 4 24 7 25 44 0 0 0 5 16 27 0 14 16 8 11 0 0 0 0 22 12 8 0 14 3 20 11 0 2 21 38 5 24 0 111 0 0 0 3 0 0 0 21 
45 3 0 30 0 31 14 0 12 10 0 8 9 0 14 0 0 0 16 5 5 26 20 5 13 9 11 0 21 75 18 0 27 3 23 0 11 50 0 0 2 0 0 21 44 0 0 0 11 
29 18 27 0 0 3 19 22 7 33 0 0 0 0 14 6 0 0 1 18 0 0 5 0 15 0 0 15 16 8 6 0 1 1 0 0 0 0 23 0 13 6 0 0 35 0 0 6 0 
48 14 0 5 12 42 5 0 0 0 0 0 22 5 0 0 12 1 4 0 0 0 0 17 0 0 14 0 0 0 0 0 0 6 0 0 0 4 0 0 2 0 2 15 0 0 0 42 48 
0 46 7 17 7 0 32 2 19 0 8 28 4 31 2 22 4 16 22 4 58 7 2 5 0 0 0 12 8 9 0 17 21 0 12 15 1 8 22 9 0 13 11 17 10 0 14 46 1 
0 0 7 2 12 1 2 0 0 17 0 0 0 0 8 10 26 0 11 7 0 21 5 0 0 7 1 33 15 0 0 0 10 4 8 0 0 4 0 0 0 0 33 25 0 0 4 0 21 
34 0 44 3 5 24 4 0 0 46 47 24 10 5 54 6 0 13 0 0 3 0 14 9 14 15 0 0 7 0 0 9 6 20 55 56 11 35 0 8 17 0 0 0 30 0 0 17 17 
0 0 3 41 2 0 0 0 0 0 0 3 15 5 0 6 0 2 3 14 8 3 21 0 9 0 0 5 0 0 5 0 0 21 14 0 0 0 0 13 0 0 0 0 0 0 0 0 2 
1 10 19 53 42 5 4 34 3 32 39 29 7 27 0 12 8 14 49 0 0 0 5 0 14 14 24 5 19 10 0 0 16 0 8 0 0 0 1 29 60 52 51 0 26 36 31 22 16 
5 11 0 0 0 6 0 0 4 4 0 0 59 32 0 2 15 7 0 3 13 0 7 10 9 0 0 0 1 10 0 15 0 0 0 0 10 0 0 30 0 7 3 0 36 32 0 0 8 
32 2 0 16 42 4 4 0 15 16 66 3 21 0 0 0 4 12 19 0 0 0 2 0 6 1 0 0 16 14 13 13 34 9 0 0 26 9 0 29 0 5 10 49 12 0 42 39 7 
25 48 0 2 32 0 0 0 0 10 46 13 6 0 0 0 23 0 0 4 0 4 0 0 3 7 0 26 0 20 51 17 0 13 10 5 35 15 0 20 0 0 0 23 34 0 7 14 0 
0 13 15 2 11 0 4 21 0 10 15 0 0 0 12 0 3 0 7 24 15 0 0 0 61 0 21 44 2 19 7 0 25 10 0 0 11 13 0 1 11 0 0 66 0 0 0 23 21 
6 16 0 0 0 42 10 0 21 11 0 13 0 0 0 9 15 17 39 0 0 0 18 0 18 0 0 7 10 20 0 2 8 0 7 0 22 0 0 0 22 33 0 7 0 10 0 42 5 
24 0 0 0 0 0 63 0 8 0 12 0 28 7 0 0 9 14 5 0 0 3 3 17 8 0 0 0 0 0 0 0 0 17 22 0 0 0 1 0 48 14 36 3 6 0 0 41 0 
2 42 10 0 0 19 14 30 0 6 0 6 24 12 0 50 21 29 6 0 9 1 30 0 67 12 0 27 40 6 14 5 10 33 6 13 8 30 0 13 3 8 21 61 18 0 31 0 13 
15 8 19 6 18 0 0 4 0 6 9 0 34 0 0 14 8 6 10 0 0 0 10 10 0 0 0 0 0 0 0 5 0 0 11 0 0 0 10 27 0 0 0 0 0 0 0 9 0 
0 0 2 26 15 7 3 26 65 3 0 36 0 1 1 13 14 1 15 21 13 0 27 8 2 0 2 8 6 20 0 0 0 24 26 11 3 0 1 0 40 13 0 24 0 9 6 47 0 
6 46 0 22 0 0 24 13 0 0 18 4 0 35 3 27 9 14 0 0 50 0 19 7 5 0 11 26 4 0 0 0 9 0 19 6 0 17 0 19 0 6 0 33 0 19 33 73 2 
82 91 42 0 0 37 0 10 0 0 18 17 0 4 0 0 4 14 8 9 18 0 0 0 12 12 0 0 9 1 18 0 12 33 13 0 9 12 18 20 11 5 42 1 13 0 0 0 6 
0 59 30 0 0 21 20 0 0 0 2 9 0 0 0 0 0 30 20 21 0 0 0 0 14 0 15 0 0 0 1 2 30 0 16 22 0 6 0 0 0 36 2 20 16 0 0 0 47 
0 62 0 0 0 15 31 0 0 23 12 3 0 25 0 0 0 0 5 0 27 8 12 22 0 11 9 0 0 24 0 0 23 12 0 11 25 22 0 0 0 40 0 0 0 0 18 0 21 
0 0 0 29 16 0 0 12 9 21 14 0 20 0 33 40 1 33 0 20 15 0 7 18 0 3 0 0 21 40 0 19 33 10 35 0 35 0 25 36 2 10 0 0 0 11 0 48 18 
8 0 2 10 0 22 0 17 44 6 5 24 23 37 0 6 35 45 16 0 5 0 0 9 50 5 0 12 0 11 0 0 22 25 0 25 0 7 21 3 0 24 6 0 7 10 16 0 10 
