49 28
27 23 0 14 0 39 31 12 0 0 57 14 1 15 5 0 0 4 0 18 0 0 0 6 52 37 0 29 4 0 14 4 0 0 0 36 0 25 25 0 10 42 0 0 0 22 14 0 43 
27 0 16 41 0 24 21 4 16 45 36 9 4 0 14 6 0 13 0 0 7 21 2 13 0 19 5 0 0 4 14 6 0 0 25 0 13 0 4 0 0 0 21 0 3 0 68 14 93 
7 20 0 0 0 0 0 8 0 0 22 0 11 42 0 0 29 24 0 2 0 0 14 8 34 23 11 14 23 17 15 14 14 16 14 0 11 23 0 15 44 0 10 0 21 22 0 8 16 
43 12 0 22 2 14 0 36 40 0 0 0 0 0 0 23 18 0 15 0 0 0 0 0 8 0 15 0 22 0 0 0 36 3 62 13 7 0 8 15 0 15 13 78 0 0 0 0 29 
28 4 0 22 11 4 37 16 0 0 13 0 46 1 0 0 2 15 0 10 13 0 3 9 0 0 0 40 49 10 17 0 15 13 0 3 22 11 0 27 6 0 0 36 0 0 6 0 0 
0 33 0 0 0 14 0 8 24 0 0 0 3 11 0 4 4 0 0 27 21 1 0 0 27 0 0 15 5 24 0 0 8 10 33 0 13 31 0 0 20 0 0 0 18 0 8 0 0 
0 0 0 0 0 8 30 0 0 0 9 0 0 14 6 0 25 0 50 12 0 0 16 23 0 0 0 0 11 0 0 12 11 10 0 25 0 2 20 4 6 6 0 41 0 0 23 5 33 
54 0 50 0 0 5 0 0 0 0 39 0 0 0 0 34 0 0 0 0 0 0 0 21 9 0 0 2 18 20 3 49 10 1 21 0 5 0 39 13 10 9 0 0 34 14 0 0 0 
1 0 0 24 43 26 5 10 0 0 0 5 0 0 0 0 32 4 0 0 19 0 0 4 0 18 0 11 28 29 0 26 0 0 0 8 7 0 1 12 0 0 0 0 13 0 0 53 32 
34 0 0 0 16 0 41 0 0 0 0 0 0 10 0 13 4 9 16 0 0 14 0 20 0 0 31 5 25 12 0 1 4 8 44 7 0 0 2 0 13 19 20 11 3 5 0 6 0 
0 0 0 0 20 6 2 23 0 33 0 1 0 2 15 0 0 18 13 2 0 1 0 13 0 0 0 0 20 0 0 17 16 24 30 17 6 24 0 55 1 2 52 0 24 22 9 8 15 
0 0 7 0 10 0 0 3 1 8 14 0 0 8 0 6 0 28 0 25 0 0 0 0 15 0 0 0 11 7 25 0 13 0 5 1 28 30 14 0 5 2 0 0 18 28 0 5 0 
10 48 0 2 29 8 78 30 4 0 27 0 0 6 0 0 7 20 19 7 0 6 21 0 15 0 0 7 1 0 0 0 8 56 0 0 0 43 14 0 13 0 10 0 0 0 0 30 8 
11 0 30 11 27 31 2 0 24 12 0 0 0 0 27 0 0 31 16 0 0 9 0 19 6 0 0 4 9 0 0 0 21 0 4 0 74 0 60 2 6 33 0 0 0 0 8 0 31 
27 1 0 2 17 47 56 20 8 0 5 0 23 4 5 11 43 13 0 0 0 40 17 18 18 4 0 20 5 15 11 0 32 0 1 0 31 23 0 5 6 0 0 0 32 16 16 8 15 
11 12 8 0 11 0 14 0 0 35 2 5 0 0 0 0 0 0 0 0 0 0 7 0 2 0 5 6 0 7 12 0 2 15 0 0 21 0 6 0 0 8 0 0 35 0 0 6 15 
3 32 0 9 5 0 34 14 5 22 35 22 32 25 0 0 5 14 8 0 27 41 30 10 10 15 3 4 0 0 0 0 5 27 0 6 0 39 31 0 11 0 39 4 3 0 6 23 0 
18 0 22 0 1 10 10 4 17 19 4 11 0 15 0 0 0 29 27 0 0 34 29 23 14 15 7 16 17 11 0 8 10 11 2 14 28 9 15 2 11 8 4 0 23 0 47 0 0 
4 35 23 0 8 23 0 30 31 0 32 36 0 7 18 0 1 2 21 0 16 0 0 19 18 9 0 20 0 5 0 15 33 13 0 2 7 21 0 12 24 9 10 4 43 9 0 118 6 
0 0 11 36 0 7 0 0 5 37 7 6 0 4 35 0 1 0 17 4 9 1 11 18 1 0 3 5 0 6 5 0 0 4 12 32 6 0 0 2 41 8 33 12 1 0 20 0 0 
0 39 0 0 3 0 7 42 0 0 0 0 36 59 0 0 24 10 3 16 18 15 0 19 0 0 0 17 0 0 0 0 15 26 4 0 0 45 22 9 55 0 14 4 4 1 9 15 1 
15 0 27 0 0 46 0 26 0 0 10 0 2 0 2 27 0 0 0 0 10 0 0 0 11 0 6 2 21 27 30 26 5 20 0 14 4 46 0 0 2 0 27 13 13 19 41 0 3 
0 12 0 0 8 4 0 27 6 1 16 0 0 31 24 12 22 16 23 2 11 29 10 0 5 16 4 8 11 9 0 11 9 0 27 0 1 0 47 4 0 59 0 0 37 0 42 0 0 
16 12 18 9 0 23 3 0 51 2 1 0 0 0 6 0 0 0 13 0 18 0 19 7 3 0 0 0 22 0 29 0 31 13 0 0 8 33 0 0 17 23 0 75 26 0 0 4 0 
0 39 27 0 0 0 5 0 0 0 6 0 0 28 0 0 6 0 0 0 0 15 0 0 0 0 7 0 0 27 17 0 13 0 0 0 0 0 0 0 0 27 1 18 1 3 45 1 19 
0 29 0 36 16 0 0 6 0 12 15 8 2 0 0 29 0 0 19 0 6 0 0 0 6 0 0 14 5 0 20 0 4 2 0 0 39 27 25 0 0 39 16 0 41 46 36 3 15 
40 73 40 51 0 8 0 6 0 10 0 23 0 5 31 17 9 8 7 7 0 3 0 16 1 4 18 6 0 12 9 0 9 8 0 11 13 49 6 2 48 0 47 17 0 10 5 4 12 
27 0 0 0 23 0 0 10 0 3 37 0 3 0 8 11 0 15 30 0 46 0 0 11 14 0 4 14 0 20 12 20 0 0 0 1 1 11 38 0 0 23 25 0 30 9 0 65 20 
