49 28
21 4 2 22 13 63 25 15 0 0 19 0 11 0 2 0 2 42 17 23 25 18 0 14 3 37 16 3 10 0 0 0 0 0 29 2 0 28 0 5 22 0 55 0 3 0 38 1 0 
0 0 57 27 0 41 25 0 0 0 0 7 0 2 8 15 19 0 0 14 9 0 15 20 0 0 21 3 13 25 40 0 27 2 0 19 0 0 0 25 11 19 0 46 0 0 0 13 0 
6 0 6 2 1 30 30 14 0 16 0 16 0 0 45 6 31 11 1 0 2 56 2 7 7 2 16 16 0 0 0 0 0 0 29 8 40 14 19 4 0 8 21 22 0 25 0 50 0 
0 0 0 19 4 0 0 18 4 2 41 5 0 13 0 0 2 13 0 0 13 0 1 0 0 0 0 18 18 0 0 0 12 37 0 0 19 10 10 14 18 0 0 0 0 30 13 5 0 
17 0 0 29 0 5 12 9 0 0 17 28 0 0 0 0 8 2 0 12 0 0 0 0 0 2 0 11 5 0 0 16 16 3 0 0 3 2 0 45 0 0 0 0 1 14 0 0 0 
0 0 0 0 0 0 1 0 0 3 5 0 21 15 0 0 12 0 0 7 0 31 0 0 0 0 3 27 0 0 0 3 0 0 0 0 29 4 1 0 0 0 0 0 5 0 0 0 27 
0 34 37 36 12 3 17 31 0 1 1 0 7 18 11 0 2 43 3 0 0 39 22 0 0 0 0 0 0 0 0 29 30 0 0 52 0 0 26 33 70 19 0 48 1 0 0 9 0 
6 7 19 1 22 2 44 4 9 1 0 0 0 21 18 0 0 0 0 0 10 28 11 8 4 0 12 0 5 0 15 1 1 3 0 20 13 19 0 0 77 3 19 3 14 46 11 87 0 
6 15 31 26 82 13 40 22 37 41 38 34 36 0 0 5 0 0 0 0 1 6 14 0 0 9 21 8 0 66 0 4 16 3 42 0 0 33 3 15 32 0 3 0 0 37 36 17 30 
0 11 19 0 34 43 0 6 4 0 0 14 26 3 1 32 1 29 0 2 9 28 3 0 7 0 0 16 12 0 51 30 9 8 11 18 10 2 63 19 0 12 9 0 0 0 71 0 44 
21 5 22 0 0 23 21 6 38 39 8 8 21 3 3 13 17 0 0 0 22 7 0 0 0 19 8 16 10 6 0 5 32 23 0 8 5 1 36 15 19 21 23 0 24 31 37 0 107 
19 60 35 0 0 0 0 9 0 0 33 0 0 6 16 3 14 20 3 19 0 22 16 10 0 0 0 6 0 3 12 0 0 3 0 0 0 54 21 11 5 11 0 11 0 0 10 0 47 
0 17 18 40 0 0 0 0 1 20 15 10 33 33 0 0 0 0 45 7 18 0 0 23 0 13 0 8 3 20 0 1 0 0 0 0 14 9 6 0 22 14 0 40 31 33 23 0 0 
5 33 0 21 10 47 0 13 13 35 0 8 1 9 13 4 0 0 38 13 0 9 4 0 0 0 8 19 13 1 2 1 12 9 40 10 0 9 20 36 35 4 27 12 75 0 1 46 0 
87 0 12 0 0 13 13 0 0 0 0 0 0 1 9 0 31 0 14 19 7 0 22 14 18 9 10 6 12 0 5 0 5 0 2 0 20 3 38 0 15 0 8 0 12 0 0 0 0 
0 26 0 0 7 3 0 0 0 13 0 7 10 10 58 17 0 0 0 0 0 0 21 0 3 5 20 3 0 0 1 5 5 3 0 10 0 0 0 0 18 6 0 0 0 12 32 15 0 
23 0 5 0 35 15 6 6 10 7 7 11 7 5 0 25 7 13 9 10 18 0 16 11 0 13 6 9 16 11 12 0 8 0 0 11 6 7 23 22 8 0 0 0 22 0 0 2 0 
11 0 16 45 0 48 0 24 51 0 6 10 0 8 11 0 34 0 9 0 4 10 0 16 9 0 10 8 20 1 19 45 2 5 11 4 0 0 14 0 23 1 0 38 17 0 6 0 100 
44 0 0 17 12 0 0 0 9 21 8 0 7 0 0 20 6 3 21 11 20 12 0 7 0 17 12 0 17 2 20 0 0 3 3 22 0 3 12 35 0 3 17 33 44 17 45 2 0 
5 0 25 0 0 49 0 25 37 0 19 16 0 0 0 0 9 0 7 2 12 0 2 4 0 0 1 40 0 0 8 0 2 0 0 0 10 11 0 20 0 0 0 38 7 37 1 19 0 
0 0 0 0 42 0 0 28 0 0 0 13 0 13 0 0 0 0 0 0 2 4 0 0 13 0 13 0 0 0 0 0 0 6 11 28 18 11 0 6 3 0 13 0 0 7 42 0 21 
95 0 5 28 2 4 42 31 31 0 63 12 0 0 33 8 26 26 29 13 15 0 19 34 0 19 6 27 13 2 0 34 25 16 0 16 26 23 47 15 15 34 25 46 36 11 86 43 0 
72 38 2 36 0 5 0 0 22 0 0 10 0 3 34 7 0 17 9 0 17 32 0 2 0 4 12 0 0 15 0 0 1 13 0 0 19 17 0 2 1 11 0 43 23 0 22 0 22 
74 0 30 10 0 0 0 21 27 0 6 0 16 0 0 0 3 0 18 0 0 0 0 11 14 13 0 3 0 0 6 0 26 13 30 14 18 6 3 5 62 13 0 6 32 13 0 0 0 
0 7 29 0 30 4 5 58 0 0 5 28 0 16 0 5 0 0 11 0 0 4 8 31 9 0 0 0 0 0 0 29 9 9 14 28 0 30 0 31 17 0 31 0 0 0 0 34 0 
8 0 2 0 4 1 8 31 0 0 0 28 24 6 23 0 16 0 16 0 12 0 0 0 0 40 0 2 0 15 0 3 0 0 3 0 0 0 20 61 0 19 0 0 0 0 0 0 23 
0 11 19 36 34 33 20 0 4 0 0 5 0 13 19 0 3 0 1 9 0 26 0 0 0 1 0 4 0 5 3 0 3 5 6 5 14 51 23 33 15 5 16 0 0 19 0 49 0 
0 0 28 0 0 35 50 0 15 0 21 26 6 20 0 0 17 0 0 0 8 0 0 15 0 0 0 8 26 6 25 17 0 30 0 8 0 20 24 0 0 0 11 37 0 49 0 0 0 
