49 28
0 8 103 6 31 0 0 41 0 2 21 48 7 0 0 5 4 23 11 7 4 0 3 25 37 42 0 43 14 2 5 0 0 12 32 14 19 53 6 14 3 17 37 4 0 5 14 0 24 
0 0 0 0 36 0 10 0 0 24 0 12 3 0 17 0 3 0 0 0 24 0 0 30 15 0 0 0 0 2 0 2 26 0 25 5 0 3 0 0 39 0 0 4 0 0 2 20 11 
0 11 0 0 30 0 0 0 33 0 13 2 18 0 4 3 4 1 25 0 8 0 0 25 0 23 2 0 0 0 3 0 22 0 39 7 0 1 0 0 6 57 21 9 9 0 0 0 28 
24 7 52 0 8 0 7 30 2 0 38 0 9 8 0 3 1 1 12 4 0 17 14 21 35 0 1 19 4 0 12 0 4 9 2 4 0 30 22 0 0 0 3 11 0 26 0 0 79 
0 0 0 31 0 24 0 36 20 22 0 43 28 0 28 0 9 10 6 1 0 0 22 0 6 22 1 14 4 24 0 0 0 0 2 0 0 5 11 13 0 1 23 0 27 0 39 0 0 
11 19 0 0 0 0 0 0 19 51 0 36 1 26 20 13 18 8 15 14 0 0 6 18 0 0 40 0 47 0 19 0 9 38 3 19 25 0 5 26 0 13 2 0 0 19 21 0 0 
0 74 9 10 0 20 19 0 25 15 0 35 1 10 0 3 5 0 8 16 0 0 0 6 24 9 4 14 12 0 15 7 6 67 0 36 0 39 12 0 0 0 15 42 1 1 0 1 14 
0 29 3 43 10 0 7 9 11 5 0 0 0 38 33 0 0 15 16 15 13 19 4 10 7 0 12 4 0 3 20 0 2 0 1 12 19 0 0 0 0 4 3 13 37 15 53 33 0 
45 0 15 39 0 8 0 25 0 22 31 0 6 0 1 1 0 0 2 0 21 0 11 0 10 0 9 3 0 0 0 10 38 3 0 0 27 39 0 0 6 56 39 19 0 6 0 0 4 
2 0 6 0 0 4 41 0 0 4 7 0 14 29 0 54 0 31 0 1 19 0 9 0 0 0 6 18 0 0 0 4 16 1 0 17 14 39 0 0 27 2 10 10 0 0 0 73 14 
45 17 6 1 0 19 25 28 14 2 23 0 5 62 9 9 30 3 7 10 14 9 20 10 93 1 17 18 0 11 1 0 8 65 0 51 23 7 0 16 8 32 2 52 20 0 0 0 0 
24 0 28 0 26 3 20 0 0 16 0 0 0 0 18 0 5 0 0 6 48 0 8 0 24 21 20 0 0 0 28 2 1 6 0 13 2 11 2 28 15 3 18 18 0 34 14 0 0 
0 0 0 0 0 3 0 0 3 0 15 0 11 0 0 6 0 0 12 0 0 0 5 0 12 0 0 0 0 0 10 4 1 0 5 12 5 8 13 0 0 5 0 0 6 8 0 0 4 
3 5 0 0 0 0 0 23 0 11 0 8 3 0 0 19 0 30 11 4 0 0 8 0 0 0 0 0 10 0 15 2 1 0 11 19 0 0 12 0 0 34 6 3 0 0 29 0 3 
6 5 0 26 3 0 3 0 5 0 31 0 22 0 16 5 10 10 0 0 5 0 2 17 12 24 8 1 0 13 1 0 6 12 0 9 6 0 0 3 27 41 0 1 4 0 35 0 7 
0 9 9 47 20 16 0 31 0 19 25 0 10 0 32 0 24 2 0 0 18 42 0 15 41 7 14 6 19 17 0 0 19 0 0 0 5 17 18 0 74 21 0 0 0 0 32 0 59 
16 0 31 6 0 0 42 0 9 0 7 0 0 0 16 11 8 26 0 0 7 7 8 0 0 0 10 8 2 0 11 17 0 31 0 0 0 0 16 36 8 0 0 38 0 42 0 0 28 
0 5 0 2 3 0 0 0 0 4 7 34 6 10 0 0 34 10 0 7 0 0 5 7 17 0 8 0 1 0 10 0 7 3 5 10 5 0 0 0 5 15 25 2 32 23 20 38 22 
8 17 18 9 45 40 9 0 0 9 0 0 8 0 9 7 32 8 15 0 25 0 11 30 18 0 0 42 31 0 15 0 4 0 7 8 11 12 22 0 41 0 0 11 43 10 0 11 44 
38 0 27 0 42 0 0 9 6 0 0 0 0 19 0 0 0 0 0 0 0 14 6 0 0 0 14 0 27 1 9 0 19 0 0 0 8 0 31 0 14 0 4 16 8 0 4 43 0 
6 0 0 0 20 1 0 0 0 0 0 9 34 0 22 0 3 10 0 0 9 0 0 0 7 13 0 23 0 18 26 0 6 0 0 14 13 16 13 0 28 0 0 0 0 9 0 0 58 
43 0 6 0 45 28 5 0 7 9 14 5 0 43 14 7 0 3 0 8 3 5 15 0 21 14 21 0 16 24 21 16 13 2 0 3 14 0 3 14 31 0 18 30 0 0 0 38 0 
0 5 0 26 0 0 27 0 8 0 7 14 7 0 0 0 30 24 20 16 0 10 0 0 7 22 0 10 17 18 0 1 4 10 7 9 33 10 22 18 0 29 0 0 0 0 0 0 0 
42 23 0 0 2 43 0 1 0 10 11 26 2 0 0 0 17 0 0 22 13 11 0 0 23 0 10 14 0 0 0 11 10 9 0 0 11 0 19 0 8 0 32 7 2 16 29 0 43 
0 0 5 35 0 49 0 0 34 0 0 2 0 17 1 23 21 0 3 0 0 22 8 0 14 14 0 0 0 14 0 0 1 0 31 2 31 4 23 0 1 57 18 14 0 0 25 39 0 
29 24 40 37 0 0 21 19 22 56 0 8 0 16 8 0 16 0 15 22 4 0 13 1 0 8 14 17 0 21 0 0 28 22 25 3 0 17 0 0 8 0 17 32 44 0 0 0 16 
8 0 2 30 0 0 0 0 19 6 0 25 0 17 8 24 17 0 33 24 0 26 8 33 35 0 21 6 38 0 17 0 17 13 0 17 0 0 5 23 3 62 14 16 0 0 21 0 17 
0 43 34 3 0 0 0 0 27 3 15 23 19 0 0 0 3 7 21 7 3 0 14 0 0 0 0 10 0 10 10 4 26 0 0 13 0 6 0 27 9 0 48 4 43 0 0 0 0 
