49 28
0 0 14 19 0 0 0 33 25 115 29 20 27 20 34 0 18 14 0 18 8 10 5 2 0 8 18 1 17 10 0 9 0 29 6 0 7 37 7 18 33 0 23 6 18 54 0 14 10 
0 27 33 53 36 0 0 23 1 14 8 10 0 0 5 17 23 10 14 0 13 0 6 20 0 0 7 0 6 12 20 23 25 6 0 0 0 1 0 24 26 28 19 61 4 59 0 19 37 
48 0 3 5 0 13 35 0 15 31 51 0 0 24 8 49 32 0 4 16 7 15 20 12 0 12 0 18 5 15 0 0 0 0 0 18 7 18 0 0 19 55 4 33 15 3 0 0 16 
0 24 4 13 19 1 0 0 0 0 28 0 0 0 0 8 37 0 21 8 2 0 0 0 0 22 17 10 6 0 0 5 0 9 0 0 0 3 28 5 5 21 13 1 1 0 7 12 7 
0 0 15 0 0 37 0 0 0 30 33 0 0 0 40 0 5 0 1 0 14 0 0 0 21 0 0 0 4 0 17 0 11 3 4 16 0 9 4 53 2 41 2 62 0 0 5 0 0 
0 34 0 11 0 34 0 0 14 1 0 30 7 0 0 0 13 0 6 10 49 2 20 0 6 7 19 4 0 6 0 0 27 0 0 39 0 0 0 38 18 5 20 0 7 15 0 20 4 
11 19 13 0 0 15 0 17 29 5 18 2 0 20 5 0 0 0 4 0 0 0 0 0 0 13 0 0 18 0 0 0 0 19 0 0 0 25 12 0 0 2 3 0 0 0 0 20 0 
0 39 7 0 0 0 44 0 0 5 0 2 0 0 27 0 0 0 0 0 2 8 0 0 2 0 13 14 0 6 35 0 31 24 3 29 0 12 0 0 0 13 0 0 14 0 0 7 9 
0 0 27 44 0 0 0 24 0 15 8 8 6 28 0 0 16 0 24 8 10 1 0 0 19 0 0 8 0 0 9 19 16 13 2 6 0 0 10 22 8 2 0 40 4 0 7 0 0 
67 27 0 48 57 0 0 0 15 0 16 19 12 12 11 9 0 10 0 0 15 0 0 0 0 2 3 31 46 15 4 11 12 0 9 21 26 0 25 3 4 34 47 6 0 0 5 20 27 
16 0 22 0 7 0 26 0 17 29 0 0 15 24 14 0 7 30 13 22 29 4 0 6 6 21 0 8 14 0 0 1 26 0 1 17 0 0 14 0 0 32 0 15 0 10 16 30 19 
11 1 40 0 0 7 0 0 6 1 30 13 3 0 0 10 0 36 7 0 0 0 4 0 6 22 4 4 0 45 0 20 0 0 3 0 0 0 1 0 40 0 0 0 6 11 0 0 0 
15 8 0 7 0 29 0 41 10 1 3 0 0 0 0 35 12 0 13 6 10 5 0 0 0 0 0 19 0 14 14 14 0 8 23 0 0 0 13 0 6 0 11 0 0 14 0 12 41 
0 0 39 29 21 20 38 16 0 32 14 33 17 7 0 4 32 0 12 3 10 0 1 0 13 41 0 7 0 24 1 0 48 0 19 0 0 20 8 17 0 61 0 0 7 0 0 0 66 
0 13 11 0 0 0 0 0 0 0 0 0 7 30 0 11 0 5 12 0 0 0 0 13 0 0 13 0 2 13 2 0 13 0 0 10 0 12 0 0 0 0 0 18 0 0 0 0 11 
6 7 10 0 4 23 20 0 43 50 0 0 13 0 17 3 0 8 20 10 6 2 12 2 19 17 11 0 32 0 0 0 45 0 12 36 8 4 0 10 8 2 14 62 5 0 27 26 0 
69 47 4 7 25 1 5 4 0 0 33 16 18 0 0 4 2 13 7 0 0 18 0 0 6 19 0 0 0 0 0 19 0 21 42 35 0 25 0 0 28 83 13 33 19 5 0 16 56 
11 28 0 0 0 0 0 10 2 3 50 16 0 0 6 6 28 0 10 0 39 10 0 9 14 8 48 5 0 3 20 0 12 6 0 0 0 0 0 6 0 4 0 0 5 19 2 27 21 
20 11 23 9 0 0 0 0 33 1 4 1 0 0 0 0 2 0 13 5 39 19 0 0 9 0 0 8 0 29 11 0 0 32 0 0 0 0 4 0 0 0 0 28 43 8 0 0 40 
0 34 67 17 0 3 6 7 51 7 15 24 0 13 13 0 2 4 4 0 31 0 0 0 4 28 0 8 0 42 10 3 15 22 0 38 0 16 2 0 7 0 0 35 15 43 0 7 0 
0 7 3 7 0 40 0 26 11 3 34 0 0 28 13 0 0 0 0 18 4 0 19 21 3 5 32 6 0 23 33 0 9 0 0 11 0 0 20 7 0 37 0 0 10 21 16 14 28 
27 18 39 4 0 15 23 40 29 0 7 2 0 5 12 73 0 17 0 18 11 0 0 8 0 30 0 0 20 5 20 0 0 0 26 0 19 0 32 5 0 39 27 3 29 15 0 60 0 
0 33 0 0 0 11 0 0 35 0 22 0 20 0 20 4 0 0 1 4 0 15 11 0 2 18 15 13 0 0 0 9 20 9 20 0 4 9 0 0 9 40 0 17 0 18 7 0 12 
0 0 41 0 0 36 18 17 30 15 46 0 0 0 6 6 0 12 1 30 0 0 12 13 15 0 0 23 0 16 0 2 13 0 0 0 11 20 2 0 17 36 0 33 0 5 0 15 23 
0 0 72 1 44 0 0 23 0 27 43 0 0 14 0 0 0 0 0 0 23 0 0 0 2 0 0 14 18 0 0 0 11 2 8 25 61 0 0 5 38 0 0 23 5 0 2 12 47 
0 32 29 74 16 3 6 0 3 0 46 47 32 3 0 0 8 0 42 0 26 0 0 0 0 13 8 0 0 0 0 6 29 49 0 0 14 6 15 17 3 0 30 12 0 27 10 11 0 
25 0 13 44 60 0 6 21 0 14 28 3 17 9 31 13 0 4 0 0 0 7 0 17 31 9 0 10 14 40 40 0 0 0 0 12 4 28 6 0 0 6 18 34 0 31 19 26 25 
9 31 12 61 0 8 39 22 21 0 26 83 2 5 12 12 0 12 10 14 38 14 0 17 10 12 12 30 0 7 0 26 12 14 0 46 0 34 8 103 14 17 31 0 0 1 0 20 23 
