49 28
24 43 0 0 27 0 26 14 6 21 32 0 0 0 92 4 26 0 0 0 0 11 0 40 29 16 18 0 6 28 0 12 5 0 51 3 0 21 0 23 9 17 16 0 20 4 0 37 0 
0 5 0 0 36 0 5 0 33 0 15 8 29 10 11 6 0 18 0 0 0 0 0 16 55 0 0 0 4 22 16 0 13 0 11 3 8 4 32 0 0 42 0 39 20 1 9 0 0 
0 8 0 0 18 0 0 0 4 10 0 0 21 0 0 6 0 0 0 4 18 10 22 0 19 0 0 0 31 8 0 0 2 6 0 0 2 0 35 6 0 6 0 24 3 18 0 6 0 
11 0 0 0 0 0 0 3 10 0 19 13 0 0 12 0 16 0 0 1 40 2 8 8 17 0 0 0 18 0 0 0 9 3 15 3 0 0 0 0 0 1 2 0 0 0 23 0 23 
8 28 46 37 0 6 31 6 0 0 0 42 0 0 0 0 0 0 0 0 6 12 4 3 0 14 6 0 14 0 23 0 9 4 3 9 6 28 5 26 47 61 21 11 0 0 10 36 23 
20 0 0 0 0 11 0 0 1 33 0 34 40 1 1 0 0 16 17 3 2 2 3 11 16 14 0 5 0 19 30 18 0 7 0 0 0 0 0 3 2 31 31 24 0 38 0 14 3 
0 0 0 0 10 0 11 40 5 11 29 0 26 0 8 19 8 0 0 0 11 0 4 4 0 2 0 44 0 0 20 0 0 3 43 0 9 3 9 0 0 4 0 16 0 4 2 40 0 
0 37 0 24 15 2 20 0 10 4 7 18 0 6 0 32 7 0 17 2 0 1 8 0 6 0 12 14 5 0 19 10 0 25 5 8 0 1 5 0 19 17 8 4 29 0 1 1 22 
48 12 0 11 0 0 25 39 2 28 27 15 0 0 1 33 23 12 0 0 0 14 4 0 11 0 15 0 25 25 0 47 23 17 0 0 0 18 8 0 0 0 0 0 12 0 31 0 39 
16 27 0 1 0 0 34 7 31 5 13 0 19 0 0 11 0 0 2 20 19 0 32 0 28 0 6 0 14 15 0 0 13 0 15 0 0 25 5 38 0 5 0 19 0 27 42 0 3 
41 36 4 5 46 0 4 4 13 0 0 0 15 0 0 0 0 19 11 11 16 6 8 4 8 18 0 8 4 28 2 12 6 6 0 0 25 36 0 6 0 10 14 0 0 0 24 13 0 
7 47 0 17 12 34 26 0 0 0 53 28 17 31 0 0 8 10 2 16 0 14 11 22 12 16 15 22 9 0 3 0 26 21 21 7 28 0 0 3 30 52 12 4 0 13 0 36 45 
33 3 0 0 0 11 6 0 4 4 0 0 0 0 11 0 0 30 0 7 0 0 3 10 0 19 21 0 0 0 30 8 8 13 15 0 0 0 0 39 0 36 0 14 38 0 21 0 5 
13 42 0 0 13 19 37 10 17 15 36 0 0 0 32 4 0 0 3 20 5 9 29 15 63 2 0 6 0 0 21 3 4 12 0 9 0 0 0 20 0 5 0 5 0 0 68 25 24 
0 0 2 3 5 72 34 3 0 1 12 0 0 12 8 21 2 0 0 0 12 12 37 0 0 25 19 8 0 0 2 0 6 13 11 0 18 0 0 7 45 7 37 0 19 13 17 2 26 
13 12 0 3 0 0 28 30 0 22 8 0 18 10 0 0 0 3 20 12 0 18 12 9 0 0 9 0 7 0 16 0 0 0 23 14 0 0 20 13 0 0 19 0 1 0 0 0 0 
18 0 0 5 15 34 12 0 0 6 15 46 22 0 5 9 2 0 23 5 0 0 0 0 41 9 2 0 2 0 0 3 0 0 22 0 1 8 0 34 0 0 0 0 0 0 2 0 7 
0 35 0 17 0 23 41 0 10 36 0 3 0 16 2 4 25 0 23 8 17 2 8 0 17 3 0 26 30 0 16 3 2 0 0 2 0 2 35 9 7 20 0 42 2 36 0 7 7 
2 0 8 22 3 76 32 0 0 5 33 0 27 0 5 4 0 1 8 4 19 9 19 6 6 7 19 0 14 0 12 5 3 7 4 16 7 0 31 27 0 5 37 44 59 0 27 0 0 
13 37 0 0 1 0 35 18 0 0 18 20 0 2 18 41 0 18 0 7 8 11 5 12 0 11 26 18 24 0 17 3 2 0 6 8 0 22 37 26 0 47 0 5 0 3 32 9 5 
0 9 0 0 0 0 0 5 0 0 29 52 0 0 19 0 0 0 0 0 0 13 0 2 7 0 15 0 0 0 8 0 8 10 20 0 0 30 0 2 0 45 0 0 0 0 2 0 0 
0 9 30 41 4 42 3 0 12 34 25 30 0 0 3 0 64 0 26 0 4 20 2 20 85 5 4 0 0 13 27 20 51 3 26 25 8 3 6 6 31 19 16 27 18 1 11 42 0 
0 0 17 0 15 0 34 4 17 13 45 0 0 0 1 0 20 0 15 4 4 0 11 0 0 21 0 0 19 12 1 1 0 4 0 0 0 0 0 3 8 0 32 0 15 0 19 18 0 
13 26 0 0 57 34 0 10 0 0 5 0 0 0 3 5 0 0 0 0 0 0 0 0 0 15 0 49 21 36 0 13 0 3 0 0 0 3 19 79 15 4 0 0 3 4 0 13 4 
0 3 6 20 26 0 17 0 6 3 18 6 1 0 0 0 0 6 0 19 7 0 10 11 12 6 48 4 31 0 0 18 0 0 0 2 5 0 0 15 0 0 0 17 0 13 0 0 0 
4 10 23 4 0 0 0 0 1 0 0 16 0 20 0 0 8 0 0 0 0 9 2 39 4 42 5 12 17 0 0 0 0 30 25 42 33 13 2 28 0 0 21 0 0 0 23 6 0 
12 10 0 8 13 26 17 4 18 24 12 32 31 12 29 3 5 21 0 10 12 23 19 26 16 31 0 18 15 8 0 26 7 6 0 6 0 9 7 15 0 22 34 22 8 0 0 36 23 
0 17 26 44 0 0 24 25 31 12 14 3 25 0 3 9 24 0 12 29 0 21 4 17 20 0 4 23 26 5 5 12 25 0 21 0 18 0 26 20 39 0 0 4 0 0 19 44 56 
