49 28
0 34 14 13 2 27 3 0 6 0 28 0 26 24 0 0 18 19 10 0 2 17 0 15 0 0 10 0 0 36 8 13 0 0 0 34 1 19 56 0 26 7 0 19 33 15 0 3 39 
0 10 0 8 0 46 13 37 0 0 53 17 0 32 0 0 10 18 0 0 9 0 5 6 0 18 0 7 0 29 0 35 0 24 8 0 29 41 24 9 18 36 8 18 17 14 0 0 1 
0 35 8 0 0 25 5 0 0 0 6 8 0 42 0 0 0 2 0 0 12 27 20 11 0 0 0 19 10 8 14 18 0 0 32 34 1 0 10 0 0 7 8 0 0 14 1 0 22 
0 4 17 21 0 0 0 0 28 0 20 49 0 0 0 0 0 18 0 19 23 0 3 14 0 0 0 29 10 0 5 8 21 3 16 0 3 9 14 11 9 0 0 0 19 8 24 0 2 
58 0 0 7 4 0 3 0 9 14 0 0 0 3 0 2 26 0 0 7 0 4 0 0 0 0 20 0 5 0 22 1 1 0 6 0 3 0 4 3 0 41 0 27 0 0 0 0 47 
0 0 32 29 0 0 3 38 6 17 43 43 0 0 3 29 0 7 11 10 6 11 12 0 21 1 26 3 13 10 17 9 0 9 16 2 11 14 34 24 0 0 5 0 0 8 6 1 58 
4 51 13 3 6 14 0 9 6 28 12 4 0 10 0 8 0 0 7 41 6 0 22 19 0 20 19 16 0 2 0 17 0 6 0 3 4 2 0 0 0 4 0 42 0 23 0 5 28 
12 5 4 21 17 18 5 6 13 9 24 4 0 11 15 3 0 0 0 14 0 12 8 20 7 0 5 17 0 0 2 0 8 5 0 0 0 0 28 0 19 7 3 0 6 0 5 0 0 
11 4 1 30 33 0 10 7 25 27 0 54 23 0 3 59 8 7 15 0 31 0 2 0 23 10 8 27 0 12 30 0 0 54 36 0 54 13 0 28 0 4 0 0 4 6 0 32 0 
0 0 15 3 0 65 14 19 0 0 2 8 0 27 0 0 2 10 21 10 0 0 5 21 0 0 0 17 8 0 15 0 25 0 0 21 1 14 0 21 0 7 6 1 10 0 0 0 49 
0 0 22 11 14 0 0 10 0 40 5 0 0 0 22 0 0 41 5 0 0 0 16 2 33 0 15 0 0 18 0 0 0 0 19 0 20 33 38 24 0 0 7 17 35 9 7 1 17 
17 17 75 36 0 8 8 7 7 7 10 0 0 30 12 6 40 51 0 6 0 7 21 0 11 16 0 0 10 0 28 14 0 2 10 5 0 0 23 0 8 3 0 36 29 0 0 21 71 
12 0 33 0 6 0 31 29 16 4 35 22 3 16 5 0 0 15 13 0 0 0 16 12 0 0 4 0 15 17 0 13 0 0 0 68 20 0 8 22 21 0 0 0 9 43 13 8 0 
0 0 18 0 0 0 28 0 49 3 14 0 9 2 0 0 0 6 7 4 0 9 0 14 6 23 0 10 0 9 0 0 0 0 26 27 8 24 9 2 35 0 0 3 24 43 0 0 38 
38 0 40 1 13 5 56 13 5 34 0 0 1 22 13 19 0 24 3 10 0 19 9 0 24 0 4 0 23 0 25 12 0 12 0 0 11 28 0 0 0 35 29 41 0 2 54 0 41 
0 47 4 39 0 81 4 5 31 0 9 32 0 8 59 0 15 16 15 11 2 15 6 3 0 23 3 0 10 10 6 0 0 0 13 12 15 0 0 29 0 0 41 61 41 41 41 0 14 
3 0 85 70 45 1 4 36 4 0 14 0 6 0 0 0 0 0 28 11 0 0 20 0 25 7 5 4 0 11 11 2 35 0 0 0 0 4 0 12 37 0 0 17 4 39 16 0 0 
0 0 7 10 31 14 2 0 23 0 31 0 0 0 4 0 0 0 4 8 0 0 0 0 0 0 0 0 8 17 7 17 0 0 0 13 0 0 14 2 0 31 0 39 0 0 0 8 20 
2 47 14 0 0 0 0 32 10 12 8 29 0 16 7 7 0 10 9 0 7 45 0 0 13 3 20 0 1 22 11 2 0 0 7 14 0 9 7 0 29 0 0 23 9 13 0 0 14 
0 0 46 9 15 55 19 0 27 0 64 15 4 18 11 19 25 1 0 13 20 16 26 0 0 0 0 18 0 19 35 0 7 34 3 32 9 11 0 0 8 20 0 20 1 74 16 0 7 
0 0 14 0 0 1 0 0 11 6 0 11 1 0 9 10 14 0 30 2 0 0 0 12 0 16 0 15 16 0 0 5 0 0 12 0 5 0 0 0 0 10 0 0 4 0 0 0 32 
8 0 0 0 10 0 15 0 6 0 6 5 0 0 4 0 0 6 0 17 40 0 0 0 0 13 17 30 0 11 0 2 0 22 10 0 0 12 7 1 1 0 31 0 0 0 35 0 0 
0 0 17 6 0 0 8 0 11 0 0 0 0 0 0 0 0 0 0 13 0 18 14 0 6 0 0 0 0 0 30 0 13 0 0 3 0 4 0 13 4 0 0 4 26 0 8 0 15 
0 0 0 0 7 22 18 0 24 0 2 0 4 0 0 0 25 3 0 0 3 23 5 0 0 0 0 0 0 0 0 17 0 15 0 0 23 1 20 0 2 25 2 0 25 0 18 0 27 
0 1 7 2 10 43 0 19 0 0 0 12 0 52 0 27 31 1 1 4 7 0 15 12 17 0 15 18 0 29 9 0 0 0 12 0 5 4 0 0 3 86 27 3 0 16 0 0 72 
0 1 0 16 15 17 0 0 0 0 2 38 0 0 7 21 0 2 42 16 7 11 0 39 19 0 0 0 0 15 0 6 3 20 3 0 21 15 28 0 0 0 0 27 0 0 28 0 67 
0 31 20 0 28 0 0 0 25 31 0 10 0 9 12 0 0 0 5 0 46 24 43 5 0 0 19 20 15 0 0 25 52 0 11 0 0 20 0 0 26 0 1 3 33 56 0 0 4 
0 0 0 10 0 52 31 20 0 16 6 15 3 6 0 29 4 2 10 18 11 0 13 17 11 0 17 0 12 23 0 0 12 8 0 7 4 0 0 12 0 8 3 0 17 0 0 0 0 
