49 28
0 26 22 60 22 0 0 0 36 0 5 22 3 27 1 8 12 23 3 11 18 0 1 31 17 0 11 8 1 0 1 0 15 52 15 39 9 0 2 11 34 24 24 0 17 41 42 3 45 
0 2 0 0 0 0 0 21 0 58 30 0 0 17 0 6 7 11 0 0 0 0 0 0 0 0 0 14 7 0 17 14 11 0 7 3 0 3 25 5 13 12 14 0 8 14 39 26 0 
0 36 0 57 0 0 0 36 0 0 0 17 7 14 0 0 0 0 14 0 27 0 0 0 0 0 6 0 27 0 16 6 0 0 0 0 0 42 10 0 19 0 0 36 0 2 18 12 0 
24 44 31 0 40 37 0 12 57 17 6 23 1 8 16 0 6 0 17 26 12 28 5 0 21 0 14 0 13 22 23 0 0 0 23 27 0 21 12 2 32 21 1 41 84 43 17 35 0 
0 24 0 0 8 2 0 19 3 43 0 57 0 19 14 0 19 0 0 0 1 11 0 14 10 16 6 16 21 9 3 0 14 0 15 10 9 0 3 29 18 30 0 27 0 3 14 4 26 
0 13 20 67 22 0 0 5 14 0 5 0 0 21 1 12 25 0 0 11 38 0 0 25 19 0 0 0 12 0 0 0 7 0 21 16 1 0 9 34 8 6 38 21 3 37 2 11 25 
0 28 0 11 0 7 0 0 43 0 0 33 0 20 29 29 0 17 0 0 0 22 12 16 0 0 0 0 13 28 0 18 24 23 13 2 0 0 0 28 20 13 0 22 25 6 2 7 35 
26 25 4 37 0 0 0 0 0 20 0 2 0 5 0 6 0 1 0 0 19 4 2 20 0 0 49 0 0 20 18 5 0 0 0 14 0 0 0 0 37 0 7 6 0 0 3 10 0 
0 31 29 41 0 24 0 47 29 4 3 0 3 0 11 8 37 15 0 0 3 19 19 3 0 17 11 35 7 5 4 6 16 7 0 23 20 30 1 36 43 3 35 4 0 33 2 18 0 
0 0 0 0 0 0 0 0 3 0 0 10 16 0 0 0 3 0 0 17 9 0 18 0 0 0 0 0 7 18 3 0 0 1 0 0 9 0 16 37 4 0 10 0 8 0 0 4 8 
38 0 0 10 0 0 0 5 7 0 0 1 7 0 0 0 0 0 16 23 0 0 0 0 0 0 8 0 0 0 0 0 0 1 22 0 0 0 46 0 11 0 37 0 15 15 5 3 14 
0 29 43 3 56 0 2 11 9 7 1 11 0 16 3 59 22 27 11 18 8 20 0 0 16 0 1 10 4 20 7 0 0 12 0 31 6 0 13 0 0 10 1 0 21 0 9 0 33 
0 0 0 0 49 0 42 25 9 0 0 0 12 0 15 0 0 20 29 29 2 18 15 0 16 2 9 3 0 15 27 0 43 0 4 0 0 17 0 1 0 0 8 0 11 25 0 31 85 
0 41 11 37 7 7 0 0 25 0 0 0 11 10 1 6 0 0 0 22 0 14 0 0 0 0 0 0 0 2 0 5 0 7 2 0 7 13 0 54 37 36 13 42 1 1 0 4 1 
26 0 35 30 0 6 9 0 16 0 17 2 8 9 0 21 0 8 18 2 4 0 23 11 23 0 2 17 5 3 0 6 0 10 8 0 10 35 2 21 0 30 49 12 0 0 0 5 12 
0 17 0 15 0 15 30 0 10 0 4 0 0 0 4 26 0 0 36 11 17 0 0 7 0 24 15 16 5 0 0 3 0 1 16 0 31 0 0 17 0 2 41 14 7 0 0 0 0 
48 22 12 14 0 0 40 0 23 9 27 0 0 4 10 7 0 4 24 0 2 6 2 18 13 1 2 0 11 0 15 0 9 0 0 16 8 21 0 29 40 3 13 9 3 31 31 11 0 
0 0 5 42 0 0 12 18 22 26 12 37 10 0 0 18 0 10 12 0 2 20 0 13 21 31 0 9 0 33 0 0 5 0 30 0 0 0 0 4 0 0 0 18 0 20 3 42 37 
0 52 0 9 0 2 25 39 0 0 0 20 16 0 20 33 9 0 0 0 44 0 12 0 3 14 0 1 0 0 0 36 0 0 15 0 0 25 0 44 4 0 0 0 37 0 34 10 33 
0 78 42 5 3 0 0 7 3 0 13 48 0 0 18 0 0 8 0 0 8 0 5 0 22 0 0 14 10 28 0 0 0 7 0 0 4 0 9 15 9 19 51 0 0 0 22 20 37 
0 0 0 0 13 2 0 2 27 1 0 15 0 0 0 0 7 30 48 3 3 27 0 0 0 0 15 17 32 0 0 0 0 2 0 11 11 9 0 0 32 18 0 0 21 0 6 19 32 
0 0 0 0 0 0 0 0 2 0 0 0 45 9 14 21 10 25 0 18 0 0 11 21 3 0 7 13 16 13 0 0 0 0 0 16 0 0 0 0 8 0 52 0 32 0 0 0 0 
47 7 29 11 15 0 0 32 6 0 20 0 22 42 69 5 5 0 26 0 0 4 41 5 0 23 36 0 0 0 8 3 1 10 5 12 0 38 0 0 21 0 12 31 29 157 30 5 44 
20 5 2 35 33 2 11 2 30 4 4 13 0 7 1 0 0 23 1 17 0 0 8 0 0 0 0 8 28 17 0 15 21 6 0 8 0 33 68 6 22 3 15 0 4 23 50 0 0 
2 17 5 0 0 3 34 2 0 20 28 3 11 0 0 4 0 20 42 19 4 0 0 0 44 15 0 2 2 11 12 0 0 0 0 0 8 7 47 0 20 25 21 31 0 0 6 5 11 
12 0 19 45 57 4 0 0 10 13 29 0 39 0 0 18 0 0 0 9 0 18 25 1 14 17 25 0 15 0 20 0 20 0 1 0 26 33 0 12 0 1 2 0 5 10 9 13 45 
0 39 1 0 4 0 0 19 58 10 0 31 0 22 23 0 0 31 0 7 19 0 7 9 0 0 36 2 18 0 2 0 0 7 3 0 15 29 0 31 22 0 18 49 1 0 0 0 17 
0 0 0 92 0 0 0 33 27 53 32 0 12 20 0 13 15 8 0 0 28 5 24 21 17 0 0 24 13 11 17 0 0 16 0 18 2 0 14 9 55 29 24 0 25 0 0 5 64 
