49 28
5 9 30 0 0 5 5 0 23 0 0 0 0 0 7 34 1 21 40 0 0 0 4 0 8 26 0 26 38 22 0 10 14 0 0 0 8 25 25 5 0 0 0 0 12 0 0 0 34 
21 0 27 38 0 16 70 0 29 9 0 0 0 3 0 2 30 0 0 3 14 31 0 0 9 0 0 0 0 23 5 0 5 7 14 0 0 35 21 0 28 38 8 0 0 40 37 0 0 
49 0 6 40 0 0 10 15 37 7 76 36 21 19 2 18 18 26 68 12 20 1 0 41 0 7 8 0 34 8 3 0 41 20 14 19 0 8 5 6 0 75 13 19 28 100 0 1 0 
0 0 2 15 0 3 0 25 3 12 0 0 0 0 0 11 0 0 0 3 0 4 0 0 0 0 11 0 0 12 0 28 25 0 0 0 7 0 0 9 2 0 0 3 0 0 43 0 0 
67 24 0 33 0 3 9 0 0 0 1 8 4 0 62 0 4 0 0 27 0 0 4 0 0 30 0 0 0 0 0 0 10 0 0 0 0 83 0 17 0 0 28 0 44 0 46 0 48 
0 0 36 18 1 11 2 4 0 38 24 36 7 19 45 3 6 6 6 3 0 18 9 14 5 9 0 24 0 9 0 18 18 32 4 11 0 15 2 5 3 4 9 25 0 42 0 35 14 
0 28 0 62 0 0 31 64 0 0 11 0 0 0 0 9 26 27 11 3 11 0 0 2 17 0 0 17 11 27 5 0 5 16 0 28 0 31 0 0 0 0 0 36 41 0 30 3 0 
75 22 6 0 2 0 18 19 7 6 8 0 0 0 4 16 0 20 29 15 4 3 4 0 6 14 7 11 0 43 0 0 0 7 0 0 0 47 11 9 33 4 0 36 37 0 46 24 0 
19 81 28 19 0 4 10 3 0 12 12 0 0 34 0 23 17 0 0 19 0 20 1 0 7 0 2 11 2 0 0 0 0 0 14 0 0 2 11 14 0 0 0 16 6 43 0 34 47 
0 9 0 0 0 0 8 0 38 0 0 28 0 27 21 0 13 9 0 3 0 0 0 9 9 13 15 0 0 0 0 0 0 0 0 16 9 0 7 16 5 18 0 0 0 15 0 0 0 
0 0 13 0 39 14 0 22 0 0 0 6 0 5 2 0 2 0 0 4 13 4 0 0 0 4 0 0 0 22 0 0 7 31 0 0 9 23 2 0 0 0 10 29 0 0 54 4 0 
0 0 0 0 0 0 70 6 9 0 27 11 0 0 28 5 0 6 19 0 9 31 7 0 24 30 8 0 0 10 6 4 10 8 9 0 0 9 0 33 0 27 18 12 0 37 2 2 0 
36 0 3 69 0 3 7 19 28 0 0 0 8 15 8 0 29 22 0 0 28 0 0 9 0 0 19 10 25 0 0 0 10 13 8 4 8 8 21 18 4 0 25 4 24 0 0 27 0 
10 39 12 0 3 30 2 28 0 1 7 31 34 0 0 19 32 19 6 0 19 0 0 0 46 0 19 9 30 21 0 0 12 2 7 30 6 0 0 38 0 0 15 0 0 0 38 19 56 
16 39 0 9 51 0 39 0 0 0 36 19 5 10 3 6 18 0 0 4 4 21 10 19 1 10 0 11 0 0 0 0 4 0 5 0 54 25 39 5 43 0 21 0 0 81 0 0 0 
14 12 41 0 26 0 22 6 12 0 6 0 0 15 7 48 0 0 8 13 26 3 0 10 12 18 12 10 13 4 0 0 0 21 0 34 0 11 1 12 12 13 9 15 0 50 0 43 0 
7 1 0 0 14 11 0 3 14 0 0 4 0 4 1 3 4 0 41 1 20 27 0 10 0 4 0 0 8 0 7 0 0 2 0 4 0 6 34 1 4 4 10 0 0 10 15 0 25 
29 3 27 0 12 9 34 0 39 16 41 1 18 19 2 29 12 7 0 0 0 24 0 11 8 9 0 0 0 5 16 0 4 21 29 0 0 13 7 3 24 2 32 0 31 23 8 41 0 
5 32 0 18 0 0 21 32 0 0 0 0 0 0 0 0 31 0 8 6 14 0 0 9 0 0 0 8 0 0 0 0 0 32 31 0 0 0 2 32 4 0 26 0 0 0 0 0 0 
0 16 18 30 0 25 0 0 9 0 36 0 9 24 0 0 6 21 17 0 0 0 0 15 0 13 0 6 0 4 25 0 0 32 13 0 3 24 0 0 2 23 0 3 0 0 36 21 0 
0 0 34 0 0 0 18 19 9 4 4 4 0 27 0 13 0 0 18 11 0 14 16 0 5 22 3 0 0 23 0 0 6 0 0 0 34 16 0 0 33 0 10 7 21 2 0 34 0 
42 14 12 0 34 0 0 0 19 1 32 8 0 0 30 19 0 0 0 8 12 0 0 5 0 14 23 4 10 14 0 0 28 0 0 19 0 17 9 0 0 6 93 6 0 0 0 15 0 
12 0 3 0 0 6 0 3 0 44 28 15 19 6 125 10 10 6 0 32 0 20 17 14 16 7 14 0 13 33 0 0 25 23 24 0 10 18 21 30 9 11 0 1 30 0 32 0 6 
16 19 37 28 18 30 0 0 21 0 21 5 42 0 17 11 17 11 29 12 28 39 0 3 0 11 0 0 14 0 7 2 1 29 32 68 0 0 0 0 0 0 42 0 0 0 0 27 0 
62 8 35 0 0 45 0 4 0 8 0 7 10 10 2 24 8 5 0 0 0 0 0 0 4 7 20 0 5 0 2 1 6 0 0 0 21 20 2 0 40 0 0 30 0 0 20 0 0 
0 0 0 20 15 0 7 12 40 0 29 41 73 0 28 24 1 26 25 7 0 0 17 7 0 12 0 0 17 8 0 19 4 0 0 16 19 5 25 17 29 22 30 51 21 0 0 0 36 
18 23 0 12 0 33 22 25 0 0 29 2 17 12 24 2 1 0 32 0 0 0 0 5 0 42 5 26 22 14 0 0 25 0 0 0 9 13 33 27 0 0 5 1 0 9 0 0 0 
2 16 3 22 0 14 0 65 10 20 0 20 2 7 29 3 0 41 13 36 21 0 11 5 11 0 0 8 32 20 25 24 32 2 10 0 0 13 0 3 0 20 35 15 67 25 0 36 0 
