49 28
0 38 4 26 0 20 5 4 12 0 19 0 0 26 0 0 15 20 0 0 12 24 9 0 0 8 14 0 4 0 9 26 12 7 0 0 0 9 0 66 14 0 22 0 0 21 17 0 46 
13 71 40 1 0 0 0 12 0 21 56 0 0 14 52 0 0 3 0 0 15 4 23 0 26 0 1 3 43 0 38 0 0 51 33 0 0 27 39 38 0 0 68 2 0 14 15 14 0 
0 0 0 0 0 7 0 0 3 47 13 5 29 0 0 0 11 4 6 0 0 6 18 26 15 1 2 16 12 15 0 4 10 24 25 25 26 45 0 17 0 20 0 2 6 45 1 2 14 
8 0 32 33 0 5 0 4 15 0 83 13 0 0 28 19 5 0 12 47 0 1 0 0 24 5 0 0 18 50 7 6 30 2 10 10 0 23 2 0 0 0 0 24 34 35 1 6 23 
0 90 27 54 21 17 29 17 61 34 23 0 20 30 16 0 8 35 42 13 0 0 13 0 16 37 13 20 20 27 0 0 17 41 1 50 10 21 20 38 8 5 29 63 38 0 29 35 11 
0 0 12 14 16 0 37 30 0 34 18 11 26 24 0 0 0 5 29 12 7 10 0 0 4 14 0 14 1 15 2 0 0 16 21 0 0 0 32 0 1 0 21 34 0 0 0 0 0 
11 0 9 17 12 2 0 28 12 0 13 10 15 10 0 0 19 21 0 0 10 46 0 0 1 0 33 0 28 25 10 0 0 0 14 28 34 0 21 15 0 41 0 8 0 16 25 0 32 
0 9 76 17 0 43 15 89 37 0 9 10 0 0 0 5 15 6 0 5 5 5 0 0 1 0 0 20 0 22 0 0 50 4 0 14 1 6 0 13 33 31 10 41 3 50 6 0 39 
0 0 11 0 0 4 50 0 3 32 9 0 25 11 0 0 2 5 0 19 0 0 26 0 1 17 0 4 17 0 0 0 4 0 1 1 6 6 0 0 0 0 17 19 0 26 19 1 41 
4 4 27 12 0 0 15 0 0 13 13 11 0 3 0 0 23 16 0 19 33 12 12 0 4 0 29 0 4 28 21 9 0 24 0 0 20 0 8 20 0 24 19 13 12 0 15 5 6 
43 1 14 0 0 67 0 0 4 6 0 14 5 19 0 0 4 7 0 0 4 11 8 9 0 0 0 0 0 0 11 4 29 0 0 4 0 0 22 4 0 13 0 65 0 0 0 0 17 
0 0 17 0 0 39 2 5 9 7 46 35 9 18 0 14 5 0 5 0 18 0 0 0 0 0 0 0 0 14 1 0 0 4 29 8 0 3 0 0 15 0 31 0 0 0 0 12 38 
39 39 0 2 0 0 52 7 12 39 11 0 7 11 0 0 0 0 24 13 0 0 0 0 0 5 20 2 3 6 0 0 9 9 0 22 9 0 32 0 39 0 66 0 0 5 0 15 0 
0 13 10 26 0 0 0 12 7 5 15 0 0 10 0 13 0 12 0 1 0 0 11 17 17 23 7 0 32 0 0 0 0 23 0 0 12 0 14 0 54 0 0 0 0 0 0 0 14 
31 8 0 2 22 10 38 28 12 10 22 0 10 12 0 0 0 18 23 0 5 0 18 0 0 8 0 0 0 0 30 0 0 18 13 39 0 3 0 0 0 0 29 26 0 10 0 54 38 
30 0 0 22 0 50 34 0 0 0 9 10 32 0 0 4 15 13 0 0 24 0 0 18 0 17 0 0 3 0 3 0 0 0 6 0 0 32 7 0 34 3 0 0 53 0 0 0 5 
0 26 12 0 0 0 0 3 0 2 10 53 19 16 0 13 4 0 2 32 3 0 21 8 0 3 0 17 0 17 0 0 10 0 1 0 0 0 10 0 0 0 0 4 2 26 22 9 13 
0 0 17 0 0 7 3 9 4 0 13 28 0 0 0 23 36 0 0 0 0 7 0 0 15 14 2 0 17 0 0 27 0 4 9 20 3 3 0 59 3 0 44 31 0 0 19 4 2 
54 69 0 18 16 0 39 0 22 0 7 2 0 0 0 0 12 7 0 0 0 19 20 0 0 25 25 0 9 44 0 18 9 0 0 0 0 15 0 0 0 0 0 42 15 50 0 6 0 
33 0 14 0 0 0 0 15 7 0 25 9 0 14 15 40 0 0 0 0 0 13 1 3 0 22 3 15 0 0 0 8 0 26 0 27 0 0 0 0 7 0 0 0 0 18 0 42 40 
0 0 15 6 0 5 15 0 7 13 20 34 3 10 0 3 24 56 0 0 0 15 19 25 0 5 0 2 19 41 26 0 0 13 0 0 24 0 0 13 4 0 25 22 13 46 6 4 46 
12 42 27 9 11 17 4 0 0 5 3 42 15 24 0 19 3 18 30 3 0 18 9 0 1 3 6 0 16 0 10 0 0 9 0 2 0 50 16 0 35 0 27 42 18 0 35 39 54 
21 38 0 2 0 15 0 0 14 18 31 0 0 10 0 10 15 0 0 25 0 0 29 0 0 8 0 0 6 0 9 0 0 0 0 0 20 20 9 29 4 0 35 3 29 0 42 0 22 
23 33 0 44 1 40 0 0 0 0 18 11 0 29 12 12 59 0 18 8 17 0 3 15 8 0 2 11 2 0 0 28 27 0 4 0 0 0 24 3 22 40 8 0 4 11 0 7 19 
0 0 0 11 10 3 0 27 0 0 16 10 0 22 10 21 0 0 0 1 9 21 31 0 0 3 1 5 0 0 27 0 4 0 0 30 21 2 22 0 0 0 23 0 0 18 8 10 35 
11 0 0 49 21 0 0 0 0 36 27 2 0 0 30 0 30 11 0 23 0 21 20 0 0 11 0 0 7 0 0 10 21 0 0 0 0 0 2 0 2 38 18 0 3 0 67 1 0 
50 0 2 6 3 28 21 26 7 10 20 3 21 25 0 10 6 0 13 8 0 9 17 0 1 16 46 0 28 23 11 7 10 10 0 25 3 0 32 0 39 24 41 0 28 0 12 0 48 
0 0 17 11 9 0 4 0 0 0 4 0 0 6 0 0 0 39 0 3 0 27 0 0 1 8 4 23 24 0 0 36 0 0 4 11 0 33 5 0 0 0 0 0 0 0 8 0 24 
