49 28
45 48 43 35 0 16 0 29 25 2 0 2 14 0 8 18 14 0 30 0 10 11 3 6 0 25 0 0 0 0 11 24 0 32 22 9 0 20 0 4 37 27 38 4 13 35 11 3 0 
34 0 0 0 21 41 0 0 0 0 0 0 5 22 11 4 30 7 52 17 0 21 0 29 25 13 20 11 1 38 6 0 0 0 30 33 0 0 40 35 22 2 22 69 26 33 24 26 19 
16 15 0 24 37 43 25 1 5 5 1 21 0 10 24 0 0 0 29 0 12 18 48 0 15 0 40 13 16 0 2 18 0 0 0 12 16 4 24 14 1 31 0 16 16 23 0 17 43 
0 0 27 0 9 10 0 10 0 0 28 20 0 20 0 0 22 2 0 0 0 0 0 0 0 0 0 0 0 24 16 0 0 15 9 0 26 0 37 0 0 1 13 30 0 0 0 0 0 
41 18 0 0 0 0 23 12 24 0 0 0 12 0 27 0 0 0 0 0 31 6 10 7 0 15 6 1 0 24 2 0 0 6 0 0 10 0 14 6 0 9 9 5 30 25 16 11 0 
13 0 2 0 13 0 18 0 15 0 2 0 0 4 0 0 12 0 0 0 23 14 0 6 18 0 16 3 4 0 10 0 9 10 0 0 1 1 22 0 0 23 0 0 0 0 0 24 6 
47 1 4 3 0 0 3 6 0 0 44 0 0 21 30 0 33 1 10 13 0 0 0 15 8 0 3 0 9 0 8 0 0 23 2 0 0 4 3 0 0 18 9 0 0 0 0 65 7 
46 1 2 14 0 0 0 3 35 5 21 17 6 0 2 0 0 0 0 0 18 25 4 1 10 0 0 1 17 3 14 0 0 7 6 0 3 0 0 0 7 0 5 35 17 1 31 2 0 
15 20 8 38 26 0 15 0 0 15 29 0 10 16 8 5 2 10 0 0 0 0 12 3 15 0 0 11 0 17 9 0 0 0 12 20 0 30 12 0 28 38 0 6 0 11 0 37 10 
28 29 2 0 9 20 7 0 0 28 19 0 4 6 0 0 0 20 0 0 7 0 12 5 23 13 1 17 38 0 16 0 0 3 11 0 0 28 3 4 4 6 0 0 1 31 0 6 0 
9 19 4 0 36 0 14 0 0 0 0 25 1 0 6 0 2 0 25 36 35 16 5 0 15 6 0 0 0 7 0 0 0 0 0 3 25 0 3 15 36 7 0 33 12 26 0 0 0 
6 28 35 0 0 0 24 0 52 34 49 0 24 0 0 0 0 31 0 0 14 15 0 23 12 13 33 4 0 27 24 42 0 21 10 6 12 6 37 30 0 0 12 0 0 14 17 0 15 
0 28 0 0 0 0 0 0 26 0 0 0 1 0 11 0 5 0 0 0 0 7 0 11 0 0 4 8 1 28 0 0 0 2 26 0 0 1 1 0 0 0 0 0 0 18 0 0 0 
17 6 0 41 38 10 35 41 9 22 2 0 50 26 0 2 0 32 0 0 9 0 9 0 0 8 0 13 1 8 0 28 0 26 2 6 19 3 0 27 13 25 59 0 41 5 0 22 36 
1 5 0 9 42 1 3 0 0 0 13 34 27 1 0 0 4 0 0 16 20 9 9 17 0 0 20 24 3 0 12 0 2 17 10 5 13 0 0 0 0 11 9 38 29 34 75 34 36 
12 39 34 14 0 0 19 18 0 6 26 13 0 3 9 2 0 0 0 0 0 0 3 20 15 31 4 23 0 13 1 0 0 33 0 14 43 0 0 0 0 0 33 3 0 0 19 25 3 
7 0 44 0 0 0 3 12 0 5 21 7 0 0 13 0 5 7 28 0 6 4 0 1 14 4 4 0 0 0 7 21 0 19 0 0 0 13 7 0 0 16 6 7 0 0 53 0 13 
22 24 8 0 0 1 7 28 33 67 0 1 0 0 0 0 5 4 12 0 0 0 4 0 8 23 17 20 26 11 0 4 0 0 0 28 0 4 0 8 29 88 14 0 0 37 0 0 61 
53 18 23 43 11 23 29 24 0 0 0 21 3 13 0 16 0 14 17 2 17 37 9 0 11 34 0 22 10 4 4 4 0 26 0 0 35 18 30 2 29 2 38 33 36 30 8 32 28 
29 44 0 43 34 0 6 0 0 43 0 0 0 0 0 0 0 0 2 6 1 1 18 0 0 11 43 4 24 0 16 0 20 0 0 8 0 28 8 0 39 14 1 40 0 0 0 0 22 
48 5 0 11 78 0 2 0 13 7 0 0 0 41 9 3 7 4 1 10 0 38 1 21 0 0 0 7 27 0 73 0 0 32 7 31 0 20 9 19 36 36 12 0 2 0 7 17 35 
0 5 0 52 27 41 19 8 41 17 1 63 1 19 0 7 5 0 24 0 0 8 10 17 0 0 0 0 3 10 8 27 16 0 0 0 22 4 41 1 6 0 0 0 62 0 25 0 20 
0 20 0 30 0 0 5 29 0 5 10 0 2 7 0 0 0 0 0 0 18 20 0 0 0 13 0 5 0 7 20 0 0 30 21 0 0 0 0 0 20 0 5 3 24 13 3 0 0 
21 20 46 0 0 8 20 0 0 0 0 24 0 5 54 0 0 0 0 3 6 30 25 0 0 4 0 0 0 8 1 6 13 0 0 37 21 6 9 20 2 9 0 39 9 32 22 0 32 
28 18 2 0 37 0 7 0 0 0 0 12 2 0 0 23 15 30 0 15 0 17 11 0 0 23 3 0 18 5 0 17 4 9 22 0 0 2 62 3 0 37 0 21 0 16 0 12 17 
21 25 18 28 4 0 7 57 0 8 7 39 6 0 0 25 0 0 17 0 2 21 12 20 0 25 2 21 21 17 31 0 12 0 8 0 26 1 47 0 0 11 0 36 74 0 35 0 0 
11 22 0 0 0 0 0 28 0 5 9 0 18 0 5 0 0 29 0 15 1 27 5 14 0 27 0 28 0 5 0 0 0 0 2 42 0 0 0 16 4 0 0 24 4 0 29 0 8 
54 39 38 31 0 0 18 0 49 10 8 5 8 0 9 1 22 5 0 0 27 0 34 0 0 19 16 18 0 19 13 23 18 0 7 6 49 0 42 0 41 35 0 29 19 10 0 78 9 
