49 28
1 15 25 40 16 0 120 0 41 10 0 0 8 29 23 16 0 0 0 0 15 0 0 0 0 0 6 23 22 0 0 64 32 3 28 16 3 47 1 6 25 24 0 37 30 5 13 0 40 
0 14 16 95 17 42 38 19 12 4 13 35 8 11 0 32 13 0 34 23 3 7 23 0 0 25 8 9 2 71 19 19 19 1 0 0 10 20 0 14 0 29 16 24 38 56 35 87 0 
0 0 0 36 0 0 31 13 0 0 0 0 36 6 33 0 24 8 26 0 0 25 1 0 14 20 14 43 0 0 0 0 0 0 7 0 10 31 0 36 0 0 0 0 26 10 25 1 2 
8 35 14 39 0 11 47 0 0 0 20 29 54 0 17 0 16 0 0 0 2 0 11 23 4 1 25 0 16 21 20 57 9 0 32 41 0 0 0 4 0 19 39 12 19 3 40 35 4 
2 19 0 42 38 37 0 0 0 0 0 18 29 10 0 0 0 0 0 13 19 15 4 17 4 21 4 19 0 3 0 23 0 0 0 7 0 0 0 0 23 29 8 0 0 41 17 0 11 
0 1 5 12 0 33 11 1 0 0 0 12 26 2 8 22 5 16 0 37 0 10 8 17 9 4 17 0 0 14 0 0 0 0 16 10 17 15 59 20 5 26 0 0 0 0 0 0 0 
7 29 8 0 0 36 29 0 0 5 33 34 13 0 0 7 0 0 11 9 18 0 0 0 0 20 19 0 0 11 14 7 0 7 0 0 0 6 0 0 13 0 16 39 38 33 2 0 0 
15 73 0 50 6 12 12 6 3 28 19 0 43 0 10 6 28 19 24 15 38 6 28 13 4 0 3 0 2 2 18 7 26 32 0 0 10 17 0 31 0 7 61 0 21 0 3 0 4 
0 42 0 0 0 0 28 34 3 4 0 7 0 45 0 22 0 0 0 1 0 0 1 0 9 16 1 0 0 28 57 0 19 0 21 22 1 1 1 24 0 0 19 0 0 0 8 15 0 
15 38 0 0 0 4 1 6 0 0 0 12 0 0 0 23 9 0 0 28 0 0 24 22 0 13 0 0 0 8 0 17 1 3 4 0 0 9 1 0 0 0 20 13 3 13 24 0 0 
4 0 0 4 16 2 26 40 0 0 14 0 0 0 12 0 0 8 19 0 23 0 0 5 0 19 2 0 2 12 0 0 9 0 4 0 0 19 4 0 8 0 28 3 11 0 61 40 0 
78 43 0 37 14 0 16 2 39 3 18 8 0 0 0 0 0 3 22 0 27 0 0 10 0 16 12 27 29 0 11 9 0 0 0 0 13 11 12 4 37 3 22 4 87 0 29 32 11 
16 5 7 0 0 2 0 1 12 5 0 0 0 0 8 12 4 34 0 8 3 0 5 0 2 0 0 12 7 0 2 7 2 0 7 0 16 0 10 0 4 0 3 0 8 10 13 0 21 
0 13 0 45 0 37 20 7 12 17 14 0 0 0 26 0 0 0 9 0 3 15 0 0 0 4 0 1 6 11 0 0 0 0 0 0 0 9 33 0 0 0 0 0 0 0 0 0 45 
4 0 0 4 5 10 48 6 0 0 13 7 0 16 0 24 0 24 12 10 0 0 21 18 10 9 5 23 0 11 0 0 0 8 0 9 0 4 0 25 0 0 0 0 49 23 2 38 11 
55 1 15 0 15 12 0 26 29 0 8 6 2 34 8 20 28 16 2 17 25 26 8 0 0 0 0 1 0 18 0 0 0 16 19 10 0 29 0 42 0 34 5 5 10 17 47 23 52 
12 18 0 19 55 0 3 0 0 0 0 28 30 30 0 11 25 0 0 35 5 20 10 0 18 1 2 14 0 6 27 0 0 18 5 16 0 0 0 28 0 10 26 71 0 0 29 0 0 
0 72 0 0 0 0 0 6 0 0 3 0 0 0 18 22 0 0 10 0 0 0 8 20 0 1 0 0 0 0 24 5 49 0 0 0 4 58 0 0 4 0 0 13 0 0 0 0 5 
0 24 15 11 18 0 11 0 0 12 0 24 11 33 2 0 5 27 0 1 1 13 17 4 0 10 0 0 1 0 14 0 0 0 0 0 0 0 0 9 29 0 6 1 28 44 33 0 0 
29 9 0 44 25 14 21 3 17 6 4 19 0 0 6 0 20 0 0 14 0 15 22 0 0 17 3 1 16 19 19 2 4 0 7 0 36 11 0 9 47 12 0 3 0 0 0 0 11 
39 0 45 0 0 0 0 10 0 20 4 2 0 3 0 0 17 0 0 0 0 5 18 0 0 0 0 11 0 19 42 39 0 17 7 13 0 8 4 39 38 0 0 13 0 1 0 0 0 
0 18 32 0 33 1 0 0 23 0 6 12 15 0 0 40 3 0 10 20 0 13 0 17 10 1 0 0 0 20 0 0 13 4 48 0 0 2 1 15 0 18 14 6 32 17 31 0 0 
0 46 44 11 72 93 0 0 0 0 0 18 21 0 9 17 1 0 0 1 18 26 8 19 1 1 3 10 2 24 0 5 0 29 13 0 10 19 0 8 0 12 15 37 20 7 47 114 5 
0 41 0 10 2 0 25 32 22 0 8 0 0 24 0 29 1 0 27 15 1 8 3 5 0 5 0 8 6 0 7 9 0 0 0 0 0 0 0 32 25 0 63 0 11 55 18 17 20 
42 9 0 0 44 40 30 0 20 0 7 0 18 10 0 0 12 0 24 17 17 20 3 9 10 27 18 32 10 11 0 18 10 14 2 25 2 27 3 0 0 44 75 35 0 13 42 14 23 
0 75 41 0 55 3 13 1 35 12 19 0 33 25 0 24 0 30 0 11 0 6 5 13 0 0 33 20 5 55 0 0 6 5 1 30 32 16 0 0 0 22 0 45 7 52 25 10 0 
19 0 1 0 20 40 0 0 0 20 0 0 35 0 12 0 0 1 1 5 0 0 0 0 7 0 36 0 0 5 0 23 1 0 17 0 4 10 0 0 28 39 40 41 4 0 41 29 43 
0 22 7 0 4 12 35 0 0 0 14 16 3 0 0 10 25 0 23 0 26 0 0 0 0 20 25 16 0 12 4 23 0 14 4 0 0 0 3 22 11 23 19 1 0 4 66 1 0 
