49 28
13 14 0 36 0 33 0 71 0 0 8 29 0 13 30 4 27 7 14 19 7 15 0 0 7 19 0 30 6 3 0 10 25 6 42 0 15 0 51 36 21 0 31 6 21 2 4 1 19 
0 35 0 20 33 34 0 6 0 30 0 16 0 8 7 12 0 31 0 2 3 0 0 13 0 0 0 20 5 0 20 4 23 0 19 0 43 28 0 0 0 13 16 0 0 12 0 22 0 
0 0 2 4 21 17 39 39 0 16 0 2 0 0 0 3 0 3 0 13 10 0 23 0 24 31 20 20 20 8 0 0 0 0 9 0 0 38 7 0 0 0 4 0 0 2 22 20 49 
0 10 0 0 0 0 0 0 0 0 18 20 25 0 0 10 12 2 18 2 0 11 11 0 0 0 16 4 47 3 2 0 5 4 0 0 0 30 0 0 0 43 0 0 0 0 9 24 16 
0 2 0 0 0 0 17 0 0 0 0 24 17 35 13 9 0 0 16 27 17 9 0 2 9 0 0 12 0 0 0 0 21 32 37 0 23 18 0 0 0 0 1 2 46 0 30 0 35 
11 11 0 0 22 9 30 22 7 23 0 14 4 20 36 17 4 0 0 27 22 0 0 15 0 1 46 4 0 0 0 22 17 5 1 11 27 0 0 38 5 7 0 20 0 19 0 0 3 
0 14 0 0 32 17 0 29 0 3 47 13 4 48 21 23 30 0 3 11 0 12 8 5 13 4 13 0 15 14 24 26 12 0 0 1 40 0 21 47 0 0 0 0 12 0 10 19 9 
0 1 5 5 0 0 28 6 0 0 0 0 0 0 0 10 0 2 16 25 25 0 35 0 0 0 0 12 2 0 0 0 14 22 42 0 14 1 2 0 13 6 0 15 39 0 12 0 14 
0 70 21 11 0 0 22 17 0 4 8 0 16 0 42 10 0 0 0 44 3 0 23 14 12 0 0 0 35 0 0 0 0 32 33 0 13 0 6 0 18 3 0 4 6 26 32 32 3 
0 27 32 0 0 15 0 23 0 0 0 6 32 0 0 21 17 0 7 0 63 0 0 0 11 0 9 7 10 3 30 2 6 7 49 0 29 7 11 0 0 1 10 0 32 5 26 13 9 
66 6 8 0 27 12 0 10 26 10 27 0 0 2 4 27 25 0 1 0 0 25 0 11 0 0 10 0 0 10 22 34 15 17 1 0 2 27 23 9 40 9 17 0 0 0 28 0 0 
0 19 27 24 8 0 0 0 24 0 0 0 20 0 1 0 0 0 48 22 6 0 21 33 0 12 0 14 0 18 0 8 25 0 7 31 0 0 0 12 3 22 0 39 36 9 5 29 0 
0 23 20 5 2 0 28 23 0 10 0 0 0 28 0 3 27 8 3 17 0 0 0 2 25 1 14 0 0 0 23 4 0 0 0 0 0 0 0 0 0 19 0 27 0 39 0 0 0 
0 44 0 0 14 40 3 60 12 0 7 0 29 0 0 1 0 10 14 9 0 34 0 0 0 0 3 0 0 0 0 0 0 0 4 0 2 0 0 32 0 26 0 0 3 43 25 0 3 
0 14 0 0 0 28 0 15 0 0 13 4 26 0 9 0 18 0 0 0 0 0 0 15 8 0 0 0 11 0 3 22 0 28 0 0 0 6 26 3 0 0 0 0 0 5 12 0 2 
7 4 7 22 0 38 0 5 16 38 0 10 43 41 9 2 0 0 0 0 0 0 0 0 16 25 1 9 3 0 13 18 0 0 9 0 23 3 0 0 0 10 0 33 0 33 0 38 21 
31 44 6 45 0 4 45 29 39 2 15 0 15 25 5 22 14 0 22 0 0 0 16 15 10 0 22 0 3 7 0 38 0 0 9 29 20 21 21 6 22 34 6 16 43 11 37 39 21 
0 0 19 40 3 22 39 27 28 0 0 23 18 9 14 2 0 6 0 0 0 0 26 9 0 23 5 22 0 0 14 0 0 0 24 28 25 43 0 11 32 27 19 0 13 36 0 0 26 
21 53 0 0 0 33 14 0 67 16 37 29 29 0 0 7 15 0 0 0 0 31 0 4 0 6 0 0 3 0 17 0 0 15 23 13 5 0 88 31 0 64 8 5 0 5 0 26 28 
5 4 4 11 45 63 2 11 0 0 13 24 7 7 0 19 0 0 10 2 3 12 0 34 0 3 21 0 0 17 0 0 36 0 14 2 7 6 0 0 0 17 9 3 0 0 3 0 16 
0 0 0 5 3 11 0 35 39 0 7 39 0 0 6 0 37 18 13 25 2 0 15 2 3 20 2 8 0 10 0 3 13 2 26 23 5 24 4 6 6 1 1 9 3 23 4 44 0 
48 0 29 15 20 36 7 25 27 3 5 2 17 0 8 11 1 10 59 13 0 0 9 5 19 20 0 5 16 12 8 22 25 0 20 39 20 9 20 0 35 0 0 3 4 24 28 33 50 
28 0 15 2 25 23 19 0 9 1 1 22 7 5 17 5 13 23 0 15 0 0 25 9 11 10 2 11 41 25 0 0 0 9 22 2 26 18 0 4 0 36 0 4 0 0 0 6 12 
0 0 10 0 3 17 39 0 0 9 0 20 10 17 0 0 0 0 0 2 0 0 0 12 0 12 6 0 0 0 10 12 18 0 2 0 4 1 0 0 9 0 0 8 4 44 0 0 18 
4 39 26 0 0 0 0 0 10 0 0 0 10 8 18 46 0 0 10 0 0 8 0 8 0 0 10 24 0 0 0 0 0 0 9 0 34 0 0 0 39 27 0 0 0 4 0 18 33 
0 0 12 24 26 24 0 0 0 39 0 5 0 21 33 7 0 6 0 2 14 2 32 6 15 0 20 24 2 0 23 8 0 8 35 1 15 0 7 6 0 8 0 20 0 7 0 0 48 
3 0 25 8 3 29 5 0 0 0 0 0 16 14 2 45 23 2 0 2 0 6 19 27 39 0 30 37 23 30 0 0 0 0 1 0 0 0 0 34 5 0 0 0 0 6 0 32 0 
15 6 13 7 0 18 9 0 35 0 0 0 10 21 14 15 0 20 13 36 22 0 0 8 5 0 37 0 24 9 11 21 0 14 14 0 66 26 10 34 20 0 19 30 0 0 18 6 17 
