49 28
35 0 15 0 0 0 30 28 51 0 0 0 5 0 0 0 0 51 18 0 75 15 17 12 0 0 0 0 5 9 0 19 0 0 17 50 15 17 0 48 0 4 0 4 16 0 26 2 0 
0 19 0 16 62 32 14 0 33 0 0 0 4 25 23 0 5 9 0 0 14 0 7 5 1 0 16 20 0 0 0 0 15 17 0 5 13 61 37 13 18 26 0 14 32 0 62 5 18 
0 3 0 6 3 15 0 0 0 6 0 24 29 23 6 54 23 0 21 11 35 0 0 0 0 0 0 3 0 0 4 0 0 28 0 1 31 8 0 5 0 29 6 0 0 32 10 0 21 
84 33 0 17 0 23 32 22 22 0 8 9 0 2 27 26 0 28 19 0 21 0 17 0 18 10 0 37 43 18 27 0 0 0 34 5 5 37 16 0 13 35 0 15 6 28 0 13 3 
0 0 6 0 0 11 0 0 13 36 5 0 23 29 2 29 12 14 0 0 8 0 0 0 0 0 0 12 8 0 0 0 15 0 29 7 6 16 0 0 0 38 8 0 0 36 10 0 0 
0 0 11 0 4 11 0 0 11 1 0 0 4 43 16 19 32 22 0 0 0 0 6 0 0 0 0 0 17 0 23 0 5 0 18 1 0 0 0 0 5 6 0 7 0 41 0 0 14 
0 0 16 4 1 50 0 45 27 7 3 1 20 2 2 0 5 10 21 16 13 0 13 3 1 3 0 6 13 17 14 4 0 0 11 24 0 0 3 12 8 51 0 16 21 0 0 101 5 
0 0 32 29 0 30 1 0 69 0 17 19 21 0 0 0 21 0 0 0 12 0 0 0 0 14 0 14 0 12 10 0 2 21 58 27 4 40 16 0 22 7 2 3 0 37 11 44 0 
0 0 58 0 2 12 17 0 19 0 0 0 0 20 0 0 0 16 0 0 0 0 24 0 32 4 0 5 0 21 9 0 8 0 6 6 0 35 0 0 7 0 0 19 14 0 0 0 19 
8 38 0 0 0 0 2 0 43 10 0 23 3 10 10 5 0 20 12 15 0 4 13 5 24 31 8 6 10 0 3 0 42 0 26 2 6 0 15 29 1 0 8 0 0 6 0 0 7 
30 3 29 0 0 0 0 0 15 34 37 0 1 0 33 30 12 0 11 0 4 8 0 23 0 27 0 1 1 19 3 0 14 0 0 0 16 8 13 1 7 0 0 47 14 29 37 1 0 
5 12 0 0 0 6 0 0 0 6 0 6 32 19 0 6 32 0 7 0 7 25 6 0 0 6 14 8 0 17 7 0 0 4 0 11 0 0 17 5 0 28 0 27 1 1 18 5 0 
0 13 3 36 2 10 47 27 0 39 7 6 4 0 13 3 0 12 15 5 8 11 11 12 0 0 0 25 22 0 21 25 22 0 2 0 8 0 0 0 0 11 0 7 3 11 39 0 40 
33 3 0 0 0 36 22 38 7 26 0 7 23 66 0 0 0 17 22 19 5 0 15 0 2 16 33 0 9 0 0 8 6 0 6 29 3 0 19 14 16 20 1 0 0 32 1 0 1 
36 32 5 0 26 0 17 8 0 0 0 0 0 1 0 0 0 0 31 0 0 9 28 2 0 0 0 7 24 1 0 0 0 38 0 1 40 15 11 37 4 7 18 0 42 27 0 0 24 
17 28 2 4 20 19 29 0 21 0 10 53 3 59 0 3 0 11 14 3 0 0 0 0 13 0 3 0 0 37 1 7 0 4 5 62 5 0 59 3 0 0 13 0 13 0 0 33 16 
43 4 0 44 0 13 24 31 0 0 23 0 4 0 5 12 15 0 0 8 9 0 10 3 6 0 23 0 0 9 24 22 8 23 0 32 0 0 0 0 20 0 37 3 6 0 3 0 0 
10 16 32 16 0 11 2 10 12 0 12 0 0 0 28 5 19 1 3 0 7 0 7 6 0 7 4 0 0 0 8 0 7 13 0 0 34 0 4 0 0 0 15 0 0 0 6 0 0 
0 26 0 0 0 0 0 2 0 0 3 6 0 0 0 0 0 14 22 5 0 0 17 0 0 0 0 3 0 0 7 0 0 0 1 15 0 3 0 0 12 0 0 0 0 5 7 0 47 
30 18 0 4 7 13 0 3 7 55 7 69 2 3 4 27 4 9 5 1 1 0 13 12 0 9 6 0 47 8 0 5 0 13 10 35 7 47 0 2 40 1 1 10 10 5 0 5 32 
0 11 0 22 41 0 15 4 27 0 4 0 9 4 2 0 6 21 5 0 7 7 2 8 22 12 0 2 3 13 14 25 15 6 12 29 11 16 1 0 17 0 0 0 41 46 22 0 0 
0 44 0 3 0 26 34 0 0 37 1 2 0 5 3 15 0 6 5 19 0 20 7 2 13 15 0 0 0 1 3 16 0 24 0 5 8 0 18 0 0 28 0 32 11 35 45 3 0 
30 50 58 11 21 14 3 0 0 0 24 0 33 0 12 0 4 20 5 4 1 0 19 5 6 0 16 0 27 7 0 0 0 15 34 0 0 20 0 0 0 19 0 37 0 33 44 0 62 
17 3 26 0 0 0 0 0 24 32 0 37 11 0 2 15 1 18 0 21 34 29 11 29 0 0 4 15 22 15 0 0 0 0 20 10 0 0 40 4 21 34 15 0 33 11 23 1 22 
0 22 0 44 0 0 0 0 11 8 17 3 23 5 23 3 2 39 19 0 12 20 7 0 7 6 0 0 24 35 0 0 14 0 30 9 0 25 6 18 23 0 0 0 0 0 24 74 0 
33 18 0 0 0 62 29 0 4 0 10 10 60 0 0 0 0 0 3 0 9 30 17 0 0 13 0 0 0 11 3 25 27 28 6 36 36 16 22 34 0 2 2 0 0 5 38 10 0 
0 41 0 0 46 0 18 0 37 52 9 15 0 0 0 0 0 0 0 10 0 0 2 0 15 0 13 18 0 10 16 0 0 0 26 0 22 0 0 0 25 0 0 5 0 115 21 43 5 
0 11 0 0 36 18 12 0 16 0 0 0 0 0 0 19 4 12 10 11 2 8 1 18 0 0 11 19 0 2 0 0 0 16 19 13 0 11 0 0 47 0 0 0 0 0 11 0 19 
