49 28
0 0 0 27 38 0 25 0 21 0 16 0 10 0 9 22 0 18 0 0 3 0 0 11 7 0 11 0 0 2 13 0 0 0 0 0 0 9 37 19 0 0 21 10 0 8 0 9 0 
0 16 26 0 0 0 4 35 28 0 18 20 21 3 0 0 0 13 14 0 0 10 11 6 29 5 8 0 30 22 5 22 14 7 0 0 48 0 0 0 0 0 35 23 0 0 11 0 0 
0 0 0 7 3 4 45 26 37 2 0 7 12 15 0 24 4 26 4 16 20 0 0 0 0 32 0 2 17 0 7 0 24 11 20 10 6 26 0 17 0 8 0 54 19 0 0 17 19 
22 16 0 0 23 0 0 11 43 35 3 0 28 31 0 0 20 2 0 0 0 14 37 9 16 0 0 23 0 14 6 14 38 13 0 0 26 10 31 26 23 4 0 17 46 19 13 0 4 
0 0 0 0 0 0 0 0 21 0 25 0 12 0 0 0 0 0 4 0 0 0 0 5 0 0 0 0 16 7 0 0 0 0 4 0 26 0 4 1 0 0 0 0 0 6 7 0 8 
47 49 1 0 32 0 0 15 29 7 2 0 9 25 7 0 17 28 45 0 7 13 0 26 0 3 21 0 19 56 6 5 11 10 5 0 24 31 0 6 0 0 2 16 18 46 0 71 0 
16 18 0 7 17 19 22 12 10 12 3 10 30 0 0 0 0 13 24 18 9 14 22 0 0 43 0 12 1 23 27 0 25 3 1 16 32 34 15 8 15 0 61 0 0 68 0 0 3 
0 0 40 26 0 18 5 0 17 0 0 0 0 1 31 3 1 1 41 1 0 54 0 15 3 0 0 0 0 21 8 0 4 0 5 0 0 0 1 0 1 18 33 3 0 55 75 30 0 
0 0 58 31 0 18 16 0 0 1 6 2 5 2 0 8 22 9 25 18 0 15 5 13 43 2 0 10 8 27 0 3 29 19 0 33 11 10 1 0 22 0 39 11 0 2 37 11 0 
14 31 11 5 0 15 0 11 0 0 1 0 2 11 9 10 0 0 0 33 24 15 15 9 26 0 0 8 0 11 4 7 20 0 20 1 1 0 31 9 0 0 0 17 24 11 0 0 0 
41 5 0 0 0 0 0 11 2 0 38 7 0 16 21 0 0 6 1 0 44 0 0 5 0 0 0 0 3 7 0 9 22 0 5 23 0 11 10 19 0 47 13 0 5 3 9 0 4 
15 0 0 2 0 5 10 15 9 36 0 0 15 0 10 10 0 13 25 29 10 3 0 0 17 0 13 34 1 0 4 3 0 0 0 0 0 0 0 0 0 0 0 0 10 3 0 4 33 
48 87 45 0 24 0 0 0 0 17 0 0 0 0 0 4 15 7 6 0 0 16 0 0 5 0 17 6 62 0 0 0 0 0 10 0 15 0 0 0 0 20 0 0 0 8 45 52 34 
4 30 0 0 5 46 0 0 31 14 23 0 0 0 0 0 0 0 8 0 11 0 20 16 18 2 11 0 0 0 39 8 0 1 10 0 0 0 4 39 0 3 20 0 0 0 0 0 0 
0 12 35 0 2 0 8 0 0 0 0 6 0 0 0 0 0 23 1 8 0 1 4 6 0 8 8 9 9 8 9 0 0 31 0 0 0 13 14 6 39 0 22 0 43 0 19 1 0 
0 0 0 0 26 23 39 0 0 37 14 32 0 27 31 8 39 28 8 0 4 1 0 0 6 0 8 0 23 0 41 17 14 0 0 0 16 20 21 0 47 24 0 27 22 41 37 1 18 
0 28 13 3 18 0 8 39 13 28 16 7 2 12 2 21 1 7 0 0 26 32 18 0 19 35 0 0 11 26 5 15 0 17 9 0 11 25 0 0 37 8 0 36 23 36 65 0 0 
10 22 47 0 9 0 0 22 12 18 0 0 0 24 12 0 6 5 0 0 0 0 28 11 8 9 0 16 0 37 0 0 0 0 11 0 0 0 0 0 0 0 17 42 0 0 48 0 0 
12 0 12 0 0 0 0 0 16 3 0 0 13 9 0 0 18 14 0 10 4 0 15 0 0 0 19 1 0 0 3 4 2 6 0 0 0 13 5 9 0 3 15 2 1 19 0 0 6 
0 6 0 2 0 19 4 0 0 15 15 0 12 12 0 10 0 0 2 10 5 13 0 0 8 15 20 5 0 0 1 18 0 49 16 0 0 0 0 17 0 0 0 11 0 14 38 7 0 
60 7 3 0 50 0 0 49 18 36 25 21 17 19 22 29 0 0 17 2 23 15 5 6 12 21 6 2 19 28 4 10 8 2 0 17 2 33 5 6 18 26 25 41 0 17 47 0 0 
11 36 0 31 1 0 40 5 42 12 2 48 0 3 27 17 11 0 0 0 0 4 0 18 13 24 13 0 13 4 24 28 1 18 28 0 36 20 13 0 0 9 36 0 10 32 4 0 72 
48 0 0 2 23 0 7 0 4 20 0 43 25 7 0 14 0 25 22 2 47 14 0 11 23 0 7 19 0 20 6 24 0 24 13 0 15 19 0 5 0 24 15 25 33 60 0 0 69 
15 39 20 0 3 11 27 0 27 22 0 6 14 32 0 8 11 2 9 1 3 21 9 0 24 0 10 0 0 1 21 12 0 0 15 27 18 0 0 0 44 0 0 21 14 17 2 34 34 
42 43 1 5 0 64 5 0 0 0 0 29 0 0 13 0 0 29 0 2 0 2 40 0 23 16 0 25 0 14 15 0 27 14 0 0 0 0 0 38 50 2 29 23 0 15 0 25 0 
0 0 13 0 38 0 0 0 38 0 2 10 0 0 0 0 10 4 22 6 15 5 0 23 13 0 0 0 7 0 0 5 18 0 16 0 0 20 36 0 22 0 20 23 42 11 4 0 40 
87 27 0 0 0 0 17 0 35 3 0 32 51 4 0 15 10 29 1 0 0 5 0 15 0 18 1 2 0 2 18 10 23 23 24 0 4 0 6 0 39 35 1 69 44 5 0 9 27 
12 0 11 27 3 0 33 26 0 45 0 0 12 0 22 0 0 26 0 2 0 4 0 0 14 0 6 3 0 0 0 0 28 45 0 0 7 11 0 70 0 0 0 4 0 36 0 26 0 
