49 28
17 21 37 0 0 67 0 1 31 5 0 0 23 40 0 0 0 0 13 0 48 19 0 0 23 7 17 0 9 0 15 0 0 5 9 3 0 0 53 3 0 0 0 47 0 14 1 6 0 
0 0 0 0 0 26 1 0 0 0 14 15 0 37 0 0 8 0 0 16 0 0 17 23 5 13 45 0 24 17 0 14 0 0 18 0 0 0 6 26 0 0 6 0 9 3 22 7 10 
27 0 6 0 36 0 20 59 14 2 0 1 20 0 0 7 12 0 0 13 0 23 0 0 0 25 35 0 0 0 0 0 32 12 0 16 11 5 13 0 0 0 37 0 0 38 0 8 0 
46 0 8 2 0 16 0 15 0 2 34 0 0 22 0 0 31 0 15 0 6 22 49 17 0 0 0 11 0 0 0 26 23 0 0 0 0 0 1 0 2 2 1 29 23 13 0 0 0 
12 32 0 26 3 5 34 4 1 42 0 0 0 2 5 6 1 17 0 0 26 17 22 0 9 0 0 0 0 0 7 23 1 27 28 0 0 24 2 36 10 5 26 39 0 21 37 7 0 
0 0 30 0 1 0 0 20 17 22 0 0 0 0 30 0 0 6 0 14 0 7 0 6 24 17 3 0 20 32 0 0 0 9 9 0 0 10 0 18 0 2 0 7 30 10 0 31 62 
0 0 8 0 20 0 0 0 0 0 11 0 2 0 2 0 0 0 5 0 13 0 16 9 0 40 32 0 3 0 0 0 5 0 0 13 0 0 21 0 4 0 0 32 23 0 17 8 4 
0 11 27 0 4 0 0 35 21 0 6 36 11 0 0 24 6 19 11 0 0 5 8 0 0 29 0 10 0 58 14 0 17 4 5 13 3 0 9 33 0 0 28 11 8 0 2 44 19 
55 9 0 40 30 0 0 12 35 0 8 4 0 14 0 4 3 0 17 14 0 12 0 23 0 25 0 35 7 16 18 17 9 16 0 31 0 0 18 0 0 0 0 5 17 16 0 33 17 
0 0 7 30 9 5 1 69 10 20 8 22 17 23 10 0 0 0 15 1 15 5 19 24 0 30 0 0 18 4 0 0 16 21 19 0 0 7 0 0 0 11 0 16 3 16 48 6 0 
0 11 5 29 9 26 1 0 27 28 0 20 20 46 0 8 61 3 58 16 2 0 0 26 20 2 9 10 25 16 0 30 9 5 7 11 16 12 25 30 4 16 39 0 68 16 0 0 5 
0 0 3 9 0 2 4 9 6 0 4 0 19 35 0 7 3 21 3 6 28 22 8 0 11 0 9 0 9 0 16 15 0 0 0 0 0 0 0 0 0 0 0 29 0 0 31 7 8 
1 25 0 0 0 0 51 21 19 2 0 44 6 8 0 10 0 10 27 11 14 7 0 0 11 41 7 15 0 4 15 26 10 5 33 18 10 0 3 21 0 0 10 3 0 2 0 8 0 
0 0 8 7 0 2 12 0 13 0 0 0 2 0 32 4 0 0 2 7 19 0 1 0 5 18 0 0 5 3 0 0 0 34 0 16 0 2 0 0 0 0 5 16 24 41 32 9 0 
0 0 5 4 0 31 23 21 0 39 30 0 9 3 4 26 11 4 11 1 15 26 1 13 0 5 0 15 22 5 0 0 0 17 8 0 3 20 23 3 30 15 15 3 0 22 3 0 29 
7 0 13 32 7 6 14 0 2 0 17 8 8 0 12 0 0 2 0 24 14 8 0 13 0 12 0 2 1 25 9 0 13 0 11 25 24 9 27 0 0 0 9 0 0 13 12 0 9 
0 92 32 0 3 0 34 0 2 0 0 14 11 0 0 0 0 0 2 0 0 10 0 0 16 7 12 0 2 0 2 0 0 0 0 33 0 0 0 0 51 0 36 0 0 31 0 9 0 
107 0 0 33 0 0 13 16 25 0 0 2 61 11 32 10 0 0 28 39 13 8 0 0 0 0 5 11 0 10 1 20 22 12 7 0 4 0 3 0 0 7 2 43 10 0 68 47 36 
0 0 3 0 26 9 31 0 18 7 0 0 8 9 6 0 8 0 0 1 4 0 23 0 4 5 3 0 20 17 18 0 0 0 0 9 0 31 0 0 0 0 3 16 0 3 9 0 33 
0 0 3 56 9 2 0 10 13 30 0 2 35 0 12 8 16 0 11 0 2 12 0 20 0 0 17 0 7 0 0 4 3 2 0 12 29 0 0 14 0 14 2 0 12 25 5 27 7 
16 0 6 22 5 0 0 0 0 0 0 8 0 0 0 6 0 0 15 0 18 0 17 0 0 0 10 22 0 0 0 2 0 0 0 0 0 0 18 12 0 0 0 0 0 10 0 8 0 
0 6 3 22 36 0 0 43 35 44 6 8 24 8 1 25 0 22 88 12 4 18 4 0 4 22 15 8 0 2 0 0 0 0 25 11 49 19 13 0 30 23 0 39 0 32 42 19 0 
95 41 18 72 41 2 0 14 30 24 22 9 0 23 4 20 38 0 8 16 16 18 22 12 4 15 21 24 27 0 8 0 16 36 34 30 36 0 22 16 7 0 8 18 2 62 4 20 13 
0 44 0 0 0 0 0 11 51 0 15 0 9 55 7 21 2 0 2 0 23 0 0 9 0 0 0 0 0 2 0 0 0 0 19 13 0 0 30 2 0 0 0 0 0 44 16 0 0 
0 31 28 16 0 40 0 0 38 0 19 0 0 0 21 3 2 14 1 0 1 6 21 37 23 0 12 23 0 9 28 0 33 7 0 2 0 15 0 13 5 31 0 3 15 0 43 27 43 
0 42 12 15 0 0 0 23 0 0 0 33 30 21 0 3 0 7 22 17 23 23 0 0 0 0 10 0 10 0 9 29 25 0 0 18 4 11 0 6 0 8 43 14 33 21 0 0 7 
0 1 16 0 0 13 12 20 22 23 23 25 0 17 0 29 0 34 13 8 0 10 0 4 5 0 0 8 21 10 8 8 48 0 0 0 21 0 23 0 9 12 4 0 0 0 21 10 30 
24 63 33 22 3 0 0 13 7 22 0 0 0 0 0 14 0 0 0 0 2 27 0 23 0 4 0 0 0 10 0 16 0 68 15 0 35 0 65 0 38 0 0 38 0 0 2 0 36 
