49 28
16 0 32 19 33 0 5 0 3 5 0 23 19 19 0 35 31 0 25 0 0 0 0 26 0 15 21 0 2 3 27 4 21 0 59 40 21 28 0 35 8 37 0 39 4 0 12 1 52 
0 0 0 38 16 17 26 0 13 9 7 28 31 44 0 5 8 23 3 5 0 32 16 0 0 33 4 22 21 0 36 0 31 0 0 0 0 26 12 22 6 0 15 16 0 0 52 34 27 
0 47 0 0 30 0 0 0 23 9 0 0 0 30 19 7 0 19 0 3 25 24 14 7 7 1 24 12 0 12 8 29 0 18 0 16 19 25 1 13 0 37 0 51 21 0 2 0 35 
8 43 43 0 0 0 23 0 16 9 0 1 1 3 0 13 0 0 21 0 0 25 28 11 0 1 7 2 13 23 0 14 0 3 11 1 13 0 10 21 0 10 3 0 43 84 25 0 0 
12 58 7 6 14 0 38 0 9 28 0 0 10 13 10 24 22 0 0 4 0 0 13 38 0 23 0 0 3 0 14 0 64 21 0 0 4 0 15 24 0 0 0 0 30 7 0 0 23 
0 0 31 0 0 17 0 6 32 16 0 0 0 0 1 1 0 26 0 0 12 17 3 0 0 0 4 8 0 0 0 0 12 26 1 0 0 0 50 15 17 0 4 26 5 7 10 0 0 
0 40 35 30 23 0 4 0 20 0 5 6 29 9 0 35 23 37 0 11 0 6 26 0 0 29 0 4 0 2 0 2 0 33 0 6 0 19 0 19 0 65 17 0 9 0 0 0 10 
0 0 0 2 36 0 17 0 34 0 12 6 0 0 0 8 16 20 0 21 0 0 0 20 7 0 8 17 0 0 0 8 0 0 0 20 28 21 7 0 30 0 0 0 0 0 0 0 0 
19 0 0 0 59 6 6 14 4 19 23 6 3 19 9 0 26 29 9 19 0 7 6 25 6 0 11 2 1 63 0 6 0 21 15 0 7 0 34 16 0 18 12 0 23 32 6 11 21 
12 41 41 40 0 0 0 0 23 0 58 0 17 1 0 45 7 0 0 26 6 21 0 26 0 0 17 0 17 0 0 35 0 26 0 0 0 14 46 8 30 0 41 41 0 26 0 0 4 
12 37 38 23 0 23 21 23 20 0 0 8 15 0 0 12 0 10 0 8 17 1 31 3 0 0 1 15 3 13 23 12 0 0 0 0 0 7 0 0 27 16 5 0 5 44 9 0 0 
8 0 44 35 11 15 3 6 0 48 43 5 46 26 0 67 0 0 11 1 28 4 0 13 0 4 10 6 0 1 0 11 11 1 42 29 21 33 21 0 30 0 11 3 0 8 36 2 11 
12 15 8 0 8 16 0 16 54 9 1 21 8 0 0 1 0 6 3 1 10 3 0 29 0 10 25 12 0 0 0 0 1 5 0 10 0 10 0 19 0 9 0 0 1 0 0 62 2 
10 27 2 5 11 0 20 39 21 26 0 25 9 3 0 8 0 22 13 0 0 22 10 16 11 5 26 12 0 19 5 17 14 4 0 0 36 0 10 36 1 0 3 12 38 0 52 3 25 
32 0 30 0 3 0 5 3 11 2 22 18 28 3 5 0 0 12 0 2 3 29 0 0 2 40 15 12 0 12 0 4 5 15 17 0 22 0 0 3 6 27 26 0 56 5 0 11 15 
0 0 0 12 0 20 0 19 30 14 0 25 0 2 9 15 10 0 7 24 6 0 15 14 13 0 4 16 0 0 13 0 0 4 4 0 12 21 18 0 0 0 14 0 0 7 14 17 0 
0 80 0 0 0 34 10 0 9 26 14 40 7 10 0 0 0 9 0 10 0 15 0 17 12 0 18 7 0 0 17 0 21 0 33 42 0 0 0 34 7 0 0 15 0 10 0 0 61 
0 47 5 10 16 0 29 34 0 6 0 17 15 31 9 66 9 6 32 0 0 0 6 0 8 5 19 15 11 0 0 7 7 14 0 49 0 37 36 4 25 40 0 0 6 6 17 0 15 
30 0 34 0 0 0 0 15 0 0 0 6 22 15 0 20 18 12 20 0 0 0 35 11 0 1 0 14 26 0 2 4 0 0 0 4 0 0 33 0 18 0 0 0 0 0 0 0 32 
0 13 0 40 0 5 0 16 18 20 2 8 20 4 2 0 16 19 19 0 0 14 10 16 7 0 7 6 0 20 2 0 1 0 0 18 0 7 0 0 0 0 11 31 0 0 0 0 0 
0 4 0 34 3 21 0 0 0 20 0 0 0 0 30 12 0 0 20 13 0 0 17 0 0 19 9 2 3 20 0 0 0 8 0 9 0 24 20 15 2 0 5 0 49 0 0 0 14 
0 2 23 7 0 0 0 0 15 3 47 9 15 0 0 0 22 0 0 8 11 0 42 31 1 48 0 20 14 15 0 13 9 9 0 1 26 3 12 8 3 15 7 0 14 64 4 22 3 
21 0 22 11 0 0 41 3 47 14 11 1 41 21 6 2 0 4 0 26 0 10 13 0 0 0 16 13 0 5 5 22 18 0 2 18 22 0 0 16 20 10 34 0 14 19 0 41 0 
0 0 0 0 3 0 0 0 19 6 0 0 18 14 12 13 13 2 4 0 0 1 17 19 0 0 5 22 0 0 0 0 0 3 6 0 0 14 22 9 7 0 8 21 0 0 0 0 10 
12 11 0 22 0 41 13 34 39 26 1 0 6 0 0 7 1 0 0 13 12 1 15 13 0 32 11 2 0 0 23 6 10 0 0 0 2 0 4 0 7 2 4 1 0 0 0 39 12 
0 0 10 0 0 0 29 32 0 3 0 0 13 0 0 0 2 50 0 0 0 26 0 0 0 0 0 0 24 8 0 0 0 17 0 29 0 8 0 25 9 24 0 12 0 4 0 47 0 
28 47 0 0 19 0 41 0 20 0 32 10 10 8 0 15 0 7 18 0 0 35 12 7 12 9 24 14 17 0 0 0 22 0 26 0 5 11 35 1 0 2 32 0 0 10 0 32 56 
4 16 0 5 0 0 40 0 15 38 0 13 39 18 14 10 10 0 2 14 40 0 9 19 0 0 0 0 34 14 27 31 16 0 27 34 0 1 38 24 3 4 0 34 6 0 40 0 27 
