49 28
0 0 0 7 0 14 0 32 10 10 3 12 0 0 0 32 0 66 16 24 13 0 0 0 0 0 20 1 11 0 5 0 0 7 12 23 0 0 10 49 6 11 0 0 27 28 29 32 8 
16 0 0 0 15 44 20 19 12 4 9 0 11 22 0 5 7 4 8 23 3 14 18 13 5 0 17 11 10 0 12 10 5 0 0 11 5 57 15 13 79 25 0 16 0 6 24 10 0 
0 0 1 0 6 16 2 0 0 0 0 7 1 22 0 0 7 0 29 0 22 24 18 0 0 19 0 16 0 17 0 0 0 0 6 2 0 9 0 17 22 0 0 30 0 27 0 13 0 
0 0 23 0 6 15 3 8 0 0 6 0 21 0 2 8 4 0 0 13 0 0 6 19 24 11 0 2 0 0 0 11 0 2 0 36 1 25 16 0 17 18 1 11 6 0 0 0 9 
9 0 0 0 0 0 39 14 39 0 0 0 0 3 0 3 0 18 15 21 3 0 0 8 0 3 0 2 0 25 9 0 0 0 8 22 7 7 8 2 0 0 0 36 0 17 8 0 0 
10 0 0 0 14 59 0 28 0 0 33 0 43 2 0 0 17 24 12 7 20 11 9 0 4 23 2 10 0 5 37 9 0 9 1 18 3 6 0 34 13 0 0 1 0 51 0 0 34 
77 26 0 19 0 0 6 0 38 0 14 0 21 0 0 0 0 0 0 0 8 0 19 17 14 0 26 41 6 19 17 0 2 1 0 0 28 0 0 9 0 0 4 1 20 48 0 18 27 
26 22 0 69 43 7 3 0 0 35 0 1 8 0 0 0 0 29 0 6 0 0 0 33 0 0 20 6 11 6 0 12 0 7 11 45 11 0 18 11 37 32 7 43 0 19 0 43 31 
0 16 0 0 13 0 0 33 0 7 20 11 0 0 0 0 6 13 0 9 1 0 0 0 13 0 4 0 10 0 24 8 6 13 0 0 0 0 0 3 40 0 0 0 43 17 0 1 0 
23 4 44 18 0 37 0 0 17 0 0 8 0 0 0 0 7 16 0 6 8 16 0 0 0 0 0 0 0 0 0 0 7 14 24 0 0 11 38 0 2 0 0 0 6 0 3 1 0 
48 28 0 16 5 5 0 0 0 33 0 3 0 0 3 6 17 0 21 2 0 1 0 0 22 3 0 0 0 6 0 10 0 0 0 0 27 6 0 39 0 0 46 42 0 0 31 0 50 
0 12 0 0 24 0 9 0 16 30 2 0 23 17 21 10 28 11 5 30 0 0 8 1 4 9 13 4 1 0 0 56 0 0 0 13 0 9 0 14 5 2 0 2 28 41 15 0 0 
3 0 0 30 0 10 15 0 11 0 31 15 12 19 6 0 0 9 0 0 7 6 0 8 15 36 0 6 6 13 0 7 2 23 7 34 2 8 12 14 7 47 0 0 0 0 19 14 28 
2 4 0 34 65 0 9 5 0 0 9 4 5 5 2 2 10 28 2 0 38 37 20 20 2 22 5 0 16 13 14 15 26 18 7 17 26 0 0 7 33 11 21 25 21 13 42 5 23 
0 0 27 0 11 38 0 0 42 4 0 0 18 0 9 5 9 15 0 11 12 0 12 8 0 21 0 0 0 27 18 26 21 6 0 4 28 0 0 9 0 0 0 11 0 38 32 3 0 
20 0 2 5 5 0 0 17 33 12 66 22 0 11 0 0 13 3 7 9 0 0 3 23 0 0 24 7 3 0 14 10 0 0 7 10 26 0 4 0 0 9 31 35 5 0 0 1 0 
76 5 10 0 80 25 38 0 28 7 0 9 0 4 13 27 55 0 6 0 33 32 18 19 2 17 9 0 0 23 13 0 1 27 34 19 18 9 17 0 42 64 43 2 0 0 0 1 41 
0 24 0 0 11 7 0 0 7 16 0 30 0 2 0 17 18 5 13 16 20 13 0 0 1 35 0 0 0 2 4 12 1 0 18 10 12 0 0 32 0 30 0 0 0 0 0 0 12 
0 47 0 2 0 8 17 14 0 0 0 73 16 8 31 5 3 0 0 17 0 5 0 0 21 0 0 0 0 0 0 0 20 22 0 6 16 0 33 19 2 30 0 0 0 21 11 8 65 
0 26 0 41 25 14 0 4 0 0 0 5 14 0 0 1 35 0 23 23 5 18 0 16 0 7 0 39 0 2 0 3 1 3 0 0 26 14 0 5 11 26 0 0 13 0 60 0 0 
47 7 29 3 3 56 14 0 0 0 5 2 10 0 0 1 20 4 4 0 4 3 0 0 19 0 20 7 0 24 13 1 1 4 7 0 0 19 0 12 0 39 0 4 14 13 0 47 0 
0 0 0 0 0 0 31 0 36 0 0 0 31 9 0 0 1 3 0 15 0 1 0 2 0 9 18 19 0 0 0 0 21 3 17 5 9 36 30 4 5 16 0 31 0 20 18 0 0 
0 0 0 5 0 10 0 0 23 10 0 36 0 1 0 0 0 16 19 29 2 1 10 22 0 9 7 6 20 17 16 15 0 30 0 0 0 25 16 0 0 3 6 16 0 0 49 36 26 
19 0 33 40 10 0 0 0 0 26 1 1 14 52 12 0 7 34 0 82 0 3 21 17 9 25 11 0 6 0 17 14 5 6 0 11 12 5 0 4 0 22 0 11 25 17 20 0 0 
1 71 0 0 0 1 29 27 7 0 40 0 4 21 0 37 23 0 0 1 41 9 12 21 0 0 13 27 11 0 0 13 16 27 38 23 0 0 6 6 81 0 34 72 12 0 0 0 8 
0 18 22 12 15 11 0 0 1 0 33 36 0 16 34 8 10 18 0 3 13 0 2 0 18 11 0 11 0 29 0 0 0 0 1 2 17 21 18 12 32 33 0 0 0 0 49 36 34 
0 0 5 0 0 19 0 38 17 7 25 0 18 24 0 21 0 0 24 0 2 22 0 2 41 14 0 0 15 16 18 0 0 0 17 34 36 24 14 0 0 25 24 0 20 53 0 22 0 
18 0 0 27 5 0 15 0 30 12 0 0 0 28 12 8 10 13 0 8 0 12 10 8 9 0 41 15 0 0 0 5 19 3 31 13 2 0 8 22 8 0 0 36 1 0 19 0 0 
