49 28
8 3 0 0 32 18 0 61 15 12 0 37 22 0 11 0 19 0 0 10 0 17 10 37 23 0 22 23 0 0 0 13 1 19 8 0 11 0 17 0 0 23 9 8 37 22 0 0 37 
43 0 17 11 6 0 5 0 47 0 14 0 35 10 0 20 0 0 0 0 5 0 18 0 0 26 0 0 0 21 17 0 0 0 32 0 0 0 24 29 2 0 2 0 0 0 0 75 0 
78 4 21 39 0 23 22 0 0 0 0 0 0 16 1 0 0 4 23 21 12 1 19 0 13 0 16 11 0 0 5 0 32 0 25 0 0 0 2 1 21 0 1 24 0 3 46 0 10 
58 37 46 0 0 35 0 50 0 5 0 0 3 2 17 27 0 22 3 5 0 0 18 6 14 0 21 5 0 2 20 19 5 3 0 52 3 0 56 11 16 0 2 41 7 17 41 0 25 
41 0 0 0 11 0 0 26 3 24 0 3 7 3 17 0 0 10 6 18 11 13 25 14 9 4 3 12 9 0 0 44 7 0 0 16 0 9 0 18 0 46 0 12 0 0 0 8 4 
0 0 14 7 43 0 30 28 0 0 7 0 0 2 19 0 1 18 0 13 11 25 0 0 0 7 0 0 0 2 16 0 15 5 0 31 36 0 8 16 0 9 7 0 0 0 0 43 0 
0 15 14 17 0 72 64 27 0 13 31 31 2 2 0 0 10 0 21 0 25 3 31 5 18 0 1 1 21 23 25 0 0 15 27 29 10 2 4 36 0 42 11 2 0 0 0 0 0 
39 25 35 39 22 37 3 0 0 0 10 0 0 21 1 0 0 0 7 0 10 12 10 0 1 5 1 11 0 0 15 4 46 3 29 0 2 23 21 27 0 16 5 0 16 3 13 0 0 
30 36 2 11 21 0 0 2 5 20 0 29 4 22 11 0 3 9 10 18 20 0 0 9 10 21 19 17 0 11 0 0 0 37 0 0 7 78 11 0 18 3 2 15 2 0 11 29 23 
67 0 67 0 54 25 18 2 0 9 0 0 0 0 0 13 16 0 9 0 18 16 6 5 0 17 0 9 8 18 0 29 12 23 34 3 22 36 18 0 29 5 10 0 12 8 9 18 18 
16 0 36 39 0 17 18 2 6 3 32 41 0 0 0 36 0 0 0 0 9 0 22 15 22 8 0 15 13 0 0 0 13 29 0 0 0 0 11 14 0 7 8 30 2 18 42 8 1 
0 12 0 0 32 0 32 15 0 0 0 7 1 8 11 16 0 30 28 3 20 14 15 1 13 12 0 0 0 15 0 20 18 9 0 0 5 6 0 29 34 21 5 23 12 0 0 14 6 
0 9 0 40 0 31 10 4 0 0 0 21 0 0 7 0 0 9 0 0 0 17 25 0 1 19 25 3 2 24 6 0 16 0 6 1 0 9 10 44 0 1 0 38 0 0 21 22 16 
12 2 0 0 12 0 20 7 0 3 0 0 25 0 14 20 32 15 0 5 0 10 23 0 0 0 20 3 3 0 0 17 15 16 0 27 0 0 9 7 10 0 6 7 2 23 7 0 0 
43 0 9 0 58 7 0 0 0 15 0 17 6 25 30 0 0 0 29 0 12 12 0 0 11 18 0 0 17 19 14 0 0 29 0 0 12 33 18 50 0 22 0 18 38 0 0 0 58 
0 41 0 0 11 0 29 69 0 0 0 0 0 8 15 5 18 11 24 0 0 0 0 3 13 10 3 0 0 15 0 0 0 16 0 8 0 30 7 0 0 0 65 9 2 7 66 14 0 
0 16 15 0 7 0 0 7 0 16 0 9 21 0 0 0 20 0 0 0 8 0 26 0 9 16 4 3 0 0 9 0 0 31 5 0 20 0 0 3 7 0 0 0 0 0 7 0 13 
10 18 10 0 32 27 0 0 15 0 21 9 3 14 25 15 0 0 0 10 0 0 6 27 44 0 4 14 0 0 0 15 0 0 18 0 10 0 0 18 0 0 37 0 0 21 0 0 6 
4 0 0 0 23 5 0 0 31 0 0 7 0 21 0 0 0 8 2 25 0 0 0 1 0 5 16 34 9 0 2 6 0 8 0 0 18 6 11 42 27 9 34 0 0 0 0 29 0 
19 3 14 16 8 0 9 23 0 16 26 4 19 9 18 9 18 5 9 16 0 3 0 0 0 0 43 3 0 0 12 4 18 0 10 0 26 0 29 0 0 0 8 0 3 7 13 8 0 
61 37 14 0 0 0 20 13 0 0 0 3 20 0 0 14 0 5 0 13 6 0 11 7 24 25 18 16 7 0 0 15 33 13 0 24 16 24 0 0 0 0 5 20 4 23 17 8 8 
0 40 105 19 0 0 0 2 0 18 14 4 0 0 0 30 4 3 29 0 0 3 31 0 29 0 14 12 0 10 0 29 17 0 1 0 19 10 10 9 38 2 20 4 0 0 0 67 5 
2 33 0 0 0 0 62 0 15 11 4 0 0 0 1 0 12 0 20 19 5 15 0 15 0 11 0 5 22 0 0 36 0 18 33 0 0 27 13 0 0 1 0 37 0 0 0 16 0 
104 27 28 52 74 5 4 17 6 0 1 23 0 17 34 4 12 0 11 15 0 0 42 20 0 10 0 0 2 17 42 1 13 30 29 0 15 26 17 0 0 38 27 9 44 11 31 17 59 
0 31 0 1 0 42 22 24 0 0 0 0 0 0 12 0 11 0 0 23 0 0 0 0 3 0 0 0 0 24 0 15 31 0 0 0 1 0 0 6 0 0 17 0 4 0 15 0 16 
0 30 44 3 37 28 15 46 20 20 0 25 7 1 30 0 13 0 7 0 19 30 11 5 9 0 27 23 41 0 0 30 9 28 25 0 0 0 51 19 33 15 0 0 30 0 44 0 22 
55 30 0 26 12 0 26 23 2 3 22 20 7 0 0 0 26 5 3 15 0 12 0 8 12 24 0 0 15 45 0 10 0 13 0 0 13 6 10 42 0 10 0 9 0 29 13 0 66 
9 3 11 27 35 49 18 0 26 0 30 57 0 9 0 26 13 1 0 0 0 16 18 0 0 0 0 5 21 1 0 20 0 0 25 0 0 0 14 10 30 1 0 0 0 3 2 8 11 
