49 28
10 0 0 8 0 2 12 26 7 0 0 31 25 26 23 2 21 0 0 1 22 7 0 23 10 22 1 24 3 6 0 2 21 18 0 0 0 80 0 12 0 4 34 32 26 3 0 28 9 
0 36 22 32 24 42 61 0 34 0 85 24 0 33 0 5 31 3 8 0 0 7 0 14 0 0 24 0 41 19 42 21 9 0 1 40 0 14 0 31 30 12 0 13 34 17 51 68 88 
22 0 96 25 0 1 7 0 0 35 5 23 13 27 0 0 32 17 0 3 0 0 9 15 8 13 0 17 65 0 1 19 0 0 0 22 5 8 63 0 29 3 0 19 2 5 8 9 0 
0 0 8 10 0 0 0 7 6 0 0 1 10 11 28 23 0 17 16 18 0 5 10 19 0 12 0 0 19 0 0 0 0 0 4 0 0 15 23 0 0 0 0 0 0 0 25 1 0 
0 29 0 32 0 40 0 25 0 0 2 0 5 21 0 41 0 27 27 2 41 2 10 0 19 0 0 1 0 11 27 3 0 0 40 37 0 6 0 0 22 4 25 3 26 18 1 0 0 
0 13 0 21 0 16 3 67 0 2 0 0 11 2 0 0 0 0 26 5 2 16 0 0 46 5 0 4 15 0 0 1 0 0 0 4 0 25 0 4 0 10 5 1 36 0 19 0 0 
0 30 0 43 17 6 0 0 0 8 0 6 2 17 17 0 20 13 0 0 27 3 3 0 6 0 5 0 0 0 0 30 5 0 0 5 0 0 0 17 0 19 6 0 42 0 61 27 6 
18 0 21 42 0 3 7 3 0 2 5 0 0 8 0 0 0 29 6 3 0 0 44 17 6 2 17 7 5 0 0 11 0 11 6 8 8 0 0 17 6 18 11 8 0 42 44 0 0 
0 0 32 0 8 5 27 0 0 6 0 0 0 18 0 6 13 0 2 0 20 14 16 0 24 8 7 23 19 0 0 9 0 0 0 7 15 0 7 0 0 0 20 0 17 7 0 0 13 
19 16 0 65 5 7 7 0 35 5 7 35 0 7 0 22 29 9 0 11 5 0 0 0 0 23 11 3 0 0 34 6 0 2 2 13 0 4 0 2 0 38 0 18 17 29 18 10 0 
41 0 27 13 9 0 11 0 10 4 0 0 0 6 0 11 4 0 3 28 20 19 24 0 14 0 14 0 20 12 0 0 9 11 0 0 21 0 34 7 14 0 0 13 10 0 18 4 40 
0 0 11 58 9 43 27 17 0 2 28 20 32 0 8 46 2 16 26 15 0 0 4 4 36 31 13 9 16 3 2 6 4 4 1 7 34 1 27 22 15 51 24 1 14 12 0 0 28 
0 0 1 11 37 0 16 0 30 11 0 78 0 33 35 0 6 0 0 8 3 9 6 9 0 0 0 0 0 0 9 11 1 0 3 0 0 34 37 0 0 37 0 0 0 34 48 0 5 
0 47 6 10 2 23 0 0 21 27 0 0 46 8 0 0 0 0 16 0 3 29 24 11 0 4 12 26 0 9 0 4 0 0 2 10 27 7 9 0 0 32 0 0 0 0 1 35 0 
0 3 44 14 3 0 47 0 15 9 38 12 6 11 5 41 4 2 9 12 6 0 0 45 8 0 0 5 0 0 0 7 0 13 0 0 0 0 21 0 0 0 0 0 0 27 78 7 38 
45 27 16 30 0 4 2 2 5 2 0 17 0 5 31 0 4 0 5 26 11 3 0 0 5 23 7 4 0 5 0 2 64 30 28 4 0 0 33 35 26 10 0 11 16 11 0 0 7 
0 0 30 37 8 28 15 0 13 5 35 0 9 26 0 5 0 0 1 15 0 14 21 0 0 14 21 0 0 11 0 0 6 12 6 0 12 35 0 34 44 0 0 23 5 23 26 0 33 
7 3 0 0 0 0 0 25 20 4 0 0 0 4 4 0 1 19 7 0 0 0 6 1 0 0 0 0 0 0 6 0 0 0 0 0 0 29 0 9 0 0 0 36 11 0 0 0 4 
0 61 8 5 20 0 2 13 0 24 0 12 0 1 1 24 1 7 27 7 4 0 0 32 0 0 27 7 15 3 2 24 1 21 7 2 10 2 3 24 0 40 0 27 35 26 7 7 0 
0 40 0 0 9 5 1 16 0 6 3 6 0 35 24 25 9 6 0 0 18 4 7 0 0 0 8 3 13 0 0 0 17 5 51 18 22 19 18 0 0 40 0 0 4 5 5 0 0 
24 38 0 0 43 0 0 17 42 0 0 20 26 24 19 0 0 15 26 19 0 0 14 8 35 0 0 9 0 0 1 27 12 19 19 11 35 7 33 0 0 0 23 0 4 0 27 43 0 
6 0 23 0 0 2 18 2 2 13 7 0 0 0 15 21 10 0 0 12 23 32 0 0 36 6 0 0 0 0 1 5 2 0 0 0 0 0 12 0 8 0 0 23 0 14 18 7 0 
4 0 1 0 36 0 0 0 0 0 0 32 25 41 1 0 0 0 0 0 0 8 0 2 0 0 0 9 0 12 0 0 0 0 4 0 5 49 5 35 17 0 0 34 0 13 19 0 1 
35 0 0 0 3 37 0 16 0 0 33 0 34 21 22 4 2 13 0 0 0 2 26 29 4 0 0 11 2 0 17 39 26 10 0 3 3 11 12 0 24 0 11 46 0 0 30 0 26 
37 31 9 0 0 0 28 0 14 0 0 0 0 33 0 0 3 15 23 0 0 0 20 0 14 23 35 0 0 0 0 0 54 0 26 3 0 0 3 1 2 9 0 8 0 0 20 0 25 
27 8 1 4 31 13 31 0 24 19 4 36 6 9 29 0 11 0 15 0 0 15 19 0 40 0 21 27 21 24 0 0 14 8 0 2 0 0 0 28 4 28 18 10 13 0 0 13 46 
12 0 19 58 1 23 19 22 17 0 0 4 3 8 0 3 4 14 21 4 33 19 12 4 0 18 0 12 69 1 0 8 16 0 0 4 2 17 23 0 43 0 0 7 26 0 45 1 60 
0 0 32 0 28 0 0 42 8 0 12 0 0 0 15 38 0 10 3 31 23 22 0 0 3 3 17 4 26 0 18 7 25 0 46 3 0 0 0 34 0 0 0 33 0 30 15 0 5 
