49 28
10 45 34 33 0 0 40 0 0 0 0 0 0 0 0 10 0 4 21 16 28 10 0 0 0 5 0 0 3 28 0 10 0 0 0 0 34 22 0 40 0 0 0 0 5 10 40 10 54 
44 0 0 37 2 1 45 1 25 25 0 0 63 0 10 0 5 1 0 0 5 14 18 32 2 8 33 7 11 0 22 0 15 0 8 20 8 7 9 0 0 0 0 49 50 0 25 0 0 
21 19 6 0 2 8 0 28 0 12 0 0 0 0 15 3 0 10 0 2 3 1 16 0 1 0 0 4 0 15 0 0 0 2 16 27 0 0 3 25 0 4 10 16 0 2 0 0 0 
0 74 0 12 0 56 0 0 37 6 2 0 2 5 22 7 15 1 0 3 20 0 3 0 22 3 8 14 0 0 0 18 27 21 21 0 22 6 0 0 0 0 19 44 43 21 0 46 0 
15 14 20 0 17 0 36 0 0 0 0 0 35 0 23 0 0 17 17 0 3 3 5 3 13 21 11 0 0 3 0 0 0 3 29 17 0 40 0 39 4 6 0 9 38 0 0 35 0 
39 38 23 0 0 0 0 0 0 0 11 16 0 21 0 19 0 37 0 5 14 0 3 8 14 25 0 0 5 12 0 15 15 1 20 0 2 8 26 73 0 5 0 19 0 0 0 0 0 
12 33 0 0 0 0 15 0 0 37 24 0 10 28 22 0 3 11 29 2 21 0 0 1 0 14 15 12 16 29 0 0 0 0 25 8 56 0 6 0 0 10 0 0 0 9 64 29 0 
0 42 12 8 2 11 24 0 0 0 0 37 0 0 40 6 19 15 0 10 31 4 10 0 1 9 5 0 11 2 11 34 14 0 1 29 5 0 0 0 16 0 1 43 28 0 15 9 17 
0 36 19 38 51 0 0 21 15 23 33 0 9 32 18 22 26 0 7 20 22 29 2 14 0 0 0 14 0 5 1 60 26 11 2 28 1 73 7 53 7 52 59 28 38 41 0 8 0 
11 1 6 17 30 7 0 28 0 9 0 17 25 27 20 27 3 4 14 23 41 25 0 11 24 1 0 3 60 8 12 28 0 13 5 0 0 0 38 0 6 1 27 30 14 0 46 0 0 
46 0 8 27 0 0 7 45 13 0 11 0 0 0 0 0 0 17 17 0 0 9 0 0 13 7 3 0 5 5 42 4 25 0 5 4 0 29 55 33 0 1 0 7 4 10 0 2 0 
7 22 0 27 0 3 40 20 26 1 9 32 20 25 3 0 24 21 3 0 0 31 8 12 0 0 0 25 0 2 26 0 39 0 44 0 0 14 34 32 8 0 26 0 6 34 40 0 0 
7 0 0 61 0 0 0 0 7 44 0 0 0 0 33 32 0 14 0 12 0 2 0 4 10 4 0 7 19 4 0 0 0 30 0 26 0 2 14 0 7 0 46 0 0 26 8 35 45 
0 29 0 6 0 0 5 0 12 17 0 10 8 0 0 6 2 34 0 8 0 1 10 30 21 40 0 0 4 12 15 10 0 24 0 18 30 0 3 16 9 47 0 3 0 15 0 0 0 
1 0 0 25 0 5 61 2 35 30 0 0 29 1 2 55 13 12 23 13 0 4 0 0 0 4 1 13 6 14 0 4 17 8 13 20 0 28 13 0 0 0 2 93 4 0 3 41 0 
28 0 11 35 0 0 0 11 16 13 11 0 0 0 16 0 4 21 15 0 0 8 3 0 0 18 0 22 0 4 0 0 1 14 6 7 0 34 21 30 0 0 0 0 5 0 0 18 0 
14 2 0 6 0 26 39 0 20 0 11 8 0 0 15 16 0 0 0 0 14 0 7 15 0 18 0 0 20 7 6 12 0 19 15 4 6 0 14 2 0 0 6 9 5 39 7 11 0 
0 0 0 9 0 0 7 39 9 0 0 0 5 0 0 0 4 22 3 16 0 0 10 0 5 8 0 4 4 19 0 0 5 0 7 0 33 0 0 0 0 0 1 8 6 43 41 0 17 
13 29 16 0 6 5 8 23 5 17 0 4 9 5 19 6 0 33 0 0 0 2 4 0 12 36 0 20 0 0 10 0 2 5 0 7 0 20 43 0 0 9 7 29 40 3 5 4 20 
17 0 0 34 0 0 0 0 0 0 15 0 5 0 4 0 14 0 26 0 0 0 2 4 3 15 0 0 0 0 11 11 8 0 7 0 13 34 6 15 11 0 6 18 30 0 0 0 14 
32 0 0 72 0 0 26 47 5 17 0 0 10 0 0 0 9 8 2 1 19 6 10 0 7 7 2 5 0 0 1 6 14 0 0 1 16 34 0 0 18 38 0 26 0 61 7 0 0 
36 64 43 0 33 4 48 0 0 0 0 16 7 22 0 0 16 10 0 9 8 8 12 0 8 12 26 7 17 15 0 1 11 0 20 54 70 15 10 12 28 0 16 19 0 2 45 0 28 
12 0 26 97 11 0 21 0 0 0 5 28 0 15 21 16 7 0 2 13 1 0 0 20 1 0 13 0 35 6 3 0 0 4 0 20 4 9 8 8 0 6 21 13 0 1 0 0 45 
39 0 0 0 0 0 0 12 6 0 0 18 10 0 0 0 0 0 0 14 0 21 0 15 0 0 15 0 0 3 0 2 0 13 0 0 0 23 0 59 28 15 0 20 14 1 2 0 0 
33 0 0 12 0 0 7 11 28 0 0 33 8 0 0 0 26 11 4 11 45 0 4 2 19 0 0 0 0 0 11 21 0 12 0 0 28 13 19 22 29 0 26 0 0 25 0 0 28 
19 16 0 0 12 24 0 0 12 0 0 0 35 9 16 0 0 14 15 14 0 0 46 8 0 48 0 2 0 0 15 17 4 14 9 0 0 33 0 0 0 0 0 8 0 2 0 40 0 
0 26 0 0 5 0 6 0 17 12 11 20 9 0 65 0 11 30 25 29 0 2 0 21 5 25 4 6 0 0 4 20 0 0 0 5 0 23 3 4 0 44 0 12 0 0 0 0 26 
0 8 57 27 0 26 0 7 7 0 0 1 22 0 7 22 15 42 0 0 3 0 0 2 0 2 0 0 0 27 0 26 16 34 18 0 0 20 13 4 0 0 0 0 0 0 6 0 0 
