49 28
0 27 5 0 5 32 19 0 3 2 0 5 24 5 2 0 17 9 0 5 15 0 21 10 15 20 9 0 26 6 0 0 0 10 0 0 25 56 0 15 0 0 21 0 22 0 12 22 0 
0 0 34 20 58 20 20 0 52 7 23 0 35 10 0 0 13 0 0 17 8 15 0 8 15 0 20 17 4 13 38 0 25 0 0 19 40 0 0 12 0 11 6 1 0 0 9 74 0 
16 20 33 13 22 8 6 20 12 0 21 0 12 27 9 0 1 1 0 0 6 0 14 9 0 2 14 0 0 0 12 17 0 0 0 3 4 0 8 0 9 17 5 0 0 4 0 0 0 
23 20 0 11 0 97 11 1 3 0 18 11 22 0 0 0 23 12 0 24 10 16 0 75 12 0 1 0 0 5 0 0 4 30 5 15 4 22 28 4 0 0 0 21 0 0 0 0 43 
0 0 9 11 0 0 0 27 0 8 4 27 23 1 0 25 23 12 1 0 9 15 0 25 0 5 4 15 0 17 0 12 0 0 7 0 0 19 4 33 12 0 0 15 23 20 10 15 37 
34 0 0 0 0 0 14 0 0 0 0 13 16 0 32 52 0 1 0 10 14 0 0 0 19 13 6 0 0 10 6 0 0 11 31 0 6 13 12 0 0 0 0 30 11 18 32 0 33 
12 0 35 0 0 8 0 10 5 0 5 5 12 3 0 12 0 24 17 1 1 0 4 0 4 0 3 0 0 12 16 12 4 0 2 0 14 35 0 0 0 5 0 0 15 0 0 0 8 
0 17 25 25 20 0 5 0 0 15 34 9 3 41 16 12 0 0 6 7 35 0 18 0 0 6 7 37 6 14 0 17 21 4 0 13 0 17 0 0 27 21 0 0 34 34 7 0 48 
2 0 0 65 26 0 28 41 0 19 6 2 15 0 0 0 28 25 1 16 5 0 0 18 0 6 0 13 0 26 44 0 0 4 29 32 17 7 5 0 7 0 12 0 28 6 0 26 41 
0 45 6 33 22 0 18 0 11 0 0 0 18 0 3 0 0 19 0 0 1 17 0 1 50 15 27 22 9 5 0 14 0 36 2 4 11 0 0 13 0 10 4 16 0 0 76 0 0 
18 0 0 0 0 2 5 7 0 9 0 2 29 0 0 3 0 17 10 0 22 0 0 1 0 12 0 1 0 0 0 0 6 0 0 0 0 12 8 0 26 29 0 7 0 0 10 0 0 
18 0 7 38 0 0 0 10 5 13 16 46 0 16 0 12 0 24 48 0 19 6 0 23 0 8 12 7 8 0 0 5 0 8 9 8 0 5 35 0 14 38 5 26 26 43 19 36 0 
73 36 30 0 0 7 0 0 0 12 0 31 40 0 32 9 3 29 0 5 0 18 17 0 16 0 26 0 18 13 10 0 1 0 1 12 6 17 0 0 5 5 11 0 7 9 51 69 15 
0 0 11 31 0 22 0 0 23 0 2 49 26 2 0 9 8 15 6 0 5 6 0 18 14 0 0 11 12 0 23 12 0 0 44 1 25 6 9 0 6 25 11 4 0 0 4 0 32 
20 0 12 5 19 38 6 19 3 8 11 35 38 29 0 0 0 0 19 0 20 0 15 19 0 25 0 0 0 1 0 0 0 0 0 13 0 9 0 0 0 1 30 37 19 0 0 10 5 
44 0 0 48 34 5 22 53 0 0 22 29 0 6 0 17 20 10 12 0 14 0 0 17 9 9 3 0 11 30 28 0 12 29 40 0 20 30 34 29 18 1 0 0 10 44 7 0 0 
0 9 15 3 0 0 0 16 5 28 14 0 10 0 2 0 2 0 0 12 0 11 0 16 0 0 0 0 0 0 0 12 6 12 10 0 0 28 0 6 6 0 0 14 10 5 3 4 0 
11 51 2 0 1 5 22 39 0 1 7 0 2 18 5 5 0 5 14 16 5 10 17 22 0 0 0 0 61 12 0 18 11 20 0 25 0 36 0 0 30 20 0 7 0 12 10 0 20 
23 7 0 10 5 5 3 14 7 17 38 7 0 0 26 10 0 18 0 0 11 21 0 0 24 0 3 0 9 7 20 17 0 0 0 0 11 17 0 14 0 0 5 0 0 0 0 0 0 
0 0 9 3 18 12 17 0 35 19 8 0 17 11 0 5 0 0 35 0 0 0 0 7 10 23 10 0 0 17 18 0 7 8 10 0 0 12 5 0 22 33 5 35 0 3 19 35 0 
0 0 3 0 0 4 0 0 9 0 0 68 0 0 0 25 0 0 23 14 0 6 0 0 0 0 0 16 0 0 0 0 0 0 45 0 28 0 3 0 0 23 0 32 0 1 0 0 0 
13 46 29 23 19 20 0 0 11 27 19 69 2 37 5 12 9 24 38 5 16 0 18 11 6 9 0 15 0 4 8 0 3 0 26 0 52 21 10 0 0 33 21 0 0 0 0 82 0 
13 17 1 44 5 0 13 25 8 6 0 0 0 11 8 0 4 57 0 5 12 0 12 5 10 3 8 9 25 1 13 14 11 12 15 2 23 0 14 4 0 0 5 21 2 28 43 19 0 
15 20 1 39 54 0 0 13 0 0 32 18 55 0 16 0 6 0 0 19 12 0 0 0 0 0 24 2 5 8 10 17 6 30 0 0 0 19 23 19 30 0 23 0 0 0 0 0 19 
0 47 0 21 46 19 9 17 19 0 0 0 0 34 6 14 23 12 0 0 0 0 0 0 15 14 0 2 24 9 24 47 3 25 3 2 18 7 9 15 10 6 0 0 16 32 38 30 0 
2 11 3 8 0 0 3 8 0 0 17 26 11 25 0 0 12 13 14 0 0 0 0 0 0 13 0 0 3 13 0 3 0 0 0 10 0 4 30 0 0 0 0 0 13 20 0 6 10 
12 19 10 14 31 0 38 0 14 8 26 40 4 32 9 9 23 23 0 4 22 0 2 12 17 15 25 19 0 5 0 0 21 2 0 57 7 0 1 28 0 17 16 12 0 0 33 1 6 
0 64 0 34 43 0 39 0 0 38 1 13 18 1 0 0 0 24 5 19 0 1 42 1 0 22 3 0 0 10 12 0 0 0 0 17 0 34 19 0 0 0 13 8 1 23 7 45 14 
