49 28
18 0 0 16 2 16 7 0 38 19 35 0 0 0 0 0 24 29 0 42 0 0 1 0 0 0 0 6 7 0 0 0 27 6 10 0 0 0 14 0 2 0 7 15 0 55 43 0 7 
37 9 57 0 0 22 0 25 0 0 13 60 21 0 0 0 0 0 4 0 51 13 11 0 13 0 0 0 14 14 0 10 7 5 1 12 0 8 0 28 0 31 0 9 22 10 20 0 9 
15 0 0 0 21 0 19 0 0 0 14 10 20 0 18 2 1 14 0 0 0 3 0 0 20 43 0 0 3 0 0 0 12 15 16 0 0 9 4 17 24 0 0 0 9 0 0 0 1 
0 0 51 0 0 0 20 19 0 0 0 0 0 0 0 0 0 1 21 3 0 5 1 36 22 2 22 18 12 28 16 0 0 10 0 7 0 0 0 18 28 21 0 19 21 24 44 7 20 
13 23 0 18 50 36 16 35 9 5 45 3 0 31 5 1 11 33 0 25 8 0 2 3 28 3 13 0 28 16 0 1 14 20 2 25 3 19 31 0 8 13 2 29 3 1 0 0 52 
0 0 18 9 36 0 0 39 34 23 30 0 9 2 0 6 14 3 0 0 22 2 8 16 13 0 33 20 18 25 8 0 23 0 0 11 0 0 28 1 5 2 34 0 18 5 13 0 10 
0 0 17 0 9 0 0 0 0 5 0 0 0 9 7 0 12 0 0 0 7 0 2 0 0 23 9 7 0 17 0 0 36 2 0 9 0 2 5 0 3 0 0 5 0 0 2 16 51 
0 41 30 20 86 0 2 0 0 1 22 24 0 34 0 9 0 0 0 4 0 0 0 16 0 13 17 0 2 12 16 0 30 8 0 24 0 8 0 0 0 0 38 39 13 0 61 0 8 
4 14 0 20 22 43 0 37 36 33 0 0 0 0 15 44 2 40 2 0 0 17 25 21 1 0 0 0 19 11 22 26 7 17 0 12 0 14 32 0 9 27 33 3 8 30 35 7 0 
13 8 63 0 0 8 0 2 0 8 18 21 0 9 14 0 38 43 0 27 0 10 16 12 0 0 4 0 32 0 10 0 0 13 8 0 0 0 13 0 11 0 0 14 0 28 28 1 0 
8 27 18 23 21 0 28 0 0 0 0 8 18 0 12 25 6 0 0 0 0 0 16 0 0 29 23 0 3 7 23 0 0 3 47 18 3 31 14 0 6 39 5 9 7 0 14 1 0 
0 1 19 48 4 0 22 10 0 39 0 14 4 0 25 10 25 0 1 0 0 6 0 6 0 30 8 21 0 0 0 28 1 3 0 35 3 0 0 25 10 0 0 0 0 10 0 0 1 
0 11 5 2 0 2 16 32 15 0 10 10 0 0 27 0 0 5 23 0 27 0 15 39 0 0 10 0 10 0 22 8 0 0 0 5 1 1 3 32 5 4 0 0 3 12 23 13 0 
34 0 23 26 0 18 52 1 12 9 10 8 0 9 0 14 0 5 14 0 1 22 0 0 10 4 8 7 0 14 3 38 26 3 10 39 0 23 0 2 2 35 6 0 8 8 5 21 0 
7 32 0 5 34 0 0 5 0 0 7 0 0 30 43 0 0 4 1 0 0 0 2 0 5 0 0 0 4 0 9 0 0 32 12 3 2 0 39 26 0 0 28 19 6 7 9 1 14 
0 0 3 19 31 5 0 0 0 1 0 0 45 34 0 0 0 0 21 7 5 67 2 0 21 13 5 0 6 3 8 0 0 0 0 31 16 24 0 13 28 0 0 0 2 0 4 42 37 
24 81 0 0 0 16 79 7 23 17 0 33 14 8 27 0 6 21 8 1 40 8 20 10 24 0 8 8 5 0 2 23 11 4 0 8 16 4 0 32 3 0 18 4 0 8 0 0 56 
0 10 5 16 26 42 0 0 2 25 3 11 0 33 1 43 11 58 21 3 16 18 11 0 21 17 35 0 0 5 19 0 14 21 37 20 27 0 52 0 3 0 3 10 6 9 7 0 10 
34 0 8 0 0 54 0 0 0 6 0 0 0 0 12 46 14 13 0 0 0 5 24 2 32 0 1 22 20 15 0 0 2 0 6 5 0 0 0 0 0 30 3 3 12 31 14 32 22 
1 0 0 0 1 5 6 0 20 10 0 0 0 12 20 1 9 21 10 0 0 10 3 7 42 3 14 0 2 7 3 1 3 4 0 4 3 0 21 7 7 0 5 0 0 0 0 0 0 
19 64 0 0 17 1 1 0 0 4 0 0 0 0 19 0 1 7 25 12 2 0 2 15 10 31 0 0 9 44 0 1 0 0 0 0 0 36 0 4 0 23 1 29 0 0 0 0 0 
7 0 26 0 22 0 59 9 0 7 7 0 0 0 10 14 4 13 0 28 0 0 7 12 5 0 0 25 6 5 1 6 0 0 12 25 0 7 0 30 33 39 5 3 4 22 29 71 0 
0 0 0 18 13 4 23 21 8 3 27 10 7 34 4 2 14 22 2 4 0 9 2 13 0 0 3 2 0 42 19 0 0 0 4 6 3 0 24 0 0 19 0 19 0 19 0 50 25 
4 11 22 0 0 45 0 28 0 0 3 35 0 0 21 13 15 5 11 0 22 11 18 0 4 13 3 1 0 0 13 0 55 17 0 5 0 0 0 0 0 0 0 5 19 38 4 36 0 
49 8 20 0 14 0 15 30 16 7 2 1 0 11 0 2 1 16 20 20 0 18 18 50 24 15 45 1 3 6 0 7 24 14 0 11 0 16 14 0 0 0 5 0 0 0 0 0 0 
0 0 0 0 0 0 0 0 1 1 1 4 0 0 0 0 0 21 0 9 8 10 0 0 23 0 2 3 2 0 0 0 19 6 0 7 8 0 0 0 0 0 0 0 18 0 0 0 0 
0 0 0 12 29 0 15 25 10 17 22 0 35 0 24 0 1 20 0 26 22 0 11 29 0 0 23 0 0 0 0 0 0 48 0 11 0 27 0 6 4 0 28 0 0 28 11 35 0 
13 0 18 22 6 14 0 0 0 22 0 26 0 9 28 2 62 0 7 0 4 12 0 11 0 25 0 14 43 24 0 28 12 18 10 2 0 0 0 0 0 14 83 1 12 7 13 20 0 
