49 28
0 46 0 29 10 26 41 3 39 0 15 3 0 21 7 23 0 8 6 46 0 24 14 0 1 41 10 17 7 0 6 0 55 0 21 0 7 0 13 31 0 7 3 11 10 26 0 46 0 
0 0 0 0 0 18 0 0 6 13 0 0 0 0 31 49 0 0 10 0 0 0 13 18 0 5 12 9 4 0 5 6 0 0 0 0 0 0 23 0 0 0 4 35 11 1 0 39 23 
0 17 25 38 24 4 0 0 27 2 8 11 7 1 1 0 16 0 0 0 8 0 11 0 19 0 0 3 51 12 0 0 16 0 0 60 11 0 0 0 0 36 40 2 3 0 0 3 9 
64 0 0 0 0 0 0 14 31 20 15 4 0 0 24 52 0 17 0 19 20 0 0 0 0 0 0 0 0 10 5 7 0 4 33 4 21 0 13 49 0 0 20 43 0 30 27 0 1 
10 0 9 9 0 0 21 6 0 22 6 7 10 11 0 3 0 0 0 13 8 3 0 39 0 10 0 0 3 9 7 44 19 7 0 24 3 0 0 7 1 6 0 1 0 0 3 22 2 
0 0 38 0 14 29 17 0 0 0 0 6 0 0 0 0 0 0 17 13 22 0 22 17 4 0 0 7 4 27 0 0 0 0 23 17 0 0 10 0 30 0 17 21 23 10 0 0 0 
62 29 0 0 1 15 13 0 11 0 5 0 32 52 16 35 29 0 0 7 4 3 6 14 3 42 0 12 8 19 26 0 10 0 28 23 4 24 0 6 0 5 10 2 4 32 0 0 14 
23 0 27 24 0 7 20 0 14 20 30 15 8 6 0 30 0 0 16 0 0 1 19 10 0 6 1 19 36 47 19 0 0 4 16 0 18 5 0 0 34 7 49 6 19 3 0 19 0 
16 32 2 0 0 18 0 0 0 16 42 0 0 5 0 0 9 0 17 8 14 0 24 0 0 16 8 14 28 13 10 2 0 32 16 1 13 23 0 11 0 0 3 33 8 8 0 13 6 
0 12 38 2 13 0 0 22 10 5 1 43 0 9 26 7 0 4 10 8 10 0 27 16 0 16 0 27 0 22 2 25 16 4 17 7 0 4 0 2 38 19 13 0 0 1 35 20 0 
0 16 3 27 23 33 15 7 30 3 36 44 3 0 19 1 4 12 12 0 38 9 24 10 4 0 17 15 14 6 17 0 38 12 23 41 6 26 30 7 4 33 3 22 3 42 0 0 16 
0 19 64 32 22 15 65 0 21 0 5 7 29 7 6 5 0 5 0 13 24 18 1 0 0 8 22 0 20 16 18 0 14 30 29 5 42 0 18 36 1 38 16 37 3 17 34 0 13 
79 0 10 0 21 0 28 0 15 4 0 0 11 5 2 13 0 0 0 17 10 0 0 12 7 30 11 5 0 44 0 6 0 32 49 10 0 5 0 0 0 0 0 0 0 0 46 22 0 
0 0 0 0 1 0 0 0 0 0 0 0 0 26 4 3 9 25 0 0 14 17 5 0 31 0 0 0 0 11 9 21 0 9 10 0 11 20 4 8 0 7 3 0 7 11 0 0 0 
10 0 7 0 18 1 0 5 17 5 5 24 0 4 7 0 0 0 0 4 0 1 18 0 0 17 1 15 17 15 0 27 0 6 0 5 0 0 9 0 5 0 9 14 15 17 14 1 1 
0 0 2 4 0 0 50 0 0 30 7 5 0 11 0 0 0 0 12 0 13 7 0 10 10 11 5 1 18 10 0 4 4 24 0 27 18 0 18 29 8 0 0 0 6 0 29 41 8 
8 14 0 0 5 0 0 8 0 0 38 0 0 24 0 15 0 0 0 10 5 1 0 18 0 0 0 0 0 9 1 6 0 4 0 0 3 24 0 9 0 14 0 7 5 1 0 8 23 
0 8 1 6 0 3 11 44 20 7 9 35 0 13 7 5 3 0 0 3 32 13 0 2 0 7 15 35 20 0 5 0 29 1 7 5 40 1 2 7 5 21 14 0 37 0 4 27 21 
19 0 1 0 0 0 19 0 15 0 9 0 29 11 0 0 24 0 10 6 0 14 8 0 0 34 0 0 0 0 0 27 8 0 0 22 3 0 0 27 31 0 0 2 0 0 4 7 17 
0 0 0 4 2 0 12 0 1 9 2 27 2 7 0 15 0 0 22 19 0 19 0 17 0 20 0 0 12 6 15 15 10 2 0 2 13 0 6 4 2 0 27 0 0 11 38 32 0 
12 13 0 6 11 25 0 4 0 0 1 0 4 6 30 5 4 9 22 1 9 0 17 0 29 20 10 0 10 4 0 7 23 4 10 1 11 0 0 7 22 17 0 45 0 0 0 0 16 
0 24 45 0 2 16 23 2 34 0 0 16 45 0 0 0 0 0 19 0 0 6 0 0 16 2 0 47 0 0 15 12 0 7 0 0 12 0 0 26 0 0 15 37 0 0 0 135 0 
15 0 13 0 42 0 29 24 37 0 0 16 0 0 0 2 25 0 5 0 0 0 0 5 8 0 0 4 12 3 3 25 19 1 0 32 0 0 3 0 12 0 0 5 0 34 23 20 5 
20 0 5 0 74 32 0 20 0 19 12 29 10 19 0 23 12 21 4 0 18 0 8 2 11 19 3 0 43 3 0 0 0 1 10 0 0 49 30 0 29 13 47 19 0 0 0 0 0 
5 15 30 38 19 19 9 14 3 17 5 0 1 27 0 6 0 17 0 0 0 31 14 29 9 0 3 0 19 17 13 20 30 0 8 0 29 2 0 2 27 0 0 0 12 0 37 0 36 
29 0 0 0 0 56 21 27 1 37 7 0 0 0 0 22 22 0 26 25 9 0 4 0 10 4 0 4 17 38 10 13 4 0 35 0 0 0 19 0 0 5 23 0 25 1 42 0 43 
11 24 0 0 0 14 0 2 0 4 38 11 33 0 1 1 0 18 8 0 9 12 1 6 0 11 0 20 19 0 4 17 19 40 1 42 22 27 0 29 7 0 0 40 19 13 0 13 0 
0 0 23 0 44 36 0 0 22 0 9 0 21 5 20 8 0 0 2 15 31 0 0 8 19 0 17 22 20 0 0 14 1 29 24 27 0 0 0 0 4 0 0 0 4 0 0 0 0 
