42 24
41 39 9 26 11 24 0 0 1 0 0 0 6 1 18 1 4 0 0 7 32 3 19 0 17 3 0 11 12 40 18 15 12 0 11 17 0 0 16 4 39 0 
1 20 9 0 8 0 24 21 31 17 0 0 0 1 15 13 14 0 10 0 15 20 20 22 18 0 22 13 4 0 6 32 20 0 3 29 0 0 0 7 17 0 
0 9 7 28 2 0 25 0 13 0 11 0 6 0 2 11 34 15 6 22 18 24 32 17 6 0 16 8 53 38 6 40 1 10 0 0 28 13 8 9 32 0 
12 0 34 61 0 22 39 0 17 26 0 8 0 3 41 6 16 2 0 0 0 10 22 17 2 52 0 13 17 20 33 14 1 0 0 0 34 34 0 20 6 0 
3 2 0 25 0 37 8 16 19 0 9 9 12 0 0 22 1 0 9 2 16 13 4 4 7 9 16 24 0 5 0 5 0 15 0 7 5 26 0 4 0 15 
0 0 23 0 24 6 0 0 8 0 0 10 0 0 0 4 0 0 15 17 21 8 1 0 12 5 2 0 26 0 4 13 0 0 2 13 0 0 4 0 5 17 
47 6 6 37 0 0 34 49 5 8 21 15 7 15 1 15 0 7 4 21 8 0 16 16 17 0 16 0 4 0 4 53 0 7 11 0 27 0 71 0 3 18 
8 4 38 0 16 14 0 0 0 0 8 0 12 1 1 16 0 23 4 2 16 15 19 0 49 13 6 5 0 0 0 23 3 12 0 6 0 0 0 0 1 17 
1 2 0 0 3 0 5 2 0 0 0 20 0 0 0 0 0 0 11 0 0 3 0 0 18 0 15 4 0 0 0 0 9 0 15 0 12 10 0 0 2 0 
12 0 0 10 18 0 0 3 4 15 5 14 42 0 0 4 13 0 0 0 3 5 14 0 8 0 18 5 3 0 0 0 29 0 0 12 35 2 0 0 0 0 
20 2 8 49 0 13 0 0 0 9 0 13 0 13 12 9 43 0 6 0 13 0 0 0 6 26 13 0 4 10 6 0 0 16 31 0 0 0 1 24 3 0 
0 7 19 24 33 0 0 5 29 10 17 2 6 0 0 1 50 0 7 0 0 10 0 11 9 3 46 4 6 0 14 0 20 0 41 18 0 20 0 23 36 0 
9 0 2 23 11 0 8 29 5 29 0 0 0 0 0 0 0 0 18 9 13 0 12 0 11 0 0 0 24 0 0 28 0 0 0 14 3 1 65 0 5 0 
0 6 0 26 0 5 0 3 0 0 12 15 26 3 11 20 1 7 0 9 0 8 15 0 0 1 0 0 0 26 15 20 0 0 2 0 0 0 26 0 0 0 
0 8 0 27 0 0 25 0 13 10 0 1 0 25 8 17 4 10 0 6 17 0 10 17 25 10 4 29 0 0 0 0 0 0 0 3 0 0 0 26 0 0 
16 2 15 0 22 8 6 0 25 0 9 50 0 14 0 0 1 0 18 0 0 3 8 0 0 0 22 14 0 0 20 5 0 22 23 3 26 0 0 28 12 9 
0 7 3 0 2 0 0 3 26 0 7 0 0 0 2 1 14 18 0 0 0 15 14 0 0 0 0 0 0 21 13 0 0 0 0 18 15 0 10 0 0 0 
0 2 13 30 0 22 0 0 10 0 0 16 0 0 0 29 6 17 5 0 5 0 5 0 12 0 0 29 13 7 0 3 9 37 32 8 0 8 11 0 5 0 
16 0 0 0 20 8 15 0 7 58 0 5 0 0 18 0 15 0 20 0 0 22 0 0 0 0 22 18 0 0 14 0 5 0 1 10 0 3 20 4 12 0 
9 6 3 10 0 5 2 20 8 4 14 5 0 0 2 8 13 0 5 6 1 0 16 5 4 0 0 20 0 0 0 0 1 0 4 10 0 0 28 0 0 0 
0 18 0 10 2 5 1 16 49 0 2 0 13 18 17 4 22 0 0 13 16 0 21 7 0 4 15 0 18 21 0 38 0 0 1 1 10 2 30 20 0 2 
89 0 0 0 10 15 8 0 0 12 34 39 0 0 29 0 11 0 5 5 21 0 1 6 12 5 9 0 0 29 0 0 27 0 34 34 0 3 33 0 0 27 
37 0 38 3 0 15 3 19 0 0 23 0 27 6 12 0 41 19 12 0 15 5 0 0 0 25 11 15 11 0 0 0 15 0 8 19 0 2 0 29 38 8 
12 39 0 17 0 0 32 28 0 0 6 9 12 1 17 0 19 0 0 8 23 10 16 0 0 0 28 27 0 0 0 11 0 0 19 28 0 0 32 0 26 33 
