42 24
23 0 11 20 0 0 0 0 0 16 0 0 18 14 5 0 13 0 0 0 14 1 0 0 6 31 0 0 0 0 47 2 8 0 0 5 0 0 25 0 5 37 
12 37 30 0 0 0 0 0 30 0 27 0 2 0 1 24 0 18 4 20 0 3 0 0 3 10 16 0 11 2 0 0 30 15 5 0 0 32 67 14 0 19 
37 0 40 23 0 4 27 48 21 0 21 0 11 5 0 9 22 8 1 0 26 12 15 0 4 8 17 0 7 21 14 5 33 0 0 22 31 8 22 21 77 0 
0 103 23 7 0 0 6 0 0 0 0 0 3 0 17 18 17 0 4 14 17 0 3 0 3 9 45 23 0 3 4 17 29 7 8 1 17 36 0 14 5 0 
0 0 0 0 39 0 0 0 4 0 0 0 0 19 12 0 0 12 10 8 0 0 0 0 0 16 12 2 0 4 0 0 4 0 0 0 0 0 3 35 17 6 
19 13 21 4 0 26 0 8 0 0 10 0 9 3 0 0 0 0 12 0 0 0 0 37 0 9 9 2 0 1 1 26 4 1 27 0 0 2 0 0 7 0 
13 1 0 0 0 5 10 7 0 46 23 0 3 0 0 0 0 0 7 18 14 0 3 10 5 4 16 18 0 20 5 0 0 6 0 12 13 18 29 6 7 31 
42 0 0 18 10 28 7 0 0 4 10 12 7 7 10 1 1 1 15 0 3 19 3 35 10 0 0 0 0 42 0 0 10 7 0 0 0 34 33 34 0 0 
0 16 13 97 24 5 20 1 1 15 0 27 3 19 4 42 7 12 4 0 16 15 7 0 2 22 0 0 0 5 14 0 4 0 21 5 18 34 16 0 15 21 
32 0 3 20 14 5 3 0 0 0 0 5 0 0 4 0 0 1 10 10 0 3 11 0 0 25 0 24 28 10 13 31 0 20 1 0 10 0 38 8 0 0 
29 36 21 19 0 25 0 2 0 25 0 0 0 0 1 5 12 0 0 23 7 4 21 0 10 29 0 7 7 27 35 11 16 14 17 7 0 36 0 0 0 6 
15 0 33 0 4 0 0 0 5 0 30 41 0 0 0 8 0 18 2 0 9 0 3 0 0 11 26 11 0 0 0 6 22 0 0 33 0 5 0 19 1 40 
0 0 14 0 36 0 0 30 0 0 0 0 28 10 8 1 0 3 26 1 14 7 10 0 0 0 0 14 17 15 8 0 5 0 6 0 6 23 0 21 15 0 
33 0 0 13 0 0 25 4 2 20 8 22 0 0 0 6 0 0 3 0 11 2 0 4 2 0 0 3 7 18 0 25 0 33 0 7 8 0 11 0 19 0 
14 11 32 6 0 0 0 27 27 53 14 0 18 0 47 1 19 0 18 3 12 12 18 0 0 12 1 7 0 0 24 9 11 4 30 16 17 28 8 25 5 0 
2 0 25 0 26 0 4 0 0 21 18 0 0 21 11 4 0 0 3 0 0 2 0 0 0 0 0 16 18 0 5 3 0 0 43 0 0 10 2 1 6 0 
0 8 0 13 8 0 25 0 0 8 24 0 4 0 4 0 4 0 14 0 0 15 7 0 3 4 0 10 0 0 4 0 7 20 24 0 0 4 5 4 0 0 
9 12 0 0 29 0 16 3 24 0 0 0 0 0 0 9 0 0 22 3 1 1 26 11 0 13 0 10 0 0 1 0 16 28 9 2 0 15 0 0 37 19 
1 1 0 0 24 0 0 18 7 0 0 25 5 0 4 0 25 0 6 0 0 6 0 10 0 10 14 0 0 0 1 2 11 9 7 0 25 0 10 2 3 32 
0 0 29 29 0 2 0 0 25 0 0 16 0 0 0 0 13 8 43 12 29 0 16 0 0 0 0 24 25 0 10 2 0 36 0 15 4 19 0 20 1 8 
0 0 10 0 13 13 0 9 21 5 70 0 3 8 1 5 20 22 25 0 5 3 0 16 11 19 35 0 32 1 1 0 16 4 1 23 10 4 0 2 42 43 
4 25 2 14 31 0 0 33 27 0 28 12 0 0 0 0 24 14 4 20 13 3 8 0 6 1 25 0 12 0 0 0 0 6 1 14 0 17 28 0 90 13 
39 0 12 0 59 0 24 19 0 17 21 5 2 0 0 0 29 6 0 12 4 0 0 0 0 13 50 34 2 2 29 0 19 0 5 5 16 0 22 38 36 0 
68 0 19 0 9 0 24 0 0 0 21 0 12 64 0 0 10 0 2 0 0 22 0 0 0 12 0 0 11 0 23 13 0 0 0 35 0 2 25 31 27 0 
