42 24
33 34 0 24 19 35 22 21 5 39 23 0 0 0 13 5 15 18 10 10 0 13 24 0 7 0 21 0 16 19 0 0 41 41 1 26 15 9 32 1 75 7 
0 15 0 0 15 6 0 0 0 20 8 0 2 0 9 8 24 29 0 2 16 0 0 2 1 34 5 0 0 3 9 0 13 0 17 0 0 19 0 9 55 0 
28 14 0 15 5 22 0 19 5 0 39 7 8 0 0 1 33 0 6 7 13 18 4 19 27 0 18 22 2 0 6 7 0 26 0 0 13 9 17 29 0 25 
0 11 0 0 3 3 25 33 6 9 4 1 7 14 0 1 0 10 0 9 0 0 18 10 22 0 0 2 0 3 18 25 12 0 17 16 0 0 0 0 33 0 
0 31 37 56 0 0 0 2 0 37 0 14 3 0 0 12 12 12 4 17 17 24 0 8 0 14 4 0 0 9 17 0 0 10 49 13 21 0 37 0 38 7 
3 1 0 0 38 4 0 28 13 0 8 8 0 0 14 3 19 18 16 9 0 28 7 0 0 0 4 23 8 22 0 0 0 32 11 6 27 19 38 10 0 13 
0 35 0 0 0 18 3 2 0 32 33 0 2 12 0 0 18 0 26 16 0 10 5 9 4 9 0 6 0 7 0 0 23 22 0 33 11 0 0 0 30 17 
5 0 0 4 0 29 1 0 0 0 0 0 0 0 2 6 0 0 0 5 0 1 15 0 0 0 8 0 0 5 0 0 0 0 0 0 8 0 0 34 0 0 
7 4 0 15 34 11 10 6 5 3 3 9 2 0 0 0 8 1 0 0 29 0 6 0 12 9 4 26 6 0 7 30 15 13 14 0 0 20 34 0 8 17 
0 22 0 5 33 15 25 21 0 0 8 12 8 0 0 20 0 0 17 0 5 11 0 0 0 0 11 0 9 9 26 14 0 5 0 6 0 0 18 0 0 6 
23 8 35 1 0 0 14 20 0 0 0 0 0 0 0 0 4 6 0 13 10 47 10 23 1 12 12 0 27 5 0 5 7 0 1 13 6 46 0 0 0 34 
4 24 6 3 23 32 0 22 16 0 17 0 4 0 6 0 0 54 23 0 8 11 7 3 8 12 6 4 11 26 13 0 0 4 0 31 9 24 0 10 36 6 
0 0 3 26 1 31 36 0 0 19 0 0 0 0 0 9 21 0 0 13 21 5 18 8 1 19 0 0 0 35 0 0 12 0 0 0 0 8 11 52 0 11 
1 80 0 21 8 1 27 0 17 9 0 0 0 0 36 0 3 0 13 0 0 13 0 0 21 36 3 0 4 0 0 8 4 0 3 0 35 23 0 21 39 0 
0 5 0 0 0 0 36 0 0 8 0 0 0 0 0 0 8 13 12 9 6 7 4 0 2 0 9 17 0 2 2 1 8 22 0 0 2 0 51 0 3 14 
7 0 0 0 0 3 0 29 3 14 29 0 0 0 0 0 15 8 0 0 0 0 10 0 0 0 0 2 0 2 0 0 7 0 0 0 53 0 0 23 0 0 
0 5 0 29 0 0 0 10 0 0 0 2 0 18 7 0 26 0 15 7 2 0 2 0 35 0 0 2 5 42 3 0 0 0 11 0 0 0 20 0 0 0 
0 40 26 1 0 0 0 0 0 14 5 0 2 0 0 13 0 0 10 14 0 0 23 16 2 14 0 11 26 10 0 9 1 1 7 17 2 0 0 0 0 40 
0 0 21 13 0 0 4 0 0 0 0 8 0 12 0 12 9 0 0 16 4 0 1 29 13 9 0 0 13 0 7 0 1 12 0 16 0 4 0 0 4 13 
12 67 8 10 0 11 57 0 18 0 7 21 30 0 4 0 10 0 0 0 10 9 4 0 0 27 21 0 0 16 3 0 47 32 0 0 13 0 0 0 0 16 
0 0 4 4 0 2 4 4 14 12 12 0 10 0 0 0 24 0 0 11 0 6 38 3 2 0 0 7 0 0 18 4 0 0 10 4 0 2 0 1 1 0 
12 11 89 7 35 18 16 74 28 8 5 20 2 12 0 16 25 2 4 17 17 5 64 20 23 0 14 0 38 11 8 19 15 21 10 4 34 30 0 41 87 33 
0 0 11 20 15 33 0 0 17 0 0 0 0 38 0 5 0 20 0 37 0 11 22 3 1 18 3 0 0 2 0 1 10 0 0 0 0 24 0 0 8 32 
0 18 12 2 7 2 0 1 0 0 0 12 25 0 12 14 29 3 3 6 0 21 21 5 0 34 0 20 14 0 2 0 2 0 2 36 16 25 20 0 0 10 
