42 24
4 0 0 0 12 0 37 8 14 0 5 4 0 0 0 31 2 16 6 0 20 12 5 9 5 29 0 1 28 23 19 0 9 0 15 29 13 0 0 9 0 41 
0 22 25 0 0 45 0 0 19 40 0 0 15 13 43 0 0 18 16 0 0 13 0 22 19 16 5 40 18 0 0 0 4 4 12 16 26 4 15 25 5 0 
28 21 0 7 0 0 1 0 41 19 7 0 17 15 0 0 0 11 24 0 0 0 21 0 0 7 0 20 45 19 0 10 0 15 29 27 0 0 0 17 5 0 
0 40 53 2 0 0 0 0 45 0 7 1 15 26 0 0 0 0 10 29 0 0 0 21 0 0 1 10 0 0 6 1 0 25 43 11 6 0 40 75 2 3 
4 0 0 63 73 0 6 0 0 0 17 26 6 0 25 14 4 9 0 16 17 0 0 0 0 0 14 3 0 11 3 0 10 30 0 5 0 0 27 25 64 37 
6 41 11 2 14 0 6 0 18 34 0 0 0 0 4 11 2 16 1 15 8 0 13 0 5 44 34 17 3 3 29 30 5 0 30 3 27 11 17 11 9 0 
6 0 7 14 9 33 6 0 0 0 15 8 25 42 20 30 15 13 30 0 16 3 25 6 4 11 38 1 0 0 4 7 32 14 24 12 4 14 2 40 7 0 
0 31 0 7 0 0 0 10 23 26 7 4 0 0 13 9 8 19 0 18 3 0 5 7 21 10 0 13 11 0 1 0 0 2 0 18 0 0 10 11 18 7 
0 29 0 1 34 0 0 6 7 7 0 0 0 21 0 0 3 7 0 0 0 0 0 0 6 0 1 0 0 0 27 5 6 0 17 0 5 46 6 0 0 1 
0 0 0 19 6 15 17 11 0 0 1 0 6 0 12 5 20 12 24 0 0 7 19 7 4 5 1 10 0 2 9 15 5 6 0 0 0 0 0 18 14 0 
20 0 67 8 15 16 12 0 2 2 7 18 0 7 0 0 7 1 12 0 13 26 0 23 18 1 0 0 7 4 23 7 0 0 30 19 2 35 14 0 0 11 
0 11 32 0 5 22 0 23 7 0 0 4 7 0 4 0 22 0 5 8 0 0 1 16 0 0 5 28 0 0 42 0 2 4 48 8 3 2 22 9 3 7 
0 0 6 0 0 0 28 4 24 0 48 4 5 17 0 0 0 15 0 0 3 22 0 13 5 0 0 10 0 0 17 35 14 6 34 0 26 0 9 10 0 0 
23 21 21 0 2 7 0 0 0 0 0 0 7 11 1 1 6 8 5 10 6 10 7 18 5 0 8 10 15 2 0 19 0 11 0 6 0 0 0 17 40 0 
0 2 0 0 8 28 24 6 14 9 0 0 0 0 0 0 18 0 8 4 0 13 0 0 0 9 0 32 0 7 0 0 24 28 37 12 10 0 0 0 0 0 
0 0 33 0 0 11 28 15 8 0 6 9 6 0 0 1 10 13 0 0 0 0 9 21 0 12 0 0 18 0 0 0 0 1 60 31 8 12 0 0 7 4 
0 9 0 0 35 0 11 0 14 0 10 4 28 0 0 9 17 0 0 0 0 10 19 7 2 3 2 6 9 0 8 0 0 0 0 0 3 0 15 3 11 56 
50 22 14 0 0 3 38 0 0 31 0 1 0 13 0 0 0 19 10 0 0 3 0 53 0 0 15 0 0 0 1 29 32 21 0 14 15 16 15 10 27 20 
35 0 0 35 36 17 0 34 34 1 0 2 37 43 0 10 48 7 13 24 0 0 0 0 14 12 0 0 46 4 17 0 0 0 16 60 0 14 26 11 79 9 
0 0 6 2 49 0 3 8 0 0 0 0 12 0 0 0 7 6 14 0 18 0 0 13 3 5 10 15 0 0 0 0 0 1 18 0 32 0 0 18 0 4 
7 0 0 11 0 0 26 55 28 0 0 12 7 0 9 0 0 9 16 5 1 12 0 2 21 8 14 3 0 0 4 0 8 5 5 48 0 1 0 33 5 34 
0 36 0 2 0 12 0 0 31 3 11 27 16 0 2 0 5 0 0 0 0 19 5 11 0 0 20 30 0 27 0 0 0 20 0 0 16 60 27 31 36 0 
5 0 0 0 1 0 35 18 24 0 6 0 22 16 0 0 1 9 8 9 9 10 0 2 0 4 1 21 9 9 24 0 0 0 6 0 2 1 11 40 0 0 
26 26 11 0 22 18 0 23 0 4 34 0 0 0 17 0 0 0 2 0 12 0 0 0 2 15 114 18 0 0 0 0 0 0 0 0 10 35 28 0 29 0 
