42 24
28 0 104 2 7 76 0 8 6 26 23 16 1 14 20 10 0 2 15 0 0 0 17 8 2 10 21 10 5 0 0 0 1 53 21 38 11 43 0 37 38 4 
0 0 5 1 27 19 34 6 52 6 0 7 0 0 0 31 9 0 0 0 0 12 12 15 19 0 20 0 0 2 0 8 0 3 19 3 0 0 47 0 2 26 
0 5 0 18 13 20 0 1 19 27 1 0 12 3 0 21 0 13 0 14 19 0 0 0 10 21 11 0 6 0 4 23 4 1 0 20 25 27 0 61 12 10 
46 0 15 0 39 19 0 1 3 0 0 0 0 0 0 8 13 0 2 0 0 14 19 0 19 0 0 0 0 3 0 6 25 0 10 0 0 6 0 39 2 8 
6 36 45 0 48 35 6 0 20 25 14 0 0 30 9 11 0 11 0 16 0 8 11 0 8 0 20 0 44 4 6 0 0 0 25 33 14 34 0 7 14 0 
0 0 21 8 0 5 4 31 0 2 21 0 41 0 11 0 0 0 8 22 0 0 6 21 7 0 12 0 0 9 0 7 0 2 0 0 0 18 43 0 28 22 
0 4 14 0 38 0 4 0 0 9 6 0 0 27 0 1 15 20 5 0 0 0 0 1 8 16 17 0 11 0 12 0 3 29 21 0 10 2 3 15 0 0 
1 6 78 0 14 0 0 3 8 3 3 27 19 4 20 19 23 12 0 16 18 27 3 12 0 0 13 20 0 31 23 12 13 0 49 31 34 11 37 12 38 0 
0 0 7 32 39 2 3 30 1 4 0 4 0 0 8 0 0 30 0 16 0 5 8 0 0 0 6 12 15 12 8 23 0 10 7 0 6 8 10 15 0 34 
1 0 0 0 0 21 0 9 9 0 26 0 10 24 0 0 0 10 2 0 20 0 15 0 15 0 0 0 0 1 1 0 0 0 0 0 26 24 29 49 0 0 
38 0 0 2 0 0 23 0 3 27 0 13 8 6 0 0 0 5 4 0 5 17 0 0 6 2 14 24 3 3 0 33 11 27 7 0 3 16 2 0 0 7 
4 0 0 3 11 0 0 2 0 9 42 0 9 0 5 0 0 0 13 0 0 14 6 2 0 0 7 0 0 11 9 1 0 6 24 24 7 0 10 11 0 5 
0 12 19 21 29 3 10 1 19 2 0 0 7 21 8 5 0 0 0 0 0 16 5 0 10 21 23 0 5 28 0 0 0 1 21 0 4 4 37 36 0 10 
0 39 13 0 17 0 0 32 0 0 0 0 15 6 13 13 14 4 8 0 13 14 2 1 11 0 4 6 0 5 4 0 0 9 2 0 20 3 0 7 42 19 
67 34 28 0 11 19 13 13 11 3 27 24 9 5 17 0 4 0 1 2 5 12 6 1 39 0 0 8 0 15 34 11 0 33 30 36 26 14 17 8 12 12 
0 9 0 0 5 20 0 6 0 0 16 0 17 12 0 8 0 27 1 14 0 2 0 0 11 7 0 1 0 17 0 14 0 0 5 11 0 32 19 5 0 0 
14 25 46 19 16 1 7 15 4 7 0 22 0 10 43 32 30 22 0 14 0 25 4 10 0 11 7 2 0 15 29 6 7 8 0 38 28 15 0 22 0 26 
0 20 35 0 0 0 16 0 0 0 34 0 0 4 0 25 0 21 17 0 0 16 8 0 6 7 15 6 2 0 0 5 0 10 24 19 0 35 8 0 39 8 
0 12 14 0 0 2 2 7 39 0 39 0 5 15 0 0 27 12 18 0 0 0 0 0 0 14 10 0 3 0 17 0 0 0 0 2 16 29 13 0 27 0 
0 0 4 16 28 0 0 0 0 0 0 0 9 0 9 17 0 0 1 16 0 5 0 9 0 0 13 3 0 0 0 3 28 0 19 19 0 19 0 1 0 0 
42 24 38 18 42 0 5 24 11 0 8 23 0 13 8 0 14 5 16 19 7 0 21 8 15 0 0 5 11 0 0 24 0 16 23 22 23 0 0 11 0 0 
23 1 0 0 0 4 6 0 0 18 29 30 16 0 0 9 22 4 0 8 0 23 0 9 8 0 30 4 0 0 4 4 10 0 29 0 23 0 22 37 19 15 
15 1 28 5 0 13 0 0 0 0 0 0 13 0 0 0 8 0 0 0 20 0 0 0 10 6 11 8 0 39 0 0 1 31 0 0 1 10 15 0 20 0 
0 36 19 3 13 22 16 0 11 10 23 0 0 0 0 0 19 13 0 14 0 19 0 16 0 0 14 22 15 0 21 0 7 14 8 19 0 37 0 2 0 0 
