42 24
0 0 28 0 0 25 0 0 0 7 0 5 0 11 9 0 0 0 0 0 22 13 30 7 0 0 0 0 26 0 25 0 17 26 9 0 0 4 0 17 0 0 
21 0 31 22 9 31 19 0 0 32 19 17 1 15 9 0 1 9 0 2 0 20 7 0 24 41 16 9 0 0 0 2 0 42 1 18 11 19 0 0 0 0 
15 0 5 17 0 0 7 18 30 9 20 4 26 4 0 6 22 9 0 0 27 15 6 15 5 25 0 0 6 33 0 10 0 8 3 0 24 0 57 0 0 20 
0 0 44 12 0 1 0 0 11 11 7 1 0 47 0 12 5 16 7 8 0 37 1 18 3 0 0 0 18 3 31 0 15 0 3 5 21 22 13 0 38 4 
34 0 0 55 0 32 5 77 0 3 5 11 7 15 0 5 0 0 11 13 0 0 0 0 23 0 0 0 5 27 23 0 25 5 0 28 26 32 20 11 0 38 
41 13 29 6 0 8 29 0 0 6 0 16 0 14 0 20 23 19 2 20 0 22 0 0 0 8 0 7 0 3 0 26 6 0 0 9 15 4 6 3 4 25 
0 16 17 0 0 3 29 30 0 18 0 0 0 0 0 19 0 14 0 13 0 0 0 0 0 0 2 18 0 12 0 6 0 0 17 44 1 27 23 13 0 0 
0 0 13 2 0 11 17 2 0 0 0 1 0 32 10 9 0 0 0 0 18 12 0 0 0 0 0 0 13 29 25 0 2 10 18 16 0 0 6 34 0 0 
0 0 0 32 0 20 0 0 0 22 0 23 45 7 7 20 0 0 13 1 13 7 23 0 12 0 8 4 0 0 0 19 0 8 22 8 0 0 31 0 0 0 
7 0 3 28 0 18 10 2 0 0 0 4 1 0 12 9 6 0 5 2 21 18 3 8 2 2 3 0 4 10 0 0 0 8 15 8 0 10 18 7 0 0 
20 0 0 0 37 0 2 19 0 0 0 0 12 1 0 3 0 0 0 22 0 0 17 11 0 8 11 13 0 0 13 3 0 0 8 0 6 0 0 17 0 59 
0 2 0 0 0 38 9 0 2 9 6 0 9 38 9 0 6 0 0 8 14 0 0 0 0 0 6 0 15 0 4 30 0 10 25 2 0 8 0 0 0 76 
8 0 0 10 0 0 0 0 18 0 0 15 4 0 0 11 0 6 0 12 0 0 8 0 21 0 22 9 0 5 0 0 0 11 0 0 3 0 0 3 21 0 
0 0 0 26 0 18 17 0 2 0 7 0 11 0 0 0 11 0 0 7 32 0 13 17 9 8 2 2 1 32 0 0 12 0 0 0 5 23 6 13 4 1 
0 3 0 0 0 0 0 0 0 11 6 0 0 10 4 0 0 0 0 3 0 8 1 1 0 0 0 0 5 8 2 0 0 0 0 0 0 0 10 0 0 0 
23 0 0 0 0 0 3 31 12 20 0 3 0 0 0 0 0 0 9 8 0 0 2 31 2 2 5 2 7 29 0 0 0 6 0 4 0 0 31 0 14 0 
27 0 0 0 0 0 0 5 5 0 26 0 1 4 7 1 22 0 0 0 3 0 0 1 0 0 0 27 0 1 7 0 0 5 0 3 26 0 16 5 0 0 
30 0 4 37 0 3 30 3 3 47 24 17 13 0 7 1 12 19 2 19 15 0 0 0 17 0 20 2 9 4 0 22 17 10 39 0 1 26 0 0 0 15 
17 13 0 17 0 4 1 9 32 4 15 4 1 11 33 13 4 34 0 4 4 0 0 0 0 12 0 6 14 13 14 8 1 4 23 0 0 0 27 3 0 3 
0 2 0 18 2 1 59 0 24 0 0 0 0 0 12 0 0 0 0 0 4 46 8 11 0 0 1 0 7 0 2 4 50 1 14 15 33 17 0 46 6 2 
0 0 23 3 31 1 1 4 1 6 42 32 9 16 10 1 5 20 2 0 7 0 4 18 11 0 4 0 8 0 17 18 0 0 23 2 0 5 0 30 0 37 
24 6 0 0 10 7 14 5 0 32 88 20 18 0 14 14 12 37 0 2 47 0 19 11 31 8 1 0 10 2 10 1 0 22 14 0 11 8 28 19 6 27 
0 18 0 44 1 15 14 0 73 0 6 16 0 3 21 0 17 6 3 25 21 10 0 19 0 14 9 7 0 21 0 0 0 38 24 77 1 0 0 14 5 13 
3 35 0 61 0 22 8 46 26 0 0 0 4 17 4 15 19 5 0 4 12 0 10 0 16 11 4 13 21 1 56 0 25 4 29 59 24 11 50 7 38 1 
