42 24
5 0 9 13 17 40 57 7 5 7 13 0 0 10 17 25 0 31 17 0 20 0 14 7 14 0 0 9 0 0 0 9 22 0 20 0 14 10 0 49 2 0 
9 13 0 2 3 24 35 22 0 27 0 15 0 21 13 15 7 2 23 0 10 0 0 18 11 16 20 8 14 2 0 6 59 0 16 8 24 0 15 13 0 0 
0 30 32 19 50 14 0 0 0 7 0 0 0 7 0 0 7 0 17 19 0 0 0 20 0 0 0 0 0 0 0 30 6 0 32 0 0 13 12 0 14 0 
0 30 0 3 0 23 16 10 29 24 24 0 0 7 0 24 24 4 1 10 7 0 0 8 19 19 0 10 0 14 0 27 7 28 0 0 7 29 19 0 34 25 
0 7 0 4 1 14 0 1 0 32 7 11 0 26 0 0 12 4 11 0 0 8 15 30 12 15 20 22 0 15 0 20 12 5 0 22 0 28 14 0 16 0 
23 22 0 0 14 49 10 0 0 2 0 0 0 0 18 14 0 0 0 0 0 7 18 23 4 8 0 0 0 0 0 0 2 0 0 30 32 28 0 0 4 0 
11 52 0 12 0 0 32 24 31 0 20 7 0 7 6 0 15 1 6 0 6 16 0 0 0 0 0 12 9 0 21 31 0 13 1 0 15 7 32 9 32 0 
0 0 38 0 7 8 26 3 0 12 13 1 0 13 0 0 21 8 6 0 5 10 15 11 6 0 20 7 15 0 20 5 3 3 36 0 0 6 0 0 31 31 
0 0 3 8 37 5 24 3 21 21 0 0 1 11 15 21 0 0 6 2 0 0 1 4 0 0 4 5 0 51 3 0 9 0 0 0 21 6 0 3 3 44 
18 24 3 0 2 0 0 7 30 11 0 0 0 26 7 0 0 0 4 0 4 1 15 16 7 24 0 4 6 10 0 0 0 0 0 0 5 0 10 14 7 33 
8 2 0 40 41 0 4 32 0 8 0 24 9 7 0 12 7 16 2 1 9 16 16 20 6 0 0 0 0 25 3 0 0 2 0 2 3 17 1 30 0 36 
0 0 0 0 17 29 3 2 21 19 7 0 2 2 2 7 0 0 0 0 4 5 4 27 4 22 5 8 19 21 0 0 4 6 0 0 26 0 24 10 0 5 
0 0 0 9 5 3 0 9 0 3 0 0 9 17 0 0 9 0 8 14 0 4 0 10 16 10 0 3 15 1 3 38 9 7 0 0 0 0 0 0 9 0 
0 2 0 18 36 0 0 6 40 0 1 3 0 2 0 4 0 32 3 0 0 0 11 11 22 6 18 0 0 0 22 0 0 0 0 0 19 0 0 15 36 3 
28 9 0 26 44 0 3 0 0 3 15 35 0 0 0 14 0 0 18 12 19 0 0 13 0 22 16 5 39 11 4 20 7 4 19 0 26 11 15 8 37 4 
0 28 31 0 0 43 54 10 13 0 12 9 15 0 12 6 1 5 21 0 0 0 12 17 0 10 13 15 3 31 28 0 4 2 8 38 0 13 13 15 11 13 
1 0 0 12 46 14 0 8 6 2 0 15 3 4 22 3 27 0 6 0 0 0 0 0 10 5 0 10 0 0 0 1 13 1 0 0 32 11 7 0 8 3 
36 38 0 43 2 0 3 0 0 28 11 18 9 13 49 26 8 17 4 0 22 10 0 9 0 0 25 16 0 0 14 12 16 5 84 0 5 19 5 1 8 6 
0 30 0 16 0 34 0 13 30 2 0 32 20 0 1 17 0 4 11 0 12 19 4 14 0 12 1 20 0 0 27 0 0 0 0 7 25 0 30 0 0 29 
3 11 0 3 3 9 0 11 7 0 0 15 0 9 0 0 0 4 0 0 12 0 7 0 15 20 0 8 23 7 0 0 14 0 0 1 0 0 0 17 0 0 
29 29 4 31 10 4 12 0 0 19 8 0 0 0 8 8 14 2 24 23 0 6 0 15 22 8 0 7 0 46 12 4 3 0 47 0 0 0 4 0 22 22 
0 0 0 8 0 16 0 0 0 0 0 0 0 0 16 1 9 6 3 0 0 0 7 18 0 0 0 13 0 0 16 0 29 4 0 0 6 4 2 0 0 6 
0 27 9 0 8 0 21 0 3 0 0 5 0 24 5 0 0 22 0 0 13 0 0 26 6 20 8 0 0 14 6 0 31 0 0 6 0 7 8 0 8 0 
35 0 14 0 0 0 27 0 0 27 20 0 0 0 3 0 0 35 28 0 6 0 0 0 0 0 0 11 0 0 0 18 0 27 8 35 27 0 21 0 0 0 
