42 24
0 25 32 36 0 0 0 0 0 0 9 0 0 0 6 0 20 10 0 39 4 0 19 0 25 12 18 2 2 0 16 22 0 11 19 15 2 1 18 19 0 0 
20 18 0 9 30 0 0 0 0 42 1 0 31 28 0 10 0 5 19 11 6 5 5 18 0 15 0 47 13 7 13 0 3 0 13 0 18 1 23 17 13 14 
28 21 28 3 11 6 1 0 4 3 0 9 22 2 9 0 24 22 0 7 0 1 0 0 21 0 0 8 0 1 11 17 7 7 15 0 3 0 0 22 55 0 
0 3 0 15 15 0 0 0 0 0 0 0 29 18 16 26 0 12 9 1 16 7 0 5 0 0 0 8 0 12 1 18 2 14 19 10 10 23 0 3 0 11 
0 10 67 15 0 48 3 0 6 0 0 10 0 0 17 10 13 17 2 32 7 0 8 17 16 10 0 7 12 0 8 0 8 7 46 5 80 0 2 0 34 0 
0 13 0 0 0 0 8 0 0 0 0 18 0 0 13 0 4 0 0 0 0 0 0 9 8 16 0 18 0 0 8 1 10 0 2 5 0 0 0 0 17 29 
0 0 0 7 7 8 11 0 5 5 0 2 7 2 1 2 0 11 9 17 11 0 3 0 0 35 17 0 10 0 1 16 0 0 0 1 0 0 10 2 19 0 
1 35 2 23 0 45 0 17 5 0 6 6 9 18 10 0 0 23 13 4 0 8 0 0 39 12 5 0 0 9 1 50 0 21 20 34 7 32 9 26 0 0 
0 0 15 0 0 34 0 0 0 1 19 27 19 0 0 0 0 10 3 8 15 3 24 15 0 7 4 0 0 1 9 19 2 13 5 0 4 0 27 39 0 19 
8 0 21 55 2 20 5 0 0 10 0 5 7 0 0 0 1 9 13 8 0 8 0 0 21 6 0 0 12 0 0 0 0 0 31 0 17 0 0 0 0 0 
7 28 10 0 0 18 1 0 26 0 1 0 2 0 10 0 0 11 10 3 25 0 8 7 44 0 0 0 20 28 8 21 0 0 17 25 0 0 0 16 0 0 
3 39 0 3 29 26 30 19 0 1 1 25 0 0 0 0 0 9 0 0 12 0 0 0 19 0 23 0 0 0 5 1 31 35 0 31 66 28 0 0 7 10 
0 0 0 7 12 9 3 7 0 10 11 21 6 22 32 0 7 0 6 15 4 0 9 0 0 13 0 6 0 0 4 16 28 6 8 28 0 33 0 10 10 2 
0 22 3 47 4 6 38 25 6 0 7 7 0 12 15 1 13 7 23 0 0 2 17 20 4 12 1 23 8 0 9 0 35 13 4 13 40 34 0 35 0 60 
12 0 0 0 4 0 1 0 0 0 27 3 0 0 1 18 1 0 0 0 6 0 0 11 0 19 20 7 11 0 3 0 2 29 12 8 0 27 0 7 15 39 
0 0 0 22 0 2 0 2 0 77 0 8 0 0 2 5 0 4 0 18 0 2 9 4 0 40 0 0 3 0 0 3 0 32 0 1 0 28 23 0 9 0 
0 27 2 1 0 7 0 0 6 5 0 0 1 6 0 0 0 6 0 2 0 2 8 4 11 0 0 0 35 0 5 3 4 0 0 15 0 5 0 2 5 2 
15 39 26 0 0 0 26 0 15 0 17 23 19 13 2 0 5 4 0 2 15 8 0 29 0 5 13 0 28 1 0 0 17 3 38 16 0 12 0 0 7 0 
25 0 4 2 17 0 4 0 0 0 0 0 0 12 3 0 0 9 0 15 0 16 0 2 0 19 8 0 0 0 0 0 0 8 25 5 10 3 18 4 0 2 
0 16 0 14 0 28 0 17 0 0 25 0 13 0 0 0 13 4 5 2 0 16 0 14 17 0 8 3 0 6 31 0 4 45 0 19 17 21 0 0 3 0 
0 0 30 24 101 16 0 18 0 24 8 0 0 19 0 0 0 9 19 9 13 18 0 0 15 28 0 19 22 0 0 0 16 21 16 0 32 10 34 35 14 0 
20 0 0 3 0 17 3 0 6 0 0 2 0 0 29 0 21 0 0 2 0 0 1 5 2 3 0 0 17 13 0 0 7 0 0 0 0 0 0 16 0 0 
0 55 28 32 16 53 1 0 0 19 1 15 14 2 2 0 2 29 23 22 33 13 0 0 0 13 14 16 19 0 0 17 0 12 29 9 0 112 13 0 36 6 
39 1 0 0 0 0 22 0 12 2 17 30 0 15 0 14 2 0 3 3 38 1 7 15 34 0 7 51 13 2 32 0 16 0 16 0 0 0 3 0 0 47 
