42 24
0 0 0 0 21 0 46 0 0 23 0 26 0 0 21 20 0 22 0 0 0 0 2 0 6 19 0 5 0 0 0 0 43 21 0 8 0 26 2 25 2 6 
14 22 0 0 0 0 21 0 0 9 0 0 0 0 0 18 37 0 0 16 0 6 0 40 0 0 0 3 21 10 0 0 0 0 21 0 0 0 0 21 3 15 
0 0 1 8 0 0 19 0 0 38 11 0 9 4 12 9 16 4 16 0 0 7 19 2 12 10 12 34 1 4 13 0 19 0 0 30 9 28 0 0 19 0 
2 0 1 14 0 0 12 34 4 11 14 0 4 12 2 19 0 8 4 0 31 17 0 0 33 12 8 0 0 0 1 4 5 0 27 0 12 0 28 3 34 23 
1 2 0 9 36 13 2 17 0 0 5 34 0 0 25 0 0 0 0 0 0 0 0 2 0 18 0 5 0 18 0 30 31 0 7 24 4 33 0 38 1 0 
0 20 0 0 9 9 0 21 5 0 11 8 0 46 4 14 14 6 17 12 0 0 14 17 29 0 3 0 21 0 17 0 6 2 0 0 4 14 1 7 48 28 
3 0 0 51 2 5 49 0 6 14 6 67 0 0 0 9 0 0 3 0 0 0 0 1 10 0 0 9 15 7 24 10 0 30 23 4 9 0 27 5 0 28 
0 0 1 7 34 9 0 11 18 0 0 8 0 25 0 5 0 0 46 0 0 19 4 1 6 0 18 0 12 8 0 5 2 7 0 0 5 3 25 7 6 60 
29 46 6 6 0 25 0 27 0 5 2 5 0 0 5 0 7 14 18 0 34 0 5 7 26 1 7 14 0 0 22 30 0 15 17 0 0 0 0 2 15 0 
45 26 0 30 21 0 3 14 30 19 16 7 0 28 0 26 16 37 3 0 0 12 34 0 0 1 0 10 0 12 0 8 0 25 26 35 11 0 38 0 1 42 
0 0 0 1 9 5 0 0 0 2 11 0 0 0 4 8 5 0 2 13 0 13 0 27 14 0 13 12 0 11 0 0 13 0 13 3 13 10 3 13 6 4 
8 61 0 0 25 10 0 28 18 28 0 16 20 0 0 8 12 8 9 2 0 5 0 0 26 0 22 7 0 5 0 8 20 3 0 0 0 20 0 38 0 34 
39 44 0 11 20 22 9 19 6 9 19 0 8 0 7 0 0 0 3 1 3 0 0 8 20 9 23 0 6 0 0 22 0 18 11 2 29 0 0 39 36 40 
7 4 36 9 54 25 27 13 4 4 6 25 0 0 0 2 6 13 0 0 0 8 11 0 7 0 22 28 10 8 17 10 2 21 0 2 36 0 16 4 0 10 
35 9 42 18 24 0 31 29 0 0 8 7 6 1 4 17 13 1 1 3 34 0 2 5 11 3 6 23 3 13 2 0 11 8 31 48 29 0 29 63 0 0 
8 0 1 59 1 0 10 0 0 0 21 15 0 0 1 5 22 2 11 0 4 0 12 12 0 0 23 0 9 2 30 0 0 0 12 13 36 0 24 3 2 8 
1 19 0 35 25 30 45 23 2 15 49 0 6 0 13 24 7 22 8 0 5 0 11 15 6 0 28 0 42 7 68 31 6 24 0 25 0 11 33 22 0 27 
0 0 0 18 0 28 18 10 0 0 0 5 0 23 0 0 17 1 15 16 15 0 0 0 14 0 0 0 0 41 3 0 17 6 6 0 23 0 5 0 4 0 
0 0 0 0 18 0 0 3 0 10 15 5 10 16 0 11 5 4 0 15 10 0 0 17 0 6 0 0 0 7 0 0 0 0 0 0 4 11 10 0 4 3 
26 0 0 0 0 14 4 0 32 13 0 34 0 0 8 11 0 0 0 0 11 0 2 0 0 0 15 34 0 0 15 8 6 7 0 0 2 0 2 2 3 15 
37 0 16 12 0 31 1 34 0 4 11 9 0 0 0 8 7 25 0 0 0 0 0 0 0 16 23 40 0 0 3 0 0 4 0 0 3 0 7 46 6 34 
26 0 37 42 40 0 0 13 0 24 0 21 3 11 0 12 14 0 0 0 0 16 18 19 35 0 0 0 28 8 4 0 29 42 0 0 0 22 5 21 59 18 
2 27 0 12 2 0 2 0 13 6 0 0 16 0 6 14 40 14 0 0 14 0 13 0 0 13 0 26 6 0 0 0 0 0 21 19 0 0 6 21 7 0 
11 9 0 6 0 12 0 6 0 0 20 6 15 3 31 9 6 14 7 0 0 0 0 0 0 4 0 23 0 24 0 0 20 0 15 0 21 0 0 0 13 51 
