42 24
14 0 21 27 2 0 0 23 0 0 7 15 12 1 3 0 25 0 23 0 0 0 10 15 0 5 0 0 0 31 17 19 4 0 0 0 7 0 0 2 0 66 
0 15 18 0 0 5 0 32 0 0 8 25 0 2 0 29 15 0 0 0 3 0 0 1 0 35 16 0 0 9 17 0 0 0 0 13 0 0 0 32 0 0 
12 11 10 0 0 29 0 0 0 28 0 12 16 0 11 0 0 18 0 7 0 0 1 13 0 3 0 0 0 11 0 0 15 0 0 7 0 36 0 19 0 13 
0 25 0 26 18 0 0 0 0 0 27 2 12 0 0 9 0 14 0 20 15 9 13 0 27 0 0 24 9 0 0 14 0 1 24 7 0 17 0 33 0 2 
10 21 0 12 0 2 0 1 0 0 10 0 28 0 0 20 24 0 0 0 19 15 44 8 10 12 4 0 0 9 7 3 0 13 19 0 0 9 0 7 52 19 
14 0 0 23 0 0 0 0 10 49 0 4 39 0 11 12 0 5 0 18 0 0 3 6 0 2 2 0 18 27 8 22 4 0 0 9 23 16 10 5 5 15 
0 0 22 27 26 5 30 0 13 0 0 6 39 0 23 0 0 24 15 0 0 0 0 11 22 40 8 0 14 0 26 0 14 14 31 0 30 0 0 0 0 24 
0 0 55 6 41 14 9 5 4 2 17 11 6 0 0 15 0 12 13 0 13 16 0 0 22 0 0 21 11 5 0 3 0 3 0 33 0 13 3 41 36 14 
46 39 0 8 31 26 0 16 0 0 7 26 0 0 34 2 0 6 0 0 2 4 0 9 11 0 0 0 0 9 13 3 5 26 4 20 0 11 0 25 76 31 
8 0 13 22 28 11 2 18 20 0 4 0 15 0 16 13 0 13 0 14 0 0 0 7 0 2 26 0 2 0 79 0 0 0 34 7 11 0 2 13 0 2 
15 0 0 32 26 6 7 0 13 0 0 6 9 17 3 2 3 3 14 9 13 0 10 0 0 0 3 2 28 8 3 0 1 37 0 0 0 0 12 5 5 0 
1 10 0 0 32 3 0 0 0 13 10 0 22 22 0 14 0 12 0 6 14 0 13 0 0 18 0 0 0 14 7 0 0 29 20 22 0 0 0 0 0 0 
11 0 10 0 0 0 23 0 0 3 35 31 5 12 0 17 2 0 0 0 0 10 0 12 4 23 0 7 0 2 0 11 14 9 0 27 3 2 11 29 9 0 
0 13 84 2 5 0 0 4 2 0 11 32 0 0 15 19 0 0 25 0 0 8 0 13 0 5 15 0 0 20 25 0 6 31 6 8 0 27 0 37 0 3 
0 37 14 54 3 0 10 29 64 1 0 4 5 0 7 26 29 27 0 0 0 0 11 0 1 10 7 28 0 2 13 0 9 41 10 34 0 0 28 17 6 35 
0 0 0 3 4 0 0 4 10 14 3 3 18 0 15 0 0 1 0 8 25 2 7 0 6 0 0 7 0 5 4 19 3 15 0 5 0 13 2 2 0 8 
21 0 0 38 0 0 0 27 2 3 29 28 0 0 6 20 18 23 18 0 21 0 0 16 4 15 0 10 11 0 3 0 16 9 36 22 33 0 0 45 0 74 
9 20 15 27 0 0 0 4 5 0 0 4 0 0 39 1 7 7 4 0 4 22 1 18 0 0 5 4 11 0 0 0 15 13 0 0 0 34 0 23 0 0 
0 24 23 21 5 0 6 39 0 0 4 17 34 8 0 0 0 0 0 0 0 4 3 0 11 13 10 2 0 26 40 0 0 23 1 23 9 0 9 0 0 29 
14 8 23 0 14 4 0 7 11 3 0 0 36 12 0 5 0 0 0 9 6 0 12 0 17 24 23 0 16 14 0 0 13 0 12 0 1 0 0 0 28 0 
4 9 14 0 12 0 2 15 10 11 0 0 13 4 15 0 15 4 0 0 7 14 20 0 0 0 26 10 4 13 8 0 32 4 4 0 0 1 0 27 6 0 
39 15 0 26 7 26 10 17 5 7 56 26 0 8 48 7 36 10 0 9 0 0 3 22 17 20 3 8 14 21 26 0 22 8 25 8 22 33 28 13 6 0 
0 21 0 0 29 3 0 0 7 0 4 21 3 8 16 0 0 13 18 0 0 0 40 18 0 18 6 0 0 9 22 0 6 12 0 0 0 0 12 30 0 30 
0 40 0 0 8 0 24 0 41 1 5 17 33 12 1 23 22 11 13 0 34 13 0 25 17 3 0 9 8 15 10 15 22 0 0 6 4 13 0 0 0 18 
