42 24
11 0 0 0 0 5 5 0 10 16 0 15 20 0 41 0 0 0 15 20 0 0 0 9 11 16 0 0 13 10 0 0 3 47 6 7 22 0 0 10 0 6 
0 15 0 0 0 0 0 21 0 5 0 0 0 2 0 23 24 0 3 0 19 18 25 0 0 1 0 0 15 4 2 5 5 0 0 8 6 13 8 30 36 0 
28 1 13 0 33 21 0 0 8 6 0 24 7 0 13 34 9 3 0 0 16 6 7 12 17 20 0 46 10 2 0 0 6 0 28 7 0 2 0 0 0 4 
8 0 2 10 11 0 0 0 0 0 10 1 0 28 0 0 25 11 4 0 9 0 2 12 17 0 6 0 22 0 0 5 0 0 0 0 13 4 14 6 0 25 
14 17 0 27 0 3 31 5 18 0 24 7 10 13 0 7 0 24 22 11 15 2 8 0 0 10 10 8 0 6 38 10 0 22 16 11 11 31 0 0 25 24 
0 0 0 0 7 0 0 0 0 0 0 0 0 0 11 0 0 20 7 0 0 0 30 0 7 2 10 3 12 0 13 0 0 9 0 0 14 0 16 0 16 0 
29 39 7 0 0 23 28 0 0 40 0 5 28 0 0 0 6 32 18 0 3 20 0 7 7 1 0 10 0 17 0 5 27 0 53 0 0 0 21 1 45 26 
0 15 9 46 10 0 12 0 0 6 0 0 20 16 3 13 1 22 2 4 6 0 0 13 4 13 0 5 28 26 0 0 20 5 0 4 0 17 28 10 25 0 
0 61 3 0 0 2 0 0 3 0 0 0 10 1 34 29 2 1 6 8 0 0 14 16 0 6 0 0 7 4 0 0 33 1 0 3 3 26 0 0 0 0 
5 26 0 0 0 0 30 21 0 0 30 19 24 7 27 9 7 0 6 22 13 0 4 0 3 4 0 32 31 0 8 0 9 3 0 0 30 17 14 6 26 18 
0 3 13 0 25 31 0 0 7 8 24 3 8 14 3 23 0 0 0 0 8 12 0 0 0 12 5 19 1 15 0 8 0 2 60 2 0 2 23 5 0 0 
29 1 15 8 4 0 28 0 18 0 0 0 4 5 26 0 36 6 5 5 22 22 0 0 2 25 17 19 0 28 1 5 7 0 9 41 14 0 0 19 26 0 
9 36 115 25 6 12 5 0 30 0 0 0 0 28 0 10 8 10 25 0 0 19 9 0 2 22 0 0 3 0 0 13 36 0 0 22 0 35 30 0 45 0 
2 9 0 0 0 46 0 0 27 0 0 26 18 0 6 8 0 6 12 0 0 0 7 0 5 0 0 10 0 12 20 0 5 3 0 18 0 0 33 12 5 0 
25 12 7 0 0 0 3 8 12 20 0 5 30 2 7 0 0 0 0 0 7 0 9 5 1 23 3 18 2 0 4 2 6 15 26 0 0 25 0 0 0 0 
0 34 13 0 2 19 0 17 0 0 0 0 0 4 0 0 18 1 25 2 0 0 0 7 52 3 17 13 0 0 0 4 2 1 3 16 11 0 0 9 43 23 
12 59 0 35 13 0 17 0 48 29 0 0 7 0 33 21 17 9 0 0 0 20 19 2 0 0 0 9 0 13 29 0 0 19 0 0 9 0 20 0 18 33 
0 0 0 0 25 37 34 0 13 2 0 10 0 0 0 19 0 4 2 0 10 17 0 18 19 3 0 15 0 20 8 20 0 1 6 0 32 0 4 0 34 0 
42 12 0 0 0 0 14 25 13 29 0 0 0 7 4 9 0 0 0 13 0 2 11 0 3 0 0 0 2 29 17 10 6 38 0 3 7 16 3 0 11 0 
15 0 4 8 27 0 38 1 0 0 0 0 58 0 6 10 8 0 25 0 0 0 0 0 0 0 1 13 5 0 0 17 14 26 1 16 14 31 0 10 1 0 
0 23 0 29 21 9 0 4 10 10 0 13 3 27 0 0 15 3 6 0 27 36 5 0 34 1 5 14 25 12 21 26 7 0 0 5 32 2 17 0 34 0 
0 47 40 0 2 27 25 5 0 29 36 0 19 8 0 8 4 2 0 0 6 18 12 0 3 13 0 0 18 0 0 5 30 21 24 14 8 0 30 6 0 6 
0 15 0 0 0 0 0 23 0 0 11 0 2 18 4 0 0 0 0 21 21 0 29 13 0 10 0 0 11 16 11 18 22 10 0 4 8 2 0 0 27 13 
0 0 13 0 3 0 0 6 0 40 0 0 31 16 15 2 4 16 0 0 0 0 15 10 0 0 0 3 36 0 10 0 0 8 7 0 24 0 0 0 0 25 
