42 24
4 0 3 34 20 0 0 2 33 6 0 0 0 5 9 6 21 0 24 0 0 0 15 4 0 3 2 0 10 0 0 0 24 0 0 6 0 34 9 0 0 15 
8 23 0 2 11 0 0 5 18 0 0 11 22 0 0 0 4 0 0 0 17 0 0 1 15 7 4 0 21 0 0 11 0 0 0 0 0 11 0 0 0 10 
0 19 0 7 0 0 15 1 2 32 8 8 28 0 10 0 22 13 14 0 11 15 19 9 23 0 9 0 2 0 23 0 58 0 16 0 0 5 24 0 52 0 
31 42 11 3 8 0 9 0 0 0 14 27 3 16 13 2 12 5 16 17 16 0 5 0 14 5 0 0 35 46 0 78 0 0 0 0 0 0 52 0 0 10 
25 22 0 0 33 18 24 7 31 25 5 15 27 32 5 9 0 7 0 24 0 0 10 19 0 26 15 1 0 16 23 4 21 0 25 3 37 75 2 71 11 4 
0 0 0 0 6 0 0 39 4 14 26 12 24 0 0 13 0 2 0 0 18 0 15 14 0 13 10 11 9 0 0 0 7 5 0 0 2 0 19 6 0 2 
23 0 8 3 14 0 0 7 0 3 50 8 0 0 0 0 0 11 0 19 11 0 12 0 4 0 1 0 0 0 4 0 22 0 16 41 0 0 16 0 8 0 
13 0 0 0 0 0 13 14 25 29 11 4 40 10 0 0 0 26 3 2 6 11 15 0 0 0 22 0 1 0 0 18 0 25 6 0 19 0 34 0 26 22 
0 28 0 10 26 0 0 2 0 4 0 24 18 39 25 24 0 10 0 3 8 5 18 10 7 2 3 9 31 34 2 1 1 0 0 23 5 0 25 29 17 8 
32 20 0 0 37 7 13 0 1 4 2 0 28 12 24 0 15 4 21 7 0 16 14 5 39 66 5 0 13 3 8 33 7 3 7 1 0 0 13 49 2 21 
0 15 4 0 28 0 0 26 9 0 9 3 3 15 6 5 22 0 8 8 1 0 0 13 0 1 8 0 15 11 2 0 23 26 2 0 9 0 0 23 0 0 
28 26 0 7 23 19 0 23 34 12 5 0 0 9 0 0 6 6 0 6 1 46 9 0 29 0 9 49 31 0 23 23 0 0 0 0 32 16 6 18 0 3 
8 29 11 0 0 8 5 0 8 0 8 31 22 46 8 19 10 15 11 10 0 3 9 14 9 0 2 10 5 18 10 11 7 17 27 15 12 10 5 2 0 25 
6 37 0 30 32 6 0 1 0 32 16 4 1 0 13 20 15 10 0 3 28 30 0 1 8 0 9 10 0 3 0 0 13 14 0 0 31 0 44 0 1 11 
0 2 24 0 3 10 0 15 0 17 0 31 1 13 23 0 0 0 0 37 7 0 11 5 5 0 2 2 1 0 6 13 5 0 0 16 7 33 27 0 28 0 
4 0 0 18 6 0 10 28 0 0 0 6 1 0 0 24 8 0 15 2 5 21 0 0 10 0 0 5 0 0 0 0 0 3 32 6 15 0 0 19 0 0 
6 0 0 15 0 0 4 0 13 3 0 0 10 0 6 0 0 0 0 7 0 15 18 18 0 0 0 0 5 8 1 0 6 3 4 0 11 0 6 0 18 7 
0 0 5 6 4 0 0 1 0 0 46 8 1 8 0 0 6 10 0 0 35 12 0 0 12 13 0 2 33 0 1 8 20 11 24 0 11 0 28 0 0 0 
15 14 0 0 0 4 2 0 4 0 0 4 5 0 0 14 0 1 0 12 0 24 6 2 0 11 0 0 8 0 1 0 0 0 16 0 14 0 0 20 0 0 
12 7 37 34 0 5 18 21 11 30 2 0 4 11 0 0 8 10 0 0 3 0 15 0 36 18 12 17 0 7 0 0 10 0 0 0 23 35 0 52 15 2 
0 22 0 0 14 0 25 7 13 16 0 5 0 0 23 1 5 0 0 11 9 25 0 14 0 16 0 3 13 0 6 13 26 0 0 8 0 24 0 0 0 13 
22 10 0 0 4 0 12 0 33 0 20 0 0 15 0 10 10 16 0 0 0 0 3 11 23 11 0 26 17 11 20 0 0 0 0 0 11 0 0 0 0 43 
0 33 35 0 30 13 0 28 5 0 16 3 5 24 14 21 0 0 0 0 4 17 8 0 20 7 0 7 0 4 0 0 7 4 72 48 0 14 43 0 26 9 
0 0 0 6 0 0 14 22 1 0 4 0 31 0 11 0 12 0 0 5 8 0 0 9 13 0 4 0 6 22 4 20 10 9 0 16 0 0 0 0 21 0 
