42 24
0 0 19 0 30 26 0 0 4 11 0 0 7 15 0 7 4 0 22 4 11 23 18 20 14 17 2 0 10 10 12 26 13 20 8 3 0 14 32 0 28 19 
0 12 30 31 28 44 13 0 23 4 23 0 16 8 0 14 18 15 0 0 13 0 14 13 23 17 27 0 11 0 11 43 0 28 41 0 0 0 0 11 6 68 
53 27 0 6 0 0 0 49 0 12 25 15 19 14 0 0 1 30 0 10 38 0 18 15 15 0 19 6 1 12 10 24 5 5 2 13 29 2 14 0 7 13 
5 0 20 0 0 0 0 0 15 32 0 0 2 22 25 13 15 0 7 0 0 0 42 0 0 24 5 0 13 0 0 18 0 0 17 4 0 0 12 16 0 4 
0 17 17 0 21 12 0 0 23 4 0 0 0 13 0 11 0 5 17 17 0 5 0 21 0 29 4 10 5 0 0 0 24 5 0 1 34 23 8 2 0 0 
0 39 37 32 0 18 9 21 29 26 12 0 4 1 5 9 36 5 31 0 0 0 12 9 0 22 0 4 0 16 10 0 0 0 28 32 0 0 20 9 2 25 
21 0 9 0 0 0 0 0 0 25 0 15 0 0 12 15 10 35 1 0 9 10 0 31 0 0 3 6 0 0 15 5 21 10 29 0 12 20 8 15 0 0 
0 5 0 25 4 0 12 2 31 48 0 0 5 26 2 7 24 0 24 0 1 1 0 0 0 13 1 0 26 4 5 23 0 5 0 19 4 0 13 56 46 2 
0 0 0 11 0 16 0 3 32 25 5 6 0 10 0 12 0 6 15 2 22 18 0 10 0 29 1 10 8 10 3 6 0 8 33 0 0 27 0 3 40 33 
14 0 22 0 17 5 0 2 0 9 5 0 2 8 0 0 0 23 23 0 0 27 13 0 0 21 26 0 7 6 0 8 0 0 0 7 0 0 0 0 1 23 
0 0 39 2 9 0 0 0 9 37 0 0 0 0 0 40 3 6 0 15 4 10 0 27 13 0 0 0 0 0 0 8 0 23 8 0 21 2 0 0 9 56 
8 7 20 0 31 14 37 1 6 10 0 12 3 12 0 0 0 0 4 0 11 0 5 30 10 3 10 12 1 0 26 12 23 1 0 0 9 7 8 0 3 28 
35 40 36 4 7 7 0 16 0 8 0 0 2 15 14 0 17 8 0 12 0 21 0 8 0 0 7 6 31 8 12 23 0 3 0 0 0 0 28 0 0 46 
0 44 21 0 0 4 0 5 2 0 16 26 4 4 0 26 18 28 13 0 0 1 7 17 14 0 4 0 26 6 0 7 9 29 23 0 0 32 13 0 9 16 
0 0 0 1 15 3 17 18 50 0 0 17 0 11 0 0 1 20 16 8 15 7 0 51 11 25 13 0 5 0 0 3 0 0 0 0 0 23 2 26 7 6 
0 13 14 2 0 13 0 20 7 3 0 0 0 13 0 8 11 0 0 11 43 0 1 3 0 0 6 20 1 16 0 0 22 14 0 9 0 22 4 0 0 13 
0 14 6 35 1 0 0 0 13 16 1 0 0 7 0 13 14 8 20 10 9 12 6 0 0 0 0 0 7 17 0 21 58 0 21 33 9 0 64 0 0 39 
16 1 0 5 28 12 12 0 0 52 0 0 2 13 0 0 2 8 0 0 0 0 13 3 3 16 4 0 0 0 0 15 31 32 0 0 0 33 0 16 0 0 
0 0 39 29 0 27 5 0 5 3 0 8 16 4 24 0 8 3 0 3 2 0 3 0 0 0 0 0 0 12 0 8 61 6 0 0 12 13 27 8 0 23 
17 12 7 26 9 10 35 0 4 0 1 0 2 0 1 26 23 0 0 0 12 17 17 15 0 0 7 10 5 26 28 0 12 28 0 0 31 22 32 16 0 28 
21 29 0 0 35 32 13 0 8 16 4 25 19 15 5 0 14 0 6 13 18 11 18 19 1 11 27 1 4 8 39 6 0 0 17 13 2 9 23 52 0 0 
12 0 15 19 0 0 10 0 0 0 0 3 5 0 0 17 0 0 29 0 8 11 19 0 0 12 25 5 0 16 25 13 6 0 0 5 0 4 0 17 0 4 
36 0 24 0 0 2 21 20 0 0 19 0 0 19 0 0 13 0 15 19 17 0 0 0 0 13 24 0 0 11 0 0 0 9 5 0 16 17 31 0 9 8 
12 0 0 0 0 3 0 0 5 13 3 0 12 0 0 0 10 5 4 0 15 14 4 0 13 16 22 27 0 0 9 0 5 0 0 0 0 8 13 39 15 38 
