42 24
27 0 17 0 0 37 11 0 0 0 2 49 0 0 0 5 25 14 1 20 4 3 23 1 4 2 0 35 23 14 36 1 0 0 26 32 25 0 0 22 0 11 
53 4 12 0 0 3 10 5 19 19 13 27 0 13 9 0 24 9 11 0 6 19 8 0 17 23 13 18 62 18 12 35 5 0 0 7 0 9 20 14 1 50 
0 20 6 27 7 24 0 0 18 11 0 30 32 0 0 14 7 13 2 0 12 26 6 6 21 12 7 22 0 6 29 27 32 0 0 0 0 4 0 0 0 2 
27 0 0 0 0 3 24 0 0 0 52 0 31 5 0 0 6 0 6 3 10 3 0 0 0 0 13 16 16 0 24 0 5 3 0 12 35 25 0 0 12 6 
0 6 15 28 0 24 6 6 24 0 0 13 9 0 3 0 12 0 0 2 0 9 10 25 8 0 0 0 29 0 0 0 16 1 16 5 0 0 1 7 7 0 
0 15 0 0 0 2 0 25 0 15 0 12 0 14 23 0 0 5 1 1 0 0 4 0 3 11 0 0 0 0 0 5 22 0 20 0 5 0 0 0 14 1 
0 0 40 39 0 0 24 0 0 7 1 4 0 0 28 11 10 15 12 4 0 29 11 29 21 0 11 0 0 12 4 5 8 31 18 29 2 14 0 0 44 10 
5 0 0 0 0 2 0 16 0 2 10 0 3 0 7 18 11 15 0 3 4 0 14 0 0 18 0 17 0 0 10 0 15 18 0 0 0 0 0 19 0 33 
0 1 30 26 17 21 0 0 26 12 0 3 26 10 11 12 7 11 19 0 12 11 18 1 13 4 41 0 11 27 26 7 0 0 0 41 0 6 43 2 9 17 
0 8 7 0 71 0 0 0 0 6 0 0 2 5 4 34 0 13 5 0 0 0 4 8 0 16 3 0 0 0 4 9 0 0 4 0 0 0 0 0 25 43 
3 34 7 2 8 14 0 5 0 15 0 4 12 4 20 0 0 0 0 19 0 12 11 18 0 3 9 0 36 15 11 0 0 4 1 66 40 0 29 8 2 22 
54 0 8 6 19 54 4 27 27 35 8 0 0 19 0 0 0 9 2 0 9 39 0 4 0 17 1 14 7 1 0 31 6 8 16 0 0 0 49 4 35 12 
0 30 13 8 0 11 0 29 12 2 0 0 0 0 15 13 0 0 8 0 7 0 6 4 4 5 3 5 14 21 20 22 32 3 25 5 25 5 10 4 0 11 
0 0 3 6 0 2 2 0 17 0 13 0 3 0 0 0 13 13 3 4 12 26 3 0 0 17 0 6 0 0 0 6 0 0 0 0 15 0 0 2 37 2 
0 40 0 24 0 10 8 0 0 0 13 4 0 12 9 10 1 14 8 0 13 0 9 9 17 17 4 13 8 0 0 15 0 4 0 0 5 24 0 0 4 78 
5 30 37 13 0 0 30 0 0 0 1 0 0 0 6 0 8 13 0 35 0 5 1 23 2 14 30 0 6 0 14 26 13 30 10 4 2 0 17 23 12 22 
0 22 29 14 23 0 0 5 0 0 10 5 11 2 0 33 5 14 1 0 3 0 4 22 0 0 0 23 0 11 2 2 0 0 32 13 14 0 5 3 4 0 
36 0 23 0 0 0 2 0 0 0 0 0 24 0 0 0 0 4 5 0 0 13 6 0 8 24 0 0 0 0 5 19 0 12 10 0 36 0 4 0 0 0 
7 10 8 0 4 9 3 0 0 0 8 28 0 12 0 0 11 0 0 18 0 21 4 4 0 6 0 21 0 0 0 17 0 0 0 0 10 16 0 10 4 3 
0 40 9 0 0 3 0 0 24 0 0 16 0 14 1 1 0 1 35 0 4 11 1 5 0 3 9 38 17 24 0 9 0 25 3 0 0 8 0 0 14 105 
5 40 25 12 0 35 0 3 15 37 10 0 18 10 13 0 0 4 8 1 2 0 0 10 14 0 25 1 0 1 0 26 0 0 32 11 0 0 10 2 0 1 
0 31 0 0 12 21 0 1 0 0 0 0 29 0 10 0 0 29 0 8 0 0 3 15 0 0 0 27 3 10 1 1 31 0 21 0 0 0 6 0 0 4 
33 0 37 0 23 3 0 21 3 0 25 18 13 0 0 9 22 1 22 0 9 0 4 0 3 0 0 23 12 0 6 0 0 0 0 25 24 25 0 50 22 0 
23 14 11 0 12 0 5 22 4 2 0 4 0 11 0 14 8 0 7 0 25 12 15 6 14 0 0 23 0 0 11 9 0 20 23 23 20 1 11 12 38 4 
