42 24
4 0 0 8 0 5 10 4 22 5 11 0 0 5 20 7 4 7 1 17 4 0 7 0 0 0 18 14 0 5 0 0 0 0 6 3 27 0 38 21 0 14 
0 20 14 12 0 20 0 21 25 33 0 0 0 0 21 21 0 0 0 0 0 25 0 27 3 20 1 17 24 0 1 4 0 31 0 21 0 7 8 0 30 11 
17 13 1 20 7 22 0 0 33 4 0 33 2 0 19 0 0 0 4 0 0 5 0 16 29 13 0 4 0 8 8 0 0 0 12 1 7 0 3 4 2 33 
1 14 1 3 18 3 2 12 5 10 0 0 6 0 19 4 0 8 11 1 14 2 11 5 1 0 0 0 31 0 1 3 0 0 30 3 0 0 0 0 21 13 
47 0 0 19 0 7 0 53 3 0 5 42 2 0 16 4 0 5 31 22 0 0 0 1 5 0 9 0 0 0 14 14 14 0 11 19 0 26 38 0 2 15 
31 0 25 8 10 9 0 0 18 8 0 6 3 0 4 17 18 6 21 0 0 16 0 0 0 7 18 29 0 5 5 31 16 0 8 5 0 3 17 0 12 7 
42 34 28 31 11 31 17 11 0 7 35 28 35 10 18 29 9 17 12 4 13 18 5 12 10 25 0 10 0 0 40 21 23 15 6 17 3 7 53 15 0 20 
15 0 14 12 6 0 16 0 13 2 0 2 8 0 0 0 38 0 31 19 26 3 0 17 20 4 0 11 0 24 0 6 0 2 15 11 4 0 18 35 0 6 
12 7 0 1 5 0 9 17 11 17 0 11 0 9 13 34 3 23 0 8 0 23 39 22 24 0 8 8 0 1 0 7 11 0 0 0 0 0 0 7 0 12 
1 1 13 22 0 7 26 4 0 4 0 25 0 13 48 2 0 7 0 0 0 0 9 4 14 8 9 4 0 0 0 0 0 0 13 9 0 12 0 25 29 0 
27 0 0 0 27 27 0 17 0 0 0 18 3 0 0 0 6 24 0 15 13 0 15 11 0 0 1 17 15 20 4 20 0 13 17 15 10 3 0 0 6 34 
25 0 22 34 13 21 0 0 0 28 10 0 5 8 15 3 33 25 4 16 34 12 5 4 22 7 21 23 12 0 5 2 0 5 1 16 33 112 3 25 0 18 
2 0 1 0 14 0 0 6 19 0 47 0 7 10 12 14 0 0 14 0 0 11 0 0 0 6 18 12 2 14 0 6 0 0 0 0 0 29 0 0 11 31 
9 2 5 0 0 3 18 5 9 0 0 0 3 9 0 0 0 0 23 0 7 11 0 9 18 0 3 0 0 0 0 0 0 0 0 6 0 0 0 8 0 23 
2 27 0 28 0 0 1 32 50 0 4 0 21 0 4 10 0 2 3 13 0 0 0 18 4 0 18 0 18 8 18 35 0 0 15 0 0 14 0 31 0 0 
0 49 14 10 10 10 0 9 0 0 7 0 0 0 0 0 0 0 0 0 0 13 0 11 0 13 0 0 0 0 4 0 0 0 18 0 35 3 0 8 1 0 
0 6 0 31 0 12 0 6 0 0 6 0 0 4 2 4 25 5 13 0 0 13 2 16 0 25 0 4 21 0 22 13 0 17 64 0 0 0 17 21 0 0 
39 0 5 19 25 0 8 16 0 5 0 0 21 9 20 0 0 0 0 17 0 0 19 10 20 0 7 8 0 25 9 0 0 28 0 8 3 0 0 26 0 0 
16 0 6 14 25 0 2 0 33 15 0 0 0 0 9 13 0 6 12 36 8 18 1 24 0 0 0 0 18 0 7 42 0 3 0 32 3 3 0 18 10 50 
0 3 0 34 0 21 29 23 0 2 13 0 5 11 7 0 8 1 14 19 0 18 0 0 11 18 3 15 0 0 0 4 0 12 0 25 0 0 11 0 37 0 
14 0 49 0 0 21 0 4 15 7 27 0 3 0 0 10 37 0 0 0 0 1 0 21 0 17 22 0 26 2 14 0 3 2 0 29 27 27 0 21 32 2 
0 13 31 34 9 9 35 41 0 26 0 15 0 17 13 1 12 0 21 0 27 1 0 9 13 34 0 21 0 22 10 7 7 50 0 15 26 20 0 51 0 35 
38 0 15 20 2 5 32 0 25 11 33 5 0 42 5 0 10 22 9 6 0 17 13 21 0 15 0 14 0 10 6 0 0 27 7 13 0 0 38 22 8 32 
0 0 36 19 0 17 0 0 20 3 0 0 0 0 21 15 18 15 0 0 0 0 34 15 17 14 0 0 0 0 2 0 18 4 16 18 0 0 20 0 18 0 
