44 25
17 20 0 0 3 0 0 0 0 0 0 8 7 0 3 0 0 0 0 5 0 4 8 0 0 6 16 38 0 0 26 13 15 0 5 0 0 18 7 0 0 7 31 12 
24 0 0 0 20 10 29 0 0 0 0 18 1 0 0 0 0 0 0 7 1 0 0 11 44 13 0 0 0 19 0 0 1 1 5 29 0 6 9 0 0 20 17 6 
0 44 0 0 23 0 0 17 0 34 33 40 45 0 0 18 0 1 1 0 0 0 15 19 0 2 0 2 27 0 23 0 3 0 24 10 67 4 0 47 0 0 18 3 
14 0 8 27 1 0 15 30 28 0 35 28 2 4 3 0 18 14 34 1 5 32 20 18 15 5 10 0 0 3 3 0 1 6 13 0 28 3 1 3 0 1 39 3 
34 0 16 0 0 30 36 3 0 2 16 0 0 0 0 2 5 14 3 16 1 24 3 0 0 28 11 0 6 0 0 16 0 0 53 0 0 0 12 0 0 1 22 0 
40 31 24 0 23 0 11 0 0 0 32 0 17 0 22 0 0 15 44 7 2 20 0 15 47 0 0 23 0 0 11 4 0 35 21 0 18 0 14 0 4 0 60 22 
4 0 57 11 7 29 0 2 26 5 0 19 15 7 0 14 0 4 0 0 12 12 6 16 0 22 15 0 3 3 31 22 3 8 54 1 31 4 0 13 2 14 0 0 
7 0 20 13 0 2 0 2 0 34 40 28 0 19 8 0 26 26 8 0 0 0 0 0 24 35 0 0 4 0 0 57 24 0 4 0 0 11 10 32 0 0 58 16 
26 2 0 5 0 0 0 0 10 0 0 13 0 22 25 0 1 8 3 0 3 0 15 0 0 35 33 0 6 0 6 0 0 7 21 22 2 15 2 7 43 0 0 18 
0 42 0 2 29 0 0 4 0 0 7 8 0 0 0 0 6 7 17 0 0 3 13 0 0 0 25 0 0 0 0 4 0 7 0 0 1 1 0 0 10 0 0 9 
2 8 3 0 0 11 0 13 6 14 0 0 3 7 7 0 0 0 0 0 13 0 0 14 0 0 5 9 0 8 13 0 8 0 7 0 2 8 2 0 0 11 0 0 
13 0 8 4 0 55 0 30 35 9 4 0 6 25 9 0 0 0 15 5 5 29 0 0 3 4 0 0 0 1 17 0 8 28 4 28 0 8 0 0 2 0 37 57 
7 33 13 0 0 1 0 0 30 0 31 0 26 0 0 0 0 0 39 0 0 0 14 24 0 5 0 0 0 0 0 0 7 5 33 2 10 14 3 21 0 26 0 5 
8 48 18 0 7 0 6 35 8 0 11 6 0 2 9 0 0 0 0 8 20 2 11 22 0 0 30 0 7 0 0 0 22 8 7 17 0 0 12 44 14 5 43 8 
51 3 30 34 53 16 0 9 15 12 6 27 18 23 12 16 5 20 0 8 17 13 0 15 9 0 12 0 0 0 15 26 0 0 9 2 23 54 36 12 0 37 0 0 
6 0 0 0 12 0 0 9 9 0 0 0 0 4 0 0 12 0 10 0 0 16 8 0 24 4 5 0 1 7 0 0 15 30 0 0 0 16 0 7 0 0 0 0 
0 8 10 14 0 27 0 0 6 33 0 16 0 0 9 0 23 8 0 0 0 13 0 4 0 12 12 18 13 5 0 0 3 0 8 12 0 0 12 0 0 0 40 0 
59 20 22 0 0 5 12 6 8 0 0 3 41 6 13 19 5 1 24 0 22 13 0 1 29 0 0 38 0 0 9 0 0 5 12 19 0 0 0 0 0 0 10 8 
0 8 23 5 0 6 17 12 5 7 0 28 1 0 0 0 9 1 11 3 0 19 0 0 0 0 3 0 0 28 0 3 15 1 2 26 27 5 0 0 0 0 3 0 
0 0 39 2 0 0 6 13 0 2 0 28 0 0 0 0 0 0 0 18 14 0 0 0 0 43 12 0 0 0 0 0 8 26 14 0 0 26 25 6 0 23 0 14 
0 20 13 20 0 13 44 0 14 16 17 3 10 7 0 37 14 4 23 0 7 27 0 21 0 26 2 0 12 8 7 4 0 9 0 0 11 0 9 0 0 35 10 28 
6 1 8 15 4 15 0 1 27 16 23 0 6 0 21 0 8 0 0 7 3 15 0 0 1 19 8 0 14 33 0 17 1 21 4 58 40 0 0 0 12 27 9 14 
2 0 13 0 25 0 0 3 0 0 7 0 0 0 0 0 0 0 17 17 10 0 13 6 7 28 7 6 0 6 3 0 0 10 0 0 0 0 13 0 0 0 0 39 
22 19 27 0 4 0 12 9 0 0 0 38 0 34 0 0 0 0 10 0 7 0 43 0 12 0 0 0 0 0 13 19 42 0 2 10 0 26 0 20 15 0 0 9 
52 0 0 0 4 3 6 19 7 0 11 0 12 0 0 0 17 0 2 19 3 0 0 19 7 0 30 0 0 0 0 0 0 0 0 0 0 0 14 0 24 0 0 5 
