44 25
0 1 6 0 13 0 0 10 0 19 0 3 0 24 15 0 19 10 8 0 0 3 0 0 3 8 19 12 18 23 8 6 0 8 0 0 0 11 0 21 0 0 15 0 
6 10 0 46 11 27 5 0 0 19 0 12 0 0 0 0 15 0 1 0 0 15 10 0 15 23 0 18 0 11 26 22 1 0 0 3 33 23 0 30 0 37 0 0 
0 9 13 0 20 0 14 0 4 0 8 0 0 24 0 22 5 14 21 0 3 0 0 0 16 0 19 0 0 1 0 2 1 0 33 11 0 41 8 0 0 0 0 42 
0 0 0 0 16 0 15 0 8 32 0 19 27 33 16 0 0 5 0 8 15 3 0 0 20 0 18 0 0 1 19 19 0 21 8 5 33 12 19 0 0 0 0 21 
0 20 19 10 4 2 0 27 7 6 3 0 14 12 4 8 13 0 9 7 0 6 0 0 19 4 0 5 0 0 15 0 0 13 54 0 22 0 0 0 18 8 33 0 
0 30 4 0 15 3 15 1 0 0 15 51 16 29 7 0 3 7 1 14 0 0 0 0 12 0 3 4 0 3 0 37 0 39 0 0 12 13 0 28 0 5 38 11 
0 0 1 0 0 0 24 0 4 0 11 1 0 0 29 13 18 0 0 0 0 35 0 0 0 0 16 1 0 2 13 25 0 0 6 14 0 0 15 0 10 0 10 46 
36 34 0 31 0 0 4 0 0 8 15 39 12 12 0 0 0 0 9 0 0 0 0 10 0 0 6 9 0 0 0 0 23 0 31 34 0 8 0 17 0 30 42 0 
5 0 17 1 4 3 55 0 3 0 4 18 0 0 15 4 15 0 14 0 26 19 0 0 3 1 4 0 8 14 8 0 0 27 2 5 30 0 8 0 41 0 0 0 
2 0 2 0 0 0 0 3 1 19 44 0 0 0 0 19 0 0 0 0 0 0 0 0 0 0 6 0 0 20 0 0 0 0 19 0 0 0 0 0 0 31 0 6 
0 7 0 0 14 2 11 2 3 9 5 9 0 3 0 0 0 34 0 0 15 12 0 0 7 0 0 0 0 0 0 8 8 0 5 0 0 0 8 8 15 0 11 6 
0 10 0 0 12 29 0 0 8 4 0 37 9 3 0 0 0 18 22 7 5 3 0 0 3 1 5 3 17 0 30 0 0 19 31 0 0 28 14 2 22 13 0 15 
41 0 26 29 5 0 0 0 0 0 2 0 0 0 9 4 15 0 5 5 4 21 0 0 0 0 5 0 37 8 0 9 29 0 8 0 5 0 0 11 0 13 0 0 
5 0 0 0 23 0 2 0 0 5 0 6 0 23 16 2 0 9 0 0 0 16 16 0 0 10 0 0 2 0 17 0 11 0 3 11 0 14 0 0 0 0 0 10 
0 0 0 13 0 0 31 0 0 3 0 0 25 10 21 0 0 0 0 16 0 15 0 10 0 0 0 22 0 0 0 12 0 0 0 16 3 2 0 8 8 0 16 11 
23 0 30 9 0 0 0 0 0 41 3 0 40 0 0 0 0 0 16 23 4 7 0 25 4 0 10 10 7 0 0 0 13 7 16 0 7 22 0 17 28 0 15 6 
0 0 0 11 4 30 34 0 0 0 1 20 23 4 21 0 3 0 4 1 9 7 0 0 20 2 11 2 8 9 10 3 16 3 5 24 8 6 0 25 34 0 18 10 
33 20 3 0 4 0 13 11 0 3 0 8 0 0 0 7 20 23 16 8 6 20 5 28 20 9 6 0 0 9 0 11 28 46 9 0 14 0 0 0 0 6 0 0 
0 0 0 0 0 0 28 0 32 0 8 0 0 41 4 0 6 0 0 6 27 0 9 0 2 12 0 14 0 0 0 5 7 11 8 0 0 3 16 3 1 0 3 0 
0 0 12 0 37 0 17 0 34 24 29 11 0 7 13 7 23 0 0 0 4 3 18 10 3 0 0 0 0 6 0 0 1 26 0 15 25 0 0 16 16 32 0 16 
19 0 3 21 6 0 1 0 0 3 0 0 12 55 0 0 0 0 14 19 0 0 0 19 12 0 0 0 0 8 0 0 0 29 22 14 0 0 0 2 0 2 0 30 
16 0 7 1 8 25 29 13 39 32 10 6 26 2 0 4 51 9 0 0 4 28 0 11 17 3 4 0 28 21 30 7 30 13 82 30 0 5 18 0 14 13 8 44 
9 0 0 9 2 0 8 32 0 19 0 6 9 30 18 2 7 0 0 7 11 39 20 0 0 6 5 15 24 0 0 8 0 7 31 0 7 15 19 8 18 26 23 30 
0 31 20 0 12 0 0 27 13 20 34 8 8 0 15 0 31 5 0 0 13 0 0 6 19 1 4 9 0 6 0 25 12 0 10 0 0 0 22 8 0 0 0 0 
0 15 2 17 12 36 0 32 33 0 42 4 0 24 11 17 9 2 3 0 17 17 21 18 1 24 10 6 0 0 13 0 0 21 6 0 34 4 22 54 7 8 32 0 
