44 25
0 3 39 53 3 0 13 15 12 0 12 0 0 0 0 0 0 0 0 0 3 0 5 4 0 0 12 7 5 1 0 22 0 10 4 0 0 14 15 0 37 20 20 0 
9 0 42 24 12 17 0 26 21 0 11 31 31 9 0 0 0 5 17 0 12 0 17 20 0 10 35 5 0 1 0 0 12 10 32 8 7 9 36 0 0 10 31 8 
33 0 0 0 3 0 30 31 0 0 12 18 0 8 10 14 27 13 0 0 0 0 31 0 26 12 36 0 0 26 0 0 0 33 0 0 0 31 4 28 0 19 0 15 
73 0 3 20 0 0 0 4 15 29 0 0 8 11 1 17 0 4 19 0 10 0 0 0 0 0 0 0 11 13 0 3 23 0 34 2 8 0 0 39 0 1 19 0 
0 0 0 0 11 24 0 0 0 0 17 14 0 0 17 0 0 0 0 0 18 0 17 0 25 29 2 0 10 4 1 10 0 0 0 14 16 22 4 11 0 0 1 0 
11 0 3 0 18 28 0 0 23 0 0 18 21 0 20 0 0 0 6 5 1 2 15 0 0 0 0 8 0 0 0 0 0 18 1 22 0 16 11 0 27 0 0 0 
0 16 0 61 2 0 4 5 0 0 17 0 0 3 0 0 14 5 0 6 27 5 0 4 1 0 17 7 0 10 3 0 12 1 19 15 33 0 2 18 0 0 12 17 
0 0 0 0 0 28 0 4 0 0 0 24 9 0 9 0 16 0 3 0 0 0 1 1 10 0 0 0 0 7 0 0 0 0 0 36 10 0 3 12 22 0 0 42 
16 0 28 11 12 0 1 0 0 0 0 0 4 15 15 16 5 0 1 0 0 0 0 0 0 0 0 0 14 12 34 0 0 0 3 0 0 0 0 0 0 12 8 0 
3 0 37 40 0 0 1 0 0 5 0 3 3 7 8 22 1 1 4 0 11 2 0 11 12 0 8 12 32 15 0 0 0 0 0 7 7 24 37 37 6 13 0 7 
1 0 0 20 0 0 23 0 8 0 3 55 6 5 8 5 0 23 0 0 9 0 16 20 9 0 0 8 0 1 25 25 0 19 0 4 10 0 27 6 16 7 0 0 
0 2 37 0 17 28 0 27 22 6 4 7 0 0 0 33 7 0 0 0 15 2 7 33 1 12 1 16 8 0 11 1 13 1 0 0 7 10 18 0 17 7 14 0 
2 0 0 0 3 5 0 33 4 0 13 0 0 0 3 4 5 9 19 0 9 0 0 0 7 0 1 9 0 0 0 11 0 4 0 5 0 19 1 37 0 3 0 0 
16 0 0 27 4 33 45 0 6 2 4 0 0 0 0 0 0 10 0 0 31 0 22 0 0 0 17 7 0 0 10 7 4 3 31 0 0 0 8 33 8 42 9 0 
0 28 39 0 29 0 36 31 12 20 0 0 0 14 0 22 2 15 2 10 8 0 13 3 14 9 22 0 0 38 0 0 8 38 12 4 3 18 13 26 3 39 36 10 
0 0 0 40 39 0 2 13 0 0 0 0 0 27 0 0 0 0 0 0 0 0 0 0 0 0 0 0 0 8 0 0 0 0 7 0 33 22 0 7 28 37 0 0 
0 0 0 16 0 22 0 30 0 4 0 3 19 4 0 0 0 0 5 0 0 21 16 6 5 0 3 22 0 18 0 1 0 9 11 0 18 34 0 0 27 16 22 0 
0 29 6 0 21 0 46 8 0 0 0 0 12 1 20 8 0 0 16 0 29 0 0 2 2 0 9 12 0 23 22 34 9 5 31 10 10 34 0 7 7 25 0 15 
28 7 0 0 52 0 0 0 32 0 0 0 9 9 0 0 0 0 0 0 0 8 0 22 2 21 5 0 23 0 0 0 0 5 2 0 0 2 0 0 2 37 7 1 
0 0 51 6 2 74 2 4 0 0 0 0 0 22 1 15 13 4 13 17 0 0 0 11 0 15 3 11 0 1 3 20 20 28 11 30 34 0 5 0 11 18 0 37 
0 0 0 17 0 2 11 19 18 40 0 4 21 0 9 17 7 19 13 1 0 2 0 13 1 0 0 9 8 0 33 3 0 22 9 6 1 2 14 6 3 5 19 2 
0 0 0 0 2 29 13 16 4 10 0 0 0 0 0 5 0 4 20 0 4 5 0 9 0 15 19 32 0 0 0 0 0 0 57 9 10 16 0 0 15 0 0 0 
0 0 0 17 47 1 9 0 14 18 22 30 0 9 21 22 0 0 50 11 13 0 21 0 0 16 17 2 0 20 0 22 6 0 22 23 18 18 11 7 36 56 24 5 
36 10 0 1 4 0 49 0 1 0 0 29 0 3 0 0 0 0 0 0 12 0 13 22 6 12 12 0 0 3 0 26 23 32 28 11 0 0 14 0 11 21 0 11 
16 0 17 0 0 0 0 26 36 31 8 3 19 0 0 0 0 0 8 17 20 0 0 0 13 0 0 0 0 0 0 0 0 26 0 0 28 0 0 17 44 0 0 7 
