44 25
20 0 12 72 0 0 6 0 11 0 0 0 6 18 0 0 12 23 0 11 27 0 0 2 0 21 12 0 0 26 0 18 11 0 24 0 0 22 7 0 11 0 39 0 
0 0 0 1 28 5 47 25 0 4 26 0 21 0 11 0 1 0 3 3 0 2 0 0 14 7 22 0 0 26 0 0 25 12 7 0 0 23 34 1 35 10 28 0 
14 19 0 38 24 22 8 0 39 2 0 24 4 5 32 0 0 9 4 11 13 0 0 28 0 0 12 22 5 25 0 0 0 7 0 18 33 0 0 16 37 0 19 35 
5 0 0 0 0 0 13 36 9 0 2 0 0 0 3 0 0 0 4 12 2 0 20 13 11 6 0 5 0 0 0 0 0 0 21 0 0 19 0 0 5 0 2 36 
6 75 18 14 0 0 28 31 4 19 0 15 2 13 0 8 0 0 6 27 7 14 21 18 13 16 0 7 0 0 10 20 9 10 7 0 0 3 27 15 5 24 0 0 
35 11 14 0 19 36 88 0 0 0 0 0 6 0 2 21 0 0 19 0 2 18 0 8 26 0 4 17 4 0 28 0 0 0 0 35 0 2 68 53 36 36 13 0 
23 0 0 42 0 0 7 0 0 0 8 0 35 26 18 3 0 19 4 2 1 0 0 41 18 0 3 3 0 3 0 0 4 10 12 0 0 0 16 20 37 0 0 33 
2 0 43 1 14 22 23 95 28 0 44 2 50 0 7 0 13 0 14 0 2 0 4 0 1 10 17 16 0 27 25 7 13 7 3 33 22 42 31 1 37 0 11 41 
37 0 0 0 0 0 9 0 29 28 14 17 0 3 14 18 3 0 22 0 0 5 0 0 0 0 6 4 16 9 3 0 5 28 0 8 13 33 0 0 17 0 0 20 
7 29 2 38 0 0 0 24 0 10 1 10 12 0 0 0 0 0 0 0 11 10 0 0 15 0 19 0 0 0 29 24 0 0 7 0 0 0 3 0 0 25 0 0 
35 0 7 26 0 2 14 5 2 0 0 0 0 63 6 2 14 26 13 5 8 0 0 0 0 11 0 0 0 0 1 0 4 0 0 28 0 0 0 36 3 24 0 42 
10 5 36 12 7 16 1 0 3 17 9 2 31 4 21 4 0 0 8 24 13 0 6 5 1 13 0 2 0 11 31 0 43 9 0 1 0 22 49 2 11 0 0 32 
13 0 11 0 0 0 15 2 11 0 11 0 8 4 0 1 1 9 1 12 0 0 0 0 0 0 4 0 0 0 0 0 8 8 0 0 0 0 3 12 0 50 40 0 
43 43 0 27 0 19 24 6 0 19 0 16 1 5 0 0 10 0 7 6 0 5 0 0 0 0 10 1 23 10 3 5 5 0 0 0 22 31 4 8 39 0 0 0 
9 0 35 10 10 0 0 31 10 7 0 0 0 3 26 0 7 0 0 0 0 0 0 0 2 14 0 8 0 0 0 23 11 0 0 0 5 47 31 0 26 4 0 2 
3 0 63 8 0 0 5 15 6 1 5 18 2 0 45 0 0 15 16 10 11 5 28 21 0 0 20 29 0 11 0 4 18 0 15 0 0 0 0 0 0 27 40 0 
21 11 4 0 2 1 30 3 0 3 0 0 27 0 0 0 0 4 0 18 0 0 0 0 24 18 0 0 0 0 0 0 0 0 0 13 0 22 0 27 0 0 1 18 
44 29 0 0 3 0 5 0 3 0 17 5 30 2 0 0 7 0 17 0 0 9 0 11 14 1 16 0 0 19 29 0 0 0 0 12 0 0 4 0 1 4 0 0 
10 12 0 16 3 0 10 0 0 0 54 11 0 1 0 13 5 0 0 0 0 19 9 0 7 3 15 13 0 2 17 15 22 10 0 22 0 6 0 0 1 9 42 0 
22 0 36 0 15 0 16 0 0 0 1 0 6 15 0 0 0 0 5 0 0 21 0 0 0 0 0 0 22 18 0 0 0 0 0 38 0 17 18 0 0 1 6 8 
0 0 0 16 0 0 47 4 22 0 8 1 4 0 18 0 37 0 0 4 0 5 25 0 0 2 0 0 0 0 8 3 31 0 0 0 4 1 0 16 4 0 5 0 
0 19 0 0 1 31 17 14 0 26 6 0 14 0 10 26 0 0 0 0 0 0 12 0 19 11 0 7 9 2 0 0 8 7 12 18 19 9 0 0 1 30 3 0 
10 0 12 0 26 51 17 0 0 33 36 12 11 2 0 25 17 0 2 0 0 0 19 12 0 7 21 18 5 0 0 3 0 45 0 6 0 3 35 4 25 0 33 8 
11 0 0 23 0 0 0 0 0 21 10 2 16 0 15 0 6 23 0 0 10 0 0 20 0 0 0 0 0 25 0 14 0 0 0 0 0 6 0 0 0 11 0 23 
18 41 2 36 49 21 39 26 10 11 48 22 30 9 6 11 8 0 16 11 0 21 29 0 78 17 9 0 7 8 0 20 20 11 30 8 5 23 14 7 0 30 19 14 
