44 25
17 0 4 15 24 0 0 8 26 5 0 16 0 0 16 0 0 19 0 5 6 0 18 0 0 12 6 19 0 2 6 5 0 13 26 0 1 14 5 6 6 0 0 0 
48 0 0 32 0 0 0 0 10 0 9 16 0 7 28 0 32 0 11 0 21 21 14 0 13 0 23 10 20 0 25 31 18 0 26 0 0 13 0 19 0 25 17 1 
25 0 0 23 0 6 0 13 0 17 17 6 2 0 0 9 5 0 0 20 0 0 15 7 0 54 6 0 0 0 0 0 10 0 0 0 0 0 22 14 0 0 0 7 
42 0 55 21 0 0 0 3 0 0 0 10 0 0 0 0 7 3 0 0 8 0 15 9 0 5 20 0 9 25 0 21 0 0 0 0 0 61 0 18 19 4 41 0 
0 84 10 24 0 1 11 12 0 3 17 5 0 42 12 20 22 0 0 0 0 0 21 0 0 0 10 2 0 0 17 5 0 0 2 11 0 0 12 0 38 9 39 9 
4 1 0 18 10 8 0 0 14 0 4 0 7 0 0 0 0 0 0 0 0 18 0 0 0 0 0 0 0 14 0 1 5 0 0 0 0 0 0 2 0 0 0 11 
4 44 0 30 7 0 0 35 31 22 27 1 52 0 0 0 16 12 22 19 0 10 9 0 23 5 0 15 0 0 4 8 0 15 9 10 9 2 14 127 3 0 41 3 
0 40 23 10 0 0 0 2 0 3 5 17 33 16 0 2 15 10 0 7 0 17 0 0 0 0 0 0 10 12 0 0 12 0 17 18 13 0 0 5 0 48 14 0 
19 2 0 19 46 0 0 14 0 17 3 13 11 11 15 0 7 23 7 18 13 14 17 16 0 3 20 0 3 5 0 0 0 2 0 0 13 0 0 3 23 7 0 39 
11 0 0 0 8 0 6 0 0 0 4 0 0 0 0 0 0 0 0 5 0 7 5 0 5 9 0 6 7 0 5 5 0 0 3 0 2 0 0 28 1 2 0 20 
0 9 3 5 12 8 0 0 0 21 16 0 0 0 0 1 0 13 0 14 0 0 0 14 0 9 5 0 0 0 24 19 20 7 0 0 0 0 4 20 2 0 1 12 
23 0 16 0 49 26 14 29 2 7 54 19 40 0 3 1 11 0 0 17 16 0 0 29 0 23 22 15 0 24 10 30 7 0 20 0 14 12 0 5 2 31 0 0 
0 7 9 0 0 2 0 0 0 3 5 10 0 4 0 25 10 1 0 0 0 2 8 0 0 12 0 7 9 0 0 14 10 0 0 5 6 0 0 0 18 1 20 0 
17 30 7 0 1 0 20 4 0 4 0 15 0 3 19 0 16 33 26 1 0 0 12 0 0 0 15 16 28 7 19 25 0 0 17 0 0 0 0 0 0 0 0 29 
5 7 3 10 0 39 0 19 23 1 0 0 6 0 0 0 14 11 0 0 0 2 0 11 0 6 0 6 0 6 14 1 32 11 0 1 4 9 0 0 4 0 0 0 
0 84 17 50 41 69 41 15 2 5 22 0 1 21 0 3 21 0 4 0 5 7 8 19 23 5 40 4 27 0 20 8 7 8 7 32 61 33 5 6 3 13 37 3 
38 0 14 16 7 0 15 2 8 3 1 3 0 9 0 6 14 9 27 15 0 25 0 18 7 0 23 0 0 0 17 0 0 0 0 7 13 0 38 0 0 17 62 0 
17 0 0 0 6 0 6 11 0 0 10 16 0 29 0 0 0 22 20 10 13 4 0 10 0 11 0 0 0 0 0 7 19 9 0 0 0 2 9 0 0 0 0 26 
22 3 0 19 23 0 13 1 10 0 0 0 0 2 0 13 0 11 5 13 0 7 52 0 0 0 1 9 17 22 1 16 7 1 0 0 5 0 16 0 13 5 0 0 
0 18 62 0 0 22 5 45 18 0 0 16 19 5 0 11 13 21 5 8 0 0 17 9 0 32 1 1 0 35 12 1 16 6 2 0 10 0 0 22 0 15 40 24 
0 0 0 0 5 41 14 0 0 5 21 0 0 0 0 1 0 0 0 4 18 0 20 0 1 1 0 9 4 1 4 3 0 22 12 0 21 6 0 0 35 0 0 0 
55 15 14 8 0 5 18 2 8 2 26 35 0 9 21 11 16 7 3 0 0 54 8 0 18 0 2 3 20 20 13 6 16 4 1 4 0 6 0 0 0 0 19 39 
14 0 3 0 0 0 0 4 0 0 2 0 0 0 0 0 18 0 11 20 0 0 0 0 0 0 0 17 0 0 0 9 0 0 8 0 0 0 0 14 28 0 0 13 
0 0 20 0 0 0 43 0 0 0 13 0 0 0 15 14 0 0 0 1 0 15 0 0 0 3 26 1 0 18 0 11 0 0 0 2 11 0 0 1 0 12 0 37 
41 6 0 23 0 0 0 0 0 26 0 0 0 0 0 16 20 11 0 21 0 0 9 0 1 1 0 0 4 12 4 1 1 1 0 9 8 47 1 1 0 53 0 15 
