44 25
0 16 0 0 0 6 0 0 0 34 6 10 6 17 0 0 17 7 0 4 0 0 6 10 0 2 0 17 6 0 0 0 0 27 0 0 22 0 0 20 0 20 25 34 
32 37 7 14 8 30 0 0 2 7 0 17 15 7 0 0 0 14 0 0 7 37 0 0 0 20 0 0 5 0 0 0 47 5 0 7 0 14 30 1 23 0 73 0 
15 31 0 0 12 0 0 16 0 0 28 0 0 14 18 0 6 18 21 9 0 8 19 0 0 20 10 14 0 17 0 0 47 19 14 19 10 0 0 26 0 14 29 18 
0 8 56 0 0 20 32 5 11 8 0 9 27 30 7 0 3 15 0 3 0 2 4 7 0 7 0 9 1 27 22 59 4 11 0 7 23 0 32 0 0 0 0 41 
43 8 21 10 0 6 6 17 0 12 0 3 22 33 0 0 0 16 0 0 0 0 0 0 41 10 0 0 8 0 0 0 2 35 54 2 0 24 0 0 5 0 0 0 
0 0 0 0 0 1 33 0 6 34 26 0 0 2 3 2 8 11 8 5 0 5 12 1 0 7 0 12 11 7 9 0 22 1 6 0 5 3 0 11 19 0 3 34 
26 42 0 22 50 6 0 14 14 15 63 1 0 11 0 37 1 1 0 13 0 17 5 0 4 6 24 25 0 0 0 21 15 32 0 0 0 27 20 12 12 28 0 39 
0 46 0 0 0 21 25 0 34 0 6 0 0 16 26 0 0 0 8 0 0 10 25 2 0 6 0 0 6 7 16 48 4 0 16 0 0 0 3 5 0 47 74 17 
0 0 0 0 37 10 0 3 0 0 7 29 15 27 3 0 3 0 0 3 0 0 12 3 0 11 1 0 15 0 0 0 20 0 0 23 0 0 0 13 29 0 0 0 
0 0 8 0 0 0 14 17 10 1 10 0 9 5 10 0 0 0 2 0 0 0 20 0 31 0 12 0 12 19 0 0 0 0 0 0 0 0 0 0 5 0 18 0 
5 9 0 15 66 51 26 4 0 0 0 24 20 0 7 5 18 0 7 16 5 13 17 5 0 7 5 0 0 10 0 55 46 11 58 7 5 5 0 16 0 0 0 39 
68 0 2 5 0 40 20 0 0 0 0 7 6 0 9 0 9 18 13 0 17 0 0 0 0 0 3 0 0 0 30 0 11 22 1 0 0 17 71 1 0 0 0 4 
0 5 40 7 0 0 19 5 0 0 40 5 26 5 0 0 0 0 4 17 8 0 0 0 0 29 8 0 11 10 4 11 0 0 6 0 41 8 2 0 0 0 37 31 
0 21 24 0 0 0 0 0 0 0 0 9 3 0 10 3 0 3 5 0 0 0 21 0 33 0 4 0 0 7 16 13 0 0 0 0 0 0 3 0 0 0 16 0 
0 5 0 10 0 0 4 8 0 0 18 0 20 13 0 8 0 4 0 0 0 8 10 13 16 7 16 0 0 0 18 0 5 0 10 0 0 0 0 0 16 0 21 0 
49 27 45 3 39 13 30 7 2 0 0 27 17 14 43 20 2 18 10 17 4 0 0 16 27 19 9 14 0 2 7 0 44 0 3 0 42 58 23 51 0 30 0 54 
0 12 11 0 22 9 5 0 0 4 4 5 0 10 0 23 45 0 18 0 13 17 0 0 0 15 33 0 8 8 0 0 0 0 3 7 6 11 82 1 15 2 15 0 
57 0 39 9 54 10 6 0 0 0 11 5 9 31 2 24 11 12 6 15 1 27 3 19 0 3 0 12 6 28 0 29 17 22 29 6 13 0 5 86 11 7 42 3 
0 0 0 0 0 61 0 16 0 0 18 7 0 0 0 18 0 14 2 1 1 5 16 0 0 0 0 0 17 0 0 26 16 0 12 5 0 0 0 0 4 46 0 0 
0 4 0 8 0 0 5 0 10 0 0 30 0 0 46 18 24 0 0 39 1 0 0 1 1 0 0 4 4 0 0 0 22 0 4 0 25 23 19 15 23 0 0 0 
0 28 0 0 14 0 0 36 31 6 20 2 0 0 0 19 14 0 14 0 20 11 14 0 0 6 18 7 2 10 3 0 35 0 27 0 10 4 0 0 38 24 0 15 
13 0 38 36 6 15 34 0 0 20 40 0 10 20 22 0 0 6 0 0 11 21 1 9 0 12 12 0 12 20 28 9 0 8 35 0 21 0 0 38 43 0 0 30 
0 0 15 28 15 2 1 28 0 0 1 0 4 0 29 0 23 15 11 2 6 0 0 3 12 34 9 1 2 4 11 40 20 18 50 0 14 32 8 5 0 0 0 4 
0 17 38 0 17 31 44 32 11 0 46 11 7 23 0 8 0 12 17 11 7 4 0 0 0 0 0 0 0 0 0 13 8 0 0 0 6 0 0 0 29 0 36 3 
30 0 0 0 16 0 0 0 0 15 13 0 0 0 0 10 0 0 0 0 0 0 0 3 26 15 6 0 0 8 30 16 0 3 0 16 0 0 28 0 0 0 0 17 
