44 25
0 0 0 0 0 0 6 0 0 38 15 0 0 0 0 6 0 0 0 1 0 0 6 0 0 0 0 19 15 0 4 12 0 6 0 15 0 0 0 0 43 0 12 0 
1 53 0 0 0 21 0 14 0 0 6 1 5 0 0 0 7 0 0 0 0 4 0 0 0 0 28 0 0 0 0 0 0 32 0 0 15 0 0 0 0 0 0 16 
34 0 19 0 0 0 36 0 0 6 8 23 3 0 0 0 0 4 6 0 0 43 0 2 7 2 0 21 0 18 0 17 0 0 14 4 0 0 0 14 0 6 81 13 
20 35 0 0 0 19 0 0 15 0 13 39 0 19 24 0 0 0 0 0 20 9 2 15 27 0 0 0 0 0 5 0 8 0 0 0 10 0 111 4 18 0 47 32 
5 0 29 0 1 5 0 16 0 0 19 0 0 32 0 0 23 0 0 0 14 0 0 5 8 0 0 0 5 9 10 19 0 0 14 1 12 20 0 23 16 0 0 0 
0 39 16 13 1 0 12 23 2 0 0 0 4 0 0 17 0 0 11 20 0 0 18 13 0 0 19 25 23 0 0 0 1 0 0 0 24 0 0 33 23 22 15 38 
31 0 11 12 29 3 7 23 19 0 0 2 10 8 7 0 4 25 23 0 12 3 13 4 0 0 5 9 11 4 7 39 21 18 9 0 0 0 0 7 8 0 59 13 
13 0 0 17 0 21 23 0 9 0 1 0 0 0 24 0 14 9 0 13 17 0 18 0 0 9 21 0 0 0 14 6 0 0 0 33 1 13 13 4 18 0 3 0 
12 0 0 0 22 0 0 0 4 6 6 0 4 0 0 0 14 0 0 12 20 32 0 18 0 9 32 0 0 0 5 7 0 2 0 0 5 0 6 1 12 6 0 33 
0 0 0 0 12 0 0 11 16 0 0 0 0 0 14 0 0 0 10 4 2 27 2 0 0 0 0 12 4 12 0 2 0 0 0 10 0 0 11 18 0 22 0 2 
38 9 0 0 0 0 0 0 1 2 15 7 9 0 0 0 22 8 0 9 33 0 21 19 0 1 3 4 0 0 0 5 0 0 11 15 0 0 2 0 0 0 0 21 
0 0 6 17 6 5 6 10 9 0 5 9 8 0 0 0 8 19 0 0 6 6 0 0 3 14 15 12 0 0 3 0 0 0 6 0 0 11 7 26 0 25 0 6 
4 2 0 0 0 36 8 1 32 28 34 10 0 9 35 0 0 0 0 7 7 27 2 0 12 0 0 10 11 0 1 10 0 23 0 0 0 22 0 0 0 99 3 0 
25 48 39 43 6 10 6 27 14 21 3 14 3 10 0 13 8 0 18 2 22 11 1 0 13 15 0 0 0 1 4 6 9 30 9 7 8 34 0 1 0 9 7 0 
13 37 29 28 32 0 16 0 0 0 0 0 0 12 0 0 22 0 1 0 26 12 13 0 0 12 0 15 8 0 4 11 0 0 0 0 48 2 22 7 39 3 15 0 
26 11 0 26 3 61 38 11 0 0 11 13 0 24 0 0 23 0 18 20 0 0 1 17 0 0 0 12 2 42 11 8 0 0 25 15 11 24 0 18 40 3 9 38 
0 0 8 34 33 16 0 3 6 0 11 0 0 4 0 0 0 22 0 0 0 4 6 22 10 12 13 0 0 0 9 12 0 0 12 0 11 59 0 18 2 0 14 0 
38 20 0 14 6 0 67 28 0 5 6 5 0 7 0 33 0 20 4 11 1 5 0 0 8 0 0 0 33 0 0 11 12 0 0 0 4 0 38 0 0 0 27 47 
0 15 2 18 22 0 0 0 18 7 2 1 23 18 0 25 2 0 0 6 39 0 2 6 5 12 54 0 13 5 8 12 0 4 3 0 33 13 10 0 37 0 29 0 
0 37 3 0 0 0 8 0 0 0 3 22 0 15 2 0 20 2 0 2 6 7 0 0 6 0 13 0 0 1 1 3 0 22 0 10 0 36 16 1 0 0 26 27 
73 16 15 31 19 22 13 27 6 29 22 15 23 27 21 24 15 0 30 20 0 28 8 14 0 6 26 18 0 2 8 20 6 0 13 0 0 0 11 11 9 29 12 34 
20 25 8 67 27 0 0 0 0 1 0 0 0 0 0 13 0 2 7 22 20 0 25 0 0 0 21 0 6 1 11 0 0 3 3 0 33 1 0 0 0 41 18 0 
2 33 0 14 0 35 0 83 2 22 19 14 0 3 5 17 16 14 0 5 11 7 13 6 0 29 3 0 13 5 23 15 33 26 35 30 2 0 19 0 2 23 0 0 
0 27 11 9 1 0 0 0 0 0 17 8 0 4 0 0 0 0 0 35 26 0 13 15 29 0 0 2 0 0 17 16 23 0 0 17 17 0 0 8 0 0 18 21 
10 1 1 0 4 16 0 0 2 25 0 16 0 0 0 0 0 0 0 5 10 4 0 9 1 24 19 42 2 0 0 0 0 0 20 0 0 20 6 0 1 6 11 0 
