44 25
0 0 11 0 0 0 0 7 2 0 0 0 14 41 14 0 4 0 0 0 4 1 4 3 0 0 3 0 0 0 0 0 0 0 0 0 15 0 0 7 0 0 0 4 
0 0 8 0 0 0 0 9 51 3 97 0 0 0 0 0 26 6 16 0 37 0 21 46 16 0 3 17 0 0 0 0 0 26 0 0 26 0 18 29 31 18 32 59 
0 0 0 0 0 0 0 5 2 0 0 0 28 17 0 0 0 0 8 0 0 12 1 13 0 0 6 0 0 0 18 0 0 20 0 7 0 0 0 0 0 0 9 0 
0 0 31 14 0 39 0 0 0 10 34 4 20 3 0 6 9 8 43 0 0 3 0 18 0 0 6 0 9 13 0 9 0 11 16 3 0 9 16 18 0 6 0 7 
37 0 0 0 27 15 0 0 31 2 3 2 6 3 29 25 1 0 6 2 0 13 14 2 3 0 3 9 10 3 4 20 0 16 6 0 2 25 0 34 34 0 0 43 
0 8 34 0 4 37 5 0 17 0 64 3 10 0 0 12 0 0 11 0 0 0 11 0 9 0 0 0 13 2 0 23 1 14 24 19 0 35 0 0 0 13 0 12 
6 1 7 2 2 29 27 23 2 0 33 21 29 15 2 0 16 16 0 0 14 0 0 12 0 17 0 5 8 0 34 0 1 43 13 7 0 0 0 34 0 11 20 46 
32 0 40 0 0 0 3 7 4 0 8 34 27 0 21 0 0 15 12 0 0 12 2 0 10 0 0 0 0 0 1 0 0 45 1 10 0 35 0 3 4 19 6 0 
34 0 0 2 1 11 35 0 9 24 3 13 15 0 20 1 1 0 10 0 19 0 0 0 4 0 13 16 18 1 2 0 0 5 25 7 0 0 28 6 14 12 1 1 
11 0 0 58 10 0 3 11 21 13 1 3 0 0 3 0 0 3 0 9 0 4 0 0 0 18 6 0 32 21 0 0 0 10 27 0 33 0 0 0 1 6 15 6 
24 0 41 0 0 34 2 1 0 0 0 0 0 38 2 0 10 0 10 0 4 13 0 10 34 14 0 0 23 0 8 0 0 23 0 0 7 0 0 48 0 28 14 62 
28 4 0 0 3 24 29 0 5 0 5 0 30 7 0 7 0 0 25 0 0 9 0 0 0 9 0 5 26 13 0 9 0 0 0 29 0 0 2 0 7 0 39 25 
0 0 5 0 0 9 6 23 0 0 7 0 2 0 30 7 20 0 18 20 18 0 19 0 0 0 6 4 0 0 24 4 0 4 7 8 20 1 42 20 0 42 8 0 
8 5 0 26 6 35 23 24 16 0 7 5 0 28 0 3 16 34 17 30 11 0 9 0 14 0 20 9 18 26 0 24 29 0 0 0 0 0 0 31 2 28 6 0 
43 18 28 39 2 38 33 0 0 0 9 17 0 0 14 25 7 13 11 0 9 0 9 11 23 0 11 21 5 0 31 8 0 24 11 7 9 0 0 28 49 0 0 32 
7 14 28 27 12 0 2 0 11 30 19 30 0 7 9 7 0 0 0 0 13 7 11 0 0 26 25 0 0 0 75 0 0 0 0 7 0 0 0 75 0 0 3 11 
0 0 0 0 12 13 41 13 8 4 49 0 30 4 0 52 4 5 14 1 8 0 21 0 0 17 0 2 22 0 0 14 0 0 0 4 16 12 26 29 7 5 0 7 
11 2 0 3 4 0 10 1 1 8 23 2 15 0 0 6 0 11 18 0 0 0 0 0 10 0 0 0 0 0 0 0 0 16 0 25 17 0 0 4 0 0 0 8 
0 46 0 15 3 24 0 0 12 8 31 26 6 12 12 2 0 15 13 0 5 0 0 42 0 0 11 17 11 19 16 18 0 30 0 31 19 32 0 13 0 0 0 20 
0 4 13 0 3 49 0 9 6 0 0 12 20 25 0 0 0 0 0 9 15 5 0 0 10 0 5 3 4 0 0 0 15 41 48 0 0 0 6 0 21 3 0 15 
7 28 17 0 21 0 37 20 7 21 33 15 3 20 0 7 30 0 8 10 70 0 0 0 10 16 16 0 2 27 6 0 16 0 1 0 0 8 2 1 0 0 12 4 
5 0 27 0 0 3 26 4 0 0 0 0 0 6 0 0 10 0 6 65 7 3 6 18 3 0 0 0 1 17 6 24 0 15 0 19 0 3 19 2 0 0 12 24 
10 0 0 0 0 45 30 3 7 0 19 0 0 18 0 0 2 8 21 0 5 0 26 0 4 1 12 14 0 0 0 0 0 39 8 0 0 0 2 0 18 0 37 0 
9 31 0 0 17 0 6 21 32 23 30 0 1 0 18 7 0 0 0 7 1 16 0 5 17 8 0 0 1 0 0 0 53 8 0 0 23 0 0 29 40 0 0 0 
0 0 0 0 35 25 17 15 8 0 0 32 0 22 9 0 14 0 1 13 21 0 0 8 0 0 0 0 0 17 0 0 5 20 0 37 8 9 22 68 1 27 0 94 
