44 25
28 23 5 0 0 32 19 17 21 13 27 11 7 17 0 4 8 0 1 22 20 6 0 14 31 13 8 20 53 0 0 5 8 5 48 0 10 0 16 13 0 32 0 38 
0 0 16 0 14 0 0 1 0 0 27 0 14 35 23 3 8 0 1 0 7 22 0 0 21 23 13 1 23 0 3 5 0 0 8 9 5 0 24 7 0 10 0 0 
3 0 18 9 0 20 30 32 0 0 0 28 0 0 18 0 0 0 0 14 27 0 0 6 0 26 15 0 0 8 0 1 16 2 17 0 8 0 10 54 3 15 36 0 
0 0 1 0 0 0 0 0 18 0 0 0 0 16 0 0 3 7 24 3 0 2 0 0 7 0 23 6 26 27 0 1 0 0 0 9 3 0 0 0 3 0 24 0 
0 0 78 40 9 38 0 16 15 23 18 31 0 2 0 10 0 23 0 23 0 0 20 15 0 0 0 8 34 3 38 5 53 7 0 0 5 0 17 2 23 0 8 78 
5 0 0 0 10 25 3 29 0 0 5 8 4 0 12 33 0 0 0 9 3 0 0 19 12 18 16 9 18 14 43 15 17 3 0 1 23 0 0 0 29 0 13 0 
0 51 2 0 28 14 55 2 15 0 9 0 12 1 28 0 0 0 0 0 14 6 0 25 0 0 0 13 0 21 17 26 19 26 0 4 3 0 3 0 13 10 28 5 
0 0 8 0 0 0 0 34 11 0 0 0 5 1 36 30 5 17 0 17 18 0 0 21 13 0 0 0 0 11 0 15 6 0 0 0 22 0 9 11 4 34 18 11 
10 73 61 1 34 6 16 29 0 5 52 51 0 1 9 6 21 32 20 36 6 9 0 7 0 0 19 21 8 0 34 0 17 3 3 16 71 61 9 44 3 0 16 32 
40 12 0 11 0 0 59 0 32 0 0 0 0 22 8 68 8 0 0 0 16 0 0 4 0 0 3 7 0 17 0 0 0 0 0 0 6 0 0 33 82 12 42 28 
0 22 0 8 4 0 9 57 37 0 10 12 0 7 0 16 9 24 22 4 0 10 16 18 14 0 15 11 0 22 0 10 0 0 18 19 37 26 14 2 78 77 2 14 
11 0 8 0 10 17 6 25 35 16 10 0 19 17 0 0 24 0 21 9 20 0 0 0 0 22 16 0 9 0 17 24 26 0 9 0 31 0 5 28 60 25 17 36 
0 69 0 0 0 1 0 0 0 5 0 4 6 5 28 0 2 0 12 0 0 0 0 0 26 20 25 9 6 13 12 0 6 6 27 9 7 65 19 10 13 15 0 0 
6 11 5 14 9 8 2 0 0 2 1 14 0 8 26 21 0 30 0 0 1 1 0 12 2 0 2 0 0 4 12 0 18 0 10 0 23 0 0 0 0 0 0 0 
9 0 0 0 0 0 0 8 0 0 0 21 12 3 0 0 25 5 0 9 0 0 0 0 20 0 12 3 10 0 0 0 23 1 14 0 0 0 10 0 2 27 0 2 
0 20 30 2 0 27 0 0 4 2 0 0 0 0 0 11 0 0 0 0 0 0 0 0 0 24 10 6 0 0 0 0 57 0 0 0 9 0 37 7 0 0 0 0 
0 2 0 0 0 31 3 0 0 0 0 0 26 29 5 0 0 0 0 0 0 0 16 0 0 18 0 0 0 0 0 6 2 0 6 0 36 0 35 0 7 11 29 28 
0 0 16 7 0 0 0 0 16 17 0 13 5 26 0 0 4 16 0 11 0 0 0 0 38 0 0 3 0 8 0 6 6 0 0 0 0 0 3 0 0 3 0 0 
0 38 25 7 0 26 0 0 11 10 30 0 45 0 6 28 10 0 0 14 15 0 3 13 0 0 13 13 1 17 0 13 16 25 0 15 35 6 29 18 0 0 0 0 
19 5 9 38 0 0 0 14 1 0 17 0 0 12 10 7 11 17 0 0 0 0 7 0 11 0 12 30 0 0 0 0 9 10 0 0 0 0 0 0 13 47 0 20 
0 0 36 70 21 23 0 20 33 0 0 0 0 0 52 11 20 11 10 2 26 0 0 0 15 0 3 0 27 9 0 26 0 0 20 31 32 1 33 2 0 3 0 0 
12 33 3 0 72 0 0 0 0 0 0 0 0 0 19 11 4 0 0 0 0 0 0 0 13 0 0 5 0 0 0 12 28 6 38 0 0 0 26 31 0 0 0 12 
0 0 15 26 19 0 0 19 0 0 24 13 0 13 0 11 0 15 7 3 0 0 0 9 27 0 2 8 0 0 0 21 9 29 34 0 33 0 0 0 0 0 39 0 
4 1 0 5 28 45 0 23 30 31 23 0 0 0 0 25 5 0 1 6 0 22 16 0 2 9 16 0 21 0 28 0 0 18 0 0 8 0 0 31 72 14 36 0 
0 4 40 16 3 3 35 0 35 41 24 5 19 12 16 13 0 0 3 0 26 21 0 15 0 40 13 0 13 23 4 16 30 0 10 15 15 28 0 0 0 0 1 23 
