44 25
0 0 0 4 0 17 0 36 0 7 0 0 0 13 10 51 0 0 37 0 0 0 0 0 0 0 0 0 0 0 8 0 9 1 0 0 0 24 31 21 15 26 24 36 
37 15 0 0 31 24 9 0 20 8 6 22 0 2 3 8 6 2 0 10 32 0 0 4 7 0 9 12 19 37 15 7 32 16 29 37 13 0 0 0 0 0 31 37 
0 0 0 0 0 1 31 0 0 10 0 0 2 0 0 2 2 0 2 6 0 5 0 0 5 3 10 0 11 0 0 0 5 3 8 0 0 0 0 7 34 0 0 0 
0 11 0 5 0 9 1 0 0 24 16 8 5 3 0 17 0 0 0 13 0 0 0 0 9 0 0 17 18 8 0 0 13 8 25 0 10 0 0 9 19 0 0 0 
0 0 12 44 2 18 42 7 0 0 9 19 15 0 36 18 25 0 8 0 10 0 10 0 7 0 8 5 6 0 10 16 29 7 24 14 6 23 19 6 38 0 0 67 
47 0 5 0 0 0 16 19 57 0 26 0 0 5 16 0 0 0 5 13 8 0 0 15 17 13 0 6 12 0 18 55 0 3 0 10 2 0 15 0 0 0 0 0 
0 0 40 20 3 7 13 3 0 0 0 7 8 0 5 0 19 14 0 0 0 7 0 12 0 0 0 5 11 0 0 0 0 0 17 1 0 20 0 0 0 0 40 0 
3 0 25 0 0 0 35 0 0 7 0 0 0 0 0 0 23 26 10 13 0 0 0 0 8 0 15 33 9 0 0 6 10 0 0 7 0 1 1 23 0 19 3 32 
36 0 2 29 0 29 0 4 0 0 1 18 1 19 0 0 13 0 15 0 0 16 0 15 0 0 12 13 0 9 0 0 8 0 2 22 11 0 47 2 4 0 0 14 
43 13 35 12 37 27 30 0 0 5 30 0 24 11 42 12 0 0 0 13 5 0 0 5 5 0 0 13 4 0 0 0 5 0 0 3 32 20 21 0 36 22 6 74 
3 0 0 0 33 0 9 60 52 0 34 19 0 0 10 9 2 0 22 16 10 8 18 12 0 0 21 5 2 0 0 0 2 18 19 4 2 29 5 7 18 34 7 0 
0 0 49 0 40 0 0 43 0 10 13 2 5 19 11 0 0 7 16 0 0 0 0 32 0 11 1 5 9 19 5 18 0 10 21 12 32 1 0 0 0 0 12 36 
4 0 0 9 46 17 8 0 0 10 18 53 32 0 3 0 17 15 13 8 0 0 5 9 4 15 9 11 16 24 0 20 0 28 0 32 0 25 11 23 15 5 38 4 
34 0 11 0 0 10 0 0 0 26 14 0 0 24 0 0 61 0 7 3 0 0 0 0 0 7 19 0 11 7 3 0 0 3 0 29 13 11 3 0 24 11 0 14 
22 0 40 28 0 0 28 13 7 21 0 25 10 20 26 0 25 8 0 3 15 0 17 9 16 0 0 0 0 0 12 43 0 20 42 12 40 0 0 23 26 0 40 13 
1 0 0 34 38 11 16 0 20 19 0 9 24 26 5 0 9 0 0 16 9 0 33 0 0 1 0 0 22 0 0 0 10 0 0 27 45 31 0 9 12 0 48 7 
1 24 0 15 15 0 0 42 0 0 0 0 17 27 0 5 2 16 27 15 7 0 0 0 0 1 0 17 7 0 8 11 5 1 35 34 39 0 0 0 55 0 0 10 
0 0 32 0 28 42 29 0 0 0 0 5 5 0 21 5 5 0 24 2 6 0 0 0 8 4 1 16 38 24 0 9 8 0 15 8 0 33 0 6 44 5 31 11 
0 0 19 2 0 19 4 35 0 0 5 9 0 0 0 19 0 7 0 0 9 3 0 0 19 15 0 0 5 0 0 0 0 17 26 4 4 5 0 0 15 0 61 0 
22 13 0 19 3 0 0 0 13 29 0 10 25 0 0 0 0 0 0 14 0 13 44 0 12 0 0 5 3 2 0 5 9 0 5 13 2 25 31 0 0 0 0 15 
7 0 14 12 8 2 14 2 0 0 12 0 4 7 0 12 4 16 2 0 2 0 31 13 0 0 24 17 6 0 0 13 16 16 0 9 0 14 6 0 38 0 0 2 
16 22 33 1 1 1 29 3 0 16 0 9 3 0 0 0 0 0 11 0 0 0 0 31 0 3 8 22 0 5 0 0 0 0 17 7 34 0 0 0 1 0 0 0 
23 52 45 5 12 21 39 33 11 11 8 10 9 0 24 5 14 25 8 0 54 0 0 0 3 24 3 10 6 39 0 0 8 0 22 0 4 0 25 0 65 14 0 30 
26 0 19 20 0 0 0 0 0 0 0 1 0 0 0 3 25 0 3 7 1 16 0 42 3 0 16 0 7 0 0 0 0 11 35 19 10 0 19 6 0 16 7 0 
0 31 0 0 7 0 0 5 0 0 0 21 25 0 0 20 25 0 0 37 10 0 0 0 15 11 0 5 0 7 0 5 36 0 36 18 5 8 1 20 0 29 37 0 
