44 25
38 17 0 0 0 50 57 0 23 22 11 1 0 30 2 22 2 14 7 0 22 14 17 0 0 0 14 5 0 0 16 33 31 0 0 8 0 0 38 0 1 0 12 10 
0 21 0 16 37 19 0 0 3 20 11 14 8 9 5 0 13 26 0 1 7 1 61 14 14 0 0 0 0 7 0 0 22 17 0 0 0 1 33 0 1 0 0 26 
20 28 15 42 0 28 0 39 2 0 8 0 17 10 10 0 0 12 0 10 34 18 19 21 0 0 0 0 3 21 0 0 0 0 3 11 19 1 0 3 19 36 0 0 
31 71 11 0 18 0 0 0 0 0 30 5 0 0 12 21 5 0 0 0 0 0 3 0 21 0 2 0 31 16 19 28 0 0 49 8 0 1 4 3 29 19 0 0 
0 0 0 33 0 58 37 15 1 0 7 0 2 8 1 4 17 0 0 18 0 0 11 0 0 5 0 21 2 0 14 0 13 17 12 0 33 0 55 13 13 0 19 28 
19 12 0 8 29 0 0 22 0 2 3 11 31 16 25 3 0 3 4 0 0 0 14 19 26 3 10 16 24 18 0 10 0 10 0 0 10 0 24 3 0 0 1 28 
0 32 0 15 12 0 0 0 30 0 6 27 0 0 0 0 0 20 1 0 11 7 38 12 0 0 15 0 9 0 0 0 0 22 0 15 0 0 3 0 0 5 20 5 
0 2 0 48 0 0 0 0 0 12 11 8 29 23 27 2 0 0 0 32 16 12 6 3 8 0 7 2 32 11 5 22 20 0 0 8 11 34 12 10 12 26 2 5 
2 13 1 0 0 3 31 0 0 20 8 0 6 9 16 2 20 10 8 0 12 0 9 0 6 0 0 0 0 0 10 34 0 33 9 0 20 31 6 16 0 0 0 10 
23 0 1 0 0 27 0 0 7 0 0 18 0 16 20 22 0 0 0 4 8 0 0 0 0 0 0 0 0 43 0 0 27 0 10 0 2 0 19 14 0 0 12 0 
41 13 0 6 13 8 0 0 0 0 8 0 11 0 10 0 0 13 0 21 0 11 0 15 10 0 0 0 13 8 0 7 0 0 0 0 17 0 0 10 11 35 1 1 
29 38 1 8 0 8 5 10 0 0 14 5 0 1 0 3 10 6 23 0 0 0 0 0 0 33 1 0 13 5 0 0 6 0 0 0 19 0 6 0 39 57 17 9 
0 31 38 3 0 19 0 0 32 0 37 3 10 18 16 0 0 13 11 8 0 0 19 0 0 0 4 4 2 18 28 0 27 7 4 0 33 0 4 10 28 0 44 0 
0 0 0 36 60 20 34 3 0 6 3 8 25 23 15 3 0 7 0 2 0 0 10 6 5 10 3 23 8 4 10 0 0 0 0 6 9 14 0 0 12 43 0 19 
47 2 6 23 1 4 0 21 0 0 27 3 0 29 6 0 0 0 0 11 21 16 6 4 0 0 3 25 24 0 4 12 13 0 10 13 0 25 25 0 27 0 0 0 
40 26 0 0 11 0 19 3 0 0 0 9 0 0 18 6 2 2 0 19 0 0 0 0 0 18 9 42 10 0 0 0 25 10 9 7 25 2 10 0 61 0 17 9 
0 27 19 3 0 5 30 0 13 0 0 0 0 23 4 5 10 4 2 30 15 18 4 9 0 0 12 6 49 23 0 3 1 0 20 16 13 16 6 0 0 1 0 11 
25 69 0 33 0 16 2 4 34 20 1 0 0 7 16 0 6 16 0 1 4 0 1 14 0 0 37 9 6 0 6 0 45 0 0 0 6 36 8 56 0 35 0 0 
17 2 9 0 0 0 36 11 0 0 39 20 0 43 0 5 0 0 9 2 0 0 15 4 0 0 0 5 39 11 0 8 18 0 4 0 14 0 25 8 3 0 4 17 
23 15 1 10 0 28 0 17 17 4 10 19 31 6 0 0 0 13 0 0 8 0 0 0 0 20 0 0 7 0 0 8 0 33 17 0 0 0 26 0 0 9 0 0 
0 13 40 0 17 3 0 33 0 12 3 0 0 9 0 12 0 0 16 2 0 3 0 13 42 0 0 21 0 41 8 0 0 5 11 0 4 0 7 0 13 0 13 13 
0 5 0 15 0 0 2 10 2 0 14 0 25 13 0 11 6 18 0 8 0 11 1 4 4 0 13 9 13 0 0 3 0 1 2 18 17 25 21 0 3 19 12 7 
0 15 0 24 0 0 0 0 12 0 47 0 0 0 0 22 15 0 0 0 27 0 0 13 0 0 7 45 1 2 19 10 7 0 0 7 42 0 0 7 2 2 29 14 
40 9 30 0 23 0 22 0 0 4 3 0 14 12 0 18 7 0 5 9 13 0 0 40 2 17 33 23 33 0 0 0 52 8 1 22 12 11 19 35 40 0 17 0 
66 1 0 0 0 52 1 6 0 0 0 0 5 0 24 0 0 0 0 0 0 0 0 3 40 0 0 2 0 2 0 5 0 0 0 0 0 32 0 0 40 0 24 11 
