44 25
0 16 23 0 14 36 15 0 0 16 0 0 0 0 0 9 0 0 28 17 12 9 0 0 8 32 0 1 1 0 0 6 8 24 0 5 17 15 19 0 5 0 0 0 
2 0 3 0 0 0 0 0 0 0 0 0 0 10 16 0 0 0 16 24 1 14 0 11 20 1 0 41 20 0 0 14 0 0 0 14 0 20 0 0 0 0 3 24 
0 15 0 0 0 15 42 0 7 0 13 0 20 27 0 13 22 18 2 4 13 0 0 24 0 0 14 2 7 0 4 8 1 1 4 35 0 9 53 0 27 25 0 11 
9 0 0 0 0 0 0 2 0 62 0 6 0 0 0 0 13 0 9 0 0 0 0 5 14 5 0 0 0 8 26 8 20 0 0 0 0 0 14 0 0 19 8 34 
16 7 0 0 19 9 0 0 6 6 0 19 0 36 0 0 25 0 24 0 30 0 0 8 0 16 0 2 0 9 30 9 12 18 0 0 0 0 5 0 6 20 21 0 
0 8 39 1 0 28 34 6 20 0 0 31 5 30 7 32 7 1 5 0 10 8 7 15 16 0 14 6 13 0 24 0 52 13 12 29 0 0 0 0 42 1 0 10 
0 4 2 0 0 4 28 0 0 25 2 45 0 53 12 20 14 4 7 5 4 6 16 5 0 9 6 33 5 7 10 5 9 5 8 4 22 0 0 7 17 36 15 0 
0 33 0 0 8 0 12 0 0 0 33 23 0 0 0 0 0 19 0 0 9 0 0 16 2 14 6 0 5 0 5 5 0 0 33 0 30 0 0 16 10 0 12 0 
0 0 15 0 22 0 0 0 16 0 20 7 10 0 0 0 0 0 0 5 0 0 0 0 5 0 25 26 14 0 20 0 0 5 4 0 0 0 1 0 0 0 15 0 
20 23 0 0 0 0 11 15 0 66 32 6 23 7 4 9 4 0 9 15 25 17 13 14 23 0 10 8 0 0 0 11 69 9 0 7 27 5 41 0 0 0 54 34 
0 0 9 31 0 38 9 0 41 3 10 0 0 5 0 30 0 0 4 0 14 0 23 0 0 0 2 0 21 12 0 0 11 0 31 0 0 11 6 17 0 48 0 15 
0 7 60 1 25 22 13 0 30 2 0 23 0 6 0 2 0 0 0 7 0 12 2 0 13 0 15 10 0 18 28 8 0 66 2 0 0 9 30 0 0 22 8 9 
0 0 0 7 7 3 0 27 12 2 10 1 1 45 0 2 0 5 0 0 5 22 0 8 0 8 0 0 4 9 0 0 7 6 33 14 0 0 15 0 0 0 0 0 
0 0 26 31 0 4 8 35 8 4 6 0 5 0 12 0 15 0 0 22 0 0 0 1 0 17 0 15 1 0 0 0 9 17 31 8 0 0 20 0 38 22 27 5 
7 26 0 0 0 0 25 0 5 3 4 0 9 11 7 1 0 2 12 19 27 0 3 12 9 3 13 2 1 0 16 25 0 8 0 20 0 0 19 25 0 12 1 12 
0 0 26 0 20 2 15 8 22 17 8 18 0 6 0 8 7 3 27 15 0 0 0 8 0 0 7 6 26 0 3 46 28 0 0 13 18 11 0 8 0 14 9 0 
5 16 0 37 0 5 18 1 9 3 0 21 0 0 0 7 0 0 0 13 19 0 0 18 0 0 7 0 10 0 0 7 24 0 0 0 0 0 2 20 45 18 0 0 
0 24 12 24 0 32 0 0 15 0 16 2 4 0 22 17 4 4 0 6 6 14 0 12 6 2 16 47 1 1 1 1 11 0 0 1 0 5 4 0 42 14 0 0 
0 0 0 7 0 5 16 34 20 22 0 13 0 14 1 0 1 19 0 14 13 0 6 15 13 0 9 0 4 20 0 25 0 20 0 25 11 0 31 0 5 0 0 0 
23 3 9 17 11 2 9 2 0 19 12 0 0 0 1 0 0 0 0 23 10 0 18 0 0 0 10 29 5 0 0 31 39 3 0 0 0 4 0 0 42 0 36 17 
16 0 0 40 0 20 0 5 33 11 28 0 0 2 0 21 14 37 0 7 4 9 6 0 22 0 12 3 26 5 14 16 0 0 13 0 29 0 0 0 0 3 14 22 
43 7 0 0 0 0 6 0 20 0 5 0 28 30 0 0 0 0 8 0 5 4 0 0 49 4 7 4 20 0 3 12 0 0 0 0 0 4 28 4 0 0 0 37 
1 10 1 1 3 0 6 13 0 0 9 10 26 0 0 0 0 25 0 0 14 22 0 17 0 0 1 0 4 16 0 0 0 5 0 0 0 0 26 2 0 14 34 10 
0 0 27 15 19 0 18 14 29 0 19 0 27 25 0 2 15 0 0 20 27 0 0 10 18 11 7 32 0 45 1 7 1 0 0 0 16 2 35 13 0 40 30 2 
0 70 0 23 0 0 19 0 16 33 0 0 18 20 11 12 0 0 0 22 19 0 0 0 0 18 0 23 14 0 2 0 32 0 4 7 0 0 1 0 39 21 48 0 
