44 25
0 29 22 0 5 1 0 27 16 15 0 24 6 1 18 0 12 0 0 0 0 3 1 31 28 9 1 13 0 13 5 23 30 0 0 0 0 0 0 0 3 0 0 24 
28 0 0 0 26 17 4 0 23 10 0 0 18 0 17 16 0 0 0 0 0 0 0 0 0 21 8 0 37 3 44 13 14 19 0 31 0 0 0 0 10 0 0 2 
0 10 3 9 10 8 0 29 0 12 8 9 6 0 27 16 6 0 4 1 19 1 0 0 0 35 12 0 7 0 14 10 7 9 4 23 11 15 20 21 0 34 17 8 
0 2 0 23 36 0 29 0 0 0 9 0 0 0 0 0 19 0 0 9 0 13 0 0 0 8 12 20 6 26 0 0 0 0 7 29 14 0 8 0 0 12 0 5 
14 25 0 49 0 12 20 2 2 27 0 16 15 10 0 0 0 12 0 16 6 0 0 10 17 0 13 31 7 0 0 0 4 5 0 16 33 0 10 0 31 9 0 42 
9 0 0 0 17 0 4 6 0 0 0 14 0 3 10 1 14 0 0 1 5 0 0 0 0 10 0 14 1 0 0 0 0 0 2 10 15 0 1 0 0 4 15 4 
36 23 34 31 22 16 2 10 3 9 6 38 3 0 1 55 6 10 9 8 0 4 0 0 0 0 8 0 4 0 55 3 0 0 44 0 3 0 0 24 0 30 0 0 
2 41 2 9 0 12 7 21 21 0 0 11 46 9 0 3 21 5 2 24 16 5 0 0 0 13 0 0 11 21 0 11 0 5 0 0 1 0 26 7 0 25 14 18 
7 38 38 0 1 26 0 4 0 4 0 0 0 0 0 0 0 0 0 4 2 0 0 0 0 0 0 0 3 2 0 33 1 0 0 0 0 0 0 38 38 0 0 0 
9 33 23 0 6 18 6 0 0 9 13 16 30 0 13 0 6 0 0 3 0 0 34 0 0 0 0 0 0 0 12 3 0 21 14 0 58 32 4 0 0 4 12 4 
0 0 0 0 28 27 34 0 0 0 0 9 0 12 26 0 0 0 5 0 28 0 10 14 0 0 0 13 0 0 17 0 1 13 21 0 0 1 1 26 14 6 21 1 
35 11 30 0 0 0 25 8 26 11 23 4 0 29 0 12 13 0 16 17 0 0 18 0 0 2 0 5 7 0 0 18 0 53 23 25 20 0 5 4 23 1 29 4 
76 23 10 44 4 3 0 65 2 19 9 0 25 1 28 7 0 35 0 28 1 37 0 2 29 0 0 6 4 0 0 4 0 0 34 0 19 0 50 0 0 34 14 23 
4 0 19 0 21 9 0 34 2 18 21 23 11 30 0 23 0 10 24 0 0 12 13 0 18 21 19 15 0 2 6 0 3 23 19 3 0 0 13 0 11 0 2 30 
131 47 1 3 8 0 12 40 0 0 0 3 0 16 27 0 27 0 16 19 0 21 9 10 0 8 19 0 15 16 0 0 20 0 14 21 35 0 9 12 0 73 28 22 
0 28 34 0 16 35 0 0 0 0 0 1 20 0 0 9 0 0 0 28 16 8 10 15 0 30 9 0 0 35 2 0 4 10 0 8 57 0 12 0 39 0 17 0 
0 0 9 27 0 0 0 0 0 15 0 0 9 16 0 0 0 17 0 0 0 2 15 0 0 4 0 8 0 8 27 7 16 1 12 0 0 15 25 0 0 0 0 11 
0 2 72 7 0 10 0 0 1 22 7 8 0 0 10 0 13 0 0 11 27 0 8 17 5 0 0 2 0 9 0 43 0 0 24 53 16 0 6 0 7 39 0 15 
12 41 0 0 3 0 7 8 0 25 29 0 0 0 0 16 0 3 0 0 3 12 0 12 0 0 0 0 0 0 0 0 0 23 34 12 0 36 0 30 0 0 0 1 
0 10 0 5 0 0 0 20 0 1 28 4 0 0 0 0 25 5 9 0 0 0 7 0 0 0 0 21 0 5 0 0 14 0 0 0 7 0 28 0 0 0 0 3 
73 0 4 0 0 38 0 0 13 21 0 27 0 10 0 5 27 0 20 0 0 0 0 0 26 0 13 30 6 0 3 22 6 0 0 58 12 9 41 4 0 1 11 20 
1 20 15 26 0 0 0 14 15 0 25 0 0 0 14 15 25 20 5 0 0 3 2 0 21 0 16 0 46 26 0 0 0 0 0 0 0 0 9 23 12 0 0 0 
35 37 40 27 0 17 0 6 4 31 21 0 35 48 18 0 7 20 0 17 0 40 0 21 12 1 2 15 13 29 0 9 25 7 2 21 42 16 22 36 9 18 10 0 
0 46 17 0 0 11 4 2 26 0 4 0 0 8 0 12 0 0 0 0 37 10 0 0 3 0 0 23 34 0 23 15 0 0 40 13 0 0 2 3 0 0 3 0 
6 0 0 0 0 0 20 28 0 34 2 2 2 0 0 0 7 0 8 0 0 9 0 12 1 1 11 0 0 0 0 0 0 0 23 35 0 0 12 0 0 0 0 0 
