44 25
0 4 0 5 19 17 0 7 21 0 20 30 0 22 7 0 17 5 0 0 2 17 17 29 22 8 0 10 17 12 0 0 13 10 0 18 0 10 2 0 0 42 8 0 
2 0 37 21 0 0 4 0 11 9 18 20 13 0 0 19 4 0 0 25 24 27 0 4 27 0 23 15 17 1 1 7 0 0 6 0 0 1 0 15 12 0 7 0 
7 4 0 0 0 0 3 28 34 0 19 0 0 6 0 0 0 0 0 18 0 0 16 0 0 17 0 0 21 20 0 0 2 0 0 0 0 0 9 21 0 32 34 0 
0 0 24 0 0 0 0 0 0 16 0 0 0 5 0 0 10 0 0 0 0 0 10 12 6 16 14 0 0 23 0 0 0 17 0 0 0 0 1 16 0 0 0 19 
1 4 31 11 20 21 0 0 0 19 0 10 11 6 19 21 0 0 0 0 9 0 0 1 53 20 12 0 10 0 0 6 16 66 2 0 21 6 7 15 0 2 4 0 
0 0 0 0 38 0 26 0 6 1 2 1 0 11 4 27 0 5 0 3 0 0 20 6 19 12 0 13 0 0 5 2 2 0 0 5 0 2 15 0 0 7 23 0 
0 6 23 5 27 25 36 13 18 20 22 16 15 0 0 0 0 12 0 20 6 0 11 0 41 29 0 16 0 25 1 26 21 12 0 0 31 5 34 8 16 0 49 0 
34 0 13 8 0 2 0 0 0 4 0 23 0 0 0 21 21 0 0 0 1 0 1 2 0 0 0 5 0 0 8 15 0 0 54 0 21 3 13 0 0 8 12 0 
0 0 0 12 0 14 0 25 30 0 32 0 18 5 9 6 10 11 6 10 7 1 0 3 1 8 0 5 14 0 18 0 5 0 0 12 0 0 33 13 7 0 2 36 
31 1 0 0 0 47 33 0 0 0 11 0 0 8 13 7 0 1 13 14 0 0 16 18 8 12 0 0 0 0 0 0 0 10 0 0 0 20 33 71 1 1 0 0 
0 0 18 29 0 20 0 41 0 9 8 20 10 6 0 0 9 21 0 1 3 0 4 5 0 29 11 0 6 0 10 20 24 8 3 0 0 1 0 31 5 27 0 0 
0 0 29 6 8 15 0 0 0 8 0 9 14 19 0 0 0 0 6 1 15 10 0 14 0 0 0 0 0 0 0 39 9 0 0 22 2 9 2 7 0 0 0 0 
5 0 26 0 34 0 46 16 53 20 0 0 0 5 22 25 22 0 0 26 0 6 9 15 6 0 0 17 16 20 1 0 9 14 28 29 12 0 73 32 18 7 0 28 
0 33 36 7 0 36 2 0 7 0 0 0 8 5 0 0 22 0 1 1 8 0 0 0 0 0 2 0 11 10 0 0 0 0 40 0 0 0 65 2 0 26 0 0 
23 9 0 0 31 0 0 0 0 34 34 4 11 20 8 1 0 0 14 29 11 21 3 31 0 21 0 0 0 25 0 4 1 6 24 0 18 8 19 13 0 8 21 34 
0 21 2 19 20 34 24 10 0 0 7 9 14 7 0 7 5 24 2 1 15 6 21 14 0 0 27 0 0 0 29 14 22 30 19 3 0 0 17 32 16 5 0 14 
11 0 32 8 10 32 0 5 36 16 0 19 0 32 1 19 0 3 24 0 0 0 2 6 2 11 0 19 0 13 1 13 14 2 11 0 7 32 3 0 0 18 10 19 
5 0 17 36 2 0 33 1 39 3 8 16 0 6 2 7 10 10 13 0 0 2 0 0 9 11 8 0 20 12 3 2 12 8 0 0 0 15 0 42 4 10 2 27 
0 16 30 31 0 0 0 1 0 2 2 5 26 6 0 0 2 0 0 26 9 0 13 11 0 0 0 15 0 11 11 0 30 11 45 18 0 0 5 0 53 21 0 1 
17 0 1 35 5 0 3 30 0 31 14 0 0 25 5 0 17 8 7 11 0 13 17 0 0 7 0 0 4 0 12 0 17 23 13 10 0 33 47 0 0 0 83 0 
19 0 23 1 52 28 20 1 1 2 18 69 6 5 0 40 5 27 13 1 0 0 7 0 3 0 0 32 5 0 18 7 37 64 0 24 8 1 51 0 52 2 23 13 
17 0 0 0 27 11 5 21 0 5 1 2 21 0 0 9 9 0 14 0 0 0 0 0 14 0 11 0 1 0 5 27 0 0 0 0 0 30 0 0 4 0 34 0 
57 4 0 0 3 0 17 6 0 2 0 18 0 4 10 4 0 38 0 41 17 21 2 6 4 7 0 14 13 20 5 11 0 4 14 18 0 4 32 29 31 7 1 41 
0 6 0 3 0 0 11 0 0 0 0 2 0 24 0 9 0 0 18 0 0 0 0 10 0 0 0 0 0 0 0 0 0 16 7 15 8 0 0 6 8 6 2 0 
23 0 0 9 0 0 21 0 18 13 0 0 9 0 0 0 0 21 0 0 0 0 0 14 40 20 21 21 14 0 0 19 0 0 0 0 0 21 21 0 0 8 10 9 
