44 25
0 0 0 22 26 13 37 0 0 0 2 0 5 19 0 28 14 0 7 2 4 8 0 0 7 26 6 2 29 25 33 0 19 18 4 0 0 0 12 0 20 0 0 65 
0 0 0 17 18 0 0 0 0 21 3 0 16 0 0 20 0 0 0 0 20 6 0 0 19 26 1 0 2 8 18 8 0 0 0 23 2 0 0 2 7 0 19 19 
0 0 9 9 8 0 0 2 14 2 0 1 18 0 0 0 7 0 0 0 4 0 0 7 26 0 19 0 2 0 10 0 14 0 0 0 9 25 26 3 10 0 0 0 
21 0 0 59 11 19 13 53 16 6 30 19 9 0 0 21 0 1 23 33 7 28 0 16 0 3 9 13 0 19 30 0 23 30 27 6 2 16 0 34 0 23 57 0 
17 0 41 0 0 17 0 0 7 0 3 24 10 16 2 12 18 20 0 0 21 10 17 0 28 0 0 0 18 0 0 23 0 31 0 62 12 20 47 26 0 0 8 0 
16 0 0 19 0 0 0 21 0 26 0 0 47 26 11 0 14 3 12 2 15 18 0 20 0 0 0 2 4 0 7 1 0 10 7 29 4 0 17 0 15 21 0 21 
39 0 17 0 20 25 25 5 0 11 0 16 23 0 11 11 0 0 6 0 5 7 21 0 20 2 10 7 0 0 18 25 6 1 4 0 2 0 8 17 15 3 0 41 
39 0 22 0 16 35 0 0 12 36 0 12 0 0 0 12 11 0 0 0 10 18 16 17 22 0 0 14 0 10 0 0 0 0 0 0 27 0 13 67 26 0 0 0 
13 0 29 38 16 0 34 0 56 21 0 16 12 11 49 7 20 19 4 37 0 0 34 0 10 0 15 27 36 13 40 31 6 2 34 0 3 0 0 16 41 50 47 4 
0 0 34 0 0 10 0 0 0 0 0 20 0 0 0 0 9 13 27 0 0 9 4 0 0 23 4 14 0 0 15 0 0 0 0 0 40 12 20 0 0 1 6 2 
4 0 11 0 0 0 14 0 0 0 0 8 0 1 0 0 0 6 0 6 21 0 2 10 3 0 0 5 0 0 5 0 0 0 6 0 0 0 0 0 5 0 0 0 
9 0 0 0 15 0 0 0 5 39 0 0 24 0 0 4 8 3 12 11 10 0 0 0 20 0 10 9 0 0 0 0 0 25 0 11 12 0 4 10 1 3 0 34 
0 50 0 2 0 37 0 16 0 9 45 0 10 31 7 0 12 17 9 0 25 1 18 0 0 19 1 6 8 47 0 7 0 13 10 0 9 0 2 29 30 28 67 0 
15 0 0 34 0 0 0 0 23 28 9 7 14 12 0 0 0 8 18 0 6 6 5 13 3 2 9 0 28 16 2 26 2 0 13 1 4 6 0 7 4 29 0 7 
0 11 50 80 0 9 14 0 29 14 27 30 3 0 35 23 14 4 0 0 36 0 8 7 1 0 11 0 5 0 21 2 30 5 14 0 13 50 13 0 7 21 44 1 
8 0 43 0 23 0 0 0 0 6 0 0 23 0 0 8 26 0 6 12 0 34 0 18 4 15 7 0 3 28 5 0 0 10 0 13 0 4 22 14 0 42 0 41 
0 23 0 0 0 3 0 0 41 13 0 0 19 0 0 0 11 7 9 2 15 10 10 0 9 3 0 13 0 8 3 6 0 11 0 0 0 0 7 10 43 0 7 0 
0 0 41 39 29 0 0 18 0 19 4 4 0 9 0 11 0 0 0 0 13 0 20 0 37 0 0 0 9 0 0 0 0 7 44 12 0 0 13 0 7 20 39 62 
0 0 23 17 39 0 0 6 0 0 0 14 0 0 0 0 19 1 10 4 0 6 0 0 0 38 0 0 8 0 0 0 0 18 0 8 0 0 21 11 0 0 0 47 
0 0 17 20 22 25 0 0 28 0 13 12 0 11 20 0 11 11 0 23 13 13 0 20 0 1 0 14 24 19 3 0 4 0 17 30 9 0 28 0 0 5 0 0 
75 18 0 9 0 0 0 0 31 26 4 14 15 0 26 0 0 3 6 35 10 0 0 0 0 9 24 0 0 5 0 0 0 39 8 26 0 26 0 37 23 4 61 0 
13 0 11 2 4 10 0 0 1 29 0 1 0 14 1 0 0 12 6 6 2 0 0 1 1 6 0 10 16 0 0 0 11 0 0 8 0 19 12 12 0 0 0 21 
18 10 73 0 0 0 0 14 1 24 0 21 0 0 3 0 11 0 32 7 9 7 0 4 26 16 14 0 11 11 11 0 0 0 5 11 34 0 0 4 0 39 21 25 
4 0 21 9 0 9 0 20 0 0 0 0 23 26 1 0 38 2 4 0 0 0 10 1 0 29 0 22 14 0 2 0 15 0 0 0 34 7 14 26 24 39 2 2 
2 7 13 14 29 0 14 0 8 0 3 1 0 17 0 60 12 10 0 0 0 27 16 2 0 0 9 0 0 0 17 0 0 29 0 0 0 0 4 0 0 54 27 0 
