44 25
0 0 29 35 35 11 0 34 9 51 1 5 0 0 21 12 17 0 14 0 0 0 15 9 0 0 23 0 0 5 0 17 2 0 22 0 0 0 0 0 9 32 8 43 
0 0 0 9 22 0 0 21 24 3 0 0 22 25 0 0 14 0 0 0 0 10 12 8 3 0 12 5 1 6 9 8 31 0 7 0 0 0 13 15 0 8 3 9 
0 0 0 0 22 7 11 0 0 0 0 22 15 3 0 9 22 2 0 22 0 21 8 2 5 0 18 0 7 16 0 0 12 0 2 48 9 0 11 0 3 0 44 1 
0 0 0 0 0 21 29 25 0 0 0 0 0 27 8 0 5 4 0 0 0 0 5 0 2 0 7 5 0 0 14 17 1 7 21 50 7 30 0 1 10 0 0 20 
5 0 0 0 0 0 0 9 0 15 17 0 0 7 2 5 10 1 29 0 6 0 0 2 6 9 5 11 0 10 0 0 2 9 0 10 34 0 6 7 25 0 0 20 
0 0 0 16 31 16 18 11 13 14 5 17 0 2 0 0 0 0 13 41 11 4 0 22 20 0 21 32 14 0 0 6 0 0 25 42 0 6 31 18 4 18 14 2 
27 38 12 0 29 13 0 4 0 27 6 3 16 11 12 0 15 0 11 0 12 10 9 0 15 7 4 30 0 13 7 9 8 61 21 6 13 0 0 49 0 17 5 15 
0 24 15 0 0 12 0 7 23 6 6 12 10 0 0 6 6 1 0 14 0 0 0 7 22 18 5 2 0 6 15 12 2 0 7 0 9 0 7 1 3 0 11 13 
9 13 46 0 0 0 0 54 0 54 0 14 1 0 4 17 0 21 22 0 0 2 0 0 17 16 0 0 2 0 0 24 17 3 15 4 25 0 0 32 53 39 8 0 
41 65 49 14 11 42 1 28 8 33 22 8 9 15 5 11 18 1 6 8 3 16 32 5 41 0 21 15 20 14 9 0 15 17 9 1 1 0 27 23 62 38 0 52 
19 0 0 0 0 23 8 26 0 0 30 32 25 0 18 15 6 4 0 12 0 1 8 13 3 10 0 19 26 18 17 24 1 0 0 25 13 0 20 9 8 0 0 13 
0 36 0 0 53 10 0 34 0 0 11 5 11 1 7 0 0 12 1 26 21 11 0 0 11 0 25 0 11 4 2 2 2 4 3 0 0 3 10 22 3 21 46 39 
8 28 12 0 0 33 0 29 0 17 0 30 0 10 12 0 2 0 1 12 0 12 0 0 10 0 0 0 3 29 9 0 13 9 0 8 0 0 12 0 9 0 40 13 
19 0 41 0 0 0 0 0 0 2 0 19 13 0 0 0 0 0 0 6 0 0 12 7 25 13 0 0 10 0 12 0 0 0 34 0 0 35 27 15 0 0 8 19 
0 0 0 0 5 0 0 0 0 0 0 12 7 0 27 20 0 0 21 0 0 3 0 7 3 0 0 0 0 0 11 0 1 0 7 20 4 6 0 21 0 16 0 6 
37 13 0 0 0 0 0 0 0 12 0 68 0 4 20 0 14 6 0 0 19 12 12 0 0 3 15 0 0 0 0 2 1 20 6 0 25 0 0 39 0 0 0 6 
24 0 39 4 0 0 32 17 0 14 0 0 0 7 0 0 12 25 0 0 0 5 21 14 11 0 12 0 12 8 0 15 0 10 0 25 0 4 6 18 1 57 30 58 
9 28 29 0 0 0 6 11 17 5 0 4 5 0 0 23 0 5 11 3 0 20 3 0 5 17 0 0 1 28 5 43 0 7 0 0 10 7 7 11 0 0 27 42 
0 0 13 3 0 0 0 5 13 0 0 7 0 0 11 0 0 0 18 5 0 0 0 3 0 0 0 8 0 27 1 0 0 0 0 12 6 0 2 0 0 2 44 0 
12 0 0 0 9 5 0 16 0 0 0 13 5 6 0 0 0 12 0 3 0 7 12 18 11 0 0 14 0 0 30 0 13 12 0 17 3 18 0 0 19 0 0 0 
62 0 32 4 0 31 6 30 15 20 37 11 0 7 2 0 0 0 0 0 5 5 0 13 4 28 16 16 3 9 0 5 14 15 0 12 63 0 0 0 0 41 0 29 
12 13 32 3 0 0 5 4 0 0 17 0 29 0 0 0 9 15 0 17 0 0 0 0 23 0 12 1 4 17 0 1 0 0 0 0 8 0 0 0 0 0 8 15 
52 39 0 34 20 0 0 0 12 17 2 0 0 0 5 0 24 14 0 36 0 7 14 0 12 25 10 27 14 0 0 0 0 0 0 9 4 21 32 0 24 0 10 24 
38 0 0 19 7 0 3 20 0 0 29 42 10 19 0 9 0 0 0 7 18 9 31 0 10 14 15 0 38 0 0 12 0 29 10 0 13 0 32 30 0 5 6 0 
5 0 0 0 0 4 0 3 0 0 24 0 0 0 2 0 22 0 6 0 0 16 0 22 6 0 0 10 4 7 25 0 6 13 0 22 7 0 34 11 0 18 0 20 
