44 25
0 0 15 0 23 0 0 0 19 0 1 1 5 0 29 0 0 20 20 0 12 0 10 17 1 21 0 39 0 0 0 23 18 0 0 0 2 15 22 0 0 0 0 0 
0 20 3 38 23 22 15 0 0 23 7 0 0 2 8 15 60 16 0 13 23 0 0 0 13 8 0 5 0 21 9 16 46 5 28 3 0 0 0 0 34 38 26 0 
27 30 18 3 0 24 15 34 0 0 2 0 17 0 0 0 0 25 6 19 0 12 6 10 17 0 16 62 0 2 1 58 0 20 31 8 0 4 20 0 20 42 90 27 
3 0 21 83 0 0 0 23 24 5 19 0 1 0 0 0 32 15 0 0 49 0 16 0 16 0 0 18 26 9 33 15 10 7 0 0 5 0 15 19 37 5 105 0 
52 38 17 12 40 24 34 2 10 18 1 22 11 4 0 3 9 15 24 0 4 5 0 2 16 16 12 2 12 50 30 11 9 17 40 10 15 12 12 9 46 7 13 37 
9 10 16 4 0 18 0 10 26 25 0 1 1 0 0 7 15 0 51 24 1 7 0 32 0 0 20 0 20 0 0 15 4 0 43 0 27 0 0 21 0 0 10 24 
0 0 0 0 0 4 14 1 0 18 12 35 17 0 5 0 7 6 0 5 25 6 12 7 0 0 6 17 1 22 0 0 1 0 0 3 0 30 0 0 0 2 10 23 
28 0 41 4 3 0 6 0 0 5 20 0 23 0 0 0 14 0 7 25 7 0 0 0 0 8 0 12 14 0 4 0 32 0 0 23 6 3 19 8 14 0 18 41 
0 0 27 0 4 45 0 12 0 23 0 0 24 0 9 0 0 10 0 0 4 14 4 0 0 23 0 0 0 17 0 5 8 0 1 18 32 0 0 6 0 36 0 10 
17 0 38 52 0 0 7 2 2 1 10 0 0 0 10 0 0 12 0 15 4 0 7 16 17 6 35 1 0 7 0 0 29 6 1 0 0 11 0 6 17 0 0 0 
14 0 35 0 0 32 0 31 25 0 35 0 8 21 0 0 0 0 0 16 4 10 6 1 4 14 0 17 0 13 0 10 7 18 21 0 0 0 18 0 33 19 2 0 
4 8 11 9 0 4 0 19 0 21 15 0 9 30 0 11 0 0 0 0 10 0 13 20 9 12 16 0 0 1 0 0 11 0 0 12 2 3 2 0 2 1 0 21 
0 1 12 35 26 0 0 0 5 0 30 3 0 0 0 0 0 6 0 2 12 12 0 20 21 18 0 0 0 0 26 0 39 0 12 18 0 30 0 0 0 4 12 41 
0 9 0 4 0 0 0 4 0 0 0 29 0 0 0 10 14 0 0 0 11 0 0 8 0 10 0 5 17 0 0 6 0 0 18 0 0 16 0 6 0 0 0 20 
0 19 10 9 5 0 20 22 11 0 4 0 36 0 0 16 0 0 12 0 24 0 0 0 13 0 0 17 0 4 0 8 0 23 3 8 9 19 19 6 0 0 0 0 
0 0 0 36 8 7 42 0 11 24 0 0 0 9 0 9 22 0 0 11 0 0 0 0 1 0 0 0 0 0 0 0 3 24 0 7 0 12 22 3 8 0 5 0 
11 0 25 10 0 5 0 19 1 26 13 1 0 0 7 0 10 19 9 0 7 0 0 0 1 7 19 11 2 0 12 0 8 0 0 0 8 6 0 0 0 0 4 6 
17 5 67 41 0 0 15 0 18 4 15 1 10 4 0 12 0 21 18 3 12 0 19 0 14 22 0 11 5 0 14 28 50 0 0 64 30 0 14 37 0 0 14 0 
44 8 4 22 9 0 20 4 8 33 17 0 32 5 0 3 0 14 0 18 7 0 0 18 0 0 4 35 8 17 11 23 13 4 9 0 36 18 0 0 0 29 1 35 
1 0 25 0 5 0 0 0 19 33 0 7 19 0 11 1 6 4 26 0 23 4 6 14 3 12 14 15 0 0 12 24 0 0 7 2 2 14 0 0 0 0 33 32 
4 0 12 0 4 30 28 0 42 0 0 2 0 14 0 0 17 0 0 0 11 0 0 15 9 0 0 14 0 0 3 1 8 0 35 3 0 0 10 0 0 7 14 0 
0 20 0 16 14 0 0 0 7 4 0 0 0 4 0 20 25 0 8 0 17 6 11 0 7 11 0 8 14 0 0 12 0 0 0 15 20 2 7 2 0 0 0 25 
25 16 6 0 0 12 22 0 22 20 17 37 13 0 1 23 0 8 10 2 20 1 8 0 0 0 0 20 5 37 3 3 7 0 17 36 24 10 2 0 18 27 27 0 
0 16 9 0 0 22 18 0 0 0 0 5 1 7 4 0 5 3 20 19 0 2 0 0 41 0 9 3 0 2 27 40 7 0 0 5 0 2 39 0 31 35 0 0 
14 0 0 0 23 12 33 32 0 0 7 0 5 4 0 0 14 8 19 15 26 0 0 0 0 0 0 9 0 14 20 0 12 43 19 2 13 8 0 1 13 0 0 0 
