44 25
5 0 0 37 5 5 0 0 0 0 0 17 0 30 3 10 27 0 32 0 16 0 0 12 9 0 0 0 0 0 22 0 0 3 0 0 1 1 1 12 44 6 4 56 
30 41 47 0 0 0 22 0 19 0 0 16 0 0 23 0 0 0 8 0 0 4 14 5 0 4 0 1 22 0 2 0 21 6 6 0 0 23 0 6 16 0 14 1 
0 80 0 16 20 0 0 7 52 33 2 0 0 3 7 0 3 16 0 21 16 4 21 0 5 4 0 13 28 6 0 0 2 16 0 0 16 0 0 0 0 0 33 23 
2 37 2 16 0 0 15 0 25 0 0 0 0 0 0 12 0 0 0 30 9 0 10 0 0 0 17 8 0 0 9 7 20 28 5 0 9 0 76 4 12 0 19 16 
0 0 0 14 0 16 0 0 0 26 14 0 0 0 28 0 0 37 3 0 0 0 0 0 2 0 0 10 0 3 2 0 12 10 4 26 12 0 0 16 23 0 28 10 
0 34 0 0 8 0 0 0 11 15 0 0 0 17 0 24 0 0 24 0 19 21 4 6 18 0 0 0 0 0 17 6 0 0 0 6 37 1 0 35 0 6 15 0 
71 13 35 36 35 0 36 22 11 0 0 0 0 0 17 0 20 10 28 0 0 25 1 0 2 0 13 0 0 22 10 9 0 2 0 33 56 18 0 20 0 41 17 0 
16 19 82 0 14 3 31 0 0 0 9 11 2 25 3 5 18 1 0 0 24 0 10 0 9 15 5 4 21 19 14 0 5 7 9 0 2 0 32 0 78 0 13 9 
0 25 52 26 0 12 0 6 4 12 8 8 28 3 0 5 6 7 7 10 12 0 0 1 20 4 25 9 19 30 14 0 0 21 0 0 16 1 36 2 0 0 0 52 
0 0 15 46 64 35 24 0 15 0 15 2 0 2 0 6 0 20 5 0 4 10 23 5 13 22 0 0 0 0 72 0 0 0 0 0 11 20 10 9 41 0 15 4 
74 6 0 15 0 0 0 2 10 0 0 0 0 12 9 5 0 0 0 19 3 1 0 0 6 12 4 22 14 7 0 0 0 0 20 0 0 2 4 10 41 1 0 25 
0 0 10 3 0 0 0 0 9 0 2 0 0 0 0 0 0 0 0 0 0 0 0 6 0 0 0 11 0 7 0 0 7 0 0 0 5 8 2 0 0 0 0 0 
0 24 38 0 0 0 5 32 4 1 0 11 6 34 13 0 8 0 24 7 25 0 0 0 32 0 11 14 9 17 0 10 0 20 2 0 25 7 0 32 0 11 5 10 
0 18 0 26 39 7 26 32 12 30 1 22 0 29 0 0 6 0 3 18 12 0 10 0 2 0 0 8 15 11 22 0 14 26 24 25 8 14 35 33 50 0 49 21 
0 0 44 3 15 0 0 1 31 18 7 0 0 0 0 0 0 0 0 3 13 0 0 0 2 13 6 25 14 0 0 0 0 0 0 5 7 0 17 31 0 0 14 41 
0 0 0 3 0 0 20 34 11 0 0 7 7 5 6 0 0 14 2 0 8 1 6 17 1 0 0 0 7 0 0 0 0 0 17 7 0 0 0 4 45 0 0 0 
0 20 12 5 0 70 29 1 28 8 12 0 0 7 14 16 0 19 2 29 29 3 0 2 20 14 14 9 1 8 0 24 28 0 27 0 0 32 7 21 0 0 0 46 
0 12 42 0 31 0 23 36 30 0 11 22 0 10 0 2 5 0 5 14 11 11 2 12 0 0 0 0 3 16 0 0 14 13 6 31 8 0 30 1 9 39 35 0 
8 2 0 4 0 0 7 0 18 15 18 5 12 14 4 7 21 1 4 10 0 1 10 0 33 0 0 16 0 3 0 0 19 0 32 13 7 16 1 10 0 0 0 0 
10 0 0 0 24 11 0 0 32 46 10 0 0 0 4 0 18 3 19 7 0 20 18 20 0 10 0 3 0 0 2 0 0 0 55 5 5 12 10 3 50 0 21 29 
11 7 18 0 0 2 0 0 37 27 1 11 0 0 15 0 0 15 0 0 34 16 1 0 16 0 21 19 0 20 11 0 15 0 19 0 1 3 17 28 0 0 0 19 
36 0 30 3 0 15 0 0 0 0 18 23 0 0 0 0 31 14 0 1 16 7 23 2 0 0 8 5 19 0 0 0 0 0 8 0 9 1 1 0 13 7 0 0 
0 0 65 21 45 22 0 18 9 0 7 0 0 5 4 12 0 2 11 4 32 0 2 11 6 13 5 4 21 0 51 21 15 0 0 31 6 13 6 0 0 0 10 0 
2 18 0 0 28 0 33 7 1 0 11 28 3 51 8 0 0 3 0 7 0 7 1 1 18 0 0 0 17 8 0 1 23 0 0 0 26 11 24 29 0 28 6 7 
15 28 31 13 17 20 10 0 15 10 0 27 23 10 30 18 17 0 5 0 0 0 2 10 13 20 18 32 0 26 2 0 18 0 8 6 5 15 19 2 22 0 17 0 
