44 25
7 12 32 0 0 15 6 0 15 40 0 16 0 0 22 26 11 27 0 0 0 6 25 16 1 0 11 27 0 12 0 29 20 0 0 20 12 28 24 0 0 0 20 0 
27 55 0 24 0 27 0 26 0 22 0 20 8 0 0 22 2 0 16 0 11 0 16 23 0 0 1 34 0 0 0 26 27 30 0 4 10 10 21 12 0 31 13 42 
0 26 0 0 0 14 0 0 23 20 0 0 17 6 22 13 0 0 25 41 11 0 5 0 16 0 4 1 17 0 0 0 21 7 23 0 22 0 0 1 43 0 0 10 
0 0 0 12 0 0 23 0 0 0 0 4 17 10 37 43 0 0 19 3 4 1 0 10 18 0 19 6 12 32 0 0 0 0 5 0 2 0 2 25 12 0 11 0 
32 0 37 0 18 0 9 17 0 10 10 12 2 0 2 42 0 0 0 0 3 0 5 13 0 0 4 6 0 0 0 0 32 0 0 8 21 7 0 17 0 0 8 0 
32 9 57 37 0 7 32 0 16 33 31 0 0 1 8 28 17 0 17 0 3 9 0 16 19 17 0 3 23 31 37 29 36 3 0 0 0 0 15 16 2 0 35 25 
0 0 28 8 60 0 17 0 0 7 29 8 0 1 17 0 2 0 0 22 18 0 35 5 0 3 9 6 0 17 31 5 28 3 7 0 2 0 17 21 3 22 5 26 
4 0 0 0 0 6 11 0 0 24 27 33 0 0 0 24 2 0 0 13 15 0 0 1 24 13 0 1 8 0 0 6 7 24 4 6 1 27 12 0 29 25 29 59 
42 0 26 0 22 0 3 0 0 35 11 46 5 0 8 0 0 0 10 16 27 11 13 0 0 0 0 2 6 0 26 9 5 0 10 0 0 37 29 0 14 0 0 44 
0 39 0 0 0 0 27 0 17 33 0 0 0 0 24 0 0 0 0 11 33 6 13 0 0 0 2 24 1 0 0 0 4 27 0 12 7 2 30 0 54 14 33 56 
0 30 0 30 0 33 0 0 0 0 12 5 7 0 9 0 0 1 15 0 8 0 0 0 0 3 7 0 0 24 10 30 0 0 17 0 0 34 0 0 0 0 9 0 
4 51 32 0 0 0 0 36 0 43 26 3 0 0 0 62 1 1 0 0 0 12 13 0 0 2 25 30 7 0 0 2 4 33 13 8 12 29 0 15 13 10 5 35 
43 52 8 0 0 0 23 29 23 37 23 0 8 0 0 0 0 39 2 1 26 13 0 0 0 0 0 0 1 23 0 0 3 53 58 6 31 0 0 22 0 0 0 7 
19 10 0 27 27 26 8 0 0 0 14 4 6 0 17 6 5 0 0 15 5 7 0 20 47 0 0 0 6 0 11 27 14 0 22 6 0 10 35 15 7 41 12 0 
0 40 45 0 0 0 3 25 21 3 7 21 2 7 29 41 20 16 20 2 25 6 21 0 1 0 15 18 14 24 0 5 0 2 2 20 15 32 0 33 12 5 16 60 
2 0 0 0 15 12 0 0 1 7 5 5 27 0 24 0 0 5 0 0 13 14 0 8 0 0 0 7 7 0 0 0 0 0 8 0 0 0 29 23 20 20 4 4 
0 0 0 0 0 16 0 15 0 0 0 0 19 0 0 1 18 0 0 4 13 0 15 0 0 0 12 0 5 6 0 0 0 22 0 0 7 2 0 15 2 8 12 7 
68 15 0 0 35 0 18 4 21 6 12 0 4 0 0 6 12 0 0 0 6 0 2 0 9 25 0 21 27 14 0 3 0 17 15 0 0 37 15 41 0 0 0 5 
0 36 0 0 14 23 0 5 0 0 0 0 27 25 4 0 0 0 0 0 1 2 12 14 19 6 0 6 17 0 4 4 0 0 4 4 4 36 25 34 2 3 0 28 
0 0 0 0 1 31 0 0 0 0 0 0 0 0 0 5 0 0 0 11 0 0 0 16 2 0 2 0 0 0 11 2 17 14 0 18 0 15 12 0 0 0 0 0 
0 31 27 7 14 0 0 27 0 6 24 0 0 32 10 0 0 0 11 15 0 17 0 10 8 0 24 1 0 52 6 5 28 1 27 14 6 0 0 1 19 8 0 0 
40 0 18 11 0 23 0 43 16 30 0 0 12 8 0 0 10 22 13 12 11 0 3 5 21 0 0 34 0 27 1 14 2 26 44 0 5 0 16 53 0 26 0 0 
14 18 0 29 10 14 0 0 5 0 12 8 26 7 0 1 0 21 4 35 9 0 10 0 0 0 2 0 0 9 0 11 39 0 0 0 0 0 6 0 34 0 0 0 
0 0 0 22 8 38 0 22 31 46 0 0 1 0 27 21 4 0 0 0 4 9 0 17 0 0 0 18 0 0 2 4 0 0 19 14 0 10 0 31 0 27 0 38 
30 31 16 0 0 0 0 29 12 0 0 24 25 0 0 15 3 0 10 16 15 0 16 14 3 14 0 16 21 21 26 0 31 26 16 28 0 14 34 3 14 34 22 0 
