44 25
37 27 0 38 30 22 14 38 0 31 41 19 0 4 7 0 0 14 23 0 13 2 21 2 0 7 9 5 8 23 13 10 25 19 41 18 5 40 1 10 1 6 9 20 
0 16 23 3 1 31 0 9 8 0 0 0 0 0 0 0 9 0 13 19 0 0 0 0 0 1 0 17 25 0 0 13 18 0 0 0 0 29 6 0 0 0 0 0 
0 19 0 0 0 34 0 0 0 4 0 31 0 0 0 27 7 9 17 0 7 2 2 9 0 0 5 0 0 0 4 0 36 0 8 4 0 14 0 4 0 0 4 38 
1 16 3 0 36 24 0 0 0 29 28 0 13 0 1 5 11 24 10 19 14 0 0 10 9 12 6 2 14 2 5 0 9 19 14 51 2 0 7 13 25 36 36 15 
7 12 0 32 0 12 6 71 0 4 32 0 39 9 5 18 15 0 14 0 0 13 0 12 0 17 0 20 13 0 1 36 8 2 16 44 0 13 1 39 8 29 56 36 
34 0 0 0 0 0 0 54 0 39 18 5 0 0 2 0 2 18 0 3 2 16 15 16 0 0 0 1 0 0 9 0 0 15 59 0 0 0 0 0 34 0 0 36 
33 0 0 0 22 6 0 0 0 0 0 5 0 0 7 16 3 0 0 13 17 15 9 3 0 0 37 4 0 0 0 47 10 6 14 0 3 0 0 20 2 15 0 0 
0 0 71 0 0 0 1 1 6 29 54 27 0 0 0 0 0 5 6 0 17 13 0 0 14 0 10 11 0 0 22 0 0 0 0 0 18 35 74 0 30 4 0 0 
6 19 78 0 0 3 17 13 0 4 0 8 6 0 3 5 2 9 4 3 27 0 0 17 2 17 0 30 9 2 5 0 10 6 4 0 16 0 0 5 39 14 28 8 
57 16 15 9 39 0 46 18 9 31 0 0 0 5 0 6 0 54 3 15 0 1 0 9 15 12 7 8 10 0 0 0 17 9 9 0 0 5 6 15 37 49 10 4 
0 5 0 21 9 39 0 12 0 0 0 0 10 52 0 0 1 0 0 18 0 1 0 0 19 17 0 0 15 0 0 0 0 15 0 7 0 0 5 0 0 9 17 38 
0 16 0 16 55 16 10 9 0 14 7 0 9 0 7 17 5 19 0 0 0 0 0 9 7 0 0 9 25 2 0 20 26 28 0 11 0 0 0 0 0 0 20 0 
0 0 0 2 0 30 0 5 0 0 5 28 0 0 0 31 7 8 20 0 0 0 0 3 0 16 11 0 23 0 3 0 0 6 0 4 0 0 0 18 18 7 0 0 
13 0 0 21 27 11 0 0 0 0 0 0 9 0 5 0 0 0 4 19 15 9 0 0 21 0 7 0 0 2 9 53 0 0 13 0 0 0 0 0 0 10 0 0 
0 22 0 9 21 6 73 1 30 41 22 0 30 17 0 9 37 5 6 3 5 0 8 0 15 21 0 0 15 1 8 30 30 0 0 29 0 31 30 0 11 0 23 40 
0 14 36 38 2 6 2 25 0 0 0 6 67 8 0 0 0 0 22 0 2 7 0 9 8 15 5 0 0 5 0 2 6 0 0 15 4 25 30 3 15 23 24 31 
26 0 0 0 0 12 17 0 0 0 0 5 0 0 0 0 0 0 16 0 0 0 0 22 0 8 27 8 0 6 0 8 0 0 0 0 0 14 0 2 0 13 5 8 
11 0 10 0 1 1 0 7 0 0 0 26 5 22 0 0 0 7 20 3 0 0 17 19 0 11 0 0 31 0 0 0 7 0 0 7 34 26 14 10 0 26 25 0 
0 0 39 4 0 2 0 52 0 0 0 61 10 1 0 9 2 0 7 0 0 14 0 51 11 9 4 33 0 18 4 0 0 29 10 30 36 14 15 2 29 57 35 0 
7 10 30 3 22 0 13 10 0 14 0 27 35 0 12 0 0 17 17 1 17 33 0 4 0 18 18 11 10 27 0 0 28 1 5 0 12 3 0 3 0 11 9 2 
8 0 0 0 4 16 33 20 30 0 0 25 16 7 9 9 0 25 0 16 7 34 0 1 0 0 0 14 7 9 22 0 13 15 55 17 7 0 4 2 11 30 13 0 
40 40 23 0 0 11 0 14 33 0 0 10 16 22 45 9 5 12 24 0 5 16 5 6 0 12 0 17 0 13 27 1 0 0 8 34 22 59 0 0 40 45 24 0 
27 1 5 51 35 11 38 8 0 16 0 19 15 0 18 9 9 0 10 19 0 7 5 2 13 29 22 24 10 0 0 0 20 0 0 18 0 0 27 20 0 0 39 0 
0 25 0 0 0 0 0 4 0 0 0 0 1 4 0 0 0 18 24 0 0 13 0 0 8 0 0 1 0 0 11 0 14 0 1 0 0 1 5 0 0 24 20 0 
0 0 31 17 0 0 0 0 0 0 0 7 0 24 1 4 7 0 0 22 12 0 2 41 0 0 0 15 0 0 19 0 5 45 0 0 23 0 0 7 37 18 0 0 
