44 25
0 5 38 0 37 29 0 27 0 0 0 26 0 0 8 23 25 0 0 7 1 1 0 34 5 7 9 0 18 0 23 0 9 0 0 9 3 32 0 19 58 38 0 0 
4 0 15 7 25 0 0 0 25 18 0 1 3 0 40 7 12 0 4 0 0 8 0 1 0 5 0 20 0 55 16 0 0 38 23 0 0 0 19 0 1 4 0 19 
13 9 6 0 26 56 0 23 0 38 14 0 0 11 7 18 6 0 14 2 0 0 9 0 23 0 0 22 19 0 0 0 0 16 0 0 0 0 0 2 36 0 20 0 
36 15 23 40 42 3 24 6 32 15 0 0 6 11 2 27 24 20 3 41 43 46 22 2 0 0 17 45 5 0 9 0 40 12 7 13 33 88 17 2 32 28 4 0 
13 85 3 29 31 0 0 0 0 21 6 0 2 0 14 16 19 11 0 0 0 0 5 20 23 0 3 0 13 7 0 16 32 18 0 28 27 0 0 0 0 27 0 54 
4 2 2 31 11 3 6 0 1 47 21 27 1 1 1 14 6 0 0 0 57 19 2 0 0 0 0 0 0 7 0 0 0 0 0 0 16 34 33 0 24 21 0 34 
26 0 25 73 4 35 3 0 19 20 4 0 0 0 28 8 0 15 4 4 6 0 8 19 0 4 9 19 0 50 0 10 2 7 12 0 33 0 24 37 38 3 0 54 
0 37 27 0 5 0 16 32 0 30 16 11 2 6 3 7 0 2 0 14 0 9 0 0 0 4 21 0 18 61 0 0 23 0 0 20 35 0 5 26 1 0 0 4 
0 13 2 28 0 0 21 20 12 5 0 0 11 18 0 8 7 0 0 7 0 50 0 7 0 17 0 47 0 0 25 18 6 0 0 14 0 0 0 9 20 0 0 0 
0 27 0 32 27 0 62 11 0 0 0 0 20 0 0 29 19 0 20 4 11 21 0 0 14 8 2 3 0 1 5 41 20 0 33 1 21 8 66 9 3 0 1 0 
0 21 17 20 35 0 0 34 27 0 3 19 30 7 0 37 6 0 0 14 0 20 8 20 0 15 0 22 0 11 32 0 7 11 0 4 0 0 9 0 0 0 53 0 
43 31 7 0 28 0 0 38 0 15 9 0 23 16 0 0 0 0 13 1 4 0 0 5 9 5 0 0 0 0 0 0 35 4 0 0 18 0 32 3 33 0 11 16 
9 4 38 0 3 0 12 33 4 0 0 2 1 2 6 3 7 1 18 3 0 0 0 0 14 3 0 0 0 5 0 0 12 0 0 0 0 19 19 0 1 0 0 1 
27 6 0 0 38 14 7 21 0 5 0 23 9 4 3 0 10 15 24 8 11 0 0 0 18 10 0 0 21 0 4 11 14 0 42 22 0 37 0 0 2 43 67 1 
0 5 11 0 7 0 0 24 8 0 0 0 0 4 38 1 8 0 3 6 4 0 0 4 4 1 7 23 0 7 14 26 0 7 0 0 7 0 0 0 14 0 0 0 
38 19 14 0 14 30 9 6 0 0 15 0 2 35 8 1 14 24 13 16 29 0 0 0 7 10 0 0 0 0 5 0 4 4 17 50 4 0 0 20 19 22 32 25 
0 0 0 3 0 0 10 5 1 1 0 0 0 0 0 2 0 6 0 0 0 45 0 0 0 0 9 0 0 10 2 2 0 0 0 13 15 0 0 0 19 21 0 28 
45 36 0 0 0 0 0 0 0 7 28 0 0 5 29 24 0 38 3 1 2 0 0 0 0 16 0 0 28 12 0 0 16 6 0 0 0 44 49 40 0 0 0 0 
12 1 7 0 11 0 12 16 0 3 1 77 0 0 5 0 0 0 32 0 9 10 0 0 0 0 15 9 18 0 0 4 0 22 0 3 0 0 17 36 6 0 31 0 
14 14 17 1 4 0 0 0 0 3 0 0 3 15 0 7 0 16 0 1 1 31 13 13 0 5 0 0 15 0 15 0 7 30 3 1 1 3 0 7 19 0 0 0 
5 11 14 14 1 39 20 3 45 0 31 0 0 0 0 11 15 0 0 0 22 0 0 0 0 0 14 19 0 0 2 17 19 0 26 29 21 5 0 34 0 27 23 18 
0 13 0 0 0 8 39 6 29 0 0 0 14 0 0 0 0 15 6 19 26 18 16 6 0 2 7 20 0 23 0 0 0 0 0 0 0 28 2 19 2 22 0 0 
23 40 0 22 0 0 21 39 4 20 0 0 17 0 0 8 0 0 0 0 0 0 0 7 17 31 19 0 0 10 14 26 19 18 7 0 0 0 0 37 0 33 11 0 
0 42 0 21 1 22 20 15 0 0 0 50 16 10 28 18 9 25 8 36 0 0 0 0 21 0 19 20 16 22 0 20 0 0 0 10 0 17 33 0 3 30 25 18 
78 0 0 0 20 0 3 24 4 0 0 0 19 0 2 7 1 10 0 12 7 35 8 19 12 10 0 0 13 0 0 12 3 6 28 0 36 7 0 17 0 11 21 0 
