44 25
17 0 24 15 8 0 4 4 0 0 0 4 0 28 6 0 0 41 0 15 6 0 0 0 0 1 13 0 0 19 0 14 0 0 0 0 0 0 0 0 0 43 0 1 
17 16 4 27 0 22 0 0 19 0 0 0 10 0 34 25 18 23 1 0 18 18 12 2 0 8 0 46 14 6 17 0 2 0 5 21 0 0 18 9 0 0 27 6 
0 0 0 36 0 0 7 0 29 0 0 30 0 3 1 0 0 6 0 15 21 22 11 10 17 39 14 0 0 5 5 25 0 2 5 6 0 5 0 0 0 18 0 14 
28 0 6 13 0 6 14 2 56 0 0 10 4 0 0 0 5 0 3 0 0 2 10 15 0 27 18 21 37 0 0 0 0 21 26 0 0 46 0 14 0 1 0 0 
0 21 0 1 18 26 3 5 0 13 0 1 0 16 0 0 19 0 0 2 0 2 26 6 14 12 0 0 0 26 0 46 0 0 0 0 0 0 14 0 24 16 0 21 
19 12 13 3 14 11 17 27 33 0 0 0 18 41 0 0 7 5 32 0 3 0 10 8 0 12 15 0 0 12 1 1 12 0 11 13 29 0 0 15 14 36 48 0 
21 26 0 39 18 28 0 0 3 31 0 13 52 0 3 5 0 0 0 5 0 21 16 0 10 0 0 26 11 2 1 7 0 18 0 25 31 34 0 0 45 2 18 7 
0 9 0 0 10 23 4 0 0 23 0 4 1 1 0 0 1 17 17 8 18 0 18 6 0 9 0 37 23 0 5 2 31 1 15 0 16 0 0 0 39 16 20 5 
35 10 10 0 23 0 6 5 0 0 13 10 7 0 38 0 1 1 0 0 0 0 10 20 0 0 3 0 3 2 0 13 11 1 7 0 0 0 0 0 0 7 42 29 
59 35 6 5 32 0 4 0 0 17 0 18 11 15 3 0 0 0 12 0 21 1 28 11 9 8 5 26 7 9 5 19 13 22 3 7 32 7 37 13 2 0 0 21 
1 0 16 18 4 17 14 0 4 5 1 0 0 0 0 14 0 0 2 0 25 24 6 13 9 12 0 0 9 9 9 0 11 4 0 0 17 8 13 51 0 1 2 0 
1 16 0 21 0 16 74 28 8 0 11 17 2 2 4 15 0 5 3 0 8 11 12 0 8 0 10 18 8 46 0 0 21 6 0 7 0 31 0 10 0 0 36 0 
0 26 10 2 6 0 0 0 33 0 0 27 0 0 28 0 0 0 2 5 0 0 19 1 11 15 0 26 5 6 19 0 0 0 0 0 0 0 0 0 0 27 35 5 
0 0 12 28 5 0 6 37 0 0 0 26 0 7 9 20 5 0 0 3 0 7 11 6 8 7 7 0 0 1 0 32 24 10 0 10 7 20 0 0 0 28 0 0 
6 0 25 5 0 3 30 0 0 10 11 23 2 0 0 0 0 11 10 0 29 21 0 1 0 4 2 34 10 0 5 4 26 9 11 0 0 0 0 13 0 21 2 0 
0 0 0 36 6 0 11 0 2 0 8 5 0 0 11 0 24 18 2 15 0 0 15 0 0 0 0 4 0 0 5 21 22 0 0 32 0 33 0 0 0 0 0 0 
52 0 4 0 0 0 6 0 3 21 2 0 2 0 16 0 24 8 16 0 0 21 5 0 0 14 23 0 13 0 0 0 0 0 0 0 0 8 0 0 24 27 7 21 
0 16 0 19 17 0 43 0 17 10 22 0 31 0 11 7 0 0 2 5 8 2 0 7 0 0 0 3 3 0 13 16 8 25 0 0 0 1 35 14 34 0 0 32 
17 38 62 34 46 1 10 0 15 0 0 37 19 11 4 5 27 6 5 16 21 0 6 11 13 9 7 11 0 6 27 0 0 0 0 6 0 10 20 4 10 21 31 0 
0 21 0 0 4 16 0 50 6 0 0 4 0 9 0 7 0 10 9 6 2 22 16 0 21 4 0 4 3 0 23 17 11 0 4 0 0 16 0 5 0 6 19 0 
27 38 0 0 0 0 15 0 16 0 0 4 15 0 5 0 0 0 0 0 13 10 0 23 15 7 7 3 0 0 0 13 11 0 0 3 0 0 12 23 14 0 0 16 
0 0 35 0 0 27 1 0 31 0 0 0 25 0 0 0 0 0 12 0 7 0 0 16 0 18 18 2 3 21 0 12 4 37 2 23 4 35 12 0 0 3 0 1 
0 0 10 0 0 2 40 9 0 15 12 0 0 0 9 16 0 0 3 3 0 15 11 0 8 0 0 0 0 1 1 33 0 9 0 0 0 0 0 17 0 7 0 5 
20 0 1 37 0 36 12 32 0 0 0 29 0 3 19 0 3 0 30 11 20 13 3 0 0 12 7 9 3 0 19 9 10 9 3 3 1 16 0 4 0 16 1 0 
19 0 13 32 34 0 0 0 4 14 7 14 21 73 0 0 0 14 11 6 0 0 6 0 12 6 7 0 0 5 17 36 11 3 0 0 0 25 6 12 0 0 17 22 
