44 25
2 48 0 0 0 0 17 31 0 0 30 0 0 0 23 0 3 0 0 21 26 0 0 4 0 0 0 11 2 9 0 8 4 2 6 0 0 23 31 9 30 32 63 0 
0 13 20 0 0 0 0 0 0 0 0 0 0 0 2 0 18 0 16 0 0 0 23 2 21 11 0 12 22 4 13 7 0 6 2 0 0 0 0 12 0 0 0 0 
18 0 22 4 37 0 3 40 25 9 0 9 0 21 10 30 0 2 17 22 28 8 0 7 7 6 12 0 0 0 17 17 5 43 11 28 16 26 0 0 21 37 0 0 
0 22 0 38 0 0 33 34 20 0 2 0 29 0 5 0 4 36 8 0 9 25 0 9 0 0 0 0 5 3 5 3 25 0 20 38 13 14 24 33 12 39 8 26 
0 0 5 0 0 38 0 0 0 4 0 18 0 0 3 0 11 0 35 0 3 0 17 0 18 7 5 38 0 0 10 25 0 13 18 0 30 3 0 9 12 5 0 69 
0 0 24 0 0 21 30 19 0 5 0 4 0 0 5 0 0 27 12 19 0 22 0 13 27 14 13 4 0 0 23 0 0 0 0 14 0 0 19 14 34 0 30 22 
0 0 0 28 23 3 38 0 12 0 17 0 3 0 4 23 6 0 20 0 20 11 12 4 1 10 0 28 7 23 0 0 11 0 0 0 0 0 0 21 20 0 0 0 
0 56 0 0 0 0 0 16 1 0 0 0 0 12 15 0 15 0 1 0 0 11 18 0 8 0 0 5 0 5 14 7 12 0 2 1 1 0 37 0 19 0 0 0 
0 0 22 9 0 0 34 0 9 4 17 0 9 3 17 0 0 9 0 21 0 7 0 0 34 9 2 3 0 7 14 36 0 0 13 9 34 15 0 0 44 0 18 3 
43 14 35 0 7 0 9 4 0 0 11 20 0 2 0 22 5 0 0 19 0 17 11 3 0 0 29 16 0 0 7 26 0 7 15 15 2 35 2 9 0 0 0 60 
0 0 0 0 26 0 25 0 15 9 0 4 2 37 7 4 0 5 0 6 5 17 0 20 8 9 2 0 0 6 9 21 0 22 0 6 23 26 34 0 28 0 3 0 
17 1 0 7 0 20 25 2 0 25 20 0 13 0 0 21 7 6 18 0 0 0 0 0 3 17 0 16 13 0 0 25 11 0 47 0 8 0 21 0 2 25 27 0 
4 26 15 28 1 14 56 0 0 5 28 0 2 0 0 23 7 12 0 14 10 0 0 0 0 0 8 1 19 9 0 26 0 0 20 0 10 8 0 0 3 0 36 23 
5 20 29 36 31 0 0 4 0 45 5 1 8 9 1 5 0 13 1 19 21 51 9 25 30 12 0 0 7 12 15 15 23 0 0 53 13 0 44 47 0 29 3 0 
0 0 23 0 8 0 0 3 0 3 11 0 0 0 0 0 0 14 7 0 0 16 5 0 0 24 9 0 0 0 13 0 11 0 14 0 0 16 2 0 0 0 0 0 
0 8 18 6 0 0 72 30 41 7 2 0 0 0 0 0 4 0 0 0 34 6 4 5 2 0 4 0 0 15 0 0 14 51 0 30 0 38 3 0 0 35 0 0 
64 16 1 107 0 0 0 13 31 3 0 0 4 0 0 0 0 0 17 0 0 14 0 0 24 13 0 0 0 0 11 3 0 0 0 18 1 0 15 31 3 38 0 0 
0 0 0 11 15 0 11 13 10 10 23 0 21 24 0 6 7 4 32 0 7 17 0 0 0 0 2 15 24 31 44 0 6 23 10 9 25 8 0 0 9 28 1 13 
47 18 15 18 27 22 5 0 15 0 5 0 3 6 8 17 7 26 0 27 14 11 0 19 2 21 14 42 7 5 1 5 0 19 13 0 38 5 9 5 40 17 18 29 
40 11 13 0 21 0 0 0 27 5 0 15 24 0 0 3 11 14 23 0 0 0 4 0 15 8 7 0 0 0 17 4 0 0 5 0 63 0 0 0 26 0 0 25 
40 0 12 18 0 22 0 0 14 0 3 0 9 2 18 0 0 8 0 8 0 18 0 0 0 6 0 30 1 0 0 1 0 0 0 0 0 0 0 0 40 0 0 12 
0 24 0 57 19 15 3 0 2 0 4 0 2 0 47 18 1 18 2 0 18 12 12 29 0 0 6 7 9 6 16 1 0 37 19 10 0 0 8 8 3 0 18 40 
41 0 0 2 8 2 0 27 0 32 0 18 6 0 0 0 16 0 4 0 0 8 0 0 12 14 8 16 6 8 5 0 0 0 50 0 0 0 0 0 13 10 0 16 
0 21 9 51 3 24 3 16 33 0 3 13 2 36 23 1 0 0 6 0 0 9 0 0 0 30 0 14 7 18 0 21 0 2 11 20 0 43 0 0 0 57 0 0 
0 12 40 0 22 0 0 29 0 0 0 0 3 0 0 20 11 2 0 0 3 21 0 0 0 2 22 3 0 17 8 0 9 18 0 0 20 0 23 0 2 0 46 0 
