44 25
0 15 9 31 2 0 12 27 1 39 24 0 44 12 6 3 28 0 0 1 7 0 2 1 5 0 3 30 0 21 0 16 24 24 58 0 21 12 5 23 0 33 0 36 
10 13 2 18 27 45 0 4 4 1 41 5 0 0 22 10 5 0 0 18 0 2 0 17 6 2 0 4 0 0 6 19 0 1 0 7 17 0 33 0 0 43 10 0 
14 59 31 2 32 0 11 0 0 23 27 32 2 0 0 0 19 0 13 15 21 0 21 8 0 11 0 0 7 0 0 27 9 7 3 0 15 0 7 38 0 42 11 2 
5 0 26 12 11 9 6 11 6 19 0 0 0 0 25 19 0 10 27 0 5 3 3 0 0 11 0 0 8 2 20 6 0 1 9 5 0 6 24 0 0 12 0 0 
4 3 39 33 0 0 11 0 0 0 30 14 0 17 40 21 20 27 1 0 21 5 8 11 0 9 5 0 0 8 26 20 13 0 9 0 18 34 0 18 49 56 3 7 
0 10 0 0 15 0 0 46 4 2 0 30 0 0 0 23 9 0 0 0 0 0 9 0 17 0 0 0 0 0 0 10 0 1 0 1 1 0 23 38 3 5 35 0 
0 0 39 1 34 1 20 1 42 6 25 11 29 0 16 11 0 10 3 18 0 7 5 0 6 17 25 15 1 3 10 1 13 41 0 28 41 4 0 0 0 90 0 17 
0 5 19 24 0 3 0 0 0 8 17 12 0 7 0 15 26 0 3 6 0 19 0 13 21 10 0 0 2 0 0 15 0 0 0 0 2 0 0 0 0 2 0 27 
1 38 30 17 3 30 12 2 5 2 13 24 0 0 27 0 23 0 20 0 17 14 13 29 16 2 43 0 5 7 6 6 30 19 2 11 14 0 12 66 64 13 21 31 
6 14 1 68 1 0 13 59 69 12 17 5 31 2 6 13 40 0 10 0 0 34 5 0 10 17 0 2 6 0 21 1 0 0 37 0 37 10 30 1 19 7 0 51 
0 30 0 1 7 0 0 0 0 4 14 5 0 4 0 0 0 0 3 16 3 0 3 10 0 0 4 6 0 0 0 35 0 6 12 12 9 0 0 0 13 12 0 0 
0 1 9 0 5 0 0 0 11 0 14 4 10 30 7 45 0 0 21 0 8 6 8 0 26 0 11 4 0 11 2 0 0 0 0 0 10 22 0 21 0 0 0 7 
0 0 0 9 0 37 15 0 0 0 6 12 0 0 33 10 6 10 9 6 0 0 0 0 0 8 0 9 0 0 0 20 27 0 9 21 0 0 0 13 8 11 0 0 
7 56 0 0 0 0 11 0 54 0 0 0 0 0 0 0 15 9 31 0 0 0 0 0 0 24 7 6 0 3 1 0 14 0 4 0 0 13 11 0 0 0 34 0 
76 18 6 28 0 0 0 27 0 12 0 12 0 11 0 20 0 3 0 18 0 12 0 0 11 0 0 0 0 0 5 0 0 5 7 15 7 34 12 1 0 0 42 6 
3 65 25 3 39 20 0 36 0 6 13 29 7 44 0 11 2 5 16 0 0 20 0 20 0 30 9 17 0 5 32 0 7 18 4 24 35 9 11 10 27 0 0 3 
14 0 6 44 16 0 52 0 26 0 0 0 0 0 0 3 25 0 0 0 0 0 6 6 18 7 16 7 7 6 10 25 2 27 2 0 0 0 0 36 0 39 33 0 
0 31 0 0 0 0 0 0 0 0 0 11 0 0 0 0 2 3 14 0 7 1 8 0 23 14 6 7 0 17 4 11 13 0 0 0 2 3 0 0 3 0 0 1 
36 0 34 0 32 0 6 5 32 2 10 14 3 0 11 9 0 0 18 4 0 0 0 4 0 7 0 5 0 0 0 0 6 0 0 0 36 0 19 0 32 16 23 0 
0 0 35 8 1 33 27 0 0 14 7 12 0 10 4 5 10 7 25 22 0 11 10 2 0 0 0 0 8 10 0 12 17 8 16 0 12 25 0 41 0 0 11 0 
7 17 55 24 18 13 0 0 0 0 7 0 17 0 14 0 8 16 0 7 18 0 28 3 8 3 22 0 0 0 0 20 0 31 33 0 0 0 0 0 37 3 41 6 
8 0 1 10 10 59 0 0 8 21 0 0 0 0 0 12 19 0 42 15 0 0 0 5 0 7 0 24 10 24 13 0 0 0 0 0 0 2 0 34 18 0 0 0 
40 0 0 0 20 0 0 0 27 19 0 20 30 0 23 10 2 29 0 0 5 19 0 18 0 4 0 10 1 12 0 0 7 0 5 45 0 0 0 13 40 16 0 0 
0 0 5 24 9 23 0 0 0 14 0 25 0 0 18 8 9 0 0 34 0 20 0 6 12 6 0 13 36 0 12 19 14 7 0 0 30 2 19 9 31 4 15 3 
0 0 25 8 4 0 27 0 13 15 42 0 0 5 0 0 0 0 0 9 5 3 0 15 13 5 0 31 0 0 0 9 6 12 0 0 34 18 0 0 31 1 2 17 
