44 25
0 20 0 0 11 1 0 20 0 33 40 0 36 0 23 0 4 0 22 1 3 22 0 0 0 20 4 60 7 0 29 4 15 0 0 0 5 0 0 9 78 0 50 10 
0 20 13 9 20 7 0 17 0 6 0 14 10 0 44 13 5 25 18 0 0 20 7 25 7 16 3 0 0 15 6 0 0 19 0 0 37 3 0 0 0 19 35 0 
4 0 0 12 9 18 0 11 26 2 0 0 0 9 1 7 35 22 28 0 18 3 6 0 12 0 16 5 17 0 0 0 5 0 26 0 18 12 0 42 0 0 0 0 
8 0 1 12 0 0 24 9 23 0 3 0 0 0 1 0 13 0 0 0 0 0 5 0 41 23 31 5 3 13 24 0 0 0 1 5 0 0 0 0 9 0 0 0 
0 0 6 4 0 26 19 4 9 0 16 42 24 6 60 0 0 9 0 19 16 12 0 0 10 32 11 25 0 14 9 2 28 34 14 25 40 29 13 25 44 27 0 11 
15 0 0 27 30 0 0 16 0 0 2 0 7 26 0 59 22 22 25 0 46 0 17 20 19 0 0 2 0 16 6 7 6 0 30 0 1 17 35 40 1 24 28 12 
22 41 7 0 0 0 0 0 3 0 8 22 1 45 0 0 0 6 0 16 2 0 16 13 23 5 18 5 0 13 17 31 15 0 0 38 11 7 0 42 0 0 13 0 
2 28 4 0 31 8 3 58 17 0 7 0 0 4 19 0 3 3 4 8 0 0 16 3 0 14 0 39 0 14 26 4 25 6 0 40 2 10 14 1 35 1 0 0 
15 61 22 29 15 23 27 54 0 0 3 1 8 6 1 30 0 0 9 0 14 14 18 3 7 2 0 25 0 0 0 0 0 1 0 32 0 30 33 12 16 2 29 10 
23 12 25 79 26 10 0 7 7 0 0 12 0 0 1 9 1 37 0 3 0 21 34 0 0 0 0 0 0 0 41 15 16 0 4 0 0 36 49 20 0 38 25 0 
0 0 0 0 14 0 0 12 35 3 0 9 3 0 0 0 3 13 0 2 0 2 21 3 0 0 16 0 0 0 13 0 0 0 0 0 0 0 0 0 0 4 16 19 
0 0 1 0 35 0 0 1 0 0 0 24 0 5 0 0 6 0 6 0 0 9 0 0 0 0 0 9 0 0 9 4 0 8 0 24 0 0 0 35 0 0 0 0 
0 29 44 23 6 0 11 1 3 11 27 31 5 0 23 2 0 18 20 0 5 0 17 21 0 1 27 0 12 11 34 7 0 31 6 5 0 35 25 0 15 27 55 0 
41 1 76 30 0 7 0 0 2 0 2 0 9 0 13 5 12 23 10 0 0 10 0 2 16 23 0 6 16 10 6 6 0 0 6 5 0 35 1 0 87 41 1 18 
0 14 0 26 30 0 0 21 3 0 10 32 0 0 9 0 15 0 12 0 0 0 0 10 21 0 15 0 28 0 0 3 0 10 27 7 3 0 0 10 12 9 1 0 
22 8 13 75 4 35 23 10 32 34 60 0 0 0 5 15 14 16 23 8 14 0 0 2 0 17 12 16 10 11 2 6 62 15 7 8 0 22 0 0 0 37 39 70 
0 0 6 2 0 0 0 0 22 27 0 0 16 0 13 0 7 0 8 0 0 13 0 15 0 0 0 3 1 1 1 5 10 0 0 0 5 0 0 0 8 2 34 32 
12 0 0 0 0 32 8 5 3 0 4 0 30 10 0 0 15 2 18 17 2 0 3 20 12 0 4 0 0 0 22 0 0 14 0 23 32 33 7 0 10 0 0 20 
0 53 0 4 0 15 0 0 3 0 1 14 0 5 0 14 0 0 23 0 0 19 0 0 5 26 4 20 4 0 13 0 0 0 0 0 0 48 0 10 29 0 37 2 
0 4 10 0 0 4 0 0 0 0 0 0 0 0 2 0 0 2 0 12 0 5 0 0 0 0 5 9 7 0 4 12 0 1 0 7 9 4 0 0 5 13 2 14 
0 0 0 18 35 4 0 0 0 0 0 0 19 0 0 12 0 12 11 0 14 18 8 0 0 5 16 9 0 9 0 15 0 35 0 0 0 5 0 14 0 21 28 0 
0 32 8 2 20 2 0 16 15 0 32 7 0 0 1 16 0 0 12 0 13 5 0 13 14 0 6 1 0 0 14 0 0 5 0 0 0 19 9 0 21 11 32 0 
40 0 20 25 0 0 18 54 0 0 0 13 0 0 0 0 35 14 22 0 0 27 19 7 21 0 19 20 0 22 15 0 0 2 20 19 22 0 0 0 33 0 25 27 
0 15 13 48 15 0 11 0 17 0 0 19 37 0 15 13 0 14 6 14 0 11 10 2 0 17 14 8 0 10 40 0 14 22 2 5 1 34 14 27 17 0 0 10 
66 21 0 24 14 25 0 36 43 0 0 15 15 0 0 0 2 0 4 0 0 0 15 0 3 0 26 28 0 0 9 1 0 16 36 43 3 15 0 20 39 2 42 28 
