44 25
34 0 0 0 0 0 7 2 0 15 19 46 5 0 14 20 7 0 9 0 0 12 0 6 0 0 0 15 0 6 19 0 6 13 6 46 0 0 11 3 0 10 12 0 
21 0 0 0 7 0 0 0 20 0 0 1 19 0 0 13 0 0 2 27 0 1 0 0 0 0 0 0 0 18 0 12 0 29 0 27 40 0 0 0 0 8 20 0 
40 0 0 20 1 0 0 0 0 0 0 25 20 2 13 33 0 12 16 24 0 42 2 39 8 14 0 0 13 10 0 0 15 0 39 3 0 16 0 29 40 0 20 2 
20 0 1 0 17 0 26 0 0 49 16 0 0 9 0 8 0 0 11 37 12 13 0 0 0 0 0 0 0 2 6 2 55 14 0 0 0 0 0 0 0 0 3 9 
1 0 39 16 9 13 33 5 20 9 0 0 1 30 0 0 0 0 27 0 0 17 5 4 0 38 3 8 0 2 0 10 24 12 24 5 7 9 0 36 44 0 0 14 
0 0 11 1 1 29 32 0 0 0 0 0 0 21 0 9 0 5 14 5 0 26 5 0 5 0 8 0 0 4 0 10 0 15 20 47 0 0 48 0 1 10 9 0 
34 37 39 45 0 36 37 31 0 0 0 9 0 0 0 0 0 38 1 0 0 0 0 20 0 15 0 0 0 9 0 1 27 0 28 10 0 0 15 22 1 29 0 101 
0 0 15 0 34 21 4 0 0 0 32 0 19 2 0 0 7 0 3 0 13 0 15 7 0 0 3 0 10 0 11 18 57 7 0 0 0 0 0 15 31 11 2 5 
7 31 0 0 0 27 27 20 16 29 7 15 19 3 17 0 0 0 13 4 42 2 11 21 2 2 27 0 0 24 0 8 2 27 20 0 8 0 23 0 23 0 7 14 
40 32 34 8 13 0 15 12 8 8 19 19 11 3 0 4 12 0 0 10 8 15 0 13 20 0 16 0 0 21 20 0 10 10 0 0 34 0 0 12 28 54 18 0 
59 2 0 0 0 0 18 0 0 7 3 23 0 0 0 0 7 12 8 40 0 5 0 17 24 25 4 26 0 37 1 0 13 6 10 11 15 3 0 6 29 11 0 0 
4 21 0 0 16 0 5 0 29 0 3 0 14 0 28 0 0 5 3 2 0 17 23 0 14 0 36 0 0 0 0 0 0 0 0 0 0 31 9 0 0 6 6 5 
6 0 0 0 17 0 4 35 0 0 2 2 0 0 18 35 11 0 2 5 10 22 25 0 4 0 0 14 8 0 1 14 52 0 13 0 21 0 31 2 0 0 21 17 
0 18 0 0 0 11 1 4 27 6 10 20 0 11 34 1 3 0 8 0 0 0 1 0 0 0 0 0 2 16 13 36 0 0 0 0 0 7 24 0 0 33 0 0 
0 0 0 49 0 1 23 37 19 0 11 3 0 0 36 4 13 0 10 0 4 0 0 9 0 22 5 7 0 6 17 0 7 0 0 0 0 4 0 5 0 4 63 8 
2 31 3 9 4 13 3 6 4 29 0 32 0 0 17 12 0 11 8 0 15 0 0 0 0 16 8 11 0 0 21 3 31 0 0 4 0 30 12 10 0 5 0 4 
14 0 0 8 0 5 19 2 0 11 0 0 0 8 7 20 7 10 36 0 14 6 0 2 0 5 23 0 0 0 0 1 21 11 0 10 14 0 32 0 0 10 0 0 
4 23 21 29 2 13 8 34 0 34 22 14 0 13 0 13 5 0 5 7 0 8 18 0 4 27 0 0 15 42 10 0 51 2 7 0 25 7 4 3 47 5 0 29 
57 8 0 0 0 2 21 0 0 3 0 3 10 0 0 2 0 0 0 0 0 0 32 0 0 0 12 21 0 41 13 2 6 5 1 0 0 8 0 13 0 0 10 39 
8 15 7 0 0 19 19 13 14 30 18 2 19 0 18 5 8 0 0 40 0 31 13 9 28 7 4 0 7 0 0 8 59 23 11 17 9 0 19 18 7 1 16 40 
0 6 1 14 0 2 0 6 6 17 6 19 50 0 6 0 14 18 0 0 13 0 0 0 0 0 17 0 0 0 15 0 18 0 2 18 19 0 20 0 0 0 0 31 
12 0 0 34 29 35 5 36 24 0 0 3 14 0 0 0 17 2 11 0 0 8 22 0 0 14 13 0 0 7 1 0 11 18 30 40 0 4 61 39 12 3 11 0 
0 5 16 0 0 15 11 0 3 0 0 23 0 8 0 0 14 0 0 15 0 8 14 0 0 17 0 0 0 0 0 0 50 0 40 0 21 0 0 7 14 0 0 0 
0 24 38 0 0 30 44 0 11 12 26 15 18 0 2 0 4 14 9 11 4 12 16 6 0 33 27 4 16 0 5 15 6 28 33 2 0 0 0 5 38 0 20 0 
0 0 17 4 0 0 30 4 0 8 18 1 0 0 11 0 0 8 16 16 0 7 3 0 0 5 0 17 14 0 0 0 0 29 19 0 30 14 19 31 0 9 0 0 
