44 25
29 13 0 8 65 17 0 0 0 5 30 0 30 16 17 0 13 5 0 5 8 20 17 8 2 21 0 19 3 7 6 0 19 16 16 31 0 0 54 12 51 33 32 11 
17 0 6 5 9 0 3 0 0 20 0 59 16 0 14 0 14 0 0 2 21 3 0 0 0 0 0 7 0 0 0 21 3 0 19 27 0 0 27 0 29 21 0 0 
0 25 0 17 12 0 21 33 29 0 27 0 0 0 0 21 24 16 1 1 19 0 15 15 0 6 13 0 0 15 0 18 13 20 0 0 20 1 11 6 29 36 0 0 
0 0 0 39 12 11 0 2 0 0 23 13 2 2 24 0 15 11 0 0 12 0 0 0 28 14 5 0 0 0 0 30 0 23 3 0 0 6 0 15 0 13 36 23 
0 0 23 29 10 84 13 0 47 13 16 0 7 0 8 0 2 8 0 0 0 17 5 20 0 20 11 10 24 0 0 1 33 0 0 30 0 39 8 0 0 0 37 20 
0 19 8 0 0 0 0 25 0 0 7 0 28 29 0 0 0 12 0 22 1 7 0 0 0 15 0 0 0 0 0 19 25 0 0 0 0 0 16 0 75 36 0 0 
0 0 12 22 0 0 0 0 0 13 0 0 27 1 2 0 0 26 0 10 10 0 10 0 21 0 0 14 0 0 2 0 0 0 0 0 6 0 0 15 0 38 8 5 
8 0 0 17 5 85 0 2 0 5 13 0 7 0 0 0 3 6 4 0 37 8 0 18 0 0 0 0 0 8 14 0 0 17 29 17 0 0 0 0 13 0 2 16 
42 46 0 20 0 0 0 0 10 4 0 0 21 23 26 11 6 8 6 8 21 18 2 0 8 0 12 13 0 8 2 9 29 9 5 0 18 8 0 6 0 40 52 0 
26 34 0 25 29 0 0 15 0 4 1 26 0 0 4 0 6 3 7 0 10 1 11 0 2 2 12 3 0 4 26 32 15 6 0 34 0 13 0 0 8 19 0 4 
1 0 10 0 16 3 33 0 3 7 7 8 1 19 2 7 0 13 0 0 6 17 0 0 11 0 13 0 0 12 0 0 0 0 13 0 0 0 0 20 0 2 0 0 
0 0 5 0 0 0 52 21 12 0 8 10 5 3 12 0 1 14 0 0 0 0 20 0 0 0 0 0 15 0 24 17 0 11 3 0 0 0 0 0 0 0 0 11 
0 0 11 3 18 14 2 26 0 17 0 5 0 39 0 0 1 5 0 6 9 3 9 4 0 3 17 0 0 7 1 0 0 28 0 32 0 0 17 0 0 12 0 0 
33 13 5 2 54 0 0 33 0 0 13 0 0 9 1 0 9 6 0 38 16 13 4 24 1 1 5 6 16 0 2 3 0 0 15 4 46 8 0 0 33 0 9 4 
39 37 6 9 52 3 18 0 17 22 4 11 10 16 21 0 0 5 4 0 2 0 11 9 41 0 13 0 0 3 1 0 38 5 0 52 27 10 31 31 2 0 0 19 
37 0 0 4 10 0 32 27 0 0 0 15 0 0 0 0 17 7 0 19 0 0 8 0 14 0 13 0 0 0 0 7 0 43 0 8 0 0 1 0 23 1 0 10 
22 11 35 40 1 3 0 34 2 23 0 0 6 17 13 8 0 8 21 3 26 0 16 4 21 16 14 0 25 0 3 0 13 53 18 0 0 0 14 2 1 30 24 0 
23 53 0 0 39 0 32 0 0 0 7 0 19 26 0 7 0 53 0 0 6 0 0 15 0 13 23 2 2 17 0 0 22 0 0 4 3 0 37 9 2 0 23 0 
17 1 39 28 8 22 0 3 5 0 0 0 8 18 0 0 7 10 0 23 0 16 0 35 1 18 4 0 0 0 0 33 0 0 22 0 5 0 13 26 0 0 17 0 
0 0 0 9 0 0 28 20 1 0 2 0 30 0 1 0 0 19 0 0 0 0 0 10 0 0 0 1 0 6 1 1 19 5 0 0 0 0 0 13 25 16 0 2 
0 0 71 0 3 24 4 18 26 28 9 17 22 0 3 0 0 0 4 0 0 9 14 0 12 3 13 8 17 0 8 18 16 0 68 3 7 28 3 3 6 20 3 9 
0 0 23 8 39 1 0 0 0 21 0 38 4 0 0 0 0 0 0 5 0 15 2 0 17 32 0 0 0 7 0 0 4 0 0 8 0 2 0 50 0 24 0 0 
0 31 18 42 0 2 11 0 13 24 8 0 0 0 0 0 5 8 0 8 14 8 0 3 0 0 37 32 0 2 0 21 25 4 25 0 17 0 0 0 44 0 9 17 
24 21 1 10 8 0 16 29 0 7 0 0 0 7 0 59 11 13 41 0 10 1 29 0 0 7 19 0 12 14 0 1 0 0 18 12 27 0 0 0 20 23 11 53 
0 11 43 25 2 20 43 7 0 0 4 23 0 25 3 10 18 0 0 14 17 0 6 78 16 0 0 20 11 0 27 19 26 46 1 30 2 0 25 16 0 0 33 20 
