44 25
3 0 0 83 0 26 22 1 21 0 0 18 6 0 0 30 1 1 0 7 24 0 7 12 0 10 0 0 38 0 0 34 0 29 1 27 0 0 0 0 0 0 10 54 
0 69 0 17 13 25 6 18 0 10 7 26 24 0 0 0 7 13 9 3 9 5 0 11 0 21 0 3 3 0 10 0 0 24 0 57 35 26 0 21 0 0 0 0 
13 8 0 0 1 0 2 15 2 12 0 37 17 0 0 15 27 0 2 1 15 0 14 56 0 0 6 0 25 17 0 10 0 6 1 6 4 0 15 10 1 27 23 0 
45 45 28 20 36 16 20 0 0 11 8 0 0 10 26 8 15 0 8 21 0 0 0 20 13 0 3 44 1 15 1 71 17 20 0 33 0 13 0 0 0 0 29 0 
35 0 18 3 16 0 0 0 0 1 1 0 0 1 1 0 27 0 0 17 18 19 0 0 0 0 17 0 5 0 0 0 0 5 0 0 0 0 37 19 15 13 1 3 
34 15 0 3 9 3 11 14 16 0 24 0 13 6 0 2 14 0 19 1 16 13 16 19 0 6 7 9 18 0 8 1 18 30 58 0 39 23 33 32 0 4 18 0 
0 36 30 30 8 0 19 28 19 0 28 0 1 7 25 20 18 1 3 13 13 18 0 3 0 24 18 8 33 0 1 0 29 35 17 25 11 18 37 43 14 0 9 0 
0 0 0 32 36 0 0 34 22 0 0 0 7 0 0 0 0 1 0 17 1 5 7 0 0 0 4 0 0 10 22 24 4 8 1 32 4 0 10 0 36 5 0 0 
44 0 5 8 0 0 0 0 0 43 6 15 0 0 0 0 13 25 2 0 7 16 0 0 8 3 9 2 0 0 5 41 8 0 0 11 10 0 2 0 29 6 42 46 
0 11 32 0 0 3 0 2 25 2 0 8 3 20 23 7 5 20 9 17 15 7 0 5 0 0 0 0 12 0 6 0 15 0 29 0 11 3 27 13 39 0 0 0 
2 0 10 17 0 0 0 0 0 7 1 4 0 10 3 4 1 43 16 1 17 1 20 20 10 8 0 0 15 0 4 0 3 5 17 1 0 17 5 0 0 0 9 41 
0 15 15 8 19 14 0 20 0 1 14 0 0 0 1 19 37 31 1 4 4 0 20 31 0 0 22 20 3 0 8 0 3 25 42 12 0 0 0 0 0 14 10 13 
25 0 10 28 34 0 0 0 0 0 7 22 1 0 1 0 0 4 0 6 0 1 1 31 0 25 13 0 3 0 0 37 0 22 1 0 0 0 34 23 18 0 19 11 
0 0 2 6 1 0 0 0 0 18 2 0 1 8 0 6 0 25 0 0 0 0 2 0 0 4 0 8 10 0 7 18 10 3 0 3 10 20 0 0 0 0 0 0 
32 0 0 0 1 5 2 0 0 12 0 0 7 24 11 4 20 3 0 0 0 0 7 0 9 0 3 0 0 0 15 21 35 9 0 0 0 24 0 0 0 6 0 14 
6 29 27 0 40 13 2 8 0 6 0 26 8 8 40 0 6 0 8 8 14 7 0 11 0 0 0 4 13 27 35 31 0 0 7 0 6 26 8 25 0 0 38 0 
0 14 17 0 47 0 9 0 24 41 0 8 23 0 0 0 7 17 0 6 0 20 12 0 19 0 14 0 4 0 10 13 19 23 10 10 0 25 47 15 17 20 25 0 
6 0 0 21 0 0 1 4 43 9 0 11 0 0 0 0 24 4 0 28 23 0 16 0 5 4 12 0 0 26 22 0 0 1 13 16 0 0 38 0 30 13 1 37 
11 30 16 18 21 18 6 0 0 10 6 2 8 0 20 28 0 0 16 2 8 21 0 9 5 28 0 8 0 0 0 47 8 0 21 0 3 0 0 0 0 0 6 0 
0 35 0 30 0 18 11 0 0 8 29 0 0 13 22 0 9 6 8 0 13 0 0 10 6 1 18 10 0 0 0 1 21 26 9 0 7 12 20 19 15 0 31 13 
0 26 3 0 18 1 0 5 24 2 0 0 0 17 22 13 15 13 0 22 16 0 0 0 0 0 0 11 0 0 17 12 22 0 16 0 25 0 0 25 0 17 1 12 
2 0 47 0 0 4 0 6 0 3 0 19 0 12 1 12 11 2 24 0 4 7 17 6 32 0 41 0 9 6 10 27 5 19 10 13 3 0 5 0 0 15 21 0 
0 28 32 0 0 2 0 13 0 2 0 17 16 0 0 0 0 8 6 0 13 0 0 21 40 0 0 0 11 28 0 0 21 0 0 0 12 0 0 0 0 2 0 2 
42 19 8 39 0 33 20 19 0 1 7 24 0 0 15 3 17 0 8 18 19 19 8 33 4 0 21 0 22 0 0 11 0 20 17 0 0 0 29 64 1 41 15 7 
0 0 0 0 0 18 10 1 0 0 19 0 0 0 0 0 0 7 0 45 47 16 0 18 0 0 0 21 0 0 18 0 22 0 0 11 0 1 1 15 12 0 0 34 
