44 25
0 24 5 0 16 0 12 0 44 0 0 0 0 0 22 0 8 0 2 8 3 0 0 0 4 24 0 5 4 0 0 0 0 13 3 0 5 3 0 0 4 0 34 0 
0 17 0 25 0 17 1 17 1 0 18 0 6 22 70 0 0 0 7 0 0 16 0 0 0 3 0 0 11 0 0 0 4 9 21 12 0 0 18 0 0 0 0 16 
0 0 25 37 5 27 3 34 1 11 21 0 0 11 9 29 14 23 23 0 19 14 2 0 25 1 3 2 13 26 4 12 0 7 26 6 16 24 12 1 8 57 16 4 
13 21 20 0 17 0 0 0 2 21 0 15 0 5 48 17 0 0 0 17 7 17 0 0 0 1 0 10 0 14 8 0 17 0 0 0 0 0 2 0 0 27 0 14 
0 25 43 39 2 16 115 9 46 0 1 43 2 23 2 6 0 0 20 0 0 4 0 17 11 3 29 14 41 23 15 5 0 0 32 6 48 0 0 0 32 5 57 37 
10 13 26 0 0 0 0 16 4 8 33 29 32 0 4 0 5 8 0 1 0 5 12 3 15 0 43 2 19 0 11 19 13 0 0 24 0 0 5 12 0 15 0 0 
0 0 12 19 0 0 0 37 0 14 14 24 0 0 0 0 0 6 1 20 23 0 12 0 0 12 0 0 0 8 0 0 0 0 27 31 0 0 19 0 3 16 0 18 
11 0 46 0 32 0 23 24 0 0 0 0 0 5 2 8 6 0 0 0 9 0 2 0 0 0 0 3 0 24 0 0 0 0 0 33 31 12 9 29 0 13 20 15 
49 0 0 40 0 0 0 3 33 21 1 2 0 5 8 7 0 7 0 38 7 0 2 16 5 5 16 0 0 0 21 0 0 0 34 0 0 0 1 10 0 33 28 62 
0 21 11 0 39 0 25 5 4 30 0 0 0 0 8 11 0 23 0 1 11 0 21 0 0 0 12 0 0 13 0 14 0 5 19 0 0 18 10 30 33 6 17 39 
0 25 41 26 0 0 21 0 0 31 29 7 0 0 12 5 32 0 17 0 14 0 0 13 21 4 37 21 4 41 0 16 4 4 0 15 5 0 7 37 22 0 0 8 
2 89 3 20 2 0 13 0 7 0 0 0 4 0 6 0 2 20 9 0 12 0 8 0 0 0 22 0 0 11 0 1 0 0 8 3 0 33 0 5 1 40 67 0 
0 0 1 0 1 3 3 12 28 0 0 8 28 10 9 0 0 18 0 15 23 0 0 10 5 0 11 0 9 12 0 0 0 1 15 0 0 27 10 0 28 3 0 23 
19 1 0 41 2 0 4 0 0 0 33 0 42 0 4 0 4 19 18 2 1 0 0 20 19 5 0 11 25 0 0 27 4 16 0 7 36 0 4 6 28 4 0 72 
0 0 4 36 0 0 0 12 26 0 18 20 17 0 0 6 3 6 0 0 3 6 20 16 0 3 0 0 18 9 0 32 0 10 17 0 0 0 2 36 7 0 8 4 
5 24 9 0 0 34 3 0 2 0 0 0 14 0 13 0 2 12 0 0 17 9 0 0 0 3 0 23 3 27 0 26 0 14 9 0 30 9 21 6 0 0 0 9 
51 0 0 9 14 0 25 10 31 9 70 27 3 12 20 0 44 5 3 0 13 0 0 2 0 15 11 15 12 26 9 6 22 0 0 4 0 31 6 66 26 5 7 0 
0 2 0 3 15 10 18 0 11 0 14 24 0 0 4 18 10 4 10 6 12 10 0 0 5 0 0 0 10 0 0 36 4 0 31 43 13 0 23 20 5 5 13 19 
5 0 12 70 0 61 19 5 23 4 4 9 0 4 23 8 49 10 0 0 11 20 0 0 8 0 0 18 9 23 27 23 22 9 0 0 5 31 13 36 0 20 16 38 
0 0 0 0 0 0 17 7 0 0 21 0 0 21 0 0 0 7 4 22 12 0 19 0 7 0 0 13 0 7 0 25 12 1 21 0 1 0 10 0 14 23 0 0 
0 0 48 0 0 10 39 0 23 0 82 8 0 4 19 10 25 8 9 26 0 8 20 13 10 0 16 0 0 33 0 0 0 2 0 25 9 13 0 0 0 19 12 0 
37 0 8 0 8 25 1 1 8 17 38 29 20 20 19 22 14 9 0 0 10 4 0 5 3 1 16 23 9 2 31 8 0 9 0 12 6 20 19 8 27 0 13 34 
0 0 0 5 0 0 82 35 3 30 3 0 0 42 0 0 9 18 0 6 0 1 0 0 0 0 16 0 0 2 8 0 0 0 22 21 0 24 40 12 0 15 9 15 
15 13 20 0 11 0 0 0 0 3 0 0 12 0 11 24 0 0 0 0 0 5 1 18 0 0 12 0 19 0 0 0 5 0 6 0 2 0 23 8 0 0 0 0 
0 7 0 13 0 1 0 0 7 18 0 16 33 13 21 0 0 0 14 0 14 5 17 12 3 12 0 2 19 6 0 0 14 23 0 0 0 4 25 0 0 29 15 0 
