44 25
0 26 0 0 0 10 0 0 0 14 12 33 5 26 12 18 11 0 0 38 0 10 3 0 13 0 17 26 7 12 0 15 0 18 0 0 17 42 0 29 0 8 0 12 
2 31 4 42 8 0 0 0 0 0 21 0 1 6 1 11 13 6 0 17 0 27 0 10 8 36 0 9 18 1 0 8 3 0 0 0 11 6 0 10 0 6 6 0 
2 14 23 15 24 9 9 0 0 0 0 10 0 0 0 5 0 0 0 1 1 10 0 5 0 23 0 0 0 0 3 8 0 0 31 0 0 11 0 35 0 0 11 13 
44 0 0 0 9 0 17 6 15 0 0 14 0 5 15 0 25 0 0 0 11 0 9 0 0 16 0 0 18 5 0 0 0 17 0 0 0 0 55 3 0 25 0 15 
3 0 36 25 23 0 10 11 2 16 7 0 48 9 0 25 6 0 0 18 6 31 0 14 12 13 20 0 6 28 15 23 6 10 27 6 25 10 15 0 44 44 0 12 
0 0 4 0 8 1 1 0 0 0 0 7 6 0 0 15 4 6 13 0 0 8 10 1 0 4 17 0 17 9 14 4 12 3 5 0 0 0 0 38 9 0 0 0 
0 0 0 14 14 7 0 0 22 20 23 32 0 15 10 0 0 14 0 7 0 10 0 0 10 0 22 5 7 20 36 4 8 20 0 8 2 15 12 8 0 0 27 0 
28 19 25 0 21 0 9 24 2 0 51 11 11 0 0 6 0 11 10 0 19 9 11 15 0 2 5 23 2 17 0 0 26 0 0 0 0 47 0 0 0 6 32 1 
76 9 42 0 30 4 29 3 0 4 16 16 28 0 37 1 22 34 4 23 19 0 4 13 14 5 0 6 0 6 0 14 0 14 40 0 16 54 16 21 3 1 7 42 
0 13 0 0 26 0 0 68 0 0 8 0 0 0 6 0 7 0 8 0 0 0 10 0 0 4 0 26 0 0 1 0 1 14 0 31 0 3 31 0 39 0 0 0 
0 0 0 0 0 2 0 0 0 0 0 0 0 17 1 0 10 2 0 0 0 7 9 8 7 0 0 0 0 11 0 7 14 0 13 0 0 0 0 12 0 0 0 0 
17 0 43 0 5 22 30 2 4 1 10 0 6 0 19 28 9 0 0 19 12 0 7 10 12 11 4 4 4 9 0 2 6 2 0 0 17 3 2 25 25 27 0 0 
29 5 0 6 23 4 19 4 0 1 5 32 2 0 12 0 0 21 11 1 8 15 9 0 0 0 2 4 0 46 0 0 0 0 0 0 0 1 21 12 0 2 0 22 
0 11 21 38 28 7 27 16 0 0 36 0 39 26 23 0 9 3 2 0 20 0 17 15 29 0 0 28 7 33 0 7 10 5 5 6 2 34 28 26 20 50 38 0 
0 6 0 27 3 2 4 49 24 14 30 0 0 8 10 2 0 21 0 13 2 8 0 8 0 17 16 0 15 9 0 8 43 23 14 0 0 0 21 11 41 7 0 0 
0 42 24 5 6 0 0 30 18 0 2 4 16 5 0 3 0 13 0 23 1 17 0 0 0 0 0 0 1 0 0 2 10 21 32 8 24 16 0 0 0 0 17 61 
0 18 5 23 6 0 17 49 0 26 0 7 16 8 0 0 7 12 0 3 23 7 3 15 23 0 52 0 0 0 8 0 0 26 0 41 5 0 8 0 0 0 0 35 
0 0 0 0 6 0 0 0 0 16 34 0 0 8 0 0 0 6 6 6 0 1 17 0 0 22 22 0 0 0 9 0 0 0 0 0 17 0 0 22 0 0 0 0 
0 9 0 7 0 22 0 0 7 2 0 0 30 2 15 0 0 1 1 0 7 18 17 4 0 0 4 18 2 0 0 10 0 21 0 27 0 29 0 36 0 10 5 3 
32 0 0 36 0 8 8 4 7 0 14 11 2 0 8 7 0 0 0 0 0 21 33 2 4 16 0 0 20 0 17 27 2 11 0 0 5 0 0 0 0 20 20 12 
31 3 0 0 0 5 12 18 29 28 2 0 2 19 0 22 37 0 16 0 0 19 15 0 0 29 5 0 0 0 4 0 0 9 16 11 0 22 17 0 0 20 12 0 
0 1 32 9 16 5 1 4 0 3 3 12 0 15 0 10 13 0 8 19 15 0 2 0 20 13 1 3 0 11 0 0 0 31 0 31 0 0 19 21 0 2 8 19 
34 2 0 22 13 0 0 34 0 0 0 0 2 0 0 0 0 2 17 0 24 0 0 0 18 17 0 0 0 6 0 0 0 0 34 8 19 0 0 12 8 34 0 0 
0 36 0 32 6 0 0 51 38 0 17 15 59 0 15 0 0 35 0 0 19 0 13 0 2 26 9 6 4 2 0 19 18 21 0 40 0 20 36 18 39 16 17 0 
0 6 17 0 17 0 0 6 0 0 0 0 32 37 10 0 4 1 12 16 0 0 0 7 11 10 7 0 10 0 5 11 14 10 0 18 16 0 0 26 2 0 17 0 
