44 25
41 8 1 1 0 4 4 1 4 6 55 30 0 23 0 7 0 8 0 9 2 22 11 0 11 26 0 18 0 9 0 0 0 37 0 12 33 0 0 5 0 5 0 55 
0 0 7 0 10 0 0 0 0 30 0 46 18 0 14 0 0 20 6 13 11 7 0 0 10 12 0 0 12 0 0 0 0 0 0 0 14 6 1 21 29 0 3 0 
0 0 53 0 17 16 31 12 6 16 16 57 0 3 0 0 26 0 0 12 0 30 19 0 0 0 0 0 0 13 26 0 11 0 36 45 22 36 0 37 38 13 0 8 
17 0 0 24 5 5 0 0 0 0 5 0 9 27 8 15 1 12 18 3 7 9 4 0 21 0 0 23 0 0 7 0 18 13 0 0 36 0 20 4 27 0 0 0 
16 0 14 0 0 0 0 1 37 0 3 12 0 2 0 27 24 4 1 0 0 4 0 0 0 0 0 3 0 14 21 1 0 14 8 4 0 7 0 0 0 0 22 0 
65 13 15 0 37 29 0 0 1 0 1 22 0 27 0 2 2 0 0 6 23 12 0 19 0 3 11 0 26 0 0 31 0 29 0 31 36 14 0 5 0 9 0 30 
0 0 4 3 19 0 0 0 24 0 33 26 0 12 0 0 0 47 0 4 4 0 0 5 0 0 0 12 0 0 0 17 0 0 0 4 10 28 14 3 0 13 57 0 
12 91 8 0 0 3 1 1 0 7 11 2 18 0 0 17 10 0 6 20 30 18 0 27 0 8 20 9 13 31 53 0 12 0 0 12 1 36 17 56 0 0 0 0 
19 6 0 35 18 20 0 25 12 4 0 7 9 0 0 12 0 17 7 16 2 17 19 2 16 0 13 0 15 0 0 15 38 0 0 0 46 0 35 24 16 0 42 0 
0 0 46 3 0 0 9 9 0 11 25 7 9 0 3 0 33 3 4 0 18 9 25 1 0 0 0 0 8 0 0 21 0 0 0 0 20 27 31 7 33 31 0 3 
0 0 50 37 10 37 8 34 5 14 9 10 22 5 15 0 11 1 6 9 4 18 10 21 19 0 5 0 21 0 0 0 0 8 12 23 13 0 5 17 38 6 0 0 
26 0 4 0 35 0 32 42 0 29 32 6 0 0 1 0 0 3 12 25 0 0 24 0 0 3 3 3 6 4 30 13 0 0 0 3 9 23 16 35 0 0 32 0 
28 22 0 0 32 0 17 0 4 20 24 1 0 0 31 12 12 7 0 0 9 0 13 26 6 0 0 0 0 34 30 0 0 0 0 3 32 7 0 6 24 62 0 16 
0 23 12 0 0 0 0 0 0 16 11 0 2 0 13 0 0 5 4 0 8 8 0 0 0 24 0 0 12 0 0 0 0 24 0 0 0 0 0 0 0 0 0 17 
7 1 0 0 0 0 0 23 0 34 27 1 4 0 11 0 6 3 12 8 0 18 16 30 0 21 0 7 9 0 7 0 25 11 0 7 6 0 0 8 0 2 19 22 
31 4 39 36 4 50 7 0 0 0 18 0 2 27 17 3 12 26 0 2 0 22 7 0 0 26 5 13 45 17 0 4 30 4 3 47 31 15 16 36 13 7 20 22 
9 1 0 6 8 60 54 18 12 4 9 0 0 26 0 0 15 3 0 0 0 0 5 20 2 29 0 4 0 0 0 10 0 4 0 29 42 2 13 17 0 10 20 38 
6 1 75 1 8 0 9 16 30 0 43 19 38 1 1 15 0 13 0 17 0 21 14 0 0 2 18 0 18 0 13 24 9 0 0 33 0 27 0 0 63 62 0 0 
20 13 0 40 11 15 6 0 29 8 40 27 9 21 0 57 5 8 12 4 16 19 0 0 8 0 0 11 11 14 12 23 0 14 27 20 3 0 0 0 0 0 0 6 
2 0 0 0 1 9 21 7 56 0 0 0 18 0 4 5 21 0 0 24 0 15 1 1 3 0 0 27 0 0 0 7 26 2 0 17 9 7 0 13 32 0 6 0 
21 35 15 46 10 0 0 18 0 19 14 18 0 2 0 1 0 2 0 0 15 11 11 19 0 15 0 0 11 7 15 0 0 29 0 1 41 37 0 30 0 38 0 25 
0 14 9 0 0 5 2 28 4 0 0 9 0 6 0 2 0 10 18 0 3 0 24 0 0 7 0 0 20 0 0 2 24 0 0 45 9 20 0 4 0 16 5 0 
3 0 39 0 14 0 34 2 19 2 0 1 0 7 0 6 13 0 0 0 0 6 19 15 12 14 0 0 8 0 19 0 0 11 0 2 17 29 0 10 35 44 0 0 
11 15 0 0 34 18 2 13 0 0 3 18 28 0 0 0 0 0 0 0 0 10 0 14 0 18 6 0 8 16 21 10 6 0 0 7 0 0 3 22 28 0 0 10 
41 0 54 0 0 16 0 0 0 14 16 21 26 0 21 12 0 0 0 15 0 23 4 18 0 0 10 11 0 0 6 12 7 0 32 9 47 10 43 0 29 72 0 29 
