44 25
1 5 21 5 0 0 10 28 0 0 0 0 31 0 0 1 9 0 6 0 0 0 0 8 10 17 0 0 13 0 0 24 9 10 6 34 17 0 21 0 39 47 10 0 
29 2 10 0 1 29 7 0 0 0 22 10 17 0 0 1 5 23 22 0 18 0 0 0 0 0 9 4 0 40 19 4 22 0 14 4 0 0 0 2 68 3 12 14 
32 0 42 2 0 21 34 13 1 9 15 31 3 2 12 0 16 5 3 12 20 6 0 0 0 0 0 19 6 3 0 20 14 3 58 0 16 0 0 14 6 0 0 0 
12 31 73 4 0 0 2 0 5 0 10 0 21 0 2 0 0 15 6 0 0 11 18 12 38 17 0 0 26 0 15 0 33 15 2 35 1 0 0 0 16 0 0 12 
29 18 0 0 3 0 0 17 0 11 0 19 4 15 0 0 12 19 0 18 11 9 0 12 0 1 10 2 6 34 9 0 0 0 18 13 4 5 0 0 0 18 0 0 
14 26 24 33 8 30 12 19 0 9 13 0 0 12 40 0 22 0 0 0 23 1 11 6 5 0 43 13 12 10 7 3 4 0 15 22 36 17 18 39 31 40 0 23 
36 17 0 45 17 13 19 0 0 0 0 0 0 0 0 15 7 11 12 0 5 1 1 15 0 13 0 0 38 0 0 6 32 0 0 0 31 0 20 38 0 0 0 0 
37 17 0 35 29 33 18 17 4 23 53 26 40 0 1 6 10 7 17 0 11 31 14 0 5 18 2 24 0 0 12 0 7 17 13 0 45 3 0 29 15 13 44 0 
0 31 24 0 0 7 21 0 33 5 11 0 13 0 5 17 8 2 6 0 4 1 3 0 0 0 18 9 0 0 1 18 48 23 27 0 6 0 0 21 0 33 0 0 
34 0 0 28 0 0 20 0 0 0 0 17 9 0 0 14 31 10 10 8 33 4 15 11 10 6 29 24 10 0 10 8 29 0 14 34 15 5 38 3 1 6 0 3 
25 11 25 0 58 0 25 12 7 0 2 0 2 1 0 20 16 6 18 12 0 0 0 1 0 0 5 4 0 0 4 22 0 0 0 31 5 0 0 0 7 0 30 0 
11 0 0 0 17 0 3 6 36 0 0 18 0 3 7 0 5 0 3 0 10 18 0 10 0 0 0 6 0 18 10 0 0 0 8 0 4 0 0 31 0 0 0 4 
33 0 0 10 0 14 3 28 37 1 11 1 18 36 7 4 16 15 1 0 8 22 0 36 16 25 0 0 5 5 0 12 15 10 0 29 9 0 0 31 19 17 52 19 
2 0 0 6 8 18 17 0 0 9 24 38 0 9 0 5 11 0 0 0 0 8 0 35 0 10 0 0 4 0 0 0 0 0 1 16 2 0 0 0 0 3 0 0 
39 12 11 0 0 0 11 0 0 0 3 0 0 12 3 7 0 0 0 0 0 0 0 0 0 0 29 8 0 0 0 0 4 0 0 5 0 0 8 39 2 0 4 0 
0 0 0 25 9 4 29 8 20 0 3 5 6 17 33 45 0 0 45 0 0 7 6 12 0 3 17 0 11 4 0 2 0 9 19 14 0 2 20 0 0 32 0 29 
34 0 0 27 0 0 44 0 19 0 6 31 0 14 0 0 8 0 0 0 0 0 0 0 16 7 26 0 0 0 27 0 34 0 0 3 0 0 0 14 8 9 36 6 
2 26 16 0 0 7 12 41 15 17 37 9 0 32 4 4 0 8 2 0 0 0 13 15 0 0 0 0 0 11 4 2 0 0 6 9 11 2 0 9 12 0 35 0 
0 0 19 15 0 6 25 0 30 12 0 6 25 1 10 1 8 3 2 0 12 35 10 0 0 0 0 28 14 0 15 7 30 0 0 17 14 0 0 0 0 0 0 35 
0 14 24 0 13 25 0 26 14 5 18 0 16 2 18 7 0 9 0 0 0 4 4 15 0 0 43 0 20 28 0 26 17 0 35 0 17 0 2 0 25 6 14 0 
0 0 0 21 35 0 18 45 0 22 0 25 19 11 1 16 10 0 0 20 4 0 1 0 11 0 12 0 16 0 0 16 2 24 20 3 12 0 0 23 0 13 0 0 
0 0 0 0 0 14 0 46 21 8 9 0 0 0 3 10 0 0 9 0 0 16 19 0 16 29 0 0 23 33 12 6 0 0 5 0 14 11 21 5 0 0 5 0 
0 19 37 15 0 12 0 0 0 0 0 0 1 14 0 42 2 16 2 0 31 0 2 0 0 0 0 0 0 0 9 1 20 0 0 4 0 17 0 41 15 26 0 6 
21 9 25 14 9 27 5 22 0 0 9 11 19 23 9 0 14 19 0 13 14 3 0 17 0 0 19 14 0 0 0 15 0 0 23 19 5 0 18 0 0 38 0 0 
12 0 0 0 0 16 0 0 0 32 31 19 21 8 0 0 0 2 3 26 0 15 35 17 1 1 0 6 0 0 19 36 0 10 0 14 0 0 0 0 12 63 21 24 
