44 25
2 3 2 61 0 2 10 23 2 25 6 29 7 0 13 15 49 24 0 0 0 5 15 0 12 0 0 11 25 15 8 17 1 1 26 0 5 6 11 0 28 39 0 0 
0 0 15 13 11 18 7 1 0 3 0 26 10 15 22 11 38 12 0 0 0 7 7 0 21 0 0 0 4 43 0 15 3 1 0 0 16 0 0 3 16 0 13 4 
0 57 16 29 23 4 30 20 16 9 10 0 0 4 5 12 25 11 0 0 11 3 0 13 3 0 12 0 1 7 0 8 0 0 10 34 14 0 25 25 22 7 3 0 
2 20 2 0 2 0 41 0 6 0 2 5 14 0 9 26 17 22 1 10 0 0 8 10 3 11 0 0 0 7 22 15 0 0 33 0 18 17 0 11 34 0 0 0 
0 42 0 16 0 0 34 60 28 30 11 14 0 0 0 22 12 25 1 0 14 29 14 0 0 29 0 0 12 0 20 0 3 0 0 28 64 22 17 54 0 0 9 42 
0 17 9 0 2 0 2 35 0 5 39 29 0 0 15 0 0 0 0 0 0 11 0 0 15 16 23 0 17 0 14 41 0 0 4 0 0 0 16 32 0 9 31 0 
0 9 21 2 16 7 0 0 0 3 5 65 0 0 12 0 8 0 16 10 19 0 0 18 6 18 16 0 0 5 11 20 5 17 4 0 0 0 0 4 0 15 31 0 
44 29 19 25 65 23 5 24 15 5 14 0 0 3 0 16 7 0 18 0 14 39 8 0 0 0 19 0 26 10 29 3 0 28 32 2 5 32 17 0 0 37 0 9 
0 5 0 0 0 0 0 23 0 30 10 19 15 0 13 8 0 12 0 0 29 0 3 0 8 14 0 15 0 3 2 11 0 12 0 0 6 1 9 53 0 0 24 0 
10 7 0 51 39 37 0 0 23 23 42 14 19 0 24 0 0 0 24 15 5 0 32 38 13 32 6 5 1 11 20 15 5 23 5 21 5 3 0 10 7 26 6 17 
0 24 12 34 0 41 0 12 0 6 0 18 5 17 8 6 0 10 5 0 4 0 9 25 0 0 21 0 8 13 7 10 0 4 0 34 0 30 14 16 0 0 6 0 
0 3 35 2 0 0 0 23 0 0 0 1 0 9 19 0 10 0 0 0 0 0 8 2 0 0 0 0 0 16 3 18 30 0 0 0 0 0 35 0 0 0 0 0 
63 12 1 55 12 0 0 0 22 0 0 4 0 0 7 0 21 19 13 22 15 5 19 0 36 0 26 0 41 0 25 0 0 0 10 5 52 3 17 38 0 0 3 1 
0 0 11 0 0 0 33 27 0 41 9 4 23 0 0 0 6 27 0 5 8 0 8 0 13 0 14 0 11 0 0 8 0 0 0 0 0 0 0 29 0 34 42 0 
0 16 0 0 24 0 34 4 0 0 16 29 4 0 9 11 9 0 0 0 29 7 5 4 18 11 4 0 24 0 0 4 0 16 4 30 3 4 0 11 49 9 0 0 
0 12 0 17 0 9 0 22 14 0 13 30 16 0 0 0 25 0 0 5 13 9 44 0 8 0 0 8 5 4 16 0 0 0 7 0 0 3 0 0 3 23 0 1 
80 21 64 3 0 0 35 14 14 0 40 0 8 0 14 8 0 54 0 17 8 14 27 3 32 2 14 7 6 40 0 21 0 0 0 0 33 0 1 0 5 59 31 40 
24 4 8 0 7 5 0 7 25 0 14 9 35 0 0 3 52 0 18 38 0 0 18 0 14 6 11 0 12 16 0 0 12 42 2 0 13 37 9 23 11 0 26 24 
2 3 35 37 0 30 3 10 0 10 0 0 4 0 12 0 1 0 0 2 0 0 10 0 0 0 15 0 7 0 0 15 0 9 0 30 8 35 10 0 37 19 5 0 
0 13 41 0 10 46 0 1 4 2 0 9 13 0 13 0 0 0 9 2 0 0 0 2 0 2 0 16 7 0 1 0 0 3 0 5 19 1 0 14 7 0 0 41 
0 0 1 16 0 0 16 0 0 0 0 0 23 0 0 1 0 0 0 0 2 5 18 0 15 0 5 0 12 0 0 11 0 12 0 23 0 17 4 0 8 0 20 28 
40 11 63 19 0 0 0 24 0 39 0 10 0 12 13 0 10 8 13 9 8 12 6 8 0 0 0 0 60 2 9 17 0 0 25 0 65 3 9 5 76 18 0 0 
1 4 0 0 26 12 2 0 6 27 19 12 22 6 18 0 5 1 9 6 0 13 6 0 13 13 12 2 3 30 11 3 0 0 0 0 0 49 13 0 19 40 0 0 
9 25 8 0 4 0 4 7 4 0 3 2 8 2 10 0 0 26 0 0 0 3 0 0 5 0 29 0 0 4 34 0 0 0 0 0 0 0 1 20 11 0 25 0 
0 0 0 0 13 14 20 0 0 0 8 0 0 0 0 0 11 0 0 0 0 12 0 18 20 0 0 0 0 0 12 0 0 0 0 25 22 5 42 9 11 12 0 0 
