44 25
9 32 16 0 5 0 7 35 0 2 0 8 8 7 16 4 0 14 24 42 9 0 0 0 0 7 10 0 16 0 0 0 0 0 12 18 6 18 23 4 39 15 0 20 
0 0 19 36 6 0 28 17 0 11 36 21 12 0 6 0 0 6 5 10 0 0 0 2 4 13 7 21 35 14 0 0 13 7 28 0 22 23 0 35 0 5 0 0 
0 38 5 0 22 31 0 34 18 14 0 7 19 18 7 0 26 0 0 10 18 14 14 0 0 0 0 11 0 2 0 10 24 29 0 7 57 0 12 16 1 34 33 4 
11 30 27 23 0 1 1 0 4 5 30 12 20 7 13 0 20 0 7 2 0 0 12 0 22 32 54 0 18 2 0 6 1 11 41 12 35 0 0 4 0 0 40 0 
0 35 34 0 6 30 3 4 0 19 27 26 0 7 13 39 6 31 8 0 16 6 14 3 20 10 0 22 0 11 6 0 13 0 23 7 83 32 3 42 23 0 9 0 
0 2 0 2 12 0 31 38 0 47 7 4 0 0 10 0 0 11 8 0 0 0 15 20 0 0 0 0 24 14 0 30 0 0 0 0 0 31 19 10 0 7 33 5 
0 35 0 0 4 0 7 31 0 0 0 9 1 0 0 0 0 6 9 0 23 0 21 0 2 7 8 29 1 0 0 12 32 0 0 0 35 2 1 15 21 0 0 35 
0 18 53 17 0 0 0 16 0 30 1 1 3 0 25 18 0 6 0 33 6 0 4 0 22 6 12 3 0 10 11 0 31 0 6 0 21 0 13 29 0 22 0 0 
35 17 7 0 18 0 37 0 0 17 0 10 51 0 2 11 21 10 13 0 18 11 4 0 41 3 5 0 3 8 14 5 11 21 56 46 8 10 2 43 30 1 30 43 
14 0 0 0 1 10 0 0 26 10 21 0 0 0 5 4 0 0 0 33 26 7 11 0 0 8 0 0 0 0 20 21 0 0 26 0 0 17 4 12 0 22 0 0 
0 0 67 0 3 0 0 33 5 0 0 4 0 2 9 13 0 0 18 16 2 6 18 0 25 3 0 0 0 0 6 0 0 0 2 8 34 0 4 0 0 34 0 25 
0 8 0 24 22 35 22 4 0 5 8 0 0 0 6 3 0 8 0 0 0 9 16 0 0 3 27 0 0 0 0 53 0 0 12 0 8 0 33 0 0 0 0 0 
0 13 12 27 47 41 0 40 0 8 4 6 8 0 1 0 0 18 5 1 25 0 8 0 15 0 13 0 0 25 0 31 0 0 12 20 0 32 0 4 37 0 0 21 
0 37 2 27 4 4 7 4 0 8 12 0 7 0 0 3 0 21 9 0 15 8 8 0 7 0 13 9 19 15 27 11 0 0 27 9 7 0 4 4 0 13 0 0 
0 0 11 0 34 2 0 29 12 0 17 12 21 35 14 18 2 0 0 4 0 0 0 12 19 2 6 17 0 0 20 0 12 32 0 2 29 24 34 0 0 0 4 25 
2 11 3 2 8 0 0 2 5 12 11 0 5 10 12 25 23 7 0 4 16 16 11 0 0 11 14 0 8 24 6 12 2 0 0 6 14 20 6 23 0 10 0 0 
0 0 1 0 0 0 8 21 0 0 21 24 0 0 12 0 0 3 0 0 0 7 10 0 5 0 9 4 21 2 11 21 4 11 0 32 0 0 0 12 0 11 0 0 
39 4 0 0 2 0 19 0 36 21 20 3 0 9 5 3 0 5 4 20 0 3 4 0 19 33 7 27 20 1 22 12 31 0 4 7 0 0 0 6 0 9 7 0 
3 3 34 9 0 14 3 5 0 16 15 0 3 10 8 7 2 3 0 12 9 8 2 0 9 0 13 0 13 11 20 13 9 0 0 23 0 31 0 43 10 0 6 12 
4 22 0 7 0 0 5 0 0 31 30 13 3 0 0 5 2 0 2 2 17 7 0 22 1 0 0 0 2 14 10 0 5 0 0 4 12 2 14 11 34 0 0 14 
0 0 46 37 25 33 0 20 0 34 3 36 0 0 0 0 0 0 0 0 12 0 24 0 11 0 4 16 0 52 23 28 16 22 10 0 0 0 33 36 0 7 14 34 
4 0 14 0 0 26 0 16 25 9 0 28 4 13 0 8 3 0 0 0 0 0 0 0 1 0 0 0 0 21 0 44 0 0 4 0 0 0 3 28 0 3 0 0 
17 19 4 46 8 20 17 7 8 22 0 0 3 8 13 0 8 25 0 3 19 0 8 3 14 0 0 21 24 20 0 22 0 6 0 32 0 0 0 6 0 0 2 20 
18 0 23 8 0 19 0 8 9 26 28 0 0 29 21 27 20 7 0 0 0 7 0 6 26 0 16 0 35 6 6 11 8 9 0 26 0 0 44 15 0 0 38 0 
0 0 0 0 0 0 5 0 0 0 21 13 0 1 3 18 6 15 19 24 0 0 0 0 17 9 0 0 0 25 0 21 0 0 24 6 13 20 52 15 29 3 28 0 
