44 25
22 59 38 23 11 0 12 10 0 20 0 15 11 13 0 25 0 8 12 0 0 12 47 0 16 0 25 0 0 0 4 13 0 0 11 16 0 6 0 0 40 4 30 0 
8 0 37 1 50 3 9 3 7 13 1 45 13 2 22 0 0 12 0 0 0 14 0 2 5 0 5 0 0 23 6 20 28 3 25 19 12 0 15 51 0 20 0 32 
0 38 38 0 25 0 29 20 0 32 0 2 0 18 0 0 0 0 1 22 22 27 0 0 7 12 17 25 9 0 0 5 11 44 2 7 10 36 5 15 27 25 43 0 
15 0 0 0 33 0 0 0 10 15 15 0 4 0 58 6 4 20 19 0 7 6 0 0 5 15 0 9 0 0 4 0 3 17 8 0 0 13 3 2 26 12 0 0 
10 0 0 67 0 17 0 15 6 1 0 31 17 0 6 3 13 5 0 0 22 0 5 0 16 0 12 14 15 17 27 16 20 2 0 4 0 0 0 17 0 11 31 44 
14 5 0 0 0 24 19 5 23 17 21 0 18 13 14 0 4 25 0 6 8 10 21 2 19 12 0 7 6 0 0 65 23 1 0 0 11 0 0 0 0 21 0 47 
7 12 45 18 25 30 0 4 0 3 11 18 47 0 0 15 0 0 3 0 0 12 0 12 5 0 0 0 16 1 0 0 7 40 0 3 4 29 11 0 11 6 12 0 
16 8 0 31 18 36 24 16 0 3 18 8 20 15 14 1 6 0 26 18 7 8 1 0 3 0 26 3 5 28 17 0 14 13 21 21 0 0 3 8 0 6 30 7 
0 38 11 0 0 7 0 19 7 0 1 0 0 0 0 0 0 19 0 7 0 0 0 0 16 0 12 0 5 0 0 0 0 5 5 0 19 0 1 39 0 5 0 4 
19 0 10 2 8 0 7 27 3 3 20 0 0 0 4 11 0 0 0 23 24 0 3 0 0 3 0 0 0 15 2 0 0 4 17 0 0 4 7 0 0 0 0 6 
11 24 3 0 57 5 9 21 29 17 0 21 1 10 11 0 7 0 0 24 9 17 15 0 0 39 0 0 0 9 0 0 6 8 0 12 0 29 40 0 15 14 0 32 
0 7 1 10 0 0 0 0 0 0 16 12 20 0 5 10 6 0 0 0 10 11 10 9 14 0 0 9 0 0 0 0 31 9 5 0 14 4 14 0 0 4 0 0 
0 0 20 0 8 10 0 0 2 0 7 0 15 21 11 0 0 4 16 2 7 0 0 7 4 0 0 6 9 0 2 0 10 0 19 0 34 0 0 0 0 21 5 0 
35 0 3 0 0 24 9 18 48 0 0 0 21 39 4 0 7 0 0 5 0 0 0 0 10 18 0 3 20 24 0 0 2 14 13 8 30 4 0 15 0 0 48 0 
35 7 0 23 0 29 31 7 2 0 5 11 0 2 30 29 1 0 0 0 3 22 0 0 0 31 23 2 0 13 10 19 0 0 20 1 9 26 0 11 6 9 34 0 
23 6 4 14 12 7 33 0 1 0 0 23 0 4 2 13 10 0 12 6 45 15 15 23 0 9 4 0 7 3 4 28 0 0 2 0 3 22 5 9 38 3 0 6 
35 0 10 38 12 0 45 15 2 12 20 0 10 9 13 0 0 0 0 0 0 9 18 0 3 0 1 24 0 0 20 0 24 0 22 35 5 0 0 4 0 29 0 0 
0 0 16 2 0 0 62 0 4 0 13 0 16 5 8 5 3 24 0 1 33 15 0 0 0 0 9 0 0 0 24 0 0 21 0 10 0 0 0 0 4 24 19 0 
27 23 6 0 53 19 36 9 6 0 0 0 28 23 12 0 9 6 0 30 16 12 0 0 0 0 2 6 0 5 6 0 2 8 0 11 30 36 0 8 1 26 1 38 
0 18 25 5 0 0 10 0 37 0 36 0 0 6 24 0 47 5 0 15 2 0 17 0 0 24 13 0 39 0 8 3 4 8 30 0 0 5 14 4 0 18 0 0 
0 0 18 43 8 38 0 0 0 1 13 0 0 52 0 0 0 3 0 9 0 0 9 0 16 0 0 9 9 0 0 29 0 37 0 0 0 24 5 0 37 0 0 38 
3 39 0 36 32 0 26 27 0 0 3 0 0 6 17 38 4 0 0 16 13 0 0 0 11 0 8 0 1 0 0 5 17 3 6 52 25 31 0 19 0 0 0 0 
0 7 18 6 43 3 9 0 0 11 0 0 6 27 15 0 3 15 3 7 0 0 0 0 5 8 12 9 6 16 0 0 0 0 0 34 0 0 12 6 36 0 0 0 
16 0 0 14 3 5 17 16 0 2 0 10 23 0 7 0 0 3 0 0 0 0 0 17 15 0 1 3 1 0 12 2 0 17 22 0 22 0 7 0 37 1 12 0 
9 0 0 23 0 0 45 0 0 0 23 5 1 13 0 42 0 24 1 9 0 21 5 12 9 0 43 16 0 10 5 25 1 18 0 0 26 0 0 10 2 25 21 0 
