44 25
20 0 25 32 0 4 27 0 18 13 88 9 6 1 0 37 14 0 0 6 42 0 21 8 16 18 13 46 19 24 34 14 1 16 0 32 0 11 23 20 38 11 1 18 
26 12 29 0 78 0 0 3 10 0 1 12 0 8 13 27 5 16 0 12 9 13 38 19 8 0 14 2 13 2 10 71 0 51 13 0 14 0 7 35 23 39 0 21 
9 0 0 0 6 0 0 6 27 9 0 0 0 0 29 0 0 2 5 0 0 0 0 27 0 5 0 0 0 9 0 0 12 0 0 27 0 0 0 0 0 0 0 29 
11 0 0 14 31 5 13 16 8 0 7 0 0 0 0 28 17 40 0 4 4 13 12 16 1 15 0 0 13 0 0 7 0 17 22 11 32 0 0 0 25 0 0 26 
41 0 8 0 0 0 27 0 1 0 0 19 0 0 18 32 0 0 0 0 23 0 0 10 13 0 0 20 0 2 5 0 18 27 0 0 21 30 0 0 0 0 0 43 
34 15 0 0 8 0 0 0 23 0 2 0 8 28 9 0 31 4 22 0 9 5 1 0 0 0 7 0 2 3 2 54 19 10 9 16 0 2 0 9 37 4 3 0 
10 40 39 42 7 1 0 4 8 0 0 25 20 6 15 2 11 4 5 19 12 3 1 0 0 0 0 0 25 30 7 0 2 15 0 0 0 4 19 17 12 74 3 32 
0 39 0 33 5 0 0 0 17 11 0 0 0 25 15 0 0 0 0 11 5 0 14 0 14 5 13 0 40 0 0 0 18 0 0 0 0 16 0 26 12 0 0 11 
9 0 0 0 19 11 7 0 8 20 5 0 12 9 0 11 1 5 14 0 0 0 5 23 12 19 26 0 22 32 0 0 32 14 0 0 11 7 0 2 1 0 7 10 
0 0 0 27 36 0 0 12 5 0 0 0 0 0 10 8 0 0 13 14 17 0 12 0 9 7 0 0 0 0 32 13 9 0 10 9 5 17 5 0 37 4 0 5 
0 0 0 26 21 0 0 0 6 4 30 0 5 4 23 1 4 0 11 0 6 16 9 0 1 36 0 0 0 26 4 0 0 0 0 0 0 23 0 2 30 16 0 0 
30 0 38 26 0 0 15 1 10 31 0 8 0 1 5 3 0 11 5 6 0 0 24 0 0 9 0 0 1 29 40 0 0 0 0 6 0 7 0 11 0 2 24 0 
0 23 65 0 27 0 0 3 3 12 4 6 30 0 0 0 9 0 0 0 11 0 11 7 0 18 0 0 24 17 2 2 40 3 6 0 0 0 18 37 6 0 0 21 
1 0 31 18 0 52 0 0 28 6 53 2 21 11 22 15 6 0 0 0 0 5 0 0 14 6 28 0 12 2 0 6 0 36 3 0 45 18 0 18 28 36 30 0 
20 7 38 7 0 0 29 1 1 5 9 0 0 10 16 17 18 16 0 13 62 12 15 1 0 0 17 7 0 12 4 8 7 7 11 29 3 0 1 13 0 9 0 40 
0 0 0 20 45 19 0 0 33 0 7 0 19 20 1 19 5 0 0 13 8 13 1 0 19 13 22 2 0 9 11 0 7 36 24 5 27 12 1 0 0 0 38 16 
1 8 2 0 16 21 8 17 0 0 0 16 7 2 5 0 1 0 0 33 16 6 0 17 24 26 2 3 13 5 9 6 32 27 0 0 0 0 2 0 0 10 0 37 
43 0 0 8 1 4 0 12 3 0 9 1 0 0 23 0 35 16 19 0 16 4 0 3 4 0 35 11 5 0 0 0 3 5 16 21 5 12 0 21 0 11 16 0 
41 16 12 0 36 0 35 6 0 20 5 8 0 0 7 11 0 16 0 3 0 7 0 0 0 14 0 0 0 5 0 18 4 0 0 0 9 0 0 33 43 72 0 0 
16 29 5 27 25 0 0 30 0 4 0 0 0 0 0 11 0 12 0 7 0 0 16 7 2 14 2 7 0 37 0 18 36 0 2 0 6 30 0 12 14 24 0 0 
0 0 0 0 0 0 0 0 0 25 0 2 0 12 5 13 0 11 0 0 1 1 0 26 0 12 14 0 11 12 3 8 29 0 0 0 2 0 0 28 1 2 12 0 
0 15 64 1 25 35 26 3 7 0 3 18 0 17 10 5 69 18 10 6 1 17 28 0 30 0 5 3 0 21 10 2 98 21 13 2 0 0 9 0 28 0 8 0 
0 3 32 39 0 22 0 0 0 0 0 0 0 0 15 19 1 8 0 0 0 0 16 0 22 0 0 0 0 0 1 0 0 0 1 32 21 32 16 0 0 0 0 21 
34 11 7 0 0 16 0 0 0 5 9 10 9 0 22 22 17 0 0 0 6 25 0 0 0 0 0 0 0 9 1 0 16 22 33 0 22 10 0 0 0 10 0 0 
0 50 44 0 18 0 0 6 17 3 0 0 33 12 0 15 7 21 19 37 9 20 38 18 0 0 0 24 0 24 0 0 0 0 46 16 0 10 0 0 41 0 30 0 
