44 25
8 0 0 34 0 3 6 0 12 22 0 11 0 0 0 0 0 0 22 7 6 0 7 0 0 12 6 18 0 0 7 0 0 0 0 1 6 24 2 0 0 0 0 0 
13 24 0 23 0 11 31 0 0 0 13 6 0 0 0 0 13 6 0 0 11 22 0 14 0 39 0 0 0 13 0 0 0 0 0 8 21 31 28 0 0 0 22 10 
12 0 6 0 0 0 0 35 6 17 21 40 30 0 0 9 0 0 0 19 0 1 3 16 12 4 17 13 0 0 0 0 12 0 0 4 19 5 5 44 0 0 40 19 
25 0 0 28 0 0 6 22 0 41 0 13 11 0 0 8 0 0 0 3 0 21 0 0 11 10 0 18 28 8 0 28 23 0 0 38 0 0 0 13 0 0 9 0 
0 21 9 10 7 0 3 0 0 33 0 10 0 0 0 0 0 0 7 0 0 0 21 0 0 0 0 0 0 9 19 8 0 1 5 0 2 0 6 19 0 0 0 0 
40 0 0 11 8 27 0 1 12 4 8 41 7 0 11 15 0 0 3 0 10 13 23 2 6 14 2 0 2 4 27 0 8 0 2 0 5 7 3 0 8 30 0 0 
0 0 42 14 18 12 4 16 0 34 13 5 2 21 26 0 0 10 0 3 0 3 0 7 1 3 12 20 0 17 48 19 0 0 21 26 0 1 12 0 32 14 17 34 
14 0 0 0 17 0 5 38 0 50 20 21 7 1 8 27 0 0 14 7 2 17 20 8 0 9 0 1 0 0 0 0 8 29 20 26 0 29 31 13 5 0 27 0 
0 35 0 6 0 14 16 0 4 19 0 2 0 1 7 18 9 0 0 25 0 0 0 10 19 2 0 21 14 8 4 1 0 18 0 0 47 0 3 4 0 3 0 17 
0 0 0 0 0 23 0 3 6 12 2 3 3 10 13 0 7 0 0 8 16 8 0 20 0 0 3 12 23 0 0 4 18 0 0 0 16 9 0 0 15 0 0 3 
6 0 46 0 0 0 6 10 2 1 16 14 9 0 0 0 8 35 25 5 5 0 0 4 1 15 26 0 0 5 0 0 0 33 7 5 3 20 0 39 0 39 4 14 
42 0 0 0 20 1 38 5 32 32 5 20 11 0 0 19 0 9 8 8 0 0 0 11 0 0 10 8 0 13 0 69 0 25 0 0 0 0 0 0 0 3 29 28 
71 0 34 6 0 46 19 5 9 28 34 4 34 13 11 0 11 11 12 12 11 0 15 7 2 22 8 27 0 10 27 27 27 0 14 4 27 30 1 7 15 0 1 0 
0 0 27 0 87 0 0 23 13 0 0 4 3 0 7 4 3 10 2 0 5 2 6 26 10 13 0 26 0 14 45 0 16 13 0 0 0 38 0 12 36 44 0 11 
22 4 0 10 0 4 3 16 2 7 0 25 0 21 0 0 3 22 0 0 4 0 7 16 13 0 6 6 7 0 2 6 23 7 19 8 4 2 0 29 21 0 2 11 
0 0 9 27 25 0 35 14 8 0 0 17 0 0 13 0 7 0 8 13 16 2 14 18 12 0 8 33 7 26 28 0 21 19 7 2 4 30 31 11 7 0 0 0 
9 0 0 0 67 38 0 36 12 10 26 37 9 14 1 10 0 7 29 12 9 16 0 19 20 33 0 0 7 0 14 7 7 0 22 24 32 16 0 13 10 0 0 31 
0 8 7 31 0 0 0 0 16 6 1 28 0 0 0 0 9 9 3 10 0 3 12 6 0 9 0 12 0 6 13 0 0 0 25 0 0 0 27 23 8 0 0 0 
0 0 34 0 0 40 0 3 0 0 23 22 16 26 0 33 23 0 0 12 12 0 16 6 0 14 0 7 3 0 1 5 12 6 3 20 32 0 0 31 9 0 0 12 
0 0 0 4 26 13 0 0 0 26 3 0 22 3 4 0 0 0 0 21 15 0 0 4 0 0 0 4 0 0 41 0 0 0 22 26 0 14 0 2 11 0 18 0 
22 41 54 0 81 0 3 0 4 17 0 0 2 0 9 0 0 0 0 4 14 0 29 7 0 0 10 0 0 7 44 0 0 13 8 54 4 0 34 0 0 23 27 0 
35 13 0 0 9 22 21 0 1 45 0 17 40 6 8 0 0 0 0 33 17 17 19 0 23 20 36 60 9 17 29 3 0 21 3 35 19 26 38 4 15 0 0 101 
40 13 0 0 0 44 0 10 0 3 13 0 6 2 13 0 7 0 0 1 0 3 18 30 13 0 0 13 5 2 9 0 0 0 0 18 17 9 0 4 36 0 3 0 
20 0 0 14 13 0 2 2 0 35 38 16 6 0 7 0 0 3 31 14 35 0 28 9 20 24 0 2 10 21 17 12 0 8 0 9 13 20 0 14 18 0 47 20 
0 0 7 75 17 16 16 14 13 2 31 31 22 2 6 0 0 26 0 0 2 5 2 0 2 0 0 0 0 2 0 0 11 0 0 32 0 0 31 0 10 31 31 7 
