44 25
6 12 25 35 0 24 30 9 1 16 0 38 45 0 0 20 17 0 5 0 14 0 2 35 6 6 0 30 10 28 18 18 0 7 0 20 13 0 18 0 28 0 0 21 
0 0 28 12 0 0 8 58 1 2 1 16 0 20 26 3 14 4 7 0 14 0 0 8 7 7 8 0 0 0 14 16 37 31 8 0 0 31 17 26 33 0 0 0 
17 0 0 0 27 0 0 14 0 19 0 0 5 17 6 8 17 17 14 2 16 8 18 14 0 13 0 2 0 17 0 18 0 2 27 1 16 0 13 14 18 18 19 58 
38 7 0 0 51 0 33 0 0 0 21 0 13 0 27 10 3 0 0 18 0 28 18 0 0 8 12 17 16 2 6 0 7 10 0 3 43 9 41 33 21 9 0 0 
5 0 18 0 0 0 0 35 0 25 16 1 18 4 0 0 0 7 51 0 12 0 12 0 19 0 13 15 0 16 19 4 0 4 15 0 0 7 0 0 0 21 23 0 
0 15 5 0 0 0 36 1 13 59 0 44 2 11 4 4 0 45 11 25 12 15 17 0 0 12 0 0 0 0 0 0 21 0 5 8 22 23 0 39 3 5 23 8 
20 12 27 0 0 2 0 5 11 4 0 0 0 5 0 0 6 0 0 4 0 6 6 15 23 0 0 5 1 39 0 39 0 2 14 7 0 0 20 3 0 0 52 5 
0 4 0 33 14 6 0 0 0 0 0 6 0 0 11 0 0 0 16 13 27 0 0 0 0 11 0 0 0 11 10 0 0 0 7 0 33 0 0 0 0 2 0 0 
0 10 0 0 0 36 2 0 0 8 0 2 0 9 9 16 0 0 24 0 0 0 6 16 0 7 8 0 6 0 9 0 8 0 3 0 0 0 0 48 8 36 0 5 
38 17 15 0 4 17 0 2 5 33 0 0 0 17 8 0 0 16 40 16 2 0 29 0 0 0 0 9 10 6 9 14 14 11 0 7 0 19 10 14 9 0 8 2 
0 8 13 6 5 28 2 14 0 11 28 0 0 16 14 0 18 0 0 4 0 15 0 19 0 13 0 0 10 16 20 0 16 17 20 0 20 0 13 0 0 9 20 9 
23 2 0 3 0 6 1 36 35 0 0 12 0 20 13 0 11 0 23 11 3 0 2 23 19 24 25 9 0 0 0 3 16 20 10 0 4 7 5 10 0 0 4 25 
11 11 0 0 0 0 11 0 4 0 2 6 1 17 0 9 43 0 3 0 3 14 21 11 8 17 10 13 27 3 30 0 21 0 4 0 0 21 22 0 39 20 29 0 
23 0 0 12 35 0 0 1 0 0 0 1 6 0 0 34 0 0 0 7 0 0 2 0 0 0 0 11 0 5 0 1 1 17 36 6 1 1 4 11 0 10 8 8 
0 0 35 20 0 0 0 25 2 0 37 21 0 17 7 0 23 29 9 11 3 5 4 14 15 0 4 0 0 0 3 21 25 0 0 0 6 44 24 16 0 9 9 0 
25 3 32 16 12 0 15 0 38 11 34 0 11 0 0 0 8 10 0 24 23 2 22 26 0 22 0 0 0 2 5 0 0 0 3 13 0 0 15 17 0 8 0 3 
0 7 25 0 0 0 27 0 5 32 23 0 0 6 10 14 15 0 4 6 1 0 10 0 28 5 0 25 6 14 2 20 2 45 0 34 5 0 19 0 0 41 41 0 
0 0 0 3 1 36 8 69 35 0 9 0 5 9 9 3 0 0 23 9 10 0 5 5 6 29 13 13 20 1 9 17 14 2 33 2 17 0 17 0 15 0 11 35 
0 38 0 0 15 9 13 15 0 0 0 32 0 16 9 8 26 0 0 15 0 0 21 0 17 2 0 2 1 2 26 0 0 0 0 0 0 0 14 16 9 4 26 24 
29 7 0 0 0 0 26 15 6 12 4 0 14 2 7 9 24 0 18 0 0 12 0 6 9 0 7 0 0 23 13 0 0 0 0 0 17 0 22 0 34 4 1 5 
14 20 25 2 12 0 4 7 31 34 20 10 0 12 11 40 12 18 0 13 19 8 0 0 22 0 0 2 0 0 5 30 0 7 14 0 21 58 0 18 0 38 0 53 
39 22 0 3 29 0 24 0 0 0 0 0 0 3 27 9 0 0 6 0 0 0 21 8 3 36 1 16 27 0 24 8 0 18 1 0 0 3 3 0 0 40 13 14 
0 71 37 0 0 0 17 12 4 0 0 12 16 29 0 27 11 1 0 0 0 0 9 31 0 0 2 0 21 19 9 0 0 0 0 0 19 0 0 28 0 1 74 0 
38 20 3 3 20 20 23 1 5 0 25 32 0 0 31 10 0 21 15 2 1 0 14 1 21 5 6 0 0 23 28 0 0 0 17 10 0 0 38 28 26 31 0 4 
11 13 0 0 21 9 0 14 4 4 21 0 22 4 46 30 0 0 0 23 6 21 0 0 7 21 8 11 0 14 18 7 0 0 13 0 0 10 7 11 0 21 0 0 
