44 25
0 10 14 0 0 41 28 0 0 8 24 17 0 22 0 0 14 0 16 0 0 8 0 27 0 9 21 8 15 1 0 25 10 6 0 0 0 12 0 16 3 0 0 0 
4 1 28 0 8 15 0 30 8 26 19 0 21 0 0 0 17 0 22 1 11 0 0 0 16 0 0 0 5 0 18 8 0 46 10 26 0 0 20 0 16 0 35 0 
21 8 19 40 25 8 6 3 7 0 13 17 16 8 0 15 0 11 14 12 33 34 16 11 8 15 0 3 5 0 16 18 11 11 0 29 16 0 10 0 15 4 0 59 
7 0 9 0 32 22 27 24 24 5 10 17 18 0 12 0 0 7 29 5 11 10 1 4 0 9 0 9 0 0 67 0 36 0 23 11 32 3 14 9 0 30 0 32 
0 20 10 0 14 0 43 0 30 0 16 0 0 0 0 0 0 2 3 0 7 0 0 15 0 15 38 6 27 3 0 0 7 4 0 16 0 0 30 6 2 1 37 0 
14 3 0 22 32 9 25 39 0 0 16 0 0 0 1 0 0 0 0 5 20 0 0 0 18 18 0 0 21 0 0 0 0 35 31 45 14 4 0 4 8 0 16 0 
3 36 65 15 13 3 0 25 18 5 13 3 18 0 21 10 8 13 0 4 0 0 0 3 21 1 43 10 0 20 18 30 0 42 5 0 56 11 16 0 47 4 27 10 
6 0 51 0 0 0 33 0 8 0 4 29 0 0 7 3 11 7 11 0 13 0 0 7 0 4 0 0 0 0 7 6 23 2 29 0 0 21 36 0 52 0 0 7 
21 0 2 3 29 0 29 0 0 16 23 11 5 0 0 4 0 3 8 0 11 6 0 0 0 15 14 6 0 0 16 0 0 0 0 25 8 0 31 22 0 37 31 0 
37 3 19 1 1 44 1 2 6 39 15 2 0 0 15 54 11 8 1 10 21 9 0 12 8 14 0 0 13 0 0 0 1 3 7 10 4 45 29 29 35 5 1 36 
35 3 22 32 4 16 0 4 0 2 31 11 0 0 8 11 0 6 6 14 7 35 11 1 17 10 16 10 9 0 7 0 12 9 0 31 25 9 0 15 0 0 33 43 
0 44 39 0 0 29 9 21 4 11 7 0 10 0 3 0 0 37 0 23 18 0 3 27 3 4 0 0 5 0 27 9 15 39 21 0 2 25 0 0 0 39 8 0 
0 0 0 0 10 9 2 0 0 4 7 0 20 0 28 0 26 1 10 0 6 16 0 0 0 6 0 15 0 0 3 0 6 0 0 1 0 7 10 9 0 6 13 0 
8 3 0 9 0 0 2 0 0 21 0 7 34 0 0 3 21 3 7 0 5 0 0 0 4 0 0 0 0 0 21 0 13 5 14 11 0 1 0 4 5 3 0 0 
0 22 3 0 0 16 0 8 0 34 0 0 21 2 0 0 14 34 18 8 1 0 0 10 1 15 0 0 0 5 0 0 7 0 22 36 18 2 0 0 0 5 25 24 
15 0 38 19 0 38 2 0 4 0 0 0 0 4 17 2 0 4 22 0 1 10 23 2 15 0 4 0 26 0 24 17 2 14 0 11 0 4 7 0 57 39 40 0 
20 0 0 18 8 18 0 0 0 20 0 1 7 2 0 10 7 20 0 0 17 0 16 0 20 6 15 8 0 0 0 0 0 0 0 8 35 4 2 17 0 29 10 21 
25 0 0 36 31 0 0 0 3 0 43 6 0 4 0 0 15 8 0 0 5 5 0 0 0 5 13 0 0 9 0 46 0 0 0 41 33 0 5 5 13 31 0 0 
2 49 0 0 0 0 2 22 0 0 6 20 9 0 0 0 0 4 11 4 0 21 1 0 0 15 0 0 0 18 8 0 52 2 8 0 0 3 2 0 10 0 0 9 
4 0 58 2 0 42 0 17 2 32 13 17 0 0 0 0 11 26 24 12 0 0 1 6 30 7 0 11 0 5 12 16 0 11 17 10 4 19 0 3 0 63 0 41 
12 20 0 0 4 8 2 17 4 10 11 0 0 0 0 27 9 0 0 0 2 24 2 27 0 16 14 0 0 0 0 9 2 0 7 35 0 14 0 0 25 0 0 9 
3 3 0 12 17 0 0 13 6 17 0 15 14 4 22 0 17 0 0 0 13 17 0 1 0 0 15 3 8 0 0 3 0 0 18 12 22 24 0 11 39 0 16 0 
7 0 0 0 0 36 0 0 0 4 0 93 31 16 21 4 0 0 1 29 18 20 2 1 1 25 1 16 21 4 2 0 0 0 0 16 0 0 16 0 49 14 0 31 
27 12 0 0 0 0 0 10 0 2 3 0 18 0 0 5 0 10 20 7 16 1 0 0 26 44 0 8 18 0 28 0 16 3 0 5 0 0 13 0 15 0 12 0 
0 0 48 0 39 11 4 11 16 0 9 0 8 6 43 13 8 0 0 0 0 0 0 0 17 0 14 3 0 0 16 0 0 20 0 46 0 0 0 0 0 2 21 4 
