44 25
17 31 16 1 38 21 26 11 0 32 4 0 1 18 0 0 9 3 0 0 33 3 29 0 16 12 11 0 0 27 18 39 31 21 0 10 10 0 5 19 16 23 8 5 
8 18 0 42 0 0 2 1 7 32 0 14 6 9 10 0 0 7 18 18 0 0 14 14 0 30 20 23 0 0 17 0 8 0 0 0 0 0 0 0 0 16 0 0 
0 7 39 0 0 8 0 0 7 0 0 0 10 3 0 5 0 22 0 0 0 0 0 0 0 0 0 0 8 0 0 0 0 0 0 0 8 0 0 0 0 0 40 38 
0 0 5 2 0 28 16 0 21 2 0 0 8 13 8 5 6 45 0 5 9 3 0 3 0 8 13 0 0 21 0 0 7 12 0 0 0 0 0 22 28 12 3 19 
0 16 0 14 15 0 18 0 0 0 0 18 0 0 25 2 23 13 19 0 0 0 8 16 20 0 0 0 0 0 9 4 0 6 5 3 0 0 23 39 0 0 0 0 
3 8 5 18 1 0 15 7 0 0 18 0 26 3 0 8 0 0 1 3 0 0 0 13 27 0 0 0 3 0 0 27 3 0 7 3 2 0 38 38 0 15 0 0 
42 33 3 15 45 10 17 3 0 17 0 0 0 0 15 0 2 8 19 15 0 0 0 0 13 27 7 13 5 28 0 15 9 7 16 18 32 0 8 23 13 39 0 5 
0 30 7 0 0 0 24 0 0 25 8 0 2 0 1 14 0 35 0 0 0 0 7 14 7 0 0 0 22 2 0 37 0 0 17 0 0 0 0 33 0 18 3 28 
19 27 5 28 22 0 2 0 21 24 3 0 1 4 0 0 10 0 0 38 0 6 0 0 20 2 18 14 17 21 0 27 0 3 0 0 0 28 0 11 0 7 0 15 
20 43 0 49 37 32 31 0 0 3 0 0 13 0 0 0 2 9 15 0 5 6 17 0 20 0 20 0 0 0 13 3 57 0 0 15 3 0 7 5 37 0 5 6 
12 5 0 0 0 5 1 0 0 0 18 0 27 0 8 25 0 2 0 3 0 0 25 13 15 20 3 0 6 0 3 0 7 10 0 10 0 25 23 15 0 4 1 0 
0 5 70 8 24 4 26 0 0 54 0 23 6 53 28 0 5 4 0 21 0 9 5 14 22 11 17 8 42 6 2 15 41 34 32 0 0 7 5 14 0 39 28 24 
15 38 0 0 3 0 46 20 36 6 3 0 31 12 6 6 0 0 10 18 9 17 40 0 6 10 0 51 12 0 8 6 4 9 6 19 21 44 0 17 45 9 34 31 
0 0 31 27 0 0 19 26 15 16 0 10 4 0 0 11 5 26 25 12 0 0 0 6 0 7 16 4 0 4 14 0 0 55 19 9 0 11 0 8 0 8 0 1 
18 0 2 5 0 0 0 0 2 0 7 11 4 0 0 12 0 0 6 6 0 0 0 0 0 0 0 48 0 0 3 19 5 0 0 0 0 0 0 0 11 27 5 0 
0 25 0 0 0 35 12 10 5 12 1 0 0 0 21 26 8 12 0 0 6 3 8 0 10 20 0 5 0 3 2 0 12 5 6 13 5 29 0 20 0 47 25 0 
0 1 67 19 30 0 3 1 0 6 1 4 6 0 14 5 0 0 0 0 0 0 6 1 0 0 1 1 10 14 16 0 0 8 30 33 34 0 3 5 0 12 0 9 
0 0 0 0 0 31 11 0 0 7 0 0 16 21 1 3 7 0 2 11 23 16 0 0 0 0 0 7 0 6 5 6 19 0 5 23 0 5 0 0 2 36 5 0 
0 2 0 17 22 30 0 4 0 0 6 11 31 2 0 1 1 24 0 1 0 0 0 0 7 21 0 3 0 0 0 3 16 0 3 7 0 0 0 0 2 34 2 0 
39 0 0 11 12 28 0 0 0 0 0 0 11 22 23 17 10 0 18 0 0 0 1 15 0 29 10 0 8 14 0 0 0 36 0 18 6 0 0 70 2 0 0 43 
17 16 0 19 29 3 20 8 4 0 0 12 18 0 0 2 0 26 0 15 4 2 29 12 6 0 0 0 10 10 48 0 0 19 11 0 2 14 0 5 23 0 0 0 
15 25 9 14 33 0 22 0 21 0 39 20 3 19 13 6 8 16 0 15 0 0 7 0 13 12 0 0 6 26 26 11 0 8 5 5 2 8 7 2 0 2 11 0 
36 3 0 9 38 0 12 11 15 22 14 22 37 15 7 10 3 1 0 21 0 7 16 0 27 0 17 19 4 10 7 10 0 5 10 7 5 19 0 57 21 0 34 19 
10 0 0 29 48 3 17 0 7 0 8 0 9 0 0 7 0 20 0 0 0 12 0 3 8 0 22 0 0 16 34 4 14 0 6 4 0 0 0 0 0 9 0 37 
42 0 0 0 15 22 13 13 0 8 12 3 0 4 15 0 0 22 15 0 13 8 2 17 18 12 16 0 0 4 0 10 3 20 0 15 0 0 0 0 17 0 51 0 
