44 25
0 0 17 9 20 17 0 3 0 0 3 0 35 2 14 0 0 0 5 23 2 0 22 0 12 0 0 0 0 0 11 27 0 10 0 0 5 24 4 26 18 7 15 10 
0 38 0 38 13 0 8 0 2 0 3 0 17 0 26 24 13 0 0 0 0 16 0 0 0 0 0 9 0 18 0 0 26 7 0 5 12 0 0 24 34 37 8 0 
68 0 0 0 24 46 34 45 17 16 0 22 15 0 4 21 0 0 3 0 15 14 0 0 0 8 0 0 8 24 0 27 1 24 0 20 5 29 0 32 34 0 5 43 
0 35 0 0 1 0 0 0 0 0 25 0 3 0 0 0 0 13 0 0 8 14 1 1 0 16 10 0 1 14 0 0 0 0 0 25 31 0 0 0 0 16 0 14 
63 29 15 38 0 0 0 18 0 6 17 11 19 0 34 24 0 0 0 0 41 9 12 0 16 10 0 13 18 0 2 0 0 3 0 30 7 0 4 19 13 4 70 0 
11 0 0 4 3 37 0 2 3 0 13 0 9 19 22 0 0 0 5 11 0 0 0 0 0 0 6 17 2 25 11 12 28 0 0 0 17 24 0 8 0 0 45 0 
12 0 29 7 21 17 0 6 1 4 22 30 31 8 29 22 2 13 5 12 21 19 25 0 4 2 0 8 0 7 0 4 11 0 5 5 0 43 31 34 32 34 7 43 
8 6 20 0 0 6 0 0 0 0 22 25 4 0 5 0 0 0 18 4 0 7 32 0 0 8 9 0 3 0 0 12 16 0 31 36 18 18 0 0 0 27 20 0 
2 0 31 1 6 35 0 0 0 0 0 0 0 0 49 21 20 0 0 0 6 22 10 2 3 10 0 8 0 0 0 0 0 21 1 0 20 1 11 0 35 3 8 7 
36 0 4 37 16 15 13 10 9 12 7 7 7 0 7 0 4 7 0 11 31 38 12 0 2 7 0 0 7 0 9 0 0 0 14 0 28 0 0 42 0 26 5 0 
0 26 29 4 0 23 0 4 35 0 19 1 8 0 6 1 1 2 0 0 24 0 12 11 7 13 17 11 11 0 0 21 6 0 12 3 8 6 4 0 0 0 0 35 
35 26 45 0 0 0 3 21 2 27 23 31 1 0 3 2 21 0 16 0 2 0 11 0 7 9 0 34 4 22 8 52 9 0 0 25 27 0 11 8 0 9 23 36 
0 0 2 13 15 9 24 0 0 0 37 0 7 6 0 0 16 15 0 0 19 0 0 0 18 11 0 16 0 0 0 6 0 0 0 0 0 27 0 19 30 37 0 0 
0 6 30 0 0 38 29 5 0 12 2 2 1 23 4 0 0 0 7 0 26 15 0 3 5 0 2 16 11 0 0 0 18 5 6 4 9 0 0 5 0 0 11 38 
18 10 0 0 20 0 18 32 47 16 0 7 0 25 17 0 19 0 32 0 11 27 43 0 0 11 0 0 10 0 22 9 9 25 12 42 0 3 29 0 0 9 20 27 
7 26 1 43 0 0 26 63 8 0 25 3 17 0 3 0 8 9 10 0 22 0 9 7 0 16 5 6 13 17 33 26 1 1 27 25 3 5 0 7 13 9 9 36 
19 0 32 0 0 23 0 8 28 14 7 7 21 0 2 2 0 6 3 21 8 12 16 0 16 8 6 0 1 3 18 0 0 4 31 26 0 0 0 39 21 0 0 0 
43 7 18 16 15 7 0 30 0 0 2 0 12 26 0 6 13 0 0 0 13 31 6 0 7 4 0 9 9 0 0 0 0 28 4 7 0 35 0 24 16 33 6 43 
50 0 0 1 0 0 39 4 28 8 24 0 24 26 0 0 0 13 0 0 7 0 10 0 7 0 7 0 0 0 26 25 7 12 22 1 22 37 0 7 18 0 11 0 
16 10 15 0 0 4 1 47 30 2 11 2 48 0 10 0 31 26 0 22 4 20 4 0 0 4 0 5 21 3 8 29 7 15 7 24 28 1 12 37 0 2 10 12 
16 0 0 1 3 16 0 18 3 26 0 0 0 0 0 0 33 0 2 0 0 5 18 5 6 26 0 4 0 0 2 4 0 14 2 26 18 14 0 19 9 0 21 0 
0 0 0 0 0 9 0 0 5 0 0 0 0 0 28 2 0 0 12 0 0 0 0 3 0 0 5 0 0 0 14 0 2 0 12 1 0 1 1 20 26 0 0 0 
0 0 0 6 0 0 0 18 4 15 0 15 15 0 25 6 0 0 9 0 0 4 0 0 22 15 0 3 0 0 0 0 0 0 0 14 0 7 0 10 13 0 0 0 
0 0 68 0 0 5 2 6 20 0 19 0 19 4 0 18 16 24 0 19 0 0 12 0 0 11 21 0 0 27 0 0 31 12 32 2 0 21 0 1 0 0 25 50 
0 29 2 0 39 7 0 0 0 29 0 0 0 0 0 2 0 9 10 0 0 0 9 24 2 0 17 0 0 0 29 0 23 9 0 0 38 12 0 16 0 9 0 0 
