44 25
9 41 27 0 0 15 27 0 14 23 31 28 14 0 0 27 22 23 16 0 0 0 9 2 0 0 18 0 17 0 0 9 0 4 23 0 0 0 0 0 7 31 14 13 
23 0 31 0 0 0 10 2 16 21 3 24 0 2 21 11 10 30 16 15 22 2 5 56 8 0 5 11 18 0 0 0 3 22 0 10 11 9 0 11 0 0 46 2 
0 89 21 15 13 25 31 0 0 0 22 58 1 3 6 4 0 24 23 10 5 7 22 36 9 0 14 26 24 0 0 0 18 0 13 0 3 0 10 28 0 20 0 42 
5 49 0 17 0 5 0 0 0 14 2 0 6 0 7 0 0 24 0 16 0 18 21 7 12 0 0 0 15 0 22 0 0 0 24 5 8 2 19 5 0 24 17 0 
14 0 33 9 29 11 2 0 3 0 0 23 6 24 14 15 0 35 1 2 0 0 0 8 29 0 1 4 15 0 12 29 19 34 23 20 9 19 5 0 23 0 15 15 
31 0 3 24 24 0 36 11 5 0 0 0 0 23 0 0 0 0 17 28 0 0 5 0 0 0 8 24 3 0 0 24 11 0 0 29 10 11 1 1 0 3 0 39 
0 56 9 0 2 0 14 0 41 0 7 21 8 0 27 4 0 0 4 16 5 39 5 17 15 0 0 13 0 6 10 0 15 13 0 34 3 12 0 9 42 12 0 0 
7 0 6 12 5 0 3 0 0 0 59 0 4 1 6 19 12 0 0 13 10 0 7 14 0 0 3 0 0 9 0 15 28 19 1 3 4 27 8 0 0 0 0 0 
14 48 35 0 2 4 0 0 0 4 0 12 8 23 0 3 0 21 8 18 7 2 0 7 3 6 3 7 8 23 10 36 0 0 32 8 35 12 42 0 2 3 0 13 
13 10 0 0 58 0 3 7 8 0 1 10 0 0 28 8 1 1 0 2 0 4 0 0 0 0 22 0 7 14 0 0 0 7 0 0 0 0 0 23 36 7 0 0 
42 4 0 33 19 10 0 12 8 47 1 0 7 10 7 18 11 0 12 6 16 2 8 24 0 5 0 0 3 8 4 22 23 2 12 0 50 1 0 1 0 0 42 0 
0 47 0 35 41 31 0 0 0 9 33 0 0 0 0 2 0 0 14 0 9 0 12 3 3 18 3 0 0 0 9 36 0 12 6 0 31 13 43 0 4 0 0 18 
33 3 0 30 15 9 24 0 11 24 11 6 17 6 21 51 0 2 0 2 34 15 0 12 9 5 0 3 0 15 5 16 8 45 2 60 4 0 16 0 0 16 42 34 
0 3 0 9 14 13 8 0 0 22 7 28 0 18 2 16 7 20 10 3 16 4 0 7 0 6 0 0 5 0 7 23 0 0 13 3 10 12 0 28 0 0 0 10 
37 0 0 0 0 0 29 30 8 0 0 0 14 0 9 22 0 0 0 6 0 0 0 0 10 0 34 0 0 0 30 0 0 0 0 0 0 57 0 0 0 0 0 0 
6 0 9 3 0 0 9 27 0 6 13 13 29 0 2 0 0 9 0 13 5 5 0 0 0 0 9 0 12 7 0 6 0 0 40 28 0 1 0 0 1 0 0 6 
0 0 0 0 0 0 0 23 1 1 10 0 12 8 0 20 5 19 17 0 10 7 12 6 15 9 0 0 4 0 5 3 29 8 12 20 19 2 3 2 8 41 0 0 
5 0 0 6 0 0 0 0 8 33 16 0 14 0 6 0 3 0 9 0 0 0 0 0 0 0 22 34 0 0 0 8 0 0 8 5 0 2 0 10 0 0 0 0 
22 0 26 40 2 24 0 0 43 0 0 26 0 53 0 9 0 14 13 0 0 3 29 17 0 2 3 0 17 6 28 7 0 2 32 0 0 38 5 56 27 0 0 0 
31 48 25 2 0 40 4 0 19 35 1 0 0 0 9 0 0 15 0 0 0 0 15 14 4 0 0 15 0 27 21 31 15 0 0 21 0 10 0 0 2 40 20 29 
18 12 17 12 24 10 0 0 3 0 13 31 0 0 11 52 2 7 26 6 34 36 0 2 15 0 0 0 0 0 16 4 22 0 0 3 0 0 14 22 20 26 69 19 
0 0 11 14 35 0 34 35 9 0 0 0 6 2 2 0 23 17 25 2 11 18 20 20 6 23 20 0 0 0 9 0 0 0 0 0 0 1 3 59 26 0 35 51 
14 10 0 4 0 35 34 0 0 10 4 0 0 0 20 13 22 0 12 9 17 9 11 0 8 1 0 0 0 0 11 17 16 0 22 14 0 12 43 0 1 40 0 33 
28 16 19 27 12 28 4 0 0 17 2 21 2 2 29 5 0 23 15 1 15 26 0 9 14 13 13 27 25 14 0 3 18 11 23 0 20 19 23 18 0 0 15 22 
18 121 20 0 2 0 37 29 7 28 32 0 0 8 13 7 33 23 18 10 13 5 34 17 10 0 7 7 0 10 0 37 0 14 6 11 3 7 5 0 3 0 0 106 
