44 25
0 0 41 1 43 0 13 19 0 0 0 1 20 0 8 0 13 3 0 4 14 17 0 2 0 22 74 0 0 2 0 6 0 14 16 16 0 23 0 0 26 0 16 28 
17 16 44 0 38 23 0 45 0 0 16 1 23 0 0 0 0 17 0 0 0 0 8 0 0 12 0 0 10 0 23 0 0 0 0 3 8 3 11 35 22 0 0 12 
37 45 23 34 35 4 0 0 24 17 29 29 30 8 9 12 23 20 0 10 12 0 10 0 11 11 35 22 3 12 11 11 14 7 9 0 4 11 12 16 36 0 0 22 
0 0 39 0 61 0 0 0 16 0 0 0 0 0 42 11 5 0 44 39 0 21 22 0 7 0 4 0 0 0 7 12 0 14 30 0 0 15 2 33 0 109 0 0 
4 15 40 0 11 0 2 3 20 0 63 0 36 6 11 20 6 10 13 4 20 3 3 8 0 12 12 7 15 17 22 6 0 9 28 17 0 1 4 0 0 31 40 0 
1 73 0 10 0 0 0 19 5 26 32 0 0 1 26 9 0 0 13 16 32 0 8 5 14 0 0 0 25 16 20 0 19 20 19 3 4 5 22 0 0 40 0 0 
0 1 40 18 39 0 24 0 0 0 8 7 28 0 0 7 14 16 13 0 17 3 0 10 9 9 0 16 6 12 8 0 14 18 5 0 20 0 10 0 10 30 26 10 
40 0 0 7 0 8 0 24 0 0 1 13 0 1 24 21 0 0 18 12 6 1 1 11 0 6 13 0 7 0 0 0 0 0 7 7 46 3 19 13 40 0 0 0 
3 0 0 4 0 9 3 0 11 0 37 26 7 0 0 12 4 5 0 11 4 18 0 1 18 27 34 0 0 29 3 3 0 3 8 5 0 0 0 18 0 31 0 19 
5 24 2 0 0 0 8 0 0 0 0 9 0 0 0 5 0 0 24 0 1 15 10 5 28 0 27 1 11 0 0 14 7 0 18 0 1 7 0 18 20 4 8 0 
66 0 0 17 0 42 0 0 0 31 0 6 0 2 0 0 0 0 8 0 19 0 13 10 15 0 26 0 2 1 0 0 0 11 0 4 5 3 0 30 56 36 0 0 
0 7 10 0 0 0 14 0 0 1 19 4 0 12 13 3 0 0 0 18 3 0 0 3 1 3 6 0 1 23 2 12 10 6 0 6 0 0 0 0 0 0 0 11 
2 4 2 0 0 32 3 0 36 22 9 14 0 0 12 0 8 2 3 0 0 0 0 0 3 14 6 18 2 22 1 40 10 2 0 0 0 49 0 0 14 0 0 0 
53 1 0 39 39 39 0 10 9 22 12 3 0 0 28 15 22 15 22 12 0 18 0 4 15 5 17 0 14 0 6 18 11 3 0 1 10 0 65 16 25 4 111 6 
12 5 15 34 6 0 10 22 0 0 8 0 27 6 21 29 9 39 0 0 15 0 5 7 9 0 13 1 48 14 0 12 19 12 20 0 0 0 0 35 4 0 1 75 
42 0 0 0 12 2 5 0 0 0 32 0 8 9 1 26 0 37 16 15 13 9 3 0 0 0 5 8 0 0 0 9 0 29 0 21 1 0 2 2 0 26 42 0 
33 47 12 0 31 32 0 0 28 0 12 23 0 24 12 7 0 19 1 4 6 25 0 10 13 0 18 6 0 1 1 0 3 33 33 31 22 18 26 0 11 0 9 5 
0 23 0 0 0 9 60 0 0 0 7 0 3 0 0 13 0 0 5 0 10 17 0 0 1 0 5 0 0 0 0 0 0 14 0 10 4 0 0 0 34 17 1 0 
0 0 5 0 22 0 8 0 15 0 20 39 3 0 48 9 14 0 10 6 5 0 0 17 3 11 18 0 0 0 19 20 18 13 0 0 3 0 34 29 0 27 38 0 
0 15 0 0 46 8 0 26 0 0 0 0 5 33 0 25 4 5 0 3 6 0 8 1 9 0 0 9 16 2 0 0 10 13 14 0 5 20 0 26 25 0 0 0 
0 0 12 6 0 0 10 13 0 0 15 12 11 15 19 0 1 0 4 0 10 1 0 3 0 15 1 1 1 0 0 0 0 0 5 0 0 0 0 5 0 0 26 27 
0 0 48 26 34 3 27 1 0 0 20 0 0 0 12 21 19 0 0 0 9 0 6 9 3 0 0 0 14 37 8 9 36 0 0 8 25 0 26 0 0 39 0 0 
30 27 0 0 28 0 0 0 43 0 19 0 5 0 11 27 0 22 0 0 0 0 0 13 0 11 1 16 32 0 0 0 18 5 8 0 16 0 38 0 1 0 27 35 
7 19 5 12 76 12 0 29 2 0 51 18 5 0 0 12 9 16 37 0 4 7 9 7 15 12 9 1 1 18 6 44 9 4 0 0 42 26 0 0 30 2 0 2 
38 54 1 8 24 51 51 5 0 0 0 8 23 13 0 18 20 0 21 8 23 7 0 5 0 0 26 0 1 0 4 0 0 28 0 19 0 11 49 33 0 38 0 41 
