44 25
32 20 1 40 2 19 23 18 0 8 16 7 5 3 0 0 0 16 7 2 27 0 0 17 0 12 27 1 28 3 19 3 44 18 63 20 24 11 0 19 0 24 0 15 
0 16 47 28 0 0 29 32 0 42 8 0 0 0 0 0 22 10 7 0 0 0 15 6 0 0 0 0 0 0 11 22 0 13 10 29 29 0 2 1 3 6 0 44 
40 38 4 0 2 0 21 0 45 0 0 31 0 19 19 28 0 23 0 18 23 0 0 20 6 8 20 0 0 21 2 0 24 19 2 27 9 38 0 0 76 0 20 51 
0 0 13 21 0 24 1 21 0 0 0 11 26 27 0 51 0 0 20 1 0 0 15 0 14 0 12 2 27 0 0 2 0 9 0 0 0 10 1 0 5 0 16 34 
7 0 0 20 0 7 31 18 0 0 13 0 0 5 14 12 3 0 4 1 0 0 16 15 0 0 0 0 1 1 7 0 0 1 1 12 5 24 0 0 0 7 10 33 
22 0 0 7 13 2 29 15 0 4 38 7 3 22 0 0 0 9 0 18 1 0 2 4 0 0 0 5 3 23 0 7 0 16 29 59 3 20 15 3 0 31 0 0 
21 31 24 12 47 1 21 4 1 15 0 0 0 2 10 0 0 13 0 0 0 0 9 0 15 0 0 0 5 0 2 0 23 0 0 7 0 7 0 0 8 48 0 17 
14 0 0 0 32 0 0 16 0 3 30 39 8 0 0 26 0 0 25 0 0 0 0 11 0 0 0 2 0 0 40 5 0 0 0 0 32 0 0 0 30 0 19 25 
14 36 0 0 17 2 0 0 0 36 11 20 8 24 0 0 0 0 3 10 33 12 12 0 19 16 0 0 5 16 3 0 0 34 34 7 0 47 0 0 20 37 18 0 
17 15 0 27 0 12 5 0 11 0 0 23 2 35 13 0 23 12 0 11 20 0 10 4 4 7 0 5 0 0 27 0 0 0 22 0 0 5 27 9 0 0 5 0 
20 39 0 23 16 0 0 0 0 26 6 0 29 10 0 2 18 13 0 14 1 21 6 23 16 0 23 14 6 3 0 0 10 5 19 26 3 4 0 2 55 46 0 43 
5 0 23 1 15 4 6 0 0 1 0 13 0 0 2 0 2 9 0 15 4 9 1 14 10 18 14 0 16 12 9 0 6 4 15 7 3 5 18 0 14 0 0 0 
0 16 19 1 4 33 0 15 23 1 35 34 1 12 0 6 0 0 0 0 9 15 0 16 0 0 33 0 14 27 23 16 6 0 0 10 26 0 18 14 0 0 14 4 
12 0 34 23 41 0 2 31 0 0 0 18 31 22 12 0 17 0 18 0 15 32 0 0 21 13 31 6 0 21 7 0 5 16 47 65 31 2 1 18 5 1 25 0 
18 15 0 0 0 12 5 7 0 13 30 7 25 13 19 26 5 12 5 0 41 3 10 17 0 0 0 16 19 24 0 0 0 32 0 0 0 17 0 0 33 9 10 58 
0 0 0 9 0 2 2 2 0 0 0 0 0 0 0 1 0 0 0 7 7 0 0 0 0 0 11 36 10 0 13 0 0 0 8 7 0 4 14 0 7 14 15 0 
15 3 11 29 9 0 32 26 3 0 6 3 0 9 0 11 21 7 26 0 0 15 17 16 7 7 0 9 4 0 0 10 36 0 5 9 7 32 43 0 0 7 0 22 
0 1 0 0 0 36 0 4 0 0 0 31 3 0 15 0 1 0 0 18 23 0 0 6 14 0 0 0 0 21 0 6 6 1 0 0 0 35 0 0 0 47 35 23 
0 9 1 41 8 1 0 27 27 24 14 0 0 35 8 23 24 0 0 1 5 6 13 0 0 4 6 0 49 0 5 17 5 21 29 23 3 0 22 14 7 21 4 30 
1 1 0 0 0 17 2 2 30 1 11 6 0 10 27 12 0 5 0 19 0 0 18 15 5 15 0 0 9 5 0 0 1 0 6 0 28 5 18 0 9 27 28 0 
9 0 31 0 18 0 0 6 5 2 0 13 3 1 0 0 0 17 7 0 0 7 6 0 0 0 8 0 7 0 1 10 11 4 32 38 0 0 0 0 0 0 1 0 
11 21 33 0 0 20 37 20 0 34 0 0 14 39 14 8 20 17 0 2 2 1 7 9 23 35 0 0 9 6 0 23 1 1 13 6 49 18 18 0 6 13 25 33 
0 1 0 0 0 0 0 0 4 0 0 20 0 0 9 6 21 0 20 11 11 0 7 20 0 20 0 7 4 0 0 26 0 4 19 27 0 49 16 0 1 0 8 8 
7 34 12 10 0 5 7 0 0 12 5 9 0 2 5 13 0 19 35 0 2 1 0 0 4 0 0 4 0 18 44 8 1 10 14 6 42 0 0 0 1 0 0 9 
31 20 0 50 29 30 2 0 0 28 0 0 0 0 3 23 0 3 10 18 0 20 0 0 10 0 0 14 0 28 17 0 0 4 0 30 60 65 37 34 0 29 0 0 
