44 25
12 13 0 0 0 0 0 0 0 33 0 0 30 0 0 10 0 0 24 0 0 0 12 0 0 0 0 0 0 28 19 0 0 10 14 0 8 7 4 0 27 0 68 0 
3 1 13 0 0 0 0 0 9 0 10 0 6 25 0 19 0 9 19 1 0 9 20 5 12 8 0 0 5 6 21 6 17 20 0 0 12 19 25 0 0 8 30 15 
4 0 0 0 28 24 1 1 0 0 0 0 19 15 12 0 38 2 6 2 4 20 0 0 0 0 15 9 27 11 0 10 0 2 0 0 52 0 10 0 12 29 0 21 
10 0 22 29 0 0 1 0 6 0 1 38 0 0 15 12 0 11 10 1 0 16 0 0 10 12 12 29 5 0 28 17 29 5 0 24 1 0 0 3 2 16 1 0 
0 16 0 25 1 0 0 0 0 0 28 28 5 14 17 13 0 11 10 0 8 9 15 13 6 15 14 6 8 17 22 17 0 9 6 44 13 34 0 32 6 0 0 4 
0 4 0 6 15 7 0 6 0 0 28 29 0 2 19 0 17 0 0 25 0 2 13 20 0 17 3 0 23 17 5 0 7 29 0 25 20 0 0 7 28 1 0 0 
10 0 0 14 0 7 8 2 11 0 17 6 0 14 8 2 7 8 0 8 4 0 0 14 0 0 1 0 5 0 0 0 11 3 0 0 0 0 6 0 0 12 5 0 
1 11 12 0 0 37 13 0 0 7 2 5 6 39 12 0 16 0 0 17 0 0 16 0 15 0 12 0 6 26 8 17 1 0 0 2 0 30 0 0 4 14 37 30 
0 0 0 0 0 16 47 0 39 52 33 28 0 0 4 2 10 0 10 17 0 16 22 2 0 8 20 0 4 0 0 0 27 5 0 0 17 25 5 58 0 0 15 4 
3 0 50 5 35 4 0 23 20 0 6 0 15 12 44 9 2 16 9 3 8 0 0 9 0 0 17 36 15 15 34 0 0 13 20 0 0 0 0 4 24 8 0 18 
0 19 0 0 0 0 7 0 14 9 4 1 0 1 13 2 24 0 1 0 19 8 0 2 4 4 7 0 0 3 5 0 0 22 18 12 10 16 10 13 0 0 0 0 
9 42 0 0 0 5 0 2 0 0 0 10 10 0 0 8 0 4 4 11 13 8 0 0 3 0 16 0 0 0 4 0 10 0 0 0 0 0 0 6 2 0 16 35 
12 5 41 21 32 36 15 2 1 1 8 8 40 6 29 18 21 6 0 26 5 1 0 0 0 22 0 0 5 0 7 20 0 1 4 6 32 25 10 0 38 57 30 32 
7 38 0 18 33 5 0 24 10 5 0 12 5 0 5 0 10 10 10 40 0 3 9 0 0 0 7 0 1 26 26 0 0 14 33 35 17 0 0 38 21 3 42 24 
75 28 5 0 6 2 0 11 0 3 18 0 0 17 0 6 0 0 0 0 12 0 13 23 4 0 13 0 27 2 13 0 10 0 4 48 12 37 0 26 14 11 8 14 
14 0 0 0 0 9 0 12 4 0 6 0 4 0 0 0 4 0 2 1 0 0 11 0 5 11 0 0 2 0 13 10 2 0 0 0 2 0 0 0 0 12 0 0 
0 17 6 25 5 7 3 0 27 35 0 0 0 7 0 0 23 7 16 8 0 12 18 3 25 10 8 14 39 14 22 15 8 0 0 12 0 0 0 3 0 17 37 50 
16 3 0 0 0 0 0 0 19 0 0 19 31 10 15 23 0 0 19 16 29 0 0 0 24 0 0 19 0 4 19 11 14 11 0 0 4 6 0 6 0 0 10 37 
3 2 44 0 11 9 0 2 6 48 9 0 25 18 39 0 2 0 7 31 1 21 10 12 30 0 0 23 0 27 1 3 17 3 12 5 5 25 34 2 0 34 6 36 
2 39 12 0 0 19 8 0 7 20 33 2 15 19 0 61 10 0 1 15 0 27 0 7 16 3 6 15 9 8 32 6 5 7 28 0 0 6 3 7 35 5 64 89 
0 3 0 0 32 24 9 16 0 0 0 0 20 5 8 21 3 0 14 17 0 2 12 8 15 18 11 0 0 24 5 0 6 0 11 0 13 0 0 19 0 0 0 9 
23 7 29 9 0 28 1 3 1 32 0 47 19 12 22 0 37 0 6 4 0 0 6 19 0 0 0 0 16 0 19 41 10 2 0 0 25 0 0 28 7 69 0 0 
1 9 38 14 63 5 2 2 24 18 16 0 0 18 16 10 0 7 7 4 0 21 26 0 7 17 9 15 14 7 24 9 0 0 44 25 15 33 0 41 4 1 30 9 
42 0 0 18 0 0 36 0 0 18 39 0 0 0 0 4 0 0 0 0 0 30 0 0 0 0 11 4 0 6 0 16 22 18 0 13 0 11 0 0 0 0 63 21 
45 0 10 0 0 9 0 3 15 0 0 0 0 0 9 0 0 0 0 0 44 0 4 0 0 16 4 0 15 0 13 13 0 7 9 0 0 0 0 4 2 0 2 13 
