44 25
0 0 0 35 26 0 0 3 9 0 26 0 17 0 4 0 0 0 9 2 11 2 13 4 0 0 0 20 15 0 18 29 8 0 0 2 26 10 58 0 18 1 31 0 
17 38 75 8 17 0 38 0 0 0 0 0 0 0 21 21 2 47 0 0 19 33 0 0 0 0 10 12 6 6 0 5 1 20 43 18 10 22 3 37 38 7 0 0 
9 0 27 17 0 14 0 6 0 9 11 0 25 20 19 20 6 23 13 15 9 1 15 0 12 0 18 1 9 18 0 0 0 10 20 13 6 14 3 0 18 16 11 3 
0 0 0 0 4 0 5 0 14 0 13 2 10 1 0 6 10 0 0 7 0 0 4 1 21 0 16 0 0 0 0 0 0 0 0 12 0 0 0 0 4 0 16 21 
7 6 46 10 30 0 12 24 10 0 27 5 29 25 16 7 3 0 0 19 21 24 2 14 20 2 0 8 20 5 27 18 4 9 9 0 34 26 19 68 1 12 35 13 
0 0 32 0 10 0 0 0 6 0 0 0 9 28 0 20 27 10 0 14 0 7 4 0 3 0 0 0 1 36 0 0 0 14 32 27 0 9 0 4 0 28 3 27 
40 0 4 11 43 2 27 0 2 0 2 5 3 0 0 0 0 8 0 3 0 12 5 4 0 15 1 15 0 0 0 6 9 0 20 0 32 0 0 0 18 10 0 2 
11 0 12 0 4 0 0 0 28 0 9 0 0 5 28 0 0 3 0 9 12 0 4 0 0 11 18 0 8 0 17 1 0 2 0 2 11 0 24 0 0 0 0 0 
0 42 0 21 0 0 2 0 0 22 0 25 18 6 4 3 13 7 0 0 13 46 0 9 0 13 10 0 25 0 10 32 11 0 0 0 21 0 2 0 6 0 30 54 
29 0 0 8 31 0 0 0 30 0 0 0 7 1 0 6 0 0 1 2 8 0 4 11 20 4 8 8 0 2 18 3 0 0 12 48 0 0 0 0 0 6 15 14 
40 0 0 39 0 0 30 13 0 44 8 0 0 0 0 11 0 4 8 0 21 0 21 20 0 0 0 7 22 4 13 11 0 0 7 0 0 0 0 0 40 21 83 41 
12 24 4 9 12 5 19 17 18 9 5 13 64 24 25 9 11 3 14 0 3 17 0 4 10 19 14 1 18 0 14 4 0 68 7 4 10 30 11 67 7 0 30 3 
0 0 0 18 0 0 0 0 0 18 5 9 0 5 0 5 36 11 0 3 0 3 14 0 0 10 0 0 0 0 0 7 16 24 0 3 20 2 12 9 0 0 8 0 
6 0 0 5 18 0 0 62 17 11 4 0 0 0 4 9 12 7 2 0 7 0 5 9 3 5 0 0 0 5 0 0 0 10 0 33 0 7 0 6 2 34 13 0 
0 0 0 6 33 0 0 0 7 5 0 0 18 0 4 6 21 16 14 8 0 14 0 2 12 2 0 22 0 4 0 13 5 42 0 9 0 37 0 33 0 13 1 3 
22 14 46 9 15 0 7 51 0 9 0 1 8 2 0 12 0 16 4 0 6 0 4 16 4 0 0 5 4 14 0 4 0 13 17 4 7 33 23 0 38 7 50 0 
20 0 12 0 4 0 17 0 4 0 36 1 4 4 19 13 13 5 0 0 41 0 5 12 16 11 0 17 23 23 0 0 18 17 0 0 0 2 11 1 4 0 20 0 
30 3 4 11 2 5 2 0 37 0 0 6 21 9 11 14 0 6 0 7 0 18 2 12 5 24 0 0 0 0 0 0 0 32 0 0 0 0 13 0 0 0 9 40 
0 0 0 32 35 4 86 24 0 6 20 0 0 26 17 10 17 14 0 16 0 26 5 0 0 21 22 24 0 2 14 81 0 1 6 17 10 0 32 26 9 53 11 13 
38 37 8 13 0 21 20 0 6 0 40 0 3 3 27 3 30 17 4 0 4 0 0 0 9 1 41 0 0 29 0 6 6 0 0 4 0 0 6 2 39 0 16 27 
24 2 35 15 31 0 15 43 8 0 23 25 2 12 0 0 8 19 15 14 0 7 16 14 27 18 14 8 0 5 0 0 25 15 7 56 7 17 0 9 0 7 0 22 
76 0 10 0 0 42 13 8 1 15 10 3 0 5 0 1 17 0 12 0 5 0 14 18 22 13 0 15 4 24 0 0 0 27 0 0 5 10 0 0 0 41 9 0 
5 12 15 2 0 64 0 0 6 0 5 0 11 4 26 0 0 15 0 0 33 21 15 0 11 0 0 0 0 18 0 0 1 1 8 0 16 2 33 3 26 0 41 42 
7 1 22 41 23 24 2 7 12 0 5 6 31 11 42 15 0 19 0 0 22 0 0 0 22 22 0 0 0 25 3 0 5 0 19 0 21 25 4 7 34 35 4 36 
17 0 0 2 20 6 0 0 0 6 20 22 15 0 0 6 17 0 24 0 8 0 8 0 28 0 0 15 0 19 50 0 0 17 6 5 4 0 0 0 0 0 0 21 
