44 25
0 4 0 0 37 28 1 0 0 0 9 0 16 13 29 0 0 15 15 9 42 7 23 17 0 0 13 0 11 8 0 9 4 38 0 0 0 12 0 0 0 37 36 14 
0 6 55 0 0 14 54 37 1 22 13 8 0 27 3 0 0 5 15 0 0 0 22 23 27 0 0 30 0 5 21 29 1 18 12 0 0 0 32 10 11 2 18 56 
0 17 12 1 16 16 7 0 0 20 16 21 0 12 18 0 0 4 17 0 0 5 0 0 0 12 0 3 25 0 2 0 1 3 0 0 0 0 0 1 9 0 0 0 
6 16 0 4 9 24 34 20 14 30 6 10 25 5 2 0 12 0 8 21 4 13 1 0 12 0 10 36 0 0 0 9 0 0 16 0 24 0 11 26 25 40 0 4 
36 9 12 0 12 5 3 0 49 0 15 20 0 0 9 20 0 0 12 0 0 22 9 0 0 0 15 0 0 16 31 0 0 0 19 5 0 0 9 0 11 15 0 44 
0 0 15 74 0 11 0 4 1 15 22 13 0 5 0 1 27 27 20 0 3 13 15 17 20 17 0 4 16 4 0 4 4 36 0 5 0 0 5 30 0 38 0 25 
27 38 1 0 0 5 3 9 43 20 1 18 12 0 0 6 0 5 2 3 0 1 15 0 0 11 1 19 0 18 0 0 8 0 17 17 0 19 4 38 21 0 0 15 
21 0 2 25 0 1 0 0 64 5 21 31 6 2 3 20 0 8 0 9 7 31 0 16 0 0 1 7 3 19 9 0 2 0 2 20 0 0 27 21 0 16 31 6 
0 0 42 22 25 7 0 15 8 10 15 14 0 3 5 11 21 11 16 9 0 0 0 3 6 46 3 5 0 12 25 0 0 31 0 10 0 2 0 8 1 0 36 13 
0 5 8 0 7 0 44 0 0 0 2 2 6 13 12 0 23 14 12 0 0 0 0 16 0 0 0 0 0 2 1 10 0 4 0 16 0 15 0 29 0 0 37 1 
23 12 10 0 8 0 0 34 0 32 2 30 2 0 7 0 36 0 0 0 0 10 5 3 12 7 2 5 0 13 6 35 16 0 7 5 2 1 14 23 4 66 0 20 
16 39 29 48 20 0 8 0 11 12 2 0 28 0 2 0 43 13 8 43 0 16 0 21 0 13 22 25 3 0 0 25 7 0 22 7 0 7 18 12 34 0 30 5 
1 1 25 38 27 28 0 26 0 28 0 3 0 9 82 3 12 1 35 17 0 2 0 12 0 0 17 10 28 3 7 22 24 41 0 25 0 4 0 25 26 0 24 38 
0 3 0 0 40 42 10 7 1 8 10 0 0 8 0 0 0 8 0 0 9 17 3 11 3 3 2 23 13 21 0 0 3 0 4 8 31 0 0 0 0 8 0 7 
11 11 7 0 0 0 33 0 22 0 42 8 30 0 0 0 0 23 0 0 11 5 0 1 20 0 2 7 5 3 0 0 8 0 0 6 0 10 14 62 22 1 64 0 
0 0 5 0 6 0 9 0 0 29 8 31 18 15 6 11 9 27 1 21 18 0 0 11 0 0 23 15 0 0 0 15 0 0 16 6 20 0 0 19 10 0 64 6 
38 40 49 3 25 0 31 0 8 32 6 0 0 0 0 0 15 15 0 0 1 12 0 0 20 23 1 10 0 0 26 27 6 0 0 6 0 3 29 0 0 72 0 17 
0 0 2 33 20 30 12 30 10 33 7 29 0 30 29 17 21 8 6 0 13 5 0 17 4 7 2 0 12 10 0 0 5 15 7 28 33 1 25 14 27 0 86 29 
8 8 0 27 1 0 9 0 8 8 5 0 8 0 0 0 0 0 0 0 15 0 0 1 0 0 0 0 0 0 0 0 29 0 0 0 0 6 5 0 0 5 0 5 
0 0 56 3 0 25 30 0 33 4 0 6 0 0 11 11 2 11 0 9 0 0 13 1 0 16 6 33 12 12 0 20 19 8 32 0 30 0 0 3 1 14 3 18 
0 0 5 23 0 0 4 0 13 15 11 11 13 0 23 12 23 11 20 12 0 16 32 0 2 0 24 7 4 0 0 0 10 5 7 14 1 23 0 0 14 25 1 24 
0 0 19 0 62 0 26 0 14 15 0 0 0 12 12 0 27 2 33 0 7 1 5 0 0 0 0 7 1 25 13 0 26 3 0 0 4 0 1 14 0 19 0 10 
7 7 6 39 0 0 0 10 26 20 0 0 0 15 21 0 0 10 0 0 0 0 0 17 15 25 0 10 0 9 0 0 6 12 0 15 0 10 1 0 7 17 39 0 
0 0 0 16 19 7 0 15 0 0 27 21 26 0 23 8 1 4 23 0 3 0 37 19 10 0 8 0 0 17 27 2 0 7 17 10 0 23 5 0 0 10 0 0 
13 2 14 1 15 2 16 0 0 0 0 20 0 4 0 11 12 19 0 0 0 0 0 17 0 7 35 21 0 13 16 27 30 2 0 10 0 18 9 37 0 17 0 0 
