44 25
26 0 11 41 0 0 4 4 0 24 7 6 15 7 0 0 0 22 20 20 16 10 0 0 0 5 22 0 40 19 5 21 0 0 0 16 16 0 24 0 11 0 0 0 
14 15 6 15 5 0 0 0 0 10 8 0 0 0 0 0 0 36 1 57 0 0 0 0 0 5 0 3 3 0 2 3 3 0 2 14 4 0 0 0 53 22 0 24 
17 1 31 14 0 23 0 0 0 0 0 8 0 0 7 13 22 17 0 0 4 43 7 31 4 14 2 0 17 0 19 8 0 0 21 0 2 0 23 0 19 10 0 0 
0 0 38 11 0 0 0 0 0 3 0 9 0 0 0 0 0 16 1 0 1 0 0 0 0 1 0 0 4 0 16 0 3 0 0 2 19 0 0 0 38 0 0 2 
0 11 49 34 78 18 27 7 31 7 13 7 31 11 0 0 10 22 8 0 3 0 5 9 19 0 12 0 5 6 0 10 19 5 15 17 32 28 10 91 25 7 3 32 
43 15 0 10 19 14 8 6 10 0 0 16 0 2 9 16 14 0 0 2 0 0 0 0 9 0 22 0 0 0 14 28 0 0 8 26 0 0 3 17 0 28 0 80 
3 0 16 6 19 0 0 9 34 0 5 27 2 5 28 0 41 0 18 22 4 4 0 5 15 0 10 13 28 22 15 21 3 12 0 24 5 6 0 16 36 7 7 24 
9 6 20 0 2 2 34 2 0 14 0 0 29 15 11 14 0 16 8 2 24 0 11 14 2 3 8 5 13 14 2 20 4 10 3 0 6 30 0 0 0 0 17 0 
8 4 0 20 0 33 0 0 34 11 0 36 13 15 0 0 22 0 23 7 11 0 0 0 0 29 0 0 0 0 0 20 4 13 0 0 0 0 13 13 0 1 71 0 
0 25 15 1 62 56 26 2 0 0 0 0 0 10 0 6 0 13 15 0 0 28 2 0 4 19 25 29 0 11 35 8 0 6 5 0 31 0 0 7 0 1 0 69 
2 22 0 0 0 0 54 0 0 0 11 26 13 18 1 2 2 0 0 0 0 15 9 22 0 0 14 0 22 0 0 15 1 0 0 27 23 36 29 11 0 7 0 17 
34 8 7 17 0 0 4 5 28 3 0 9 4 8 6 26 0 26 0 5 10 8 19 5 4 0 0 0 15 0 0 0 5 1 33 0 0 8 0 21 0 3 1 15 
7 0 0 8 0 63 8 9 25 0 0 5 0 1 10 11 11 0 24 16 8 6 7 28 16 0 31 5 20 24 15 8 28 40 21 0 10 11 20 0 9 6 24 29 
23 20 0 0 4 2 28 5 0 2 0 5 14 27 6 20 0 12 1 1 0 20 0 23 0 3 3 0 4 0 11 16 0 1 21 13 0 0 7 1 9 9 3 0 
40 0 21 11 0 0 5 8 41 0 31 0 15 0 10 4 27 14 6 15 18 19 20 2 0 0 0 0 14 7 0 14 22 19 0 10 0 4 0 31 40 13 0 36 
20 14 23 34 0 0 0 0 10 30 0 0 22 2 0 11 0 0 1 21 20 7 0 0 0 41 0 0 25 0 0 0 0 0 4 8 15 62 4 0 15 0 0 7 
6 21 1 30 0 0 0 16 0 0 0 0 25 6 8 0 0 0 8 0 0 0 2 0 23 8 0 12 16 0 0 0 20 30 0 16 0 0 0 12 0 19 1 0 
5 26 13 32 6 43 24 15 0 17 0 0 6 0 10 35 14 0 0 0 15 2 20 20 0 17 0 10 4 0 24 13 4 0 0 13 0 6 0 11 5 6 17 15 
43 27 0 30 26 5 0 7 54 28 4 26 0 25 4 5 18 0 0 3 40 32 19 0 0 0 0 0 15 13 11 23 0 30 33 17 16 1 31 50 0 11 0 0 
7 40 69 17 7 17 0 31 0 0 0 18 18 6 5 0 21 46 15 23 17 0 0 0 0 18 0 0 0 0 79 0 0 0 3 14 34 21 3 0 0 0 3 2 
0 33 0 20 72 0 24 11 0 0 9 4 6 11 0 0 0 7 20 6 0 0 0 0 18 8 15 0 16 11 0 0 0 1 0 0 29 33 0 0 1 0 0 76 
0 24 14 14 2 22 18 14 0 1 0 0 38 5 24 2 3 0 0 0 0 26 0 0 2 12 7 3 17 7 14 37 0 27 0 9 24 3 17 12 41 0 0 0 
0 14 9 11 0 0 0 20 0 0 0 25 10 15 5 7 8 1 5 8 0 22 15 5 0 0 10 16 0 0 9 7 5 0 0 0 54 21 4 1 0 0 3 0 
6 7 0 0 0 30 0 0 5 0 6 0 13 15 0 18 0 15 1 26 0 9 0 0 0 0 0 0 0 0 16 0 4 15 0 17 8 20 1 0 19 17 0 0 
0 11 24 0 19 11 35 16 17 27 9 9 0 5 11 0 22 0 19 0 2 0 0 16 0 18 11 3 49 0 0 13 31 0 5 0 11 8 25 15 23 15 1 0 
