46 26
3 0 0 17 10 0 0 13 0 0 0 0 0 0 19 0 12 0 0 10 0 21 22 4 1 29 19 5 3 24 5 0 7 0 2 0 24 0 4 0 33 0 26 18 22 38 
0 26 0 20 0 5 0 0 0 20 16 35 0 0 9 0 4 0 0 0 4 0 6 0 3 18 9 37 5 20 0 3 16 0 5 5 8 0 9 7 13 0 13 0 0 0 
0 19 24 0 0 6 1 12 0 0 9 0 0 8 4 7 0 20 0 8 11 16 0 12 13 15 45 0 13 0 0 11 0 0 24 9 0 6 0 0 3 0 0 5 40 0 
0 0 23 35 0 26 12 0 21 5 28 17 0 0 21 9 10 20 16 0 3 0 0 12 0 9 9 9 15 24 38 0 3 23 0 0 9 19 34 0 0 33 0 0 29 0 
0 0 8 0 0 0 30 11 16 14 2 0 0 13 20 0 0 0 21 6 23 0 0 0 3 0 22 0 10 8 43 12 3 1 3 45 0 13 18 29 3 0 0 4 0 56 
7 27 35 0 0 0 0 1 20 17 4 0 0 0 0 33 5 9 0 11 0 0 0 0 3 0 1 22 27 0 0 1 6 0 0 0 0 7 11 0 3 0 0 0 43 0 
36 0 0 27 13 57 0 0 0 0 0 0 4 24 6 0 17 0 15 12 0 30 0 7 14 0 0 8 28 8 21 1 0 3 7 10 20 19 14 5 19 11 0 4 0 0 
28 0 0 20 0 49 0 5 3 0 1 0 0 3 6 11 25 0 0 19 0 0 0 23 22 0 6 0 11 15 0 0 7 0 3 11 8 21 13 15 0 3 0 1 42 0 
17 31 0 4 5 0 2 2 0 45 0 0 0 0 28 14 15 0 11 0 0 0 2 7 0 1 0 28 4 0 2 0 24 0 16 16 22 15 7 4 0 0 15 35 28 45 
41 0 0 9 0 0 5 3 0 0 10 0 0 0 0 15 0 0 24 0 5 1 0 0 29 9 0 0 0 0 6 0 0 0 5 0 6 0 0 2 0 72 13 0 34 12 
0 0 4 37 12 14 14 0 51 0 0 0 0 4 21 5 41 0 1 23 33 0 9 0 5 0 0 0 3 0 0 3 0 6 0 0 0 0 9 25 37 0 0 0 0 29 
9 0 21 0 51 0 13 0 0 28 5 0 0 0 0 27 2 13 0 0 14 0 0 21 4 0 12 0 13 0 0 0 0 0 3 9 0 24 10 3 0 12 40 0 0 0 
0 0 7 4 0 0 0 0 0 0 5 0 0 28 16 0 2 9 2 0 0 0 2 0 2 0 3 0 0 3 0 0 0 0 9 0 0 2 0 0 0 28 0 13 0 0 
0 15 0 42 0 16 15 0 0 0 41 18 0 0 5 0 18 0 8 0 20 26 6 0 11 0 0 0 2 15 0 0 2 1 0 0 6 0 0 29 15 0 6 0 5 47 
8 25 0 7 41 25 0 0 0 70 2 11 0 0 0 3 0 1 22 11 0 21 15 21 2 0 35 10 1 2 1 7 0 0 14 0 15 0 0 2 0 0 37 34 17 5 
9 39 0 0 38 0 4 2 12 1 0 0 0 27 5 5 28 0 0 31 0 1 0 20 12 2 0 0 5 13 0 22 9 5 0 10 0 13 19 0 27 8 38 0 0 0 
0 9 0 0 0 14 0 14 11 36 5 0 0 0 4 0 0 0 0 11 0 7 12 0 3 24 0 18 0 25 12 3 12 0 8 8 14 10 0 8 1 0 0 4 3 0 
0 24 0 0 17 0 35 6 13 3 0 0 3 0 0 0 0 0 0 0 0 0 0 0 0 0 0 2 0 23 19 0 0 0 4 0 30 0 0 35 16 5 0 0 0 0 
0 0 28 0 0 0 0 0 8 72 0 30 0 0 14 0 42 18 0 1 0 0 2 9 2 0 0 0 0 0 14 22 2 0 0 34 15 18 36 15 0 47 4 0 15 14 
36 39 0 56 8 2 8 28 0 1 25 0 0 0 0 0 6 0 14 0 0 5 12 0 3 30 23 0 0 10 24 0 2 63 6 3 0 12 8 13 39 9 4 9 0 0 
36 40 0 0 0 0 0 0 30 0 0 0 25 0 16 0 0 0 0 0 0 0 0 0 10 12 0 0 0 0 16 0 4 5 10 0 2 12 39 1 1 1 0 0 0 0 
0 8 0 18 35 3 5 0 35 0 0 22 27 23 0 24 0 9 0 26 0 37 19 0 0 0 37 0 44 0 4 18 5 28 19 0 0 22 0 24 27 19 3 65 39 28 
3 0 1 0 37 0 37 14 37 28 26 31 0 1 1 1 0 57 1 7 0 0 14 0 18 0 6 0 2 0 8 22 7 0 0 24 45 0 8 0 38 11 0 0 22 37 
0 34 12 0 3 22 47 6 68 25 15 23 0 18 14 0 17 31 0 15 28 0 5 17 0 15 8 0 29 25 22 13 17 49 11 21 16 1 24 6 1 12 4 26 0 32 
4 0 0 45 35 18 29 4 0 6 0 0 0 11 12 3 14 0 0 5 0 11 22 20 29 0 0 13 25 24 10 16 6 18 18 0 24 14 0 11 0 0 9 11 39 0 
11 0 0 56 0 33 35 0 0 10 11 41 31 22 0 0 7 19 0 32 12 0 0 26 0 22 0 14 0 0 0 0 22 0 0 22 0 34 14 49 8 0 0 1 27 0 
