46 26
4 18 0 16 9 0 23 0 0 0 21 0 16 0 26 0 0 13 7 7 42 13 0 0 9 23 21 0 0 0 16 19 0 0 10 17 33 2 10 2 35 0 0 0 41 0 
0 37 35 19 0 8 33 0 22 3 0 16 0 34 23 13 13 19 3 0 6 4 5 5 33 0 0 18 0 0 22 65 0 0 4 0 27 0 49 59 0 7 0 0 2 9 
43 0 65 0 41 16 21 22 46 22 18 0 0 34 0 19 11 2 0 11 0 0 20 5 25 26 21 38 10 0 6 5 27 0 0 0 0 12 3 1 35 2 14 8 17 43 
0 0 33 0 0 0 39 1 10 0 0 0 0 22 6 0 0 0 10 0 0 0 0 0 0 0 0 0 0 40 21 0 0 10 7 68 23 0 8 0 11 6 0 9 3 7 
108 28 13 12 0 9 2 0 0 4 32 20 0 28 12 12 19 4 13 6 39 34 2 0 4 0 0 17 11 28 19 12 36 0 13 34 15 13 14 0 0 4 46 19 0 8 
0 0 17 43 18 40 0 0 0 0 0 0 14 31 0 7 0 16 27 17 0 16 2 0 6 0 16 5 0 0 3 28 0 9 0 0 18 0 17 0 0 19 0 8 23 0 
14 5 37 0 26 0 3 5 0 0 18 0 1 2 0 0 0 1 5 15 0 13 0 0 6 0 0 0 18 0 6 0 0 11 13 0 0 10 0 37 0 0 3 0 5 0 
22 0 0 41 0 0 27 0 14 0 0 19 28 56 12 0 0 26 0 0 17 7 33 6 0 19 0 0 0 6 19 5 0 8 0 8 4 0 5 0 28 0 5 20 72 0 
36 32 0 0 8 0 0 9 0 32 0 0 12 3 0 12 0 0 0 0 0 0 0 0 24 0 0 12 0 0 0 0 11 28 0 0 0 4 0 12 0 35 0 9 0 0 
0 57 28 0 26 30 14 12 0 0 9 0 0 15 35 0 3 0 9 0 24 20 0 16 19 18 18 0 0 11 30 4 0 0 0 87 0 0 11 13 16 8 10 7 0 0 
22 0 12 0 0 1 0 19 2 13 0 23 0 0 10 38 26 8 1 5 15 0 9 5 0 0 26 22 1 0 0 0 0 11 16 0 0 0 10 0 0 27 11 26 0 7 
7 6 0 37 0 17 0 29 5 0 17 31 0 12 0 0 29 32 0 5 0 24 23 2 3 0 0 9 18 0 0 11 5 0 13 32 38 0 5 0 5 24 31 14 0 33 
0 0 0 0 41 0 0 25 13 87 7 29 0 0 8 0 23 0 22 10 11 10 25 12 11 8 18 0 0 0 8 0 25 5 12 0 2 0 2 53 5 32 7 15 0 33 
0 0 0 5 0 0 0 36 3 34 12 0 27 12 0 0 25 0 0 0 2 42 2 1 8 0 3 0 0 0 0 0 8 0 0 0 33 0 0 25 11 38 9 58 27 24 
0 0 0 0 73 9 11 0 0 0 0 26 10 8 0 0 0 0 0 5 0 9 44 0 0 21 0 0 0 0 0 11 3 0 0 24 3 0 19 0 0 0 38 21 0 36 
0 19 5 4 22 0 5 32 20 0 0 1 0 3 7 4 6 9 9 18 18 16 17 16 0 13 26 2 20 4 0 1 0 2 0 4 7 4 0 6 4 6 0 0 0 0 
0 16 5 0 33 0 0 0 0 0 28 0 10 0 0 1 3 21 1 23 0 0 0 1 16 9 0 0 0 17 16 0 0 11 0 0 11 41 12 23 0 0 0 4 11 0 
1 6 1 0 11 0 0 9 22 0 0 4 0 0 0 35 0 0 0 13 0 0 0 1 0 0 0 6 0 14 0 0 0 0 0 17 0 29 5 6 0 2 27 0 0 0 
7 0 18 33 5 0 4 12 2 0 2 27 21 20 23 0 0 0 1 1 5 0 0 12 0 8 3 0 0 0 0 0 7 8 3 12 17 23 41 9 15 0 0 4 0 0 
45 0 7 0 0 0 0 0 6 20 0 0 0 12 6 0 0 12 0 0 0 0 17 0 0 0 0 0 0 0 0 0 0 0 0 0 27 20 14 6 0 0 0 7 0 51 
4 0 20 18 0 26 0 0 0 0 8 19 1 12 0 22 17 0 0 0 20 18 20 0 0 12 0 0 0 0 0 29 0 17 0 0 5 0 17 0 0 0 0 8 17 0 
0 29 5 0 35 8 0 0 0 0 0 2 1 11 15 17 0 0 0 7 0 0 11 0 20 5 26 0 2 17 37 0 12 3 3 0 2 0 16 50 0 3 0 0 9 9 
11 17 35 7 23 7 2 0 12 8 0 38 11 0 24 0 0 0 0 0 2 8 24 0 1 19 17 23 0 0 0 11 49 32 0 19 33 18 1 35 0 15 22 0 6 8 
0 0 0 30 5 2 3 1 49 1 29 0 0 0 0 21 0 0 0 0 3 0 9 14 0 0 0 0 20 12 0 1 1 31 1 0 28 0 0 27 0 6 0 0 0 22 
0 43 26 2 9 2 16 20 0 27 0 4 11 26 20 7 0 18 0 0 24 14 1 0 0 4 0 8 0 10 37 0 0 0 1 5 1 35 0 2 11 29 1 0 39 0 
0 20 28 31 26 14 21 73 36 36 30 14 0 14 1 4 0 0 11 33 10 40 8 0 38 0 0 15 18 5 17 13 59 9 4 0 11 0 13 10 35 67 0 24 37 47 
