46 26
13 66 54 0 21 16 0 38 37 17 20 42 0 24 7 2 1 12 2 9 8 31 3 7 0 7 13 8 5 1 27 62 6 31 11 0 15 27 0 0 10 30 6 2 1 61 
0 0 0 0 3 45 29 3 0 0 24 0 0 25 0 31 18 19 17 0 20 1 0 13 11 0 3 0 14 3 15 12 0 1 6 2 23 0 0 0 0 26 1 12 18 1 
57 3 4 14 0 32 3 15 3 36 0 10 0 13 0 64 0 12 0 14 0 15 0 0 0 13 4 0 0 0 0 24 0 4 0 9 0 0 0 8 0 36 33 0 0 0 
0 0 7 34 7 2 23 14 0 0 0 10 22 0 0 0 1 0 2 0 18 16 0 1 3 22 24 0 12 11 0 2 9 25 12 0 0 0 0 0 0 0 0 0 5 39 
4 0 0 0 0 0 76 12 0 0 13 0 0 0 14 0 0 0 0 13 14 11 0 13 0 0 16 0 2 3 0 0 18 27 0 29 22 0 0 0 0 0 0 0 0 0 
6 0 3 30 20 7 0 0 10 0 0 0 0 5 0 0 0 0 2 17 12 18 0 4 0 22 3 4 0 20 11 0 0 25 26 0 17 0 0 0 1 15 0 20 0 0 
35 25 22 29 2 22 2 35 8 4 1 0 0 5 0 5 0 8 0 0 0 15 0 9 0 6 54 0 17 9 0 24 29 0 0 0 50 28 28 0 1 9 27 11 0 9 
1 0 0 0 6 0 0 21 34 0 7 27 29 0 16 23 0 2 0 0 0 0 0 0 0 15 15 14 15 0 32 0 0 0 0 0 0 1 4 0 0 46 0 0 0 0 
0 0 15 7 0 32 8 27 0 21 0 38 6 21 0 18 15 8 18 29 19 10 0 3 33 0 1 3 9 14 28 3 0 3 6 24 30 35 12 19 21 15 24 0 25 8 
36 33 26 23 22 9 6 0 0 1 0 5 0 10 27 6 22 0 0 1 10 6 17 0 47 0 18 0 18 7 22 0 8 0 12 0 10 0 10 32 32 11 0 43 0 0 
0 0 0 0 0 25 3 43 15 3 0 0 0 6 0 26 6 0 0 13 0 0 1 0 0 0 0 8 5 17 20 0 0 5 15 5 0 0 4 1 10 78 0 4 0 0 
6 0 32 0 3 10 9 3 0 4 11 0 17 0 0 0 0 0 10 0 2 7 11 14 0 0 5 0 0 6 1 11 0 0 0 0 5 3 0 0 28 39 10 0 0 0 
0 20 0 14 35 0 2 18 0 0 0 0 0 35 0 4 5 13 16 2 19 5 0 9 4 30 0 10 0 6 1 0 0 2 5 0 7 24 0 16 2 0 11 13 0 0 
0 10 32 39 0 11 0 0 0 14 9 0 0 27 0 0 0 11 0 0 22 21 0 0 1 0 12 18 0 0 0 0 0 10 23 0 0 0 0 0 21 7 6 0 0 0 
14 0 25 21 0 3 63 0 8 14 0 16 0 0 0 1 16 0 17 0 4 0 0 25 5 1 1 16 0 0 5 0 4 2 11 7 30 17 0 0 8 35 1 3 0 3 
16 64 42 45 1 24 2 4 31 2 10 4 0 30 0 20 3 0 0 0 0 27 0 22 8 30 0 0 0 0 63 8 19 0 21 0 3 0 2 34 0 0 12 3 48 9 
0 0 0 14 7 0 0 0 9 2 0 0 0 0 0 0 13 0 0 0 25 13 0 4 4 4 0 0 0 7 0 0 0 0 0 0 7 0 0 1 0 9 0 0 0 25 
23 0 0 0 0 0 0 78 0 0 0 0 0 0 0 0 0 17 0 0 12 0 0 23 0 0 3 1 3 1 10 17 0 0 15 0 0 0 2 1 0 0 35 0 30 9 
0 5 18 9 0 15 20 16 10 0 0 0 9 11 0 0 0 25 11 0 0 5 15 0 0 17 0 6 1 0 0 15 0 0 5 28 0 4 9 0 0 0 10 12 0 7 
0 0 7 0 0 7 0 15 0 12 0 25 6 1 0 1 0 14 5 0 42 18 5 0 0 0 10 0 4 13 0 0 0 0 0 3 11 0 7 0 29 0 12 15 0 25 
0 11 20 29 0 41 0 0 51 4 0 29 0 0 0 15 25 12 0 0 1 20 0 4 10 6 5 10 0 30 15 16 48 0 3 0 20 29 32 34 20 59 0 0 0 0 
0 0 0 0 34 10 34 4 19 0 29 34 14 0 0 0 0 5 24 0 3 0 0 2 0 0 0 19 39 0 0 0 20 0 5 7 2 7 2 2 0 0 12 15 47 38 
0 0 0 0 0 0 0 0 0 0 0 0 39 4 26 0 0 4 20 0 19 5 2 14 4 2 12 0 15 0 21 7 7 0 0 0 10 2 33 2 26 13 0 48 0 25 
0 34 13 0 25 0 0 0 0 11 0 4 0 49 22 16 5 0 3 0 4 12 0 15 0 5 0 0 2 0 0 6 3 32 14 34 20 27 13 0 0 18 0 30 0 1 
0 0 36 0 2 1 13 0 0 0 3 24 0 0 24 0 0 5 0 0 0 0 0 19 0 12 24 2 0 0 0 0 9 0 9 33 24 0 24 0 23 9 19 0 7 27 
55 29 2 67 0 2 0 3 3 10 43 0 30 0 0 20 29 19 2 14 2 0 9 5 17 0 13 7 25 5 15 14 0 38 45 25 19 0 0 0 0 22 36 67 25 55 
