46 26
7 24 36 1 22 0 0 18 7 13 0 30 0 11 0 0 7 0 3 0 5 36 0 0 16 0 5 32 0 20 4 0 2 0 0 0 15 0 0 34 4 39 0 0 0 0 
18 0 1 28 0 0 21 16 0 1 0 0 0 0 23 23 18 0 18 6 0 0 8 20 5 14 0 21 0 0 14 0 0 0 0 2 2 3 0 15 5 0 0 0 0 17 
10 0 35 31 0 26 0 0 0 1 0 9 10 49 22 0 23 1 8 5 0 21 3 20 8 20 12 33 0 0 10 26 0 0 0 0 0 0 2 5 20 27 0 0 14 65 
0 16 4 3 1 2 0 0 3 7 12 9 25 22 13 8 0 0 27 2 1 23 0 8 0 0 25 16 5 18 0 26 8 0 0 0 2 0 26 0 0 0 0 0 3 0 
7 65 0 19 41 0 13 0 0 0 0 0 18 44 28 0 3 0 19 25 15 7 0 0 0 7 0 26 7 19 10 0 5 0 0 3 2 22 2 1 42 11 64 8 56 60 
0 0 17 7 1 12 0 11 0 35 7 0 17 5 0 0 0 3 0 0 15 24 3 0 0 0 6 0 0 0 0 0 15 0 0 15 0 0 32 0 1 1 0 4 0 24 
0 0 0 19 55 28 6 5 3 26 0 0 0 3 21 11 10 12 28 8 2 10 5 0 20 0 51 0 6 23 0 6 0 30 13 58 8 8 25 13 0 0 20 5 6 0 
0 25 0 0 0 32 10 25 10 35 17 0 4 0 5 8 6 0 0 0 0 0 17 6 7 15 39 17 0 16 0 3 11 0 1 0 0 18 0 1 20 4 0 0 36 4 
30 43 5 37 0 5 9 23 3 0 0 11 0 8 0 0 0 25 11 0 4 0 0 0 28 0 0 0 0 6 0 0 1 0 0 0 0 0 0 10 33 0 23 0 45 0 
0 0 12 0 2 0 1 20 0 45 29 0 11 0 4 17 2 10 29 10 0 0 9 22 15 2 15 2 0 6 0 0 27 0 0 0 39 5 7 59 17 0 30 0 0 0 
0 24 38 0 0 0 0 5 19 0 0 37 9 18 0 9 0 7 4 6 19 15 1 4 7 22 0 10 0 0 14 37 7 8 0 0 13 22 0 6 42 2 15 2 0 0 
22 0 30 0 25 0 4 6 4 6 28 30 0 9 3 20 2 15 9 0 16 0 0 0 0 19 28 17 8 0 30 0 45 0 4 31 32 0 10 7 38 0 15 3 28 1 
2 0 38 24 0 58 0 26 30 0 12 18 0 0 0 13 8 3 13 0 0 0 16 5 0 19 0 0 0 4 32 28 0 5 6 12 0 15 6 0 33 27 77 1 9 0 
43 35 0 31 0 57 0 0 0 0 0 26 1 6 9 17 0 0 6 10 2 10 0 19 6 0 0 0 17 0 0 0 10 0 2 68 29 2 0 0 6 4 0 8 6 4 
4 0 0 0 4 3 23 0 33 0 3 4 0 1 14 0 5 8 0 0 0 19 0 1 9 0 16 16 0 18 13 0 0 0 0 7 0 0 5 0 18 36 16 19 0 3 
0 0 12 0 0 19 6 1 21 0 18 27 13 48 15 0 0 20 0 5 5 0 0 13 18 14 13 0 11 10 5 0 13 15 3 0 0 6 22 15 0 8 0 0 3 13 
0 0 42 0 26 39 8 33 7 0 0 0 0 29 21 7 0 0 0 19 0 0 14 22 14 17 0 11 0 18 26 0 0 0 0 0 14 18 31 4 0 0 29 0 60 0 
4 21 0 0 0 9 9 0 5 8 0 0 0 0 0 0 0 0 4 0 0 0 0 15 0 0 0 0 0 7 43 0 0 0 0 3 2 0 6 0 0 0 0 12 10 13 
7 0 0 31 0 0 30 26 0 0 0 5 0 7 0 0 0 14 0 2 31 0 0 0 0 0 0 15 0 0 0 25 11 32 0 0 3 0 0 0 1 4 11 0 1 0 
93 18 0 6 0 0 0 0 46 0 9 4 0 25 14 13 5 24 0 6 20 0 7 8 0 0 0 1 11 5 7 0 0 0 15 0 0 0 13 31 6 0 42 0 0 0 
0 0 0 21 0 4 0 27 22 40 25 0 7 0 0 17 4 0 15 2 13 0 0 0 36 0 0 0 11 18 20 15 29 9 41 25 0 13 14 4 0 0 0 0 13 0 
0 33 16 0 0 13 0 25 0 11 10 43 0 19 0 0 14 0 18 0 11 18 0 0 0 0 0 21 0 9 12 5 25 0 33 0 19 18 0 8 0 11 0 0 52 0 
3 0 17 21 0 53 0 31 0 11 0 22 48 13 14 16 21 21 0 17 13 0 34 12 41 5 17 11 7 0 4 12 19 2 0 23 0 2 64 0 15 10 32 0 40 0 
0 0 0 61 0 0 0 1 17 0 0 13 0 30 37 0 0 6 7 0 13 5 19 0 12 0 0 4 0 8 4 7 0 20 20 0 0 0 3 1 2 10 37 3 41 48 
0 27 0 41 3 0 1 48 0 21 21 0 0 0 0 35 0 0 0 6 20 0 32 0 17 0 3 3 0 10 17 0 0 5 0 0 0 2 0 0 12 8 35 0 41 0 
26 14 0 18 0 0 0 14 0 0 0 0 11 0 0 13 33 0 0 0 12 21 0 23 18 0 10 20 0 0 0 0 26 0 0 3 0 15 17 0 0 0 2 11 0 0 
