46 26
18 4 0 13 0 0 18 0 0 0 49 14 3 0 0 9 23 0 12 0 18 11 18 22 24 0 0 38 18 0 0 0 2 0 10 0 0 27 19 14 0 0 61 0 10 22 
29 34 0 15 0 5 0 4 10 7 15 0 27 22 0 0 13 14 17 0 0 0 17 0 0 0 0 0 25 0 14 14 0 0 34 1 14 0 7 22 21 0 11 9 0 0 
35 0 30 18 0 5 0 76 0 0 0 8 0 0 47 14 9 6 16 0 14 2 0 2 0 9 11 0 12 8 0 0 27 8 27 28 3 3 0 0 0 0 25 34 30 16 
16 0 0 34 35 0 0 13 0 19 16 0 6 3 12 24 0 0 6 0 30 0 0 0 0 11 14 0 17 10 0 0 1 0 0 0 0 32 0 49 0 26 1 5 31 0 
24 4 0 0 0 0 53 4 0 19 1 14 0 17 0 0 0 0 7 13 0 0 0 0 0 9 8 0 9 0 12 0 13 10 0 29 0 0 5 11 0 0 11 17 0 0 
0 0 83 2 68 0 13 3 31 0 2 11 0 0 31 10 14 13 0 0 16 18 17 0 0 1 0 13 6 0 14 0 20 33 9 0 0 0 0 31 0 39 0 3 23 31 
0 0 10 0 3 10 24 11 7 0 0 0 10 0 15 10 29 7 0 0 0 0 0 5 0 0 0 0 5 0 0 0 3 0 0 3 0 23 0 0 0 24 0 0 0 29 
4 0 0 0 0 8 8 0 36 18 7 0 2 0 41 1 0 11 18 0 9 7 0 2 0 0 16 4 33 9 0 0 0 2 13 7 1 0 10 30 0 0 19 59 44 2 
5 83 5 31 2 13 0 42 3 12 8 0 16 19 1 4 0 13 22 0 5 12 10 0 7 0 16 8 0 3 9 36 25 0 7 0 36 3 0 22 13 0 30 14 0 0 
14 41 0 2 0 2 0 2 0 7 0 3 57 0 0 0 5 0 0 0 0 56 0 3 1 22 0 4 0 0 5 15 0 0 0 0 1 40 8 14 4 0 0 22 32 0 
0 0 0 0 22 6 0 0 0 0 28 32 9 0 13 0 12 0 0 15 7 21 2 22 14 0 0 4 12 0 0 15 20 0 2 8 0 0 16 0 0 0 6 5 0 12 
9 28 0 25 0 0 8 0 10 13 0 0 6 0 0 0 0 0 15 0 4 0 0 23 12 0 0 0 52 28 0 0 0 12 0 0 0 0 0 0 0 0 42 6 0 5 
10 48 19 0 19 2 5 1 10 0 2 0 24 0 5 12 0 0 0 9 0 20 0 17 15 6 8 0 26 0 0 10 0 0 52 6 0 0 0 24 0 19 8 0 0 7 
3 9 23 23 30 14 24 8 5 33 10 0 0 0 0 0 0 41 27 2 12 15 15 0 0 22 0 13 6 26 0 7 13 0 40 0 0 0 0 0 10 0 69 12 0 36 
37 0 0 39 2 2 15 16 22 0 26 14 20 23 10 7 30 16 0 13 0 0 0 6 0 10 0 12 0 0 47 7 11 18 3 8 2 6 0 23 0 0 39 21 44 1 
0 13 0 14 48 0 10 24 0 0 2 7 0 6 4 2 0 38 13 0 0 0 18 5 0 0 0 0 0 11 40 54 4 0 10 0 4 0 20 29 7 37 2 26 18 27 
0 0 0 15 0 2 0 19 0 7 15 4 5 0 0 14 22 0 7 2 0 0 0 0 0 20 9 0 0 15 0 0 11 0 15 20 17 0 19 1 0 0 0 0 2 0 
13 21 0 33 23 10 4 0 28 8 0 8 9 0 0 0 14 0 0 0 3 16 24 0 7 8 7 28 0 0 27 0 0 3 0 4 64 0 0 0 4 5 21 9 0 0 
0 10 0 0 20 28 5 0 0 0 32 22 3 17 3 22 0 21 25 0 18 11 17 6 26 12 0 10 17 0 0 13 0 7 29 0 0 22 14 0 0 0 58 38 28 0 
0 2 7 0 0 0 8 0 0 12 0 26 0 0 17 0 0 6 14 9 5 0 11 20 0 0 9 0 0 0 11 0 12 0 2 9 2 2 0 24 0 0 19 29 0 0 
21 0 35 20 37 14 0 21 0 0 7 4 10 0 10 8 24 0 0 25 0 21 32 0 21 3 0 0 8 1 0 21 0 10 3 0 0 38 0 0 20 0 2 16 20 47 
31 51 0 3 13 12 11 0 0 10 0 0 3 6 3 23 20 10 23 10 19 0 5 0 23 25 13 6 10 14 4 17 10 1 19 2 12 34 48 0 9 60 0 16 1 4 
19 0 0 0 0 0 60 17 1 16 0 0 0 0 0 10 0 0 3 8 12 5 0 0 0 6 37 2 2 0 2 23 0 0 0 3 0 0 11 0 28 3 27 15 18 21 
15 3 0 15 23 0 1 1 21 19 0 7 0 5 8 0 0 13 5 0 0 13 14 0 14 0 0 6 6 0 2 0 2 6 0 0 26 0 0 12 0 0 0 0 0 16 
0 15 0 79 25 0 1 0 34 13 16 0 0 25 0 0 0 0 15 0 5 0 1 1 28 1 7 0 17 16 0 27 0 17 0 8 6 21 0 16 18 0 71 7 0 14 
15 22 0 74 1 22 0 0 14 42 0 2 12 2 0 12 0 14 15 3 8 0 16 22 7 21 0 19 0 7 6 8 17 0 0 0 13 34 0 0 17 0 20 50 0 0 
