46 26
6 0 2 73 0 0 25 0 0 0 19 11 0 0 0 0 6 5 10 0 0 0 43 1 3 0 16 0 0 0 8 0 22 0 31 24 1 0 25 3 0 37 3 0 0 21 
0 62 13 43 0 69 0 0 22 25 0 0 0 22 0 0 7 0 0 2 0 0 0 0 0 0 23 0 0 0 0 0 0 17 0 0 0 33 20 0 0 0 41 0 0 0 
19 39 2 11 16 0 17 10 4 12 0 28 18 0 2 5 32 19 0 19 4 4 0 0 15 8 0 0 0 0 30 1 25 0 21 21 27 16 20 5 0 18 0 11 0 30 
0 36 22 11 21 21 0 0 0 11 0 1 13 0 0 19 0 18 10 21 0 7 0 0 3 3 20 0 31 68 13 0 15 0 0 6 0 0 37 0 37 1 17 0 11 11 
0 32 0 30 0 0 0 0 16 0 0 13 0 0 11 15 3 18 0 33 0 18 0 16 16 37 0 2 14 2 9 0 17 16 0 23 0 0 21 18 0 9 0 20 14 0 
0 1 28 11 34 0 0 0 0 12 17 11 0 18 11 3 0 5 0 0 10 12 11 0 34 0 16 5 2 2 26 0 5 0 5 0 0 6 20 0 0 0 0 0 0 0 
0 31 0 20 8 39 15 38 26 19 0 15 0 0 13 0 10 0 16 13 0 0 13 20 20 9 10 11 0 28 16 0 13 1 54 13 0 5 0 0 0 0 10 0 12 38 
3 0 17 39 14 34 36 6 6 15 23 7 7 5 10 2 0 7 14 0 5 0 0 17 9 8 21 0 0 4 29 0 0 62 0 6 30 0 31 60 2 0 46 0 0 0 
8 30 0 1 0 0 32 14 1 6 2 16 0 0 20 0 21 1 0 19 0 8 0 0 0 0 4 21 0 0 7 0 5 0 20 34 15 2 52 6 0 24 0 7 4 29 
0 0 0 0 12 29 0 0 24 0 0 6 0 18 6 7 0 31 14 15 0 0 0 0 0 0 5 0 0 0 0 18 0 11 21 0 7 3 7 5 0 0 26 0 0 0 
4 0 11 12 29 0 4 14 0 13 2 0 8 21 0 18 0 4 7 0 11 27 20 0 0 0 0 11 0 0 0 0 0 39 13 0 0 9 11 0 11 0 6 0 0 44 
0 29 1 0 0 0 15 27 34 0 0 9 14 44 3 0 0 11 3 0 0 20 0 48 0 0 0 26 3 8 22 18 0 0 10 4 23 37 0 11 17 0 46 19 5 20 
44 58 16 16 36 33 1 6 0 21 0 31 25 0 10 0 18 0 14 9 1 13 6 17 26 0 25 11 6 0 0 12 22 32 0 0 0 7 7 20 37 0 31 2 28 2 
34 49 0 56 16 0 0 0 0 13 0 0 0 0 0 1 16 0 0 13 12 11 0 22 4 0 2 26 0 6 0 0 24 41 40 0 0 0 0 1 0 10 0 0 0 20 
0 10 20 0 8 59 39 2 0 13 25 0 7 2 0 0 0 3 4 18 0 0 0 7 0 11 7 0 0 0 7 0 0 0 29 25 11 0 33 15 0 42 41 0 50 61 
24 76 0 32 0 0 9 3 0 2 0 2 0 0 0 0 17 0 0 13 9 7 0 12 24 0 6 33 23 0 0 0 0 21 2 20 9 4 6 4 45 7 6 22 17 4 
20 1 0 41 9 0 13 23 0 0 28 0 6 18 23 13 0 14 10 0 12 31 8 6 0 17 3 6 30 29 36 0 3 0 3 0 2 0 30 22 34 6 17 0 23 8 
30 0 0 0 0 16 11 0 0 0 0 0 0 16 0 0 2 0 0 0 0 0 0 23 0 0 14 7 15 0 1 0 0 0 0 0 9 0 0 0 0 15 0 2 0 3 
0 29 0 0 0 0 23 3 30 4 0 0 27 4 4 0 0 0 27 0 17 23 8 0 3 0 0 5 0 14 17 25 8 49 0 2 0 26 36 3 0 7 10 1 8 0 
0 41 0 2 0 47 45 2 22 0 23 6 14 0 6 0 2 0 22 0 19 0 0 0 22 0 14 8 0 0 6 0 0 23 4 6 0 0 32 0 22 3 0 9 28 0 
10 0 25 0 0 7 51 0 11 8 23 0 18 25 0 16 25 0 24 0 10 0 0 0 0 0 0 3 24 0 0 16 0 10 6 0 0 0 25 10 0 20 41 0 28 5 
0 11 11 11 30 2 15 6 0 4 15 15 12 14 0 0 0 21 12 0 0 0 18 0 18 3 15 8 0 38 3 10 18 14 32 0 0 5 1 0 17 26 13 0 0 0 
22 18 0 2 0 3 0 23 17 0 17 0 0 0 7 7 0 0 0 0 0 8 22 0 17 10 1 14 0 24 38 10 22 3 0 8 3 4 3 0 0 2 21 0 0 0 
0 11 4 0 98 22 0 13 16 36 0 0 20 4 27 0 12 0 41 0 0 19 0 0 20 0 39 9 0 0 0 15 15 3 34 3 27 3 13 21 20 5 65 5 18 42 
0 11 0 0 0 0 0 28 0 0 0 0 12 0 0 11 0 0 27 0 5 18 17 0 0 0 11 0 0 10 0 0 0 0 1 28 5 0 0 9 0 5 14 0 0 45 
0 0 33 0 0 0 8 0 0 35 0 0 2 4 0 0 0 0 0 0 0 15 9 0 20 27 22 7 0 22 0 6 7 0 0 6 0 16 30 0 31 9 0 0 0 11 
