46 26
11 37 30 32 41 18 20 6 7 88 0 13 4 9 0 18 0 0 3 12 25 10 7 12 14 0 18 13 0 21 0 33 30 0 33 32 0 0 8 18 13 34 55 0 18 52 
0 28 0 0 11 0 0 22 30 8 35 0 0 18 16 0 0 8 17 0 0 0 20 0 7 22 18 0 17 5 0 1 18 0 35 17 28 0 0 0 0 0 0 0 18 4 
31 41 14 0 9 34 0 16 2 0 0 0 0 26 10 22 3 0 0 0 14 0 0 3 0 23 0 0 0 3 0 0 0 6 14 0 0 22 0 56 0 0 13 16 0 0 
0 38 16 25 42 1 0 28 33 40 0 25 5 32 17 27 1 0 9 17 2 0 7 0 0 0 0 26 15 0 0 2 8 0 78 23 8 19 29 31 1 3 7 0 3 17 
7 20 6 0 0 45 0 11 0 12 40 20 0 7 4 0 0 0 4 0 0 0 15 21 0 19 0 0 1 8 0 49 0 15 6 0 0 16 1 10 1 28 38 0 0 35 
4 0 0 0 0 5 0 0 0 0 6 0 0 0 0 0 9 16 0 10 0 38 13 0 0 8 18 0 1 13 11 2 3 0 0 13 0 0 17 8 0 0 0 0 18 28 
0 1 13 0 0 0 0 23 0 5 0 0 0 6 21 0 0 0 6 23 3 0 2 9 2 0 0 9 5 0 59 30 0 0 0 21 0 7 6 0 0 0 0 0 6 0 
0 4 0 0 0 0 0 7 0 30 0 14 0 64 0 0 23 0 0 18 8 0 7 0 15 0 19 3 22 0 15 4 0 5 16 7 0 0 19 71 0 2 12 47 1 69 
0 0 18 17 0 0 0 38 23 0 0 54 0 0 13 11 0 0 4 2 38 0 0 19 23 0 28 0 13 5 0 15 3 0 6 12 0 26 3 17 6 0 23 23 0 39 
0 0 8 6 9 29 0 0 0 22 40 23 5 0 0 3 0 0 26 0 6 16 0 0 15 16 2 0 0 0 8 0 8 0 15 8 4 6 12 6 34 0 0 2 0 4 
28 0 27 31 40 0 15 25 0 0 0 21 32 10 0 12 0 22 0 0 13 0 0 0 0 0 0 37 0 0 0 5 5 0 23 0 0 0 0 0 6 0 6 0 49 4 
83 0 0 0 0 7 0 2 0 41 0 1 8 31 3 47 0 29 10 1 4 10 15 0 17 0 20 0 19 10 4 14 3 5 0 0 0 22 0 9 2 0 13 17 44 0 
38 23 0 1 9 5 0 0 3 14 0 59 0 35 0 0 0 0 21 0 0 0 0 0 17 0 0 34 17 10 0 2 10 37 4 0 0 0 45 1 26 32 5 0 5 21 
0 14 0 11 8 31 0 0 0 33 0 31 0 0 0 0 7 0 0 0 15 17 0 0 0 8 0 26 0 6 0 0 0 0 0 0 31 0 17 2 0 37 65 13 39 0 
19 41 2 0 41 0 0 10 0 34 5 2 0 10 0 4 16 23 0 0 30 0 7 0 14 0 0 0 29 1 0 0 1 3 0 22 2 0 6 0 12 0 47 0 8 7 
4 0 5 0 0 0 5 50 9 0 0 5 0 6 0 27 0 10 1 8 0 0 7 39 0 11 0 23 11 10 23 4 25 10 14 0 0 4 0 0 0 18 0 10 0 0 
0 26 23 9 0 12 36 0 0 12 14 10 0 16 0 0 1 0 7 0 0 20 0 22 7 0 0 6 0 0 0 11 0 8 20 0 0 36 0 8 22 20 36 0 0 0 
15 10 51 10 0 0 0 22 16 17 0 14 0 3 0 4 14 6 20 2 10 24 7 19 8 13 12 20 0 11 18 7 3 9 1 6 4 11 4 7 32 26 26 23 31 21 
0 0 0 0 0 22 11 0 40 7 5 18 29 43 0 67 11 29 0 26 7 7 0 0 0 26 0 33 20 15 12 26 10 0 9 0 23 0 0 5 25 29 0 16 0 41 
8 1 13 0 0 0 0 0 0 0 22 6 0 25 30 0 27 0 0 0 0 20 0 0 10 0 0 0 0 0 0 0 22 80 10 2 0 1 34 11 3 0 4 27 30 44 
45 0 0 15 17 0 20 11 8 3 0 0 0 52 12 0 10 0 16 0 0 0 0 5 0 17 9 13 15 0 12 0 6 20 0 17 0 0 0 3 0 0 14 0 0 13 
0 0 0 0 8 38 16 14 4 9 4 8 1 1 36 5 16 5 25 43 7 4 33 0 0 9 21 1 12 21 0 0 0 0 5 0 0 19 24 38 24 0 1 0 28 0 
3 0 58 0 0 0 0 0 0 15 0 0 0 10 0 0 0 1 4 5 18 21 4 0 2 0 0 0 0 0 0 0 19 1 0 0 0 0 0 4 0 0 62 0 0 0 
0 15 40 10 10 0 0 0 1 8 19 10 27 23 0 24 0 6 0 0 0 10 2 0 21 41 0 19 20 20 0 0 4 2 4 2 4 0 29 51 0 0 36 0 0 0 
0 13 16 3 26 0 3 0 0 8 31 0 0 6 0 11 3 0 3 3 25 13 4 0 16 0 0 0 0 0 13 0 0 0 13 0 0 0 12 2 0 29 0 17 0 8 
23 44 0 7 5 4 15 0 22 4 0 24 0 18 9 0 0 0 4 7 11 7 6 0 1 0 47 0 20 12 0 21 7 0 0 0 0 4 6 15 0 0 0 12 0 58 
