46 26
43 12 5 81 18 0 13 0 7 0 39 14 0 5 12 2 0 0 22 0 17 22 11 6 1 0 8 3 15 0 6 21 10 0 16 0 15 43 0 0 25 0 10 13 27 17 
0 0 0 36 23 0 0 32 8 13 0 35 15 1 0 7 4 0 0 1 0 9 43 0 14 4 0 9 48 4 5 12 2 19 5 4 1 0 19 0 3 0 0 9 0 0 
27 17 0 5 3 0 8 4 3 5 0 0 6 13 14 0 0 0 6 0 0 0 13 0 0 0 0 0 0 0 29 23 0 0 0 0 0 32 35 0 36 0 0 11 4 0 
0 2 0 0 36 14 0 0 0 0 0 11 7 23 0 4 2 9 0 41 7 14 0 0 3 0 14 3 12 0 1 4 0 12 3 3 1 2 0 0 47 24 0 13 0 0 
1 0 20 33 16 0 4 16 5 0 0 33 0 25 19 0 12 0 0 0 10 10 3 0 4 0 0 5 3 18 19 7 7 19 0 29 47 0 25 53 0 2 0 0 18 37 
14 2 5 0 0 0 26 27 16 0 26 11 7 0 0 0 0 5 4 0 0 0 16 2 0 14 10 8 0 11 3 0 24 8 25 31 33 12 0 0 0 0 0 0 0 0 
0 0 25 0 0 0 15 0 12 0 0 0 1 37 24 13 14 0 1 0 10 15 0 6 13 0 14 7 0 0 24 18 0 0 0 5 17 0 0 0 0 0 0 0 2 0 
0 0 0 0 0 0 35 0 0 0 0 0 11 0 0 21 10 9 0 14 0 9 0 0 10 0 2 0 0 0 0 0 0 8 10 0 33 7 0 0 2 29 2 10 0 0 
0 0 0 8 0 6 0 0 36 15 0 0 0 5 2 0 19 0 35 0 8 0 52 0 15 0 0 5 0 4 8 0 15 0 3 4 3 0 0 17 4 6 0 0 40 27 
36 21 0 0 3 0 0 0 0 0 0 16 0 0 0 4 26 0 0 0 19 18 0 0 15 4 7 5 5 0 0 23 0 0 0 2 42 0 0 0 0 0 26 0 20 2 
26 0 0 0 0 0 8 0 5 35 0 0 11 3 25 0 4 0 5 1 11 6 0 4 0 0 22 0 0 0 0 0 0 0 0 0 0 0 0 25 0 0 0 0 35 0 
38 2 2 0 38 0 12 0 3 8 32 10 13 6 17 12 0 10 3 0 10 15 16 0 7 25 19 7 10 0 0 27 0 0 0 0 12 0 0 0 36 0 35 11 32 19 
1 39 0 0 2 38 0 21 8 5 0 5 0 8 0 0 2 0 0 20 1 5 0 10 1 8 21 0 23 0 0 17 2 25 0 22 4 3 0 10 42 0 0 11 51 24 
17 20 5 0 33 2 10 1 0 11 0 0 12 4 19 0 2 12 0 0 30 0 33 0 0 23 1 56 2 29 7 5 12 11 0 0 12 58 0 9 0 6 0 11 0 19 
16 3 40 9 48 6 3 5 3 22 29 11 4 20 16 3 17 34 12 13 5 20 0 6 8 0 36 27 16 0 0 0 0 4 20 5 4 0 0 6 25 26 43 12 12 0 
33 0 0 14 0 40 11 0 0 0 0 0 0 0 15 0 4 11 0 27 0 14 3 0 0 2 0 0 0 0 0 0 0 22 0 14 5 21 0 0 0 5 0 38 0 0 
0 38 18 41 4 0 18 0 0 4 16 11 17 41 13 0 0 19 0 0 31 3 3 0 22 0 5 8 16 1 9 0 0 1 4 12 18 0 21 0 0 5 2 14 18 0 
0 34 0 17 0 27 0 50 4 0 30 21 24 32 0 5 47 0 0 16 0 34 0 15 6 0 11 0 21 0 9 1 3 16 0 56 79 6 0 23 54 20 0 10 0 49 
43 0 1 28 0 23 0 5 16 31 33 25 12 0 0 6 0 41 0 6 0 6 10 0 0 0 11 0 40 14 0 33 0 0 10 24 0 0 0 0 14 0 0 46 5 0 
0 31 7 0 31 28 42 3 2 1 1 0 37 42 0 13 9 0 0 5 8 8 35 2 37 0 7 0 24 21 26 2 20 9 0 7 21 47 0 5 0 19 0 6 19 0 
8 0 33 0 16 0 20 16 7 4 33 3 21 0 0 0 0 27 22 10 0 0 0 4 4 17 41 1 0 0 17 2 0 3 0 0 0 10 0 0 32 0 0 0 16 30 
0 0 0 0 0 9 31 0 31 0 33 26 4 0 1 1 16 28 0 32 1 0 3 16 5 17 0 0 0 0 15 21 6 0 0 16 11 19 0 9 0 11 0 19 1 0 
53 1 3 21 6 0 15 0 19 0 33 0 21 13 10 13 23 0 8 23 1 21 32 0 0 0 18 9 15 0 0 0 0 0 0 34 15 3 0 23 0 0 23 10 0 37 
0 0 0 0 0 32 23 7 28 0 0 0 22 0 1 0 2 9 18 0 1 3 0 6 0 0 0 0 10 17 0 0 15 0 0 21 28 53 0 2 0 19 0 29 7 12 
16 0 20 0 10 0 37 25 0 32 0 0 0 0 7 17 28 0 0 10 0 0 11 21 0 0 2 0 2 1 12 0 7 0 11 0 0 18 0 17 0 29 40 48 0 4 
25 0 0 0 0 0 0 0 17 27 0 24 0 31 1 0 0 0 27 1 0 21 5 0 7 4 11 5 0 0 1 11 0 0 0 24 56 0 0 0 25 0 21 0 0 15 
