46 26
0 8 21 0 23 33 0 4 16 13 5 24 0 1 31 0 9 4 0 0 0 35 0 0 11 23 9 0 20 0 0 0 8 0 0 24 22 19 33 0 40 33 24 0 0 0 
1 0 19 0 0 24 0 1 11 0 0 18 12 0 0 7 30 4 0 5 2 5 31 0 4 4 26 0 2 37 16 31 0 0 29 0 10 5 14 3 0 0 55 0 1 12 
18 43 12 28 2 0 0 39 0 57 0 0 0 0 0 0 4 20 18 13 0 6 0 0 0 9 0 2 0 13 0 16 49 5 25 0 0 46 0 7 0 32 14 4 17 14 
18 8 0 7 21 7 13 3 0 7 32 0 7 0 2 0 0 0 0 10 0 0 0 0 9 0 6 17 15 11 0 30 5 12 0 34 13 14 0 0 5 0 0 42 0 6 
0 19 20 0 38 0 37 0 19 55 7 1 1 3 0 6 0 3 4 0 19 6 1 8 0 7 16 17 23 0 17 0 0 0 0 17 0 0 0 0 29 0 5 63 20 10 
0 0 0 0 3 14 0 0 0 14 33 23 25 0 30 7 20 0 15 4 0 18 0 0 0 9 1 0 14 0 0 45 0 12 14 21 0 0 7 0 28 40 23 0 0 0 
36 2 0 18 6 0 27 6 12 0 0 0 4 11 0 2 1 0 0 25 14 0 17 0 0 12 0 0 10 1 0 0 7 3 0 3 39 12 18 2 11 8 22 4 0 0 
0 4 19 0 27 23 10 0 17 3 5 13 0 13 0 0 15 0 0 0 6 31 0 1 25 0 3 0 1 0 0 16 16 0 0 0 32 32 14 23 0 0 16 0 15 6 
0 0 0 14 9 27 22 6 0 26 0 11 6 7 0 0 0 2 0 54 1 28 2 11 0 0 21 16 9 14 10 0 14 14 11 42 0 0 0 28 27 10 0 30 0 20 
9 0 0 6 0 38 5 26 12 43 0 23 0 14 0 14 7 0 0 11 12 0 19 0 0 19 15 0 0 0 5 0 12 26 0 0 0 7 22 0 0 32 0 29 13 6 
28 0 18 15 21 15 16 12 47 32 0 11 21 6 3 20 4 8 4 15 9 24 8 3 0 9 8 0 2 27 0 3 43 26 30 42 31 0 36 0 6 7 0 72 3 43 
0 0 89 0 22 0 21 0 0 5 18 0 0 5 0 0 6 11 0 6 0 8 0 17 0 36 4 0 26 0 0 6 0 0 0 8 0 0 0 2 38 2 0 20 18 0 
0 0 0 0 49 2 7 0 11 6 0 5 8 11 3 15 0 13 20 1 22 6 8 22 9 0 9 0 0 15 7 18 0 0 13 14 0 0 4 25 0 21 56 0 5 18 
17 30 0 40 7 0 0 10 0 2 0 0 0 1 0 1 6 12 0 0 12 4 0 7 0 12 6 4 0 0 0 29 5 1 0 0 0 0 0 1 9 0 0 40 1 0 
0 0 12 0 23 24 0 14 0 0 20 34 13 0 0 28 0 16 0 17 0 16 9 7 5 0 0 13 13 0 12 6 0 28 6 0 0 17 19 0 0 5 0 28 3 0 
0 9 5 37 0 0 4 24 0 27 12 0 0 8 0 18 5 22 34 0 3 10 30 0 4 10 0 5 10 23 0 4 0 33 17 10 24 0 30 9 37 23 0 21 0 0 
0 0 0 0 0 40 13 0 37 22 4 1 40 17 0 0 6 0 0 25 0 0 0 0 0 0 0 0 0 0 8 22 6 0 0 0 13 0 0 9 0 0 0 0 18 30 
35 0 0 0 8 36 0 20 10 0 0 0 9 0 0 0 0 2 0 10 5 9 4 0 0 12 0 20 14 10 0 6 0 0 12 35 0 14 0 0 6 36 14 0 0 7 
0 0 0 1 24 0 0 0 16 6 3 0 9 2 0 0 0 28 0 4 10 9 0 3 0 1 6 23 15 0 3 0 0 7 0 0 0 0 6 0 0 0 0 9 0 28 
0 15 4 20 9 36 18 0 3 1 0 0 0 6 0 6 15 12 6 14 6 11 13 0 10 20 8 0 0 9 10 0 13 0 0 0 0 19 0 0 10 5 0 0 0 20 
0 37 28 19 22 0 0 0 15 0 4 31 8 30 10 0 12 2 0 0 0 0 8 7 0 0 0 18 12 0 0 6 0 0 14 0 32 5 39 0 0 0 5 0 0 81 
6 33 0 34 39 0 19 0 0 14 0 0 6 15 20 0 42 0 7 0 0 2 4 14 0 19 0 0 11 0 1 0 18 0 37 31 0 27 63 11 21 0 0 0 0 17 
34 0 12 14 11 0 12 24 4 0 30 9 0 20 22 0 18 16 9 0 0 0 0 21 7 22 1 0 0 30 0 5 6 29 13 0 22 0 5 14 8 0 0 18 19 19 
0 0 4 20 21 0 0 0 4 0 0 9 4 4 0 23 0 0 11 14 2 18 9 0 9 1 0 2 0 11 0 16 0 0 0 0 0 0 0 26 19 2 16 2 8 0 
10 4 0 17 9 0 0 0 0 5 15 32 0 0 13 0 6 0 0 12 17 1 23 0 15 30 0 0 10 18 0 0 32 0 0 0 0 10 13 19 0 0 53 0 15 7 
0 22 0 14 0 18 15 0 0 12 0 20 0 18 13 3 26 51 16 19 0 0 24 32 0 0 0 21 10 0 0 4 0 0 5 0 0 0 0 0 0 0 26 0 23 28 
