46 26
0 4 3 10 0 2 1 11 0 0 29 6 0 26 9 38 10 0 3 22 0 0 28 18 5 0 31 19 16 17 22 0 16 23 53 0 0 0 25 33 48 39 27 16 0 21 
0 0 0 12 28 0 0 0 0 0 11 0 0 0 6 13 0 36 16 0 7 0 0 0 0 2 0 10 4 7 0 0 41 30 16 0 17 10 29 0 23 0 12 0 0 17 
0 2 17 68 23 0 0 0 0 16 20 6 0 0 16 10 2 0 2 42 0 6 0 3 18 10 3 23 0 0 16 9 2 0 13 29 0 0 0 36 9 2 0 2 0 36 
0 0 29 0 15 15 12 0 0 31 7 0 0 12 23 24 19 7 0 18 19 0 51 0 8 10 0 0 0 4 0 18 18 0 0 0 0 10 14 4 23 0 20 0 10 36 
0 0 10 0 0 24 18 0 0 0 0 0 0 0 0 0 1 0 39 22 19 0 0 9 0 14 0 12 0 0 0 8 0 0 0 0 15 0 0 18 1 22 0 0 26 0 
16 8 13 0 11 0 0 3 0 28 0 0 0 6 7 28 16 5 0 0 14 7 5 52 4 0 0 10 18 30 18 13 19 0 14 0 0 4 0 26 0 11 17 8 0 22 
0 0 46 6 3 0 0 0 21 35 0 21 2 0 26 0 33 0 0 3 26 24 0 0 31 8 0 9 29 30 5 0 64 0 0 0 11 0 3 0 26 0 14 27 1 18 
0 22 10 0 15 15 0 2 0 25 71 3 25 9 12 17 13 6 5 14 4 0 20 39 5 0 17 0 6 0 4 3 0 32 16 38 0 0 0 20 0 31 14 43 0 8 
5 40 0 35 0 4 32 0 0 17 0 23 30 4 8 0 13 10 0 7 0 6 16 0 0 11 9 12 17 0 0 0 0 0 13 0 26 10 3 0 6 26 14 0 0 0 
0 0 0 0 6 0 16 0 0 0 0 0 21 0 0 0 0 24 0 4 0 0 16 0 1 2 0 14 0 0 14 9 9 0 0 1 0 0 16 5 9 10 0 0 0 0 
0 12 34 32 1 10 29 18 13 0 10 0 0 0 0 0 0 0 0 13 28 13 3 18 0 0 0 0 2 0 14 11 0 14 28 15 36 26 0 0 0 35 2 0 39 0 
0 0 26 40 43 0 3 35 12 0 20 0 23 8 16 21 0 0 0 0 5 0 0 0 6 10 0 0 51 0 2 27 0 31 0 18 10 17 0 11 20 38 53 0 0 0 
0 21 0 0 0 0 0 0 0 1 61 5 3 0 6 0 0 0 0 10 4 0 19 16 8 9 0 4 0 0 20 24 7 0 4 10 0 25 0 0 0 2 0 0 0 0 
3 0 28 2 0 22 1 23 33 8 0 0 0 0 0 0 9 0 14 0 27 0 2 0 0 17 0 10 22 0 30 0 14 28 0 0 6 3 0 0 32 5 29 8 0 0 
42 0 0 0 11 0 0 0 0 33 11 0 8 14 0 0 23 0 8 0 0 1 4 5 0 0 0 0 9 0 7 0 0 12 7 0 1 5 0 28 0 5 9 0 0 0 
0 0 56 4 0 4 13 29 0 54 40 0 0 0 0 0 2 17 13 0 0 14 6 2 7 3 0 14 13 0 15 0 0 24 20 13 0 0 0 0 0 45 2 0 44 44 
55 16 12 29 0 38 0 11 5 35 0 0 8 3 0 20 7 0 0 0 0 21 0 0 0 10 0 14 12 1 0 0 15 3 6 25 0 37 0 9 0 11 10 53 35 0 
0 29 35 41 0 29 6 0 0 17 25 35 0 12 17 31 0 8 20 0 23 6 0 37 0 4 10 0 2 2 14 0 10 0 28 0 6 32 17 5 1 11 24 0 15 16 
25 58 48 29 27 0 0 8 31 0 33 6 27 0 0 0 0 5 0 1 5 0 8 0 0 47 0 26 0 10 29 13 29 0 30 25 25 35 27 58 0 0 0 0 0 0 
41 0 0 8 1 34 0 4 12 43 5 0 0 10 5 5 11 1 1 5 12 12 5 0 0 24 3 9 4 0 0 0 7 0 18 0 6 0 6 23 2 28 26 34 0 0 
50 6 0 0 0 35 6 4 0 10 23 15 16 0 3 5 19 7 9 0 19 0 22 0 8 19 31 1 3 3 5 0 16 9 0 10 0 0 18 4 35 25 9 0 9 0 
41 0 21 0 0 0 16 1 0 14 10 0 19 0 0 9 42 13 0 18 15 0 21 57 17 7 0 0 28 0 25 38 5 10 7 0 0 0 0 0 0 0 32 0 2 8 
2 37 42 55 0 23 47 20 1 32 20 4 17 0 25 5 22 20 27 0 0 0 0 0 0 0 3 20 17 4 19 0 25 11 22 29 0 14 1 3 3 3 56 0 20 27 
0 0 61 8 26 8 6 0 0 0 51 7 6 12 0 0 0 0 7 0 19 0 0 11 0 0 0 0 12 0 43 0 4 0 0 33 0 0 0 0 0 11 0 0 0 35 
2 15 42 0 6 20 0 0 7 0 15 0 17 0 0 0 0 6 0 0 0 0 37 6 22 0 4 7 0 0 0 0 18 0 7 0 0 27 0 0 0 16 0 0 0 8 
17 27 0 0 33 0 12 0 27 8 4 43 0 0 17 0 0 7 0 15 0 13 27 0 0 2 15 0 35 4 27 0 18 1 25 15 9 41 0 28 0 20 0 0 0 0 
