46 26
2 0 0 0 0 20 17 8 6 30 0 0 0 44 0 22 22 3 0 0 11 0 0 0 0 10 19 16 0 3 0 11 0 45 0 17 32 0 48 42 5 0 15 0 17 33 
0 25 23 57 0 16 12 0 0 3 0 9 0 8 0 0 5 6 2 7 2 9 37 0 21 27 41 0 0 0 22 1 23 12 12 31 0 0 0 3 0 8 0 0 0 0 
11 20 17 104 0 10 52 0 18 14 10 0 0 0 8 0 13 9 0 0 13 19 0 1 6 0 3 2 13 19 23 0 0 0 0 21 23 20 5 14 0 17 39 5 0 19 
1 0 24 13 0 0 0 0 24 8 5 23 0 2 0 16 13 2 0 0 22 15 0 28 0 12 15 1 10 19 37 2 3 24 30 21 7 0 0 37 37 0 0 26 21 26 
18 14 0 0 0 13 0 27 0 0 0 4 0 0 18 14 3 14 0 8 0 3 22 0 0 17 42 14 1 0 0 37 0 0 27 3 2 9 27 10 0 14 21 0 40 2 
18 3 43 28 16 0 30 0 1 34 0 10 0 0 9 0 0 0 26 0 7 0 0 0 0 2 11 5 0 26 0 1 0 0 0 0 38 0 0 0 23 0 0 54 11 0 
0 0 0 27 0 3 11 24 8 0 0 39 0 0 0 0 10 0 0 0 0 2 0 17 0 3 10 5 0 0 28 24 5 1 0 4 0 0 0 40 0 0 0 0 0 22 
0 0 0 0 3 0 25 20 0 30 0 0 4 0 6 26 4 0 0 0 0 0 0 0 0 0 0 9 0 10 1 25 0 16 0 8 21 0 0 20 0 0 3 0 11 0 
0 14 0 0 0 0 0 5 0 0 13 1 21 31 0 0 16 0 5 0 12 0 6 15 16 0 6 0 13 1 0 0 3 11 0 0 0 0 7 11 0 0 10 0 20 7 
32 12 0 0 64 3 2 0 2 0 1 0 0 7 0 0 16 0 19 0 20 0 0 27 9 8 27 0 13 16 13 4 32 20 0 31 9 15 0 0 20 21 0 27 0 16 
0 17 0 0 0 23 0 0 0 17 6 0 11 0 0 0 0 0 0 0 13 0 9 12 0 17 17 5 40 0 0 0 10 0 0 0 0 0 0 0 0 9 8 0 0 17 
33 0 0 2 2 12 8 3 26 0 0 9 33 0 19 0 12 12 16 0 8 7 1 0 11 0 5 0 16 13 0 0 0 24 8 11 0 30 0 3 7 23 8 0 6 8 
22 0 0 6 3 10 42 0 0 0 0 21 0 13 0 83 25 0 3 0 0 15 0 0 0 0 0 0 17 0 12 0 4 0 0 11 61 0 32 17 34 25 0 28 0 15 
14 21 31 2 2 11 34 2 0 27 8 3 0 0 51 4 43 13 2 4 7 10 21 0 15 3 8 5 10 10 0 0 20 26 6 22 30 15 22 22 0 0 2 29 28 10 
0 0 0 3 1 0 0 33 0 0 0 0 18 14 9 0 0 0 0 0 0 0 27 0 0 0 0 7 0 0 18 0 0 7 10 4 0 4 1 20 40 0 0 0 22 3 
3 11 0 28 16 13 19 17 14 31 0 0 29 0 16 0 17 0 12 15 17 0 14 0 0 7 19 0 1 0 18 28 0 15 6 20 0 0 0 0 0 0 0 1 6 36 
45 6 31 28 33 6 14 3 0 14 67 18 0 0 0 15 8 0 0 23 13 16 0 13 0 6 5 0 0 5 19 29 0 31 0 16 0 32 16 14 22 41 10 7 16 0 
0 0 0 3 30 2 9 0 32 0 0 32 0 14 0 22 1 0 0 33 0 0 0 11 0 0 12 2 0 16 1 0 0 0 0 5 10 52 0 0 6 36 1 32 8 19 
0 25 33 0 48 0 0 0 0 0 29 0 8 32 3 0 9 13 0 6 13 23 13 10 9 24 2 0 0 0 0 9 19 15 0 19 34 11 0 33 6 23 19 0 0 0 
53 0 18 0 16 55 23 0 16 3 16 0 0 13 14 5 0 0 0 15 7 15 0 0 9 0 16 22 0 0 0 0 0 0 6 6 0 0 33 11 0 0 0 0 11 16 
4 0 19 0 0 21 1 0 15 17 0 9 0 0 0 0 0 16 0 23 7 18 11 9 0 19 2 20 12 0 0 0 9 25 11 2 15 0 0 0 4 0 36 0 20 11 
6 12 5 71 2 40 22 0 0 0 13 27 7 0 0 3 4 11 45 3 0 16 7 2 0 4 0 21 18 20 2 10 27 0 16 59 0 4 24 0 31 44 10 0 0 61 
31 34 0 0 2 0 12 0 0 0 16 0 28 5 41 5 32 0 0 23 0 0 9 34 14 0 10 3 6 0 34 15 11 0 6 0 0 11 6 21 11 22 0 0 9 22 
30 44 0 0 0 23 0 0 9 0 0 24 0 0 3 0 0 40 21 20 7 0 0 0 0 34 3 0 6 8 0 0 2 0 0 27 21 8 0 7 0 0 16 0 7 12 
21 0 5 0 31 5 0 47 20 1 5 23 0 0 20 0 8 0 19 6 9 12 0 0 33 0 0 29 6 0 12 0 23 0 16 7 0 0 0 13 0 30 12 0 0 0 
4 13 22 23 0 15 23 38 25 22 16 19 29 9 13 0 16 0 9 0 27 0 1 13 14 0 19 0 0 10 42 0 0 25 22 53 0 0 2 14 58 29 2 20 16 38 
