46 26
0 7 1 20 0 0 0 19 0 0 0 0 0 0 16 0 0 0 11 0 0 19 16 0 0 0 0 6 14 7 0 0 0 0 0 1 0 0 0 17 5 0 14 21 23 13 
0 35 0 0 0 0 0 10 0 0 0 4 32 23 15 2 0 0 0 18 17 5 0 0 11 0 0 26 0 22 0 0 0 22 13 0 0 7 0 12 9 0 9 0 64 1 
6 0 0 0 27 10 8 38 13 0 20 0 25 26 0 0 20 0 3 2 2 2 28 0 0 20 13 0 0 7 0 38 1 7 9 0 42 21 3 7 25 4 17 25 0 46 
35 0 46 5 0 0 2 13 48 3 22 0 0 31 16 7 0 8 11 0 13 6 0 26 0 8 0 12 5 27 22 10 0 25 19 47 0 17 0 1 0 0 7 18 5 0 
0 24 7 16 38 37 10 0 5 14 3 7 6 0 3 0 6 7 0 12 0 17 8 0 0 24 7 1 9 5 23 18 0 0 5 0 6 12 4 0 13 0 19 12 0 0 
0 0 43 1 0 10 0 11 0 0 5 0 1 19 0 35 11 0 17 5 12 0 2 0 5 0 0 0 0 0 0 0 5 0 1 7 3 5 9 3 13 19 19 3 28 43 
47 0 0 0 0 0 4 23 19 23 10 5 16 31 37 0 22 28 28 8 0 21 0 0 0 0 0 19 10 16 12 0 0 0 0 26 0 66 15 2 0 2 0 0 48 19 
17 34 30 0 0 0 7 0 44 0 0 26 10 0 0 0 0 10 0 8 20 1 2 0 2 11 16 33 0 20 0 30 0 11 0 0 16 6 0 0 0 0 105 18 11 0 
0 6 14 0 7 0 0 7 0 0 0 7 0 5 0 1 0 0 0 0 7 29 0 0 0 0 0 12 0 13 0 4 23 4 0 21 18 4 6 23 0 0 0 0 0 0 
28 0 0 0 0 0 0 3 5 0 15 1 31 14 11 15 0 0 0 0 0 0 0 4 0 15 0 17 28 0 42 10 0 0 14 0 0 0 0 25 0 0 0 31 0 0 
12 0 43 0 22 16 39 16 0 0 5 19 4 0 34 40 1 12 29 10 0 6 0 0 8 6 23 5 13 23 2 10 27 1 11 0 2 9 0 5 13 40 13 0 26 38 
62 5 20 24 0 0 0 0 4 6 0 5 23 16 0 0 0 17 24 5 0 23 0 0 2 0 31 34 0 0 0 13 0 29 0 31 9 0 14 0 29 0 0 10 34 68 
0 1 7 33 0 10 0 0 0 21 0 0 0 0 1 25 13 14 0 17 13 0 8 12 0 0 0 0 14 13 0 14 13 0 0 15 61 28 0 23 0 0 16 0 0 0 
0 61 37 0 0 51 17 0 4 0 30 29 32 0 13 0 11 12 12 0 19 0 0 17 0 0 0 11 0 0 28 34 4 0 0 5 4 0 8 25 21 0 0 43 52 1 
0 0 34 55 1 24 34 6 0 0 0 0 0 13 0 0 21 28 6 8 23 1 0 0 0 7 0 23 0 8 17 9 0 9 13 18 32 7 0 3 0 0 2 11 31 39 
0 0 0 16 0 14 0 0 23 0 64 0 9 0 7 0 1 0 1 25 6 6 0 0 7 0 13 0 23 0 0 0 15 2 2 0 33 0 0 6 30 0 0 15 17 0 
14 0 0 4 0 0 32 38 0 1 13 16 0 0 4 0 2 0 5 4 0 0 0 13 13 21 0 6 17 6 2 5 14 10 0 0 8 7 32 1 1 0 0 6 7 0 
0 13 0 3 13 0 12 2 0 27 29 34 19 0 0 29 1 8 36 1 0 9 0 22 0 0 10 0 0 0 5 0 0 0 22 5 20 0 0 29 12 37 24 0 0 4 
0 17 0 0 0 0 38 0 32 21 0 0 2 0 8 0 0 1 0 0 0 2 18 2 0 0 10 1 16 0 0 0 0 0 0 0 5 0 0 31 0 0 0 0 30 12 
1 34 2 0 2 3 0 54 3 0 0 4 0 0 26 9 0 10 7 0 4 0 0 0 9 14 0 10 0 12 0 19 0 0 4 0 33 0 0 14 9 0 17 0 36 0 
0 0 0 1 16 0 0 41 0 3 22 26 9 19 0 0 0 0 11 7 0 37 0 0 0 0 0 9 21 11 0 0 47 0 6 8 0 63 0 0 1 20 4 0 0 5 
0 37 0 24 12 40 21 0 15 0 0 0 4 0 0 0 19 14 0 13 0 20 0 4 3 0 0 12 0 39 12 13 0 19 0 0 31 1 22 8 13 0 12 1 16 40 
12 0 23 1 26 0 19 35 21 9 42 0 31 0 21 0 0 7 22 0 0 36 8 0 19 0 19 10 4 2 40 2 67 4 0 23 29 10 0 14 19 5 0 3 3 20 
0 21 5 52 27 22 0 6 2 0 1 0 5 23 12 0 20 1 10 9 0 0 1 0 0 0 0 39 8 9 14 65 0 0 17 0 6 0 0 0 21 0 0 0 43 0 
0 22 0 1 2 37 23 2 19 0 2 0 0 19 28 0 0 0 0 3 0 0 4 1 0 0 0 3 0 6 17 3 9 7 0 0 0 0 2 0 4 1 68 0 0 0 
0 11 56 3 0 0 1 69 0 11 22 0 11 5 24 23 0 0 0 2 18 24 16 0 0 0 23 0 26 18 0 8 43 9 0 24 0 28 22 12 0 0 0 18 12 8 
