46 26
0 0 0 7 0 0 0 12 22 9 6 25 4 0 10 20 0 5 0 24 0 14 0 8 0 0 0 0 0 0 4 8 24 0 0 45 0 30 3 0 23 0 0 0 11 0 
0 0 24 0 40 11 0 14 7 1 1 0 23 19 10 4 12 0 0 13 17 0 0 5 0 12 0 2 21 20 5 0 0 0 2 0 8 0 0 16 0 0 0 0 8 0 
32 19 10 9 6 0 1 21 28 1 3 23 66 11 19 13 4 7 0 23 14 15 7 21 14 0 3 2 0 3 0 2 0 0 30 10 28 0 0 11 0 0 15 12 20 0 
0 22 0 0 0 10 7 10 3 0 0 1 35 43 18 0 27 0 13 15 18 19 0 22 11 0 6 16 5 0 0 0 20 0 8 22 0 0 3 11 0 5 0 5 1 0 
0 7 0 16 0 15 38 37 10 0 2 19 2 29 15 0 0 0 24 22 15 0 0 0 20 19 23 2 9 15 3 5 9 4 8 9 0 4 0 0 19 0 56 10 14 0 
37 0 0 0 0 10 0 0 18 12 0 16 0 8 6 3 0 17 21 3 3 0 34 1 25 0 0 0 16 8 2 0 0 0 0 21 0 41 27 21 0 4 17 19 1 0 
0 0 51 0 0 47 30 9 3 8 0 10 2 0 31 14 24 7 0 0 16 7 0 0 17 0 0 12 6 1 3 5 0 17 4 31 19 0 36 18 24 0 0 0 0 37 
19 20 0 49 0 2 0 0 20 17 15 0 0 22 0 14 0 0 0 26 15 65 0 0 2 14 32 2 13 19 17 0 3 0 3 35 0 3 9 18 0 20 0 0 0 0 
4 0 0 10 14 0 0 0 7 0 0 0 25 8 0 14 0 13 20 0 0 17 0 0 0 0 0 0 0 0 13 0 0 0 0 0 0 0 20 0 0 21 0 0 11 0 
0 0 0 0 0 0 0 0 34 18 0 0 0 0 0 1 5 17 0 23 0 0 1 0 0 16 0 16 6 0 0 6 0 0 17 6 0 28 0 0 12 6 54 0 5 0 
0 16 21 0 10 20 0 11 20 56 41 3 13 0 16 29 0 5 0 44 0 9 1 21 30 53 16 0 27 0 0 13 24 6 21 13 15 24 29 35 0 4 16 0 39 0 
34 34 0 0 0 0 16 11 0 5 5 0 0 8 0 4 0 13 0 0 6 0 16 0 4 0 0 0 14 2 0 21 25 0 31 0 0 0 4 0 42 11 41 0 2 6 
0 0 0 14 0 39 20 6 0 17 43 0 0 0 0 14 0 14 2 0 15 2 23 14 10 0 5 9 0 14 0 21 9 0 0 10 9 31 5 0 0 13 2 33 41 14 
0 13 0 0 2 0 6 9 0 0 0 0 20 0 0 0 0 27 14 11 8 0 21 0 12 16 0 0 19 6 1 6 23 4 8 34 0 0 0 11 0 8 5 0 0 0 
0 40 0 0 23 13 0 6 1 6 24 0 32 17 16 4 3 3 0 12 12 11 0 0 17 0 2 16 3 0 10 0 20 28 23 49 37 32 30 7 7 87 1 36 32 45 
38 0 0 0 10 0 17 8 11 19 1 36 0 34 14 4 0 9 12 0 7 3 0 0 22 0 8 0 36 0 6 14 7 0 0 10 22 0 9 0 40 0 1 0 31 0 
0 33 0 0 0 42 0 7 0 0 5 34 31 11 9 2 0 3 0 0 0 0 0 0 2 20 4 15 4 4 0 0 3 9 39 0 0 10 0 0 0 0 0 21 6 34 
2 4 0 0 0 0 0 1 6 6 0 0 3 0 2 8 0 0 0 3 0 12 0 7 16 0 0 0 12 9 0 0 0 0 0 7 0 0 0 0 16 5 8 3 0 0 
10 0 0 10 0 33 12 24 0 1 0 0 0 21 0 0 28 13 0 6 10 3 0 0 0 0 0 14 0 0 0 13 3 0 21 0 0 0 39 0 0 4 0 16 15 0 
0 2 0 0 1 20 0 33 0 0 0 0 7 14 0 3 0 5 21 0 0 0 14 0 17 8 18 14 0 0 0 0 0 0 8 0 0 0 14 21 8 0 0 0 29 0 
0 42 0 0 1 5 0 0 0 6 0 15 7 36 1 34 0 4 0 3 11 0 0 0 0 4 15 0 2 0 5 19 4 0 0 0 0 0 0 8 0 8 3 42 0 9 
44 6 44 0 0 0 12 0 21 42 0 33 0 0 20 0 16 3 0 0 24 3 0 3 0 0 0 9 3 4 0 17 31 13 8 33 0 0 0 0 15 0 0 0 25 0 
49 0 0 0 0 0 0 9 0 25 3 0 20 0 0 6 0 4 0 20 22 4 5 0 0 0 0 8 15 14 11 0 17 12 0 0 0 0 0 39 0 11 16 0 18 0 
23 1 22 66 48 18 29 31 10 0 24 19 1 2 33 20 11 19 49 9 13 17 22 25 17 2 12 8 14 31 8 17 12 19 0 7 43 11 9 27 7 0 63 25 1 31 
0 36 27 34 27 0 7 21 3 27 39 6 6 43 14 19 0 26 4 5 0 9 0 10 10 29 12 12 0 23 11 52 0 14 0 18 27 37 15 1 25 16 0 30 0 0 
6 42 0 0 10 11 21 11 1 12 0 5 18 0 7 2 0 0 13 0 14 12 22 0 14 11 21 25 5 16 8 44 0 7 15 14 15 0 6 0 14 0 0 42 22 0 
