46 26
0 3 27 0 52 0 0 3 0 18 6 0 19 5 0 0 0 0 16 12 30 10 22 0 2 0 19 18 8 0 13 8 8 0 0 31 0 0 48 13 0 0 4 25 12 0 
17 11 0 9 26 24 5 5 4 22 12 2 18 0 0 17 11 0 0 0 0 31 18 0 0 0 0 2 0 0 0 5 5 0 27 1 9 0 23 0 4 0 48 0 34 1 
0 18 21 39 0 20 0 0 6 0 0 7 0 0 11 0 0 8 27 0 19 3 2 0 2 39 0 0 11 0 0 8 0 0 0 0 20 0 0 37 4 0 17 20 0 16 
7 3 15 0 0 0 31 0 0 0 0 0 26 0 0 0 0 0 21 0 8 0 0 0 17 0 0 2 0 0 10 0 0 0 17 0 1 24 3 15 0 17 10 0 17 10 
18 27 40 1 1 17 0 28 34 0 1 0 22 0 0 27 16 0 0 23 5 13 5 0 0 0 0 0 0 1 28 0 0 9 9 33 0 1 11 0 5 40 36 1 1 16 
0 0 55 0 0 40 16 0 0 0 21 0 0 35 37 37 0 0 0 0 8 0 20 0 0 0 19 0 0 20 0 12 0 11 19 0 18 28 0 0 0 0 22 47 6 46 
52 35 12 6 27 0 23 13 0 6 27 0 0 0 25 17 0 0 0 22 19 0 0 6 14 3 0 26 19 25 0 12 0 23 0 12 0 37 14 0 66 5 42 28 22 0 
51 0 31 15 24 13 36 0 0 0 0 12 7 5 1 0 2 0 3 0 11 16 0 0 0 25 38 0 28 21 17 0 6 31 0 0 4 12 0 0 4 38 0 27 3 2 
0 20 0 29 13 29 5 34 0 0 11 27 21 0 0 3 0 2 0 0 11 11 27 2 0 0 0 5 0 0 0 22 18 6 29 0 0 25 20 45 2 30 2 9 10 0 
9 4 0 0 23 35 0 0 23 1 1 4 0 17 0 0 0 0 6 17 5 15 0 0 6 6 0 0 0 2 17 6 0 0 0 0 15 0 0 0 35 0 23 1 0 2 
13 0 41 9 8 63 9 10 34 5 34 26 4 17 0 6 6 0 3 12 0 12 17 15 13 0 1 0 0 20 8 19 11 4 0 0 13 30 28 0 35 8 27 19 8 0 
31 0 0 0 0 104 24 0 0 0 5 0 15 0 30 22 0 0 0 0 14 0 0 20 10 20 1 0 16 0 0 31 0 0 14 2 0 30 7 12 0 8 3 11 45 47 
84 0 0 14 0 6 35 16 32 0 0 24 42 20 11 0 0 16 0 5 0 14 0 0 0 13 0 0 0 0 0 0 0 18 0 11 0 0 0 0 8 60 0 2 44 0 
0 4 3 50 6 36 9 0 0 6 12 8 0 13 1 11 19 0 0 41 0 8 9 0 0 18 0 10 20 0 41 28 0 9 0 13 0 18 28 13 38 37 14 18 0 4 
0 2 19 0 37 23 38 35 1 0 0 6 7 0 0 31 15 5 25 0 0 0 0 6 0 0 0 0 2 8 2 0 0 4 7 0 0 0 9 0 25 44 6 53 42 0 
0 0 34 12 7 0 0 0 0 14 0 24 7 0 24 14 0 1 0 0 0 0 0 14 0 0 0 4 0 4 0 4 0 5 0 55 34 0 45 0 0 12 0 0 40 0 
28 43 12 0 36 0 13 0 0 8 17 0 32 6 27 12 0 0 1 2 11 0 0 0 12 0 0 12 30 1 0 3 0 29 15 2 4 0 0 10 38 27 0 6 75 0 
6 2 26 0 39 9 51 13 0 0 0 6 36 0 24 2 17 12 0 0 9 0 2 7 8 0 0 5 26 22 7 35 37 3 2 18 22 7 1 2 0 15 3 8 0 3 
31 5 3 23 18 36 9 0 9 27 15 2 0 0 11 12 19 10 17 7 10 5 21 27 11 0 18 0 0 0 2 9 13 0 0 15 75 30 32 27 2 10 0 29 16 23 
0 0 5 2 0 0 0 50 0 10 0 9 4 0 0 3 0 14 17 30 0 23 5 8 0 0 0 0 0 27 11 24 0 24 0 0 0 8 1 8 0 12 3 34 37 6 
0 3 0 0 0 51 0 0 36 0 32 6 22 0 40 3 1 0 3 26 0 6 12 0 17 24 12 0 0 0 0 11 0 13 43 0 0 0 1 5 39 14 49 26 55 12 
0 0 0 63 24 40 16 0 0 42 7 12 0 0 0 0 11 22 0 2 2 9 0 0 4 0 14 0 15 0 0 28 0 35 0 0 0 9 1 38 0 0 5 21 0 0 
44 22 17 26 0 0 37 0 0 1 31 3 20 22 17 0 0 0 0 17 6 3 22 5 0 0 7 0 9 16 15 14 21 7 0 0 0 9 1 5 17 0 3 23 39 35 
29 22 1 20 0 7 11 0 0 3 30 0 27 10 18 0 0 4 0 0 0 7 0 1 13 0 0 0 0 0 0 21 9 1 23 24 3 0 14 14 0 0 0 0 0 22 
6 14 20 0 18 14 19 0 0 5 0 0 27 0 0 14 22 0 21 7 0 0 20 0 0 19 3 0 0 0 0 13 0 0 9 0 8 2 45 0 0 0 22 5 13 23 
0 13 0 7 4 4 0 0 9 35 12 20 0 0 2 12 0 11 0 8 0 0 8 0 10 0 16 7 0 37 8 0 5 0 18 0 0 28 5 17 0 0 37 7 0 8 
