46 26
32 13 94 0 4 10 0 0 18 0 0 0 0 5 13 1 15 12 0 0 0 3 0 24 9 0 0 0 0 5 0 17 2 2 1 0 0 0 2 0 2 0 0 27 0 0 
1 0 11 0 22 0 0 11 0 17 5 25 0 11 0 5 2 0 2 26 2 24 0 0 3 0 25 0 13 11 12 0 0 0 0 21 25 0 0 0 1 0 25 0 0 5 
6 0 7 7 0 0 68 13 0 0 5 0 8 0 0 12 18 3 13 0 0 0 0 5 18 0 0 12 0 0 0 15 0 2 3 7 0 3 34 0 4 0 77 0 10 0 
42 39 19 0 2 21 0 0 19 0 20 0 0 0 5 1 59 1 19 11 6 14 23 13 0 13 16 9 5 12 0 0 59 20 66 3 13 24 11 71 0 0 26 4 25 22 
16 4 27 21 14 19 0 0 16 0 25 0 2 11 26 31 9 18 5 1 16 5 19 0 18 16 20 0 8 27 16 10 12 8 4 26 13 0 2 19 0 51 6 28 0 0 
2 0 10 24 2 27 0 0 0 1 0 14 10 5 0 7 0 0 38 10 0 0 12 0 0 38 19 0 0 0 0 13 4 0 0 1 0 0 0 0 0 0 0 0 26 19 
0 48 27 13 34 0 21 0 5 5 0 0 8 7 20 0 14 0 0 15 8 8 0 0 0 3 8 41 39 49 0 4 0 0 21 6 0 36 0 0 0 0 0 3 0 6 
0 26 3 24 0 2 0 4 20 7 0 0 7 0 0 0 19 16 2 3 0 0 16 18 0 17 0 26 25 9 0 32 0 16 3 19 0 2 0 0 11 0 0 0 0 0 
0 39 0 36 0 21 0 7 4 0 0 0 0 14 16 0 23 20 0 23 18 15 0 19 0 8 0 16 0 20 16 0 0 0 6 0 0 0 0 62 39 0 26 0 0 0 
0 58 5 7 0 15 3 0 0 6 22 0 16 0 0 5 1 7 3 0 25 0 21 18 0 4 24 0 0 7 20 13 1 0 9 20 3 2 0 38 11 21 2 24 14 0 
6 0 24 3 0 11 18 0 5 0 33 32 1 0 0 0 12 4 27 0 0 0 10 0 11 5 0 0 7 0 0 0 0 10 3 11 6 20 13 8 0 24 40 63 0 9 
0 8 0 5 0 3 0 0 5 0 0 32 0 0 0 0 1 21 0 12 24 0 1 0 0 0 17 0 11 0 0 17 4 13 0 24 6 8 21 0 2 0 7 20 0 0 
0 0 78 7 23 7 5 24 7 1 41 6 24 1 2 6 38 10 0 6 7 39 1 21 16 5 1 13 41 11 0 0 43 0 27 31 13 12 0 11 38 17 10 103 22 45 
0 39 8 0 0 3 0 0 8 12 0 61 21 0 0 14 7 0 5 6 5 2 5 7 0 45 0 11 3 14 0 0 0 22 10 0 17 8 0 0 39 10 16 0 0 12 
0 0 0 7 14 0 7 0 47 4 0 3 0 0 0 28 2 0 2 0 2 2 6 19 7 21 0 17 9 0 0 10 0 11 13 9 0 7 0 0 0 33 13 30 26 2 
0 3 0 1 16 0 0 0 8 35 29 29 0 0 0 0 26 13 20 0 6 28 6 0 11 26 15 11 13 3 10 10 1 8 7 0 15 0 4 43 25 15 0 0 6 0 
0 0 0 0 0 31 7 0 11 1 34 20 0 0 0 18 7 13 3 0 14 0 0 22 14 14 0 8 13 11 0 0 6 0 9 0 26 0 15 29 15 0 0 15 0 0 
17 4 2 0 0 0 33 38 23 2 29 10 16 4 14 2 6 7 16 4 0 16 0 4 0 0 2 23 10 3 13 44 0 9 0 0 11 0 0 76 0 2 9 38 8 45 
34 0 0 0 0 8 23 22 20 29 0 0 15 0 28 0 7 0 0 17 4 0 0 13 0 0 0 14 25 11 9 9 0 0 52 0 27 0 0 27 11 0 22 0 39 0 
40 0 0 57 0 0 35 0 23 25 21 0 14 0 0 0 6 0 0 0 0 0 4 7 0 7 14 2 0 0 10 40 7 0 8 4 0 0 0 0 30 35 39 1 1 0 
0 41 1 1 18 0 0 0 0 17 18 8 8 0 10 5 14 23 0 0 5 29 10 0 0 0 17 0 0 0 0 0 0 12 2 0 0 0 0 0 23 0 41 0 0 0 
9 40 44 19 29 4 3 11 8 41 0 0 19 0 0 12 16 0 33 0 6 10 0 16 1 42 0 0 0 0 0 10 0 61 0 0 0 8 0 53 0 0 0 34 0 0 
9 16 11 40 0 22 2 5 2 16 0 9 0 0 25 23 11 4 4 0 11 4 4 28 0 3 0 8 11 10 2 4 30 0 0 11 0 5 23 38 15 2 44 10 4 22 
38 0 0 5 0 0 11 0 49 0 0 0 6 0 6 41 54 0 20 0 5 0 0 0 2 0 4 4 12 0 25 0 0 8 21 0 2 29 44 11 0 0 22 13 0 0 
38 0 0 5 2 39 17 0 0 0 32 32 21 49 0 0 0 5 0 26 23 0 0 19 15 21 0 0 16 0 13 7 19 0 0 10 0 0 12 15 0 11 18 55 39 7 
0 0 25 0 0 0 0 0 2 0 23 2 0 2 0 0 6 0 0 21 0 24 0 16 0 0 0 6 0 0 0 0 13 0 7 16 0 0 0 0 0 0 23 16 0 0 
