46 26
34 19 8 25 0 31 13 0 0 0 22 33 2 13 11 21 32 7 0 0 19 22 1 17 3 21 26 17 0 26 30 13 0 0 0 0 46 9 15 38 0 4 34 40 44 0 
0 2 11 23 17 0 38 54 0 0 0 0 0 16 0 0 0 17 0 8 0 18 1 0 13 4 0 7 0 16 0 0 0 41 11 2 29 19 0 0 0 0 9 0 38 0 
39 0 0 6 0 27 0 0 0 0 14 0 0 0 0 0 1 13 13 0 25 1 4 0 0 0 2 5 0 12 0 31 7 0 5 0 7 0 0 1 0 9 0 0 0 65 
0 15 0 0 0 13 12 22 3 0 0 5 4 0 0 3 39 23 22 15 0 16 31 7 5 7 22 11 0 34 9 6 0 11 6 13 7 39 0 0 35 0 34 0 0 40 
0 0 0 0 1 48 19 15 0 0 0 0 17 0 0 24 4 0 0 0 16 3 10 19 0 19 0 13 17 23 0 0 11 0 0 30 11 0 2 24 0 0 0 0 0 58 
0 4 22 0 1 7 10 21 0 10 52 19 0 36 9 36 3 16 0 13 3 2 0 15 22 2 18 10 0 0 17 0 0 0 15 6 0 27 0 2 7 6 6 28 9 2 
45 0 0 0 5 6 0 0 0 0 9 0 32 0 0 0 1 18 4 0 0 0 19 0 0 0 0 0 0 14 0 0 4 0 0 0 4 5 2 0 0 0 0 14 6 12 
0 18 12 0 7 0 0 10 17 0 0 0 7 11 6 0 12 0 5 3 0 22 0 16 0 11 0 5 27 19 11 7 0 7 0 0 0 0 8 2 11 1 9 15 0 2 
0 44 50 24 0 11 9 21 0 2 7 6 89 0 1 7 5 0 0 0 0 2 0 20 23 0 0 20 6 5 6 43 5 0 4 0 0 0 0 36 28 30 48 0 0 33 
42 52 0 0 0 5 10 31 0 0 0 0 3 0 7 0 0 15 11 10 13 23 31 13 0 0 16 17 17 19 9 25 23 19 8 5 1 2 9 0 0 40 10 6 16 25 
5 11 30 8 0 0 0 34 29 32 0 23 11 13 0 0 0 24 0 7 0 0 12 1 11 0 0 0 4 3 0 7 30 8 23 5 5 29 2 0 0 16 0 0 0 0 
0 0 5 0 38 1 7 11 0 13 0 0 0 7 0 3 26 0 0 0 13 0 0 3 17 0 0 0 0 0 0 15 0 13 9 1 0 0 1 0 4 26 21 0 0 0 
0 0 47 10 0 32 12 0 18 7 17 0 13 10 0 0 0 0 23 9 34 0 0 0 2 0 18 12 0 0 0 0 2 2 15 8 19 35 7 1 31 0 11 41 28 53 
3 0 0 20 24 0 55 13 19 0 29 0 0 0 6 0 4 0 0 0 0 14 14 4 0 0 23 0 24 13 6 11 2 40 21 0 4 8 0 17 0 7 24 0 0 2 
16 0 19 19 20 34 0 20 0 27 14 28 23 5 20 1 16 6 2 0 0 16 22 0 12 7 0 8 9 15 0 7 27 3 19 24 21 32 9 60 0 9 0 0 16 18 
44 6 0 7 0 0 0 0 0 0 30 0 7 1 0 26 0 0 1 10 0 0 16 4 0 24 0 4 34 19 12 0 1 14 9 5 4 7 32 0 0 23 19 0 43 2 
14 0 0 25 0 20 0 0 0 1 15 12 0 5 4 13 3 7 45 4 15 10 5 8 7 18 2 4 38 14 26 22 24 0 0 21 3 10 0 3 10 5 0 77 16 0 
21 0 0 0 40 17 0 6 14 0 8 0 0 6 19 25 16 7 0 10 0 25 28 16 0 0 14 8 0 15 0 15 0 11 24 33 20 0 0 0 14 27 0 0 5 8 
0 0 0 10 32 0 30 0 5 2 17 25 0 14 0 5 26 41 6 15 16 0 5 0 0 18 0 2 0 18 11 4 2 0 11 1 12 0 0 1 1 0 26 9 0 16 
0 0 12 0 21 11 0 10 0 0 2 0 23 0 25 0 32 0 0 0 0 0 2 11 20 18 12 11 0 2 16 0 5 0 11 0 2 0 0 23 0 0 0 0 20 33 
5 2 0 2 31 0 0 37 37 5 0 0 33 0 0 0 7 4 0 10 24 2 2 0 0 0 11 5 0 13 8 0 7 0 7 45 10 0 8 3 0 4 35 0 2 4 
0 18 0 0 0 2 21 7 0 0 0 22 8 7 0 14 0 1 0 0 8 0 0 6 3 1 1 7 0 0 0 0 0 11 35 0 0 14 0 34 0 9 0 0 0 0 
62 0 0 40 35 27 11 21 0 0 0 4 7 0 0 4 0 19 4 12 2 0 10 13 0 19 16 0 3 0 0 5 0 28 2 0 0 7 38 35 0 0 5 38 26 10 
0 0 0 34 0 23 0 25 20 0 26 15 0 6 0 12 0 0 7 6 0 0 14 0 16 0 22 0 17 14 0 15 25 9 6 0 26 23 0 0 0 9 10 0 0 0 
9 76 51 40 0 37 27 7 0 47 0 19 0 46 9 24 0 13 16 0 17 21 0 3 0 12 24 0 5 0 0 16 15 20 21 34 10 56 10 10 7 1 20 74 31 4 
5 18 0 39 0 0 25 5 0 0 0 0 8 0 0 19 0 16 0 0 0 0 0 9 0 0 0 0 0 0 0 5 0 0 0 4 0 0 0 0 0 0 39 0 16 0 
