46 26
0 0 0 4 0 32 20 28 3 0 34 2 0 0 0 0 0 23 0 3 17 24 0 7 2 22 2 14 9 0 12 23 0 9 8 29 0 39 3 0 0 14 1 1 34 0 
22 0 0 56 1 1 9 17 1 27 0 0 0 9 9 0 0 0 6 26 11 2 13 19 24 2 0 0 17 15 0 26 0 0 1 8 0 34 0 20 4 26 23 0 6 59 
17 0 0 21 3 45 27 14 0 0 35 12 2 0 14 0 0 0 0 0 0 0 0 18 51 1 0 13 13 33 25 26 10 45 21 30 0 0 0 25 8 0 10 0 9 35 
45 11 17 7 0 40 0 23 0 53 0 0 5 10 9 16 0 0 1 14 2 2 2 15 5 0 20 7 10 16 23 15 1 0 18 1 1 14 3 9 5 0 58 8 0 85 
34 3 33 4 17 0 0 0 0 0 61 7 0 0 0 36 1 1 0 19 0 5 0 0 2 0 11 0 15 0 0 5 0 0 0 33 0 3 28 0 0 0 0 23 2 0 
27 1 0 14 3 0 0 0 5 0 0 15 0 20 0 0 0 0 0 10 0 0 7 19 16 0 0 27 0 9 4 20 0 34 19 5 0 4 3 0 4 4 0 1 0 0 
38 15 0 37 0 3 14 0 9 29 0 0 13 20 11 0 0 29 0 6 4 0 0 14 0 6 0 18 12 4 0 30 8 0 0 2 0 27 9 0 12 0 0 1 30 42 
9 9 0 0 14 16 16 0 30 5 0 6 9 0 0 0 0 4 13 2 0 6 16 2 0 7 0 0 0 23 0 12 1 7 5 2 7 6 46 18 0 10 0 22 13 18 
41 25 52 21 0 0 0 0 6 47 0 0 0 10 28 17 28 7 8 0 0 24 0 27 49 0 12 4 0 11 5 4 0 0 0 12 0 0 46 26 41 0 52 13 28 50 
18 0 0 0 7 5 32 0 0 0 0 0 27 0 21 0 0 0 5 32 1 0 0 5 10 0 9 0 5 0 10 4 2 14 21 13 5 16 33 27 11 0 0 5 1 0 
94 6 0 24 33 6 16 9 10 4 20 6 8 45 6 0 23 10 9 4 15 4 16 13 0 1 0 1 0 23 47 20 4 22 0 13 60 27 23 16 9 0 20 0 40 0 
39 11 32 0 14 14 3 27 13 5 16 9 22 4 0 3 1 1 9 16 2 13 0 0 20 5 16 0 10 1 1 0 5 0 27 0 0 14 0 28 22 9 0 11 20 0 
10 0 0 3 0 0 0 13 9 8 0 0 4 0 0 0 17 8 0 9 0 18 0 0 0 5 0 0 0 0 3 0 0 24 38 0 0 0 4 27 23 1 9 0 0 0 
0 26 0 0 20 20 0 0 0 10 0 6 10 0 11 13 25 0 12 2 0 9 0 0 20 13 0 13 30 0 27 1 0 0 0 0 3 10 0 3 0 25 0 0 11 0 
0 0 25 14 5 2 0 23 22 0 0 27 0 0 0 0 4 9 15 0 6 17 7 0 16 18 7 8 0 7 0 0 19 15 0 1 44 0 22 0 4 0 0 0 0 13 
7 35 14 0 0 13 33 0 8 8 20 2 22 38 22 0 30 11 36 26 0 0 2 0 9 0 27 11 45 2 28 0 6 15 32 5 22 0 6 4 0 31 9 0 74 0 
0 9 0 8 24 0 0 0 11 14 5 2 27 10 6 3 0 0 0 0 24 18 0 21 0 10 14 0 0 25 11 0 0 5 0 0 2 6 11 0 0 11 0 0 9 0 
9 0 0 19 1 0 0 0 5 0 0 13 0 0 0 9 2 0 0 0 16 0 6 0 0 2 0 6 0 14 0 0 0 0 0 0 16 0 0 17 0 0 0 0 0 0 
38 0 0 31 1 0 0 0 0 0 0 0 14 0 0 0 4 0 17 0 3 0 0 17 3 5 14 0 0 0 13 3 0 9 31 13 2 1 46 0 0 0 5 0 0 11 
21 19 23 2 35 36 21 9 0 5 0 12 27 0 0 9 0 14 1 0 31 6 0 9 9 38 0 21 0 0 4 0 9 0 13 0 15 13 33 27 0 27 0 0 13 0 
0 18 44 43 0 0 34 0 32 24 22 16 0 14 0 0 0 7 0 32 2 0 18 0 0 30 0 0 0 0 22 0 22 20 32 0 22 0 0 0 18 0 17 0 32 4 
16 0 91 53 3 0 0 10 29 14 0 28 3 0 0 0 0 1 0 0 6 0 0 21 1 1 6 37 10 10 0 38 0 4 41 6 33 39 2 0 33 6 0 41 0 0 
35 6 0 0 48 31 22 0 15 0 0 0 4 0 4 23 0 6 0 17 0 2 0 23 0 22 0 5 0 15 0 30 0 0 10 51 14 3 57 0 0 3 0 0 0 0 
0 31 9 0 0 20 0 0 7 0 0 3 0 0 9 0 0 6 8 34 0 0 0 0 0 0 12 0 10 10 0 0 58 23 17 13 13 0 7 25 1 22 0 4 0 0 
31 7 7 5 48 4 18 4 35 27 4 38 9 7 21 0 0 0 13 25 9 24 1 19 21 12 22 18 2 0 1 19 0 13 19 16 0 0 0 0 0 18 23 15 0 33 
39 41 12 0 1 14 0 13 0 9 0 0 2 0 2 21 7 8 13 0 5 0 15 7 0 1 0 8 0 0 0 2 32 25 0 11 0 1 7 18 0 0 58 0 21 0 
