46 26
0 15 15 21 6 12 36 22 20 0 32 0 0 10 0 10 35 3 10 0 0 0 19 19 6 0 5 0 13 0 2 5 0 0 26 0 0 0 3 0 35 38 0 0 34 0 
0 9 0 0 5 0 0 73 0 0 21 0 16 48 0 8 10 21 4 0 23 0 4 4 0 11 23 0 0 0 0 35 0 0 0 0 14 3 21 2 0 0 24 20 0 0 
0 0 0 18 97 25 14 9 37 10 20 12 0 16 0 32 14 41 23 0 4 2 14 8 0 2 3 31 0 12 28 11 0 0 19 14 0 40 0 51 7 60 1 0 12 45 
44 0 12 0 42 0 5 0 66 20 3 17 4 1 12 9 0 3 32 0 14 13 0 11 0 14 2 0 0 0 21 1 0 0 19 9 0 0 22 6 2 33 22 0 1 6 
0 0 21 0 0 0 0 0 5 0 0 9 11 5 0 15 15 6 9 0 0 0 0 0 0 0 9 4 5 3 13 21 26 3 1 0 0 5 0 0 36 0 0 0 11 0 
17 0 0 14 0 0 0 0 0 1 15 0 0 34 5 22 13 44 0 4 0 11 0 11 0 10 3 0 0 12 0 0 0 28 16 8 1 17 24 0 2 12 0 0 0 0 
0 35 17 2 51 39 9 0 0 4 15 0 5 0 19 9 28 1 0 3 16 0 14 19 35 0 2 0 12 16 13 0 0 48 0 0 26 21 0 35 0 15 12 8 61 23 
33 33 0 0 12 52 0 0 20 25 28 0 0 0 6 0 25 0 0 1 9 2 1 0 23 5 0 3 3 0 14 0 7 32 29 6 16 5 28 30 4 71 0 0 30 0 
0 0 0 3 7 0 0 17 66 0 41 0 7 0 16 0 23 21 0 7 0 9 1 6 3 5 16 0 0 8 18 0 0 25 0 0 1 34 10 40 0 0 0 0 4 0 
2 3 2 1 23 30 1 0 0 19 0 5 3 0 0 8 28 1 1 0 0 0 0 0 0 20 0 0 2 0 5 16 23 0 0 31 0 20 0 0 0 0 37 0 28 0 
19 8 0 8 35 35 2 2 16 13 0 26 0 10 19 10 14 22 17 12 0 12 32 18 7 0 15 0 5 4 0 20 1 8 0 0 32 17 0 0 3 15 4 0 39 16 
0 42 30 0 57 27 15 1 0 0 0 0 4 9 0 0 6 12 11 15 13 16 2 0 0 23 0 0 13 0 0 0 27 7 0 0 15 17 0 0 0 13 0 45 10 2 
0 27 5 2 0 0 3 12 0 5 0 5 14 0 5 9 21 17 0 10 0 3 6 2 3 19 14 1 0 28 29 13 7 0 10 37 20 4 8 0 0 28 45 26 24 0 
23 25 0 0 25 1 56 3 0 0 13 2 8 0 10 9 2 8 15 7 0 0 16 23 9 0 8 16 14 0 31 13 0 8 10 8 0 7 16 0 0 31 0 5 67 7 
15 34 2 0 2 0 0 37 0 1 0 7 6 0 0 33 0 0 0 0 0 16 0 9 1 0 14 0 27 0 9 0 31 13 0 0 8 16 14 0 12 9 13 11 26 0 
0 9 17 8 21 0 0 23 0 1 0 29 4 67 0 8 13 13 0 40 9 25 22 17 1 6 13 5 0 11 4 0 0 0 43 10 6 15 0 56 12 29 1 1 30 0 
0 0 0 0 14 0 0 0 0 0 28 0 13 0 33 0 14 0 0 10 0 11 0 0 0 0 0 0 0 9 1 0 0 0 0 0 20 0 28 0 0 30 0 0 3 0 
0 0 0 70 19 0 18 0 0 9 0 5 78 25 32 4 0 14 4 2 0 2 16 13 6 36 16 0 0 25 0 0 20 0 0 0 0 0 54 0 28 24 27 0 0 0 
0 38 12 28 0 0 0 0 10 17 0 4 1 3 0 1 0 0 0 0 17 3 0 11 0 0 3 7 5 15 0 11 0 0 8 8 2 0 0 81 9 0 0 0 15 6 
20 0 0 0 0 0 0 0 0 0 10 9 0 0 24 3 0 0 0 4 9 0 23 19 8 15 0 14 0 0 0 0 20 0 0 0 11 0 13 1 15 21 0 0 45 0 
0 39 0 0 0 3 0 61 0 0 11 0 0 12 0 0 20 0 26 5 0 0 0 0 14 0 0 18 0 10 0 2 0 32 0 28 2 36 19 0 0 3 2 5 20 0 
0 0 0 0 0 7 0 0 27 3 6 33 7 0 0 39 6 42 0 2 0 0 4 0 2 0 9 5 0 11 0 18 5 0 8 18 2 22 4 0 30 32 0 10 36 37 
44 22 5 38 40 0 0 27 0 0 63 0 0 3 0 51 73 12 13 7 0 27 16 0 0 0 29 3 0 32 9 0 16 0 0 25 20 0 4 5 25 109 3 0 30 0 
0 0 0 0 0 40 0 0 1 20 0 0 0 21 13 2 0 13 21 2 16 0 4 0 0 0 0 0 9 20 23 0 8 0 0 0 0 9 0 21 15 0 3 0 34 0 
22 18 0 0 0 0 20 0 8 19 22 0 0 0 6 22 47 3 0 21 4 4 14 0 2 15 0 19 68 12 0 0 0 0 0 0 0 0 2 27 0 0 18 27 0 6 
0 0 0 31 22 27 0 6 36 0 0 0 0 26 0 0 0 10 22 12 18 15 0 16 7 0 24 0 16 4 1 15 27 0 31 10 4 24 0 43 21 0 0 0 15 0 
