46 26
28 30 0 26 18 15 24 7 26 61 5 0 0 19 3 1 4 0 0 0 15 67 0 22 0 0 0 21 0 28 22 10 62 0 2 17 0 0 29 18 14 32 14 0 23 22 
19 0 42 97 13 11 55 0 11 23 0 13 0 2 11 19 60 5 21 24 20 1 5 20 20 27 11 27 1 8 0 3 6 0 22 32 100 0 15 52 0 26 27 2 13 0 
0 23 19 0 0 0 6 0 15 18 0 25 17 3 37 0 17 0 0 0 19 19 0 10 16 0 0 17 0 13 18 0 46 24 20 18 0 0 15 24 21 23 47 19 12 5 
5 26 0 3 5 0 11 10 9 0 0 19 0 8 22 0 2 27 0 0 41 3 0 0 24 22 0 0 28 13 17 14 0 3 0 0 0 0 21 0 0 10 0 0 0 0 
13 37 39 0 4 21 4 34 25 0 18 2 64 5 15 12 10 0 12 4 0 0 0 9 0 7 0 13 8 5 1 31 0 66 47 20 1 25 75 0 0 33 9 8 0 33 
35 2 0 6 0 0 0 0 0 0 5 1 21 21 0 0 13 0 12 0 0 18 1 23 0 4 6 24 2 0 2 0 2 11 30 1 1 24 0 11 0 13 9 0 13 11 
5 34 3 0 0 34 11 5 0 0 19 0 6 19 0 17 0 16 11 39 1 9 17 13 8 24 8 0 2 21 14 0 24 0 8 0 11 1 1 34 0 0 6 0 24 26 
0 0 0 0 0 1 7 0 0 0 3 0 2 0 14 5 0 6 0 4 0 0 0 4 6 0 0 13 14 8 6 0 0 0 0 1 12 10 0 0 0 0 12 8 0 0 
0 8 0 0 8 17 2 10 9 13 0 0 12 7 0 26 0 10 0 0 8 0 16 15 12 0 0 40 8 18 0 0 11 0 21 1 5 0 2 3 0 30 2 9 0 0 
16 0 3 0 15 27 0 23 13 5 11 0 0 0 5 0 21 24 0 0 7 0 0 0 0 10 16 0 0 0 23 0 27 1 0 25 0 6 7 0 0 23 0 0 0 0 
0 0 2 0 39 0 21 11 0 0 0 16 5 0 23 6 5 10 9 21 13 19 8 6 5 18 27 22 0 7 3 0 12 4 0 18 0 23 12 0 2 37 0 26 0 0 
0 0 39 0 8 1 1 1 0 0 0 9 0 0 0 12 1 46 8 0 0 0 7 10 0 8 13 0 3 3 9 3 10 0 0 0 0 7 0 9 14 32 25 0 0 0 
0 0 0 0 3 0 0 13 0 32 0 0 26 0 0 2 0 0 0 3 15 6 4 10 1 8 5 0 0 9 0 8 6 3 17 0 3 0 26 8 8 32 0 0 0 0 
32 5 0 0 0 11 0 33 0 12 0 0 0 6 0 21 11 0 11 1 0 0 0 0 0 23 0 7 0 0 30 4 0 0 0 0 32 0 0 11 0 32 1 0 6 0 
50 0 0 13 0 16 23 0 5 9 0 25 12 0 0 5 11 0 0 3 5 10 22 23 36 0 4 1 0 3 3 3 14 6 27 0 0 7 0 0 50 17 0 0 2 0 
43 0 5 28 0 0 16 0 0 24 11 0 20 0 29 11 10 0 0 3 18 36 36 4 0 0 0 12 0 8 0 0 17 53 0 38 0 23 29 13 0 41 0 37 22 45 
1 0 3 42 0 3 0 22 0 36 4 8 0 0 0 6 0 0 0 9 9 13 0 0 0 0 19 0 3 7 0 3 0 0 2 0 0 0 4 0 0 0 4 0 0 87 
26 6 0 9 0 16 1 39 3 45 0 27 23 0 0 0 0 0 5 3 13 9 2 0 26 0 9 51 1 0 12 15 18 0 3 17 22 0 27 7 0 14 9 55 26 4 
19 2 0 37 2 0 10 7 12 0 10 29 18 0 0 0 0 0 0 0 61 26 0 4 13 7 0 1 0 1 0 6 37 0 3 0 0 0 0 16 37 0 0 22 11 25 
0 16 12 0 0 0 11 11 0 21 0 27 32 20 19 0 0 11 6 0 0 14 0 16 19 0 24 0 15 4 19 30 9 12 25 2 12 26 0 0 0 0 0 19 21 0 
29 0 16 0 25 0 0 0 20 0 11 0 0 16 0 0 27 9 25 2 25 0 0 21 0 0 0 0 19 2 14 0 13 8 7 18 8 21 0 0 15 16 12 25 0 7 
0 5 0 22 101 4 0 0 0 12 26 9 8 20 15 0 0 24 25 0 25 18 9 10 21 8 0 7 0 0 3 9 17 5 0 0 5 0 1 25 0 13 0 38 0 4 
0 14 30 9 11 0 27 8 13 0 18 0 55 31 0 11 0 1 0 0 19 8 0 0 4 0 0 0 4 2 28 27 39 24 0 0 5 24 1 0 3 9 52 3 30 33 
60 23 1 44 0 0 5 0 0 0 11 0 29 0 0 29 22 28 0 0 0 11 26 0 0 0 25 24 0 7 0 28 0 0 17 0 24 0 0 15 0 0 0 105 10 0 
0 1 0 7 3 0 0 12 0 0 20 0 0 0 0 0 0 0 0 0 0 0 0 0 10 6 0 0 23 5 27 6 0 8 33 20 0 0 21 0 0 8 0 0 0 0 
10 0 0 4 0 4 34 28 22 12 0 7 0 9 4 0 4 22 14 9 26 0 9 0 10 19 17 2 6 16 0 0 23 22 10 29 3 0 0 22 59 23 0 0 0 2 
