46 26
39 11 0 34 52 31 0 0 22 48 0 7 11 15 0 20 22 5 18 0 6 0 8 0 20 0 15 25 1 0 35 20 19 4 0 6 2 16 67 39 3 2 103 0 0 36 
13 2 23 29 0 13 5 16 7 8 7 0 0 28 23 0 18 22 22 0 74 0 0 17 0 0 9 0 0 0 52 14 0 0 0 0 22 0 33 19 0 0 1 0 18 30 
46 0 0 10 0 0 3 0 0 23 0 1 12 1 16 17 0 0 7 0 0 14 12 0 0 0 16 0 10 39 0 0 23 12 0 4 15 0 0 0 0 0 0 32 33 0 
0 0 17 9 0 0 22 0 0 11 0 0 31 10 27 4 1 14 8 9 22 1 0 0 17 0 0 0 5 0 0 11 0 5 0 0 0 0 0 0 26 0 0 0 26 0 
3 13 0 0 0 16 7 0 15 32 0 0 0 0 27 0 0 1 9 0 0 17 16 0 10 0 0 0 0 0 0 0 0 0 20 7 0 20 0 0 0 32 7 1 0 0 
5 0 29 22 2 27 49 36 17 0 0 0 18 12 19 0 60 6 4 0 0 12 14 13 11 39 0 20 0 12 17 37 0 7 26 33 0 5 11 20 14 0 42 75 28 0 
0 3 0 0 2 22 3 0 2 0 0 30 22 0 31 3 0 24 6 4 9 0 36 0 0 4 5 0 12 0 0 0 33 9 14 0 0 40 0 0 13 19 1 0 39 26 
0 2 0 2 0 12 4 6 0 0 0 0 28 2 0 10 0 4 15 3 0 0 36 0 0 0 0 0 0 0 14 0 0 0 17 5 12 0 0 0 9 19 0 0 0 0 
32 0 0 0 6 0 0 0 5 6 7 0 0 0 0 20 9 13 5 0 0 0 16 0 0 6 0 0 3 0 13 4 0 0 24 0 0 0 0 2 0 39 0 61 0 11 
11 6 0 12 1 5 0 0 0 0 14 0 6 0 0 0 1 1 19 0 13 10 2 0 0 0 5 17 0 0 0 29 0 0 0 0 0 0 0 34 12 0 0 0 70 0 
49 0 13 18 4 0 0 20 4 7 0 0 0 11 6 42 24 5 1 25 1 27 0 8 12 0 0 7 0 12 13 1 0 2 0 0 20 7 0 20 0 10 0 0 29 37 
0 0 0 19 0 12 6 0 0 2 0 12 12 19 3 0 0 12 0 0 19 0 19 0 0 0 14 0 0 0 5 3 19 5 3 0 19 6 11 21 0 2 6 0 8 3 
10 0 0 42 0 16 19 38 2 9 3 25 7 8 0 5 7 0 6 9 9 13 0 30 0 0 8 0 25 10 0 45 0 13 8 31 26 0 0 0 50 13 0 0 7 0 
0 6 7 14 3 0 1 3 33 21 0 2 41 10 12 8 0 0 0 0 0 0 0 11 0 0 23 0 6 4 9 2 0 0 0 27 12 0 0 0 6 6 7 4 0 0 
0 0 24 23 0 0 1 0 1 21 0 11 0 0 1 0 4 0 0 0 13 12 27 0 6 0 15 0 9 4 0 41 0 12 0 0 0 0 0 0 0 0 23 0 2 17 
0 0 0 0 2 36 11 12 16 5 0 0 0 0 5 0 0 12 21 0 0 0 0 0 28 9 0 0 0 0 0 3 6 9 5 0 0 0 0 16 0 0 0 0 39 4 
28 0 0 7 20 37 4 0 0 0 0 0 3 0 6 0 0 2 0 6 13 12 0 25 6 0 0 0 8 0 5 6 18 5 8 0 14 23 3 0 0 0 45 0 0 0 
8 0 9 0 2 0 0 18 42 63 27 0 0 0 48 29 0 26 1 0 3 17 4 0 0 0 12 6 6 4 0 12 30 19 0 27 0 28 16 29 0 0 17 29 37 0 
0 9 0 13 13 0 37 7 13 30 29 0 4 0 35 0 18 2 0 0 0 10 0 17 3 3 22 0 3 0 8 5 0 2 1 0 1 20 0 40 0 12 50 46 0 6 
11 3 23 1 0 3 7 85 19 0 0 1 7 0 0 7 12 31 91 0 0 19 0 16 16 10 17 0 15 0 0 40 0 45 1 14 25 30 0 12 8 30 16 14 37 94 
0 0 4 0 0 35 15 0 22 4 0 0 0 11 16 20 7 3 11 4 7 15 16 27 3 0 5 7 0 15 22 7 0 0 11 0 30 0 0 6 5 0 12 2 63 37 
25 52 0 16 52 13 26 16 2 0 4 0 28 0 7 4 0 5 28 0 17 6 0 16 0 0 0 21 0 0 35 0 6 0 24 31 0 0 0 0 50 2 21 9 18 0 
0 11 0 20 3 24 16 11 14 0 6 22 13 15 4 3 1 1 17 14 15 1 4 20 25 0 0 8 17 0 10 32 17 0 34 0 17 13 4 0 0 0 8 0 0 17 
46 0 0 0 4 0 0 37 2 32 14 5 6 0 23 6 21 0 38 0 0 0 16 16 0 0 0 0 3 0 1 1 0 0 0 8 0 0 0 12 0 0 68 7 58 0 
0 0 27 0 18 0 32 2 0 1 0 0 0 4 1 0 0 2 0 2 8 0 18 16 19 0 0 24 8 0 1 8 0 0 36 4 0 4 0 0 0 10 0 42 0 0 
12 40 0 52 0 0 0 0 0 41 0 0 24 0 29 5 1 8 0 0 24 35 0 13 13 0 24 11 0 0 11 7 0 0 22 0 5 19 13 38 18 22 0 63 35 32 
