46 26
32 0 24 0 24 38 0 5 26 0 9 2 6 9 21 24 10 11 6 23 0 2 4 12 5 0 23 0 23 29 0 0 32 10 30 17 14 0 0 24 6 0 0 2 1 30 
16 22 21 0 14 0 0 10 0 16 0 11 0 0 0 17 17 3 0 47 7 0 11 0 0 14 0 10 10 6 18 0 0 6 0 4 0 0 21 0 25 0 0 0 1 0 
0 32 12 10 16 4 24 17 11 0 23 26 14 25 19 12 1 0 30 0 7 0 1 21 18 0 9 0 0 0 24 0 33 0 0 10 0 51 59 4 23 0 24 0 9 7 
17 0 0 6 0 29 23 3 0 0 0 13 0 16 0 7 0 5 0 4 4 0 11 0 0 29 0 8 0 4 0 11 0 0 38 2 0 0 0 10 33 2 12 6 1 0 
20 0 0 31 68 0 32 0 0 0 36 8 8 21 0 3 0 19 15 10 12 0 13 0 0 16 0 23 2 16 0 2 17 22 13 0 0 22 32 0 30 30 0 0 31 6 
0 15 0 0 0 21 7 0 24 0 17 0 0 9 19 0 26 8 18 0 10 7 0 0 0 8 21 0 0 24 0 11 11 8 0 11 0 29 19 0 1 0 16 0 0 13 
50 23 0 7 30 2 3 46 0 13 22 13 4 21 0 3 2 0 39 18 30 14 9 12 36 1 25 5 8 0 5 5 13 15 39 68 21 3 1 11 4 15 1 7 0 58 
10 30 0 3 0 30 8 0 0 4 23 2 14 10 13 15 23 0 0 0 19 0 3 3 21 0 0 0 18 0 15 0 0 0 0 18 0 2 24 23 0 0 0 0 0 31 
31 0 0 1 0 10 6 1 26 0 2 11 8 32 0 0 23 0 3 19 0 3 5 0 19 0 15 19 32 11 11 5 0 0 0 0 17 2 16 21 11 14 0 0 0 31 
23 0 0 11 25 0 3 0 5 6 13 4 6 28 7 49 0 5 0 0 0 3 0 10 0 15 0 0 0 2 0 9 24 18 0 7 4 0 0 0 15 28 0 28 0 24 
14 5 0 24 0 22 5 0 36 0 0 0 10 10 10 0 7 5 0 9 8 0 3 19 20 3 0 46 0 6 0 0 8 0 1 5 0 0 32 16 0 0 0 0 56 8 
0 0 12 3 42 0 5 30 0 11 39 0 13 0 0 0 0 0 2 8 11 3 0 4 0 12 22 8 7 8 26 5 0 23 6 7 7 39 0 0 0 8 0 7 0 7 
31 0 43 38 38 0 0 0 0 0 0 42 28 0 21 0 18 0 8 0 8 0 0 15 0 1 2 0 9 0 5 13 0 21 33 31 0 1 1 35 12 0 0 0 41 77 
4 0 7 12 3 0 39 0 41 2 35 2 24 0 0 3 12 8 1 0 24 0 5 29 21 2 0 7 0 0 0 0 0 0 0 12 4 8 30 10 17 6 30 7 28 17 
0 0 0 0 0 15 38 0 6 4 7 0 23 0 0 0 0 0 4 0 0 15 12 0 0 0 0 18 16 17 0 11 27 1 2 25 11 25 7 0 18 10 36 0 38 13 
35 0 51 26 49 0 33 0 0 29 25 13 20 0 0 2 0 5 0 7 9 14 0 13 10 14 3 10 0 11 0 0 23 1 0 30 0 0 45 49 28 21 0 0 0 0 
0 14 0 0 6 0 26 0 0 0 0 0 14 3 0 21 0 0 3 0 0 0 8 6 0 0 0 0 0 0 0 7 26 0 0 0 0 0 9 0 0 0 0 13 0 0 
31 33 37 34 0 3 0 20 34 12 0 19 38 0 9 8 36 1 18 0 19 33 9 20 0 25 3 30 2 0 28 0 0 0 13 21 37 45 0 50 15 0 32 2 4 39 
31 11 0 27 37 10 51 15 0 23 0 31 3 1 1 4 16 0 16 4 0 10 15 0 0 0 26 0 0 18 0 0 16 0 7 7 27 31 8 0 0 2 0 2 3 8 
87 60 19 0 26 0 25 17 10 0 0 38 28 17 19 0 0 0 10 18 16 29 12 3 0 12 0 13 0 2 55 25 34 9 2 7 0 36 8 1 13 5 0 0 0 5 
0 15 17 0 0 0 2 2 5 2 26 0 14 0 0 0 0 0 16 11 0 0 4 0 0 0 20 0 0 0 13 0 13 0 0 12 2 0 5 3 0 0 6 0 4 0 
15 33 0 0 0 0 0 18 28 0 51 30 6 0 0 17 0 9 13 0 36 28 0 0 0 8 0 0 0 0 4 1 17 10 30 1 28 9 4 21 19 37 33 10 0 0 
0 9 14 0 36 0 0 6 11 11 29 0 11 16 0 19 0 17 0 7 0 0 3 6 0 0 0 0 27 0 0 1 13 5 6 12 0 0 0 5 1 16 1 0 0 14 
0 5 12 19 11 35 0 0 8 0 0 8 12 0 18 6 10 0 35 3 0 0 0 1 5 0 0 15 12 0 0 0 24 0 0 0 0 0 5 12 105 0 15 0 0 15 
0 42 0 0 0 0 0 0 0 0 0 0 0 0 0 0 0 0 0 4 0 0 11 22 0 0 0 18 0 15 0 10 22 2 0 0 0 0 3 0 0 9 0 42 4 18 
0 27 0 0 0 0 18 0 5 10 1 9 4 0 0 37 0 21 3 14 19 3 0 2 18 0 12 12 0 0 0 13 0 3 0 1 37 19 10 19 25 11 0 0 43 0 
