46 26
16 3 32 47 38 79 0 0 0 38 3 7 10 9 11 0 6 16 6 0 5 16 0 0 28 0 13 0 14 0 3 1 0 24 32 9 31 0 10 53 0 0 9 27 0 28 
0 3 0 0 22 0 0 4 1 20 0 0 7 9 0 4 39 0 2 11 3 0 9 3 0 9 4 34 6 41 0 0 0 0 0 23 20 18 0 0 21 0 26 0 0 8 
0 5 9 0 2 0 42 0 24 0 18 0 0 0 38 9 22 24 0 4 0 0 8 9 0 2 33 50 5 4 0 8 0 0 17 0 0 31 0 0 0 0 0 0 30 16 
0 0 2 14 2 0 5 0 55 0 3 24 0 0 19 0 0 22 26 0 0 10 11 0 0 0 0 17 34 0 14 0 0 0 0 0 0 0 0 0 18 0 0 29 29 21 
0 6 35 38 0 15 33 10 0 32 0 0 0 0 19 9 0 0 13 14 17 0 0 13 0 27 11 14 8 0 0 0 16 19 11 0 4 11 2 31 14 22 4 0 0 5 
44 11 0 0 0 0 7 0 0 0 21 0 1 29 22 30 0 32 0 10 5 0 0 0 29 0 17 0 14 0 24 34 2 18 0 0 22 6 8 15 0 0 9 6 44 58 
0 30 14 12 0 8 11 0 0 5 7 0 9 0 1 0 0 17 8 22 0 17 20 2 10 17 0 4 1 12 12 30 0 0 0 0 0 19 3 10 0 34 13 26 0 3 
26 10 41 5 0 0 0 0 17 0 0 25 16 7 0 0 32 0 6 19 39 0 2 0 7 1 0 0 25 0 0 0 0 10 0 8 0 0 0 1 1 0 0 26 0 55 
36 0 39 0 13 0 38 0 0 0 14 21 0 0 0 0 20 15 8 0 23 12 0 0 0 6 0 21 11 0 7 0 0 5 5 0 56 0 0 0 0 37 21 23 0 0 
0 6 0 0 9 11 0 11 0 3 0 3 7 22 0 0 15 28 0 0 9 0 0 18 17 3 13 0 3 0 0 4 0 14 0 13 0 6 0 6 0 24 4 6 0 14 
0 38 12 3 17 11 27 0 0 32 12 30 5 17 0 0 4 0 6 22 24 29 4 0 3 20 15 63 11 15 15 6 8 4 0 6 21 9 3 0 0 19 0 38 4 18 
0 9 0 36 40 11 11 31 29 1 22 1 0 0 0 0 6 16 28 0 7 10 11 0 7 7 33 0 0 3 0 0 7 0 0 0 39 0 34 19 2 9 6 0 43 38 
5 6 17 0 27 0 6 0 0 45 9 9 0 27 13 25 0 15 30 4 0 0 0 1 0 0 17 44 28 0 12 27 5 12 7 0 0 21 20 0 25 0 0 9 7 0 
8 0 0 3 4 17 9 21 27 29 8 4 17 0 1 37 0 21 10 15 25 0 17 19 15 5 0 7 11 22 0 11 0 3 27 15 5 0 26 32 0 0 0 0 36 11 
0 14 37 15 6 22 28 19 11 1 0 0 0 0 11 9 4 0 13 18 0 14 15 5 15 21 17 10 9 8 0 27 0 0 28 0 0 10 5 29 0 7 0 0 3 8 
2 20 2 22 40 5 0 30 0 0 0 5 0 0 16 0 12 19 0 10 0 35 5 12 0 0 13 0 0 25 16 9 0 0 0 11 3 0 4 36 33 0 4 0 0 19 
0 5 0 8 16 1 18 0 0 0 0 8 9 0 5 0 0 14 8 18 16 0 0 0 40 0 0 0 0 0 0 14 0 0 0 0 0 0 1 0 0 0 23 0 2 1 
6 44 0 1 0 32 0 26 44 0 0 3 3 0 0 0 17 0 2 18 8 0 20 0 0 17 0 15 14 6 0 0 14 25 0 3 0 43 30 0 7 0 26 0 20 0 
23 6 14 0 50 15 15 0 0 0 0 0 0 0 0 0 0 0 0 14 5 0 0 0 0 25 4 12 3 0 0 3 0 0 0 15 13 7 0 20 3 6 0 0 0 25 
37 0 5 34 0 12 11 5 12 30 0 47 18 0 23 0 0 0 10 0 4 16 4 4 14 14 11 0 24 22 32 0 6 0 21 0 12 71 1 30 4 0 17 0 0 0 
5 9 6 1 14 0 22 26 0 0 18 0 0 23 0 13 0 7 14 26 0 0 0 40 5 0 0 0 49 6 14 18 16 0 0 0 23 4 0 0 0 0 19 41 0 26 
55 39 34 0 0 0 10 55 12 0 2 1 1 3 27 22 0 10 29 1 25 0 10 5 0 12 7 9 19 6 14 25 0 32 0 17 12 30 0 0 6 10 0 0 5 110 
9 0 37 0 7 17 10 0 10 10 31 7 7 0 0 9 1 14 0 0 0 0 11 16 0 29 13 14 25 9 0 0 3 0 6 16 0 0 7 21 21 0 15 0 0 22 
17 0 0 0 0 20 0 0 20 0 0 0 9 7 6 0 12 11 13 0 23 9 0 9 2 11 2 0 18 6 2 0 11 5 1 0 0 3 0 10 23 0 42 0 13 14 
0 0 5 13 15 24 0 23 13 0 33 0 0 9 0 0 13 0 13 0 4 13 21 0 0 0 0 12 0 24 0 0 0 13 1 18 0 3 0 24 32 0 0 9 12 2 
9 0 21 0 3 3 31 3 13 0 14 48 15 0 0 15 1 21 19 11 0 13 9 26 0 19 4 24 5 24 0 5 2 1 0 18 0 7 0 0 0 0 0 0 1 14 
