46 26
23 6 0 42 0 22 0 24 0 24 0 0 0 10 0 2 0 0 0 19 3 20 15 23 4 0 12 16 7 0 0 23 0 0 0 13 0 17 0 0 0 0 0 16 0 42 
5 10 31 49 0 6 1 2 0 14 40 0 11 3 0 1 14 10 0 0 0 12 17 0 8 7 15 0 0 0 6 13 4 30 20 3 26 0 4 0 37 15 0 0 17 0 
0 0 0 0 12 8 13 5 3 65 1 3 13 0 0 25 0 0 14 35 17 0 0 21 0 0 0 0 10 0 0 0 23 6 16 0 0 0 8 24 4 22 33 20 14 26 
28 0 2 0 0 0 8 0 0 24 11 0 0 31 8 14 0 0 11 14 2 0 6 0 0 20 0 0 50 2 28 0 0 2 0 0 15 10 9 2 22 0 0 0 9 0 
0 8 0 0 41 19 19 3 0 0 21 30 0 9 12 0 0 12 0 0 13 0 0 14 0 5 13 0 0 0 0 1 0 8 0 6 7 0 0 4 29 15 0 9 0 35 
0 20 3 4 10 0 11 17 0 33 7 0 6 17 0 0 0 4 0 0 13 11 4 0 8 0 6 0 2 8 10 12 0 4 4 5 0 6 0 0 6 13 20 4 15 0 
0 16 15 35 0 0 0 20 0 32 27 0 6 24 0 0 8 0 13 0 0 0 9 31 18 18 24 3 13 1 25 31 0 8 21 10 0 51 0 32 2 34 0 3 12 4 
7 1 15 0 0 13 0 31 6 0 4 7 1 13 0 8 6 0 13 0 0 1 19 0 15 0 24 0 4 0 19 0 0 0 0 2 0 0 0 0 0 34 3 0 0 0 
1 6 39 0 13 14 0 9 0 19 15 0 4 4 2 20 34 28 6 2 27 7 0 6 7 16 24 4 0 0 4 0 0 10 0 14 17 0 3 1 17 18 0 23 28 0 
0 0 0 23 30 7 2 0 1 17 0 0 7 4 9 25 0 0 0 15 42 0 9 46 14 7 2 1 24 1 7 11 17 0 0 0 11 6 21 0 0 18 0 35 0 0 
0 14 0 14 13 38 33 0 8 0 34 0 12 10 0 43 0 9 10 21 0 22 0 0 9 0 0 0 0 0 45 0 28 20 30 51 2 0 6 39 27 5 3 22 14 41 
29 0 3 11 37 5 0 0 0 4 3 5 20 0 0 4 0 10 2 0 3 9 2 2 0 16 23 0 0 34 0 0 0 3 12 0 7 0 0 0 4 37 0 17 4 0 
27 8 0 32 27 8 0 24 0 0 1 1 26 0 0 0 0 5 9 1 1 10 15 0 7 0 5 2 6 4 0 32 7 3 0 38 3 24 7 0 6 0 0 0 0 0 
0 33 30 21 1 36 12 0 29 0 33 26 0 3 8 0 0 24 5 0 0 12 0 0 8 23 0 0 9 0 0 30 1 7 0 26 1 36 3 0 30 0 37 24 0 11 
0 0 5 27 12 24 0 10 0 12 0 0 20 0 0 0 10 0 11 0 3 15 0 27 3 13 10 0 0 11 12 20 29 12 32 0 0 3 2 6 0 11 19 0 0 21 
0 8 0 0 1 0 30 24 0 56 11 0 0 27 2 25 0 0 8 0 0 32 3 0 5 12 17 11 0 22 27 24 0 2 1 14 30 0 9 0 9 0 0 30 0 16 
29 28 42 29 40 8 0 0 0 0 0 6 0 3 30 0 0 9 7 0 8 0 3 0 0 15 3 0 6 70 0 3 35 0 0 16 0 1 0 0 0 0 0 0 9 10 
0 3 0 3 0 21 3 1 23 5 0 0 0 0 1 0 8 0 0 5 2 0 15 0 8 0 36 0 19 0 0 23 0 0 3 0 1 33 0 2 3 0 0 0 0 12 
0 33 0 0 0 8 0 0 0 0 52 22 0 18 30 15 18 6 0 16 0 5 9 26 0 0 16 12 14 13 8 12 0 24 44 7 23 4 23 57 15 0 0 9 59 0 
0 0 21 23 0 0 25 0 0 0 8 0 0 0 0 0 13 0 0 0 3 0 0 0 1 0 18 0 0 0 25 15 0 31 0 0 6 0 7 0 0 15 6 0 0 0 
42 70 9 0 0 46 0 62 0 35 23 9 30 12 0 14 23 15 16 53 0 20 0 14 4 9 6 8 0 0 7 11 8 10 11 1 33 0 0 8 33 3 72 0 72 1 
0 0 14 0 0 20 0 26 5 0 0 0 0 5 9 0 2 19 15 0 0 0 0 9 0 25 0 0 0 0 16 0 7 26 0 0 19 0 0 0 0 0 0 0 0 0 
0 1 2 15 0 66 0 0 4 5 24 38 2 33 0 26 19 18 22 0 14 10 0 0 0 11 4 4 4 16 19 0 0 0 24 60 0 0 0 28 22 26 39 0 0 0 
30 34 83 10 0 9 37 11 0 71 0 0 0 0 0 13 19 9 4 15 0 0 4 0 0 0 9 0 12 0 19 11 25 0 29 3 34 0 10 0 29 38 41 54 7 15 
9 0 18 15 17 8 0 24 0 15 18 0 0 0 0 0 0 11 18 0 19 17 2 4 9 1 5 16 0 0 0 0 0 23 12 0 8 0 0 19 0 0 0 0 0 0 
0 3 30 0 27 0 0 26 0 0 0 0 25 0 0 10 18 5 7 5 14 9 0 0 5 0 8 0 0 1 6 27 55 1 32 3 7 0 0 0 39 0 21 0 65 0 
