46 26
41 0 0 37 0 22 23 4 0 3 0 43 0 0 11 23 21 10 0 0 0 0 6 4 18 15 15 16 0 0 11 9 1 0 0 16 30 18 0 33 0 30 27 21 0 10 
35 0 37 33 38 21 5 35 0 7 0 5 0 19 22 17 7 0 0 0 31 19 5 0 17 22 5 0 0 8 2 0 7 0 0 35 63 0 1 7 18 5 23 0 8 19 
0 16 39 7 0 0 0 0 10 33 12 0 0 9 39 6 15 0 24 0 27 15 10 0 18 0 25 0 0 8 2 0 25 0 0 21 0 0 17 5 17 15 34 0 0 6 
10 0 26 0 6 0 0 0 18 28 6 0 0 1 0 0 0 0 0 0 0 21 12 0 8 19 18 4 26 0 0 0 27 3 0 6 0 33 0 13 0 0 10 0 19 0 
35 14 0 0 0 15 26 0 2 8 31 21 0 11 3 10 0 1 8 0 26 21 0 9 0 4 14 0 0 0 20 22 31 8 0 0 4 0 37 0 34 0 21 0 20 45 
9 22 1 0 0 6 0 0 37 0 0 0 0 0 15 0 15 24 0 0 12 0 7 0 15 0 0 0 20 22 0 0 0 28 4 18 0 36 16 0 23 0 0 0 0 12 
0 0 15 37 23 0 13 26 7 0 32 0 11 42 45 7 17 2 0 0 6 11 0 0 43 18 0 0 25 38 0 0 18 4 0 6 7 0 17 0 64 0 18 0 37 21 
0 17 10 94 0 5 0 19 18 31 5 0 10 7 5 6 8 40 0 0 6 15 21 6 31 0 20 17 0 0 26 0 14 0 25 13 0 26 49 0 21 38 39 27 0 4 
20 16 1 13 2 40 0 0 35 18 7 27 16 15 5 0 8 0 0 0 11 0 22 0 0 0 16 14 16 0 0 15 15 0 5 0 4 5 23 15 1 7 17 16 0 34 
0 16 48 23 0 0 14 5 21 0 0 0 3 0 18 12 0 11 0 19 7 0 0 11 10 7 12 3 4 19 2 5 3 0 0 15 5 0 45 2 16 0 0 0 42 0 
48 0 40 15 0 0 0 5 0 0 11 22 12 18 5 9 4 22 0 0 3 18 2 18 37 0 0 0 12 30 6 0 3 30 9 0 0 15 0 4 33 21 54 0 15 0 
6 0 20 2 11 2 0 13 0 20 9 22 0 26 0 9 0 0 9 2 6 0 7 10 0 0 5 0 11 0 0 14 0 39 0 0 3 0 0 17 3 0 0 3 28 14 
8 8 3 39 23 41 8 4 0 5 4 0 15 2 22 0 0 10 0 0 0 14 1 0 33 0 0 0 0 0 18 0 16 18 10 2 12 11 13 0 2 38 1 39 0 13 
2 0 0 35 0 0 6 0 4 0 4 1 0 27 0 0 0 0 34 0 12 0 7 0 0 15 0 0 11 6 0 13 0 0 0 6 20 0 25 21 32 12 0 0 0 0 
21 0 37 0 0 0 19 8 0 0 0 3 0 3 0 0 25 13 0 12 1 1 57 18 12 17 12 7 12 0 18 0 0 0 0 0 0 0 0 37 32 1 4 0 22 0 
0 0 0 0 26 0 7 0 0 10 47 0 0 8 5 0 19 0 5 0 19 0 0 0 0 0 32 11 0 0 36 13 17 5 0 0 10 0 0 38 2 0 0 39 1 2 
0 0 0 0 0 0 22 6 6 0 22 0 14 8 7 0 17 0 0 0 0 0 2 9 2 0 16 0 6 0 6 7 22 0 0 11 0 2 0 21 9 10 0 0 16 0 
0 14 40 24 23 0 0 4 10 4 28 0 11 20 25 14 8 22 15 0 0 0 0 0 0 0 0 1 0 0 3 0 6 20 24 0 12 0 12 47 4 0 31 2 6 7 
0 0 5 0 0 0 4 5 0 0 0 11 0 6 0 0 3 18 6 6 3 0 11 0 0 13 14 15 0 9 7 0 9 0 0 18 0 10 9 9 0 0 17 11 0 0 
22 39 23 26 0 0 7 5 0 0 9 5 0 30 10 0 18 10 13 0 5 0 0 12 0 3 0 1 11 16 58 0 9 8 33 0 2 0 0 39 0 4 24 28 8 0 
5 1 19 10 23 0 27 13 6 16 20 15 8 6 0 11 3 10 12 0 5 0 19 8 15 5 8 29 5 21 0 1 22 32 0 0 0 0 0 16 29 1 10 12 0 0 
38 19 21 0 0 25 0 46 12 2 11 0 0 0 0 0 0 4 4 5 7 7 2 1 9 0 0 3 7 0 44 0 41 16 4 5 7 0 12 0 10 7 2 28 0 0 
23 0 18 0 11 36 4 0 23 31 2 4 29 0 18 0 5 0 0 11 53 15 0 0 0 4 11 14 16 0 4 9 42 0 0 35 0 12 0 0 42 7 0 0 0 10 
0 0 0 0 28 0 4 0 0 12 2 26 28 15 0 0 0 0 0 0 0 0 0 0 13 0 0 23 0 0 19 19 6 0 0 14 2 26 17 0 7 0 31 1 0 0 
0 1 42 0 39 2 0 11 1 0 0 0 0 22 0 0 0 15 11 0 14 0 13 0 17 0 0 0 15 11 0 0 12 0 0 8 11 24 20 9 11 5 0 25 62 0 
7 6 0 36 2 0 10 39 13 10 50 26 25 19 31 9 13 34 0 0 0 0 0 0 21 16 12 0 1 12 0 0 7 26 0 0 2 0 55 0 32 11 3 33 14 3 
