46 26
9 0 2 17 6 21 24 0 0 15 0 0 40 61 13 10 0 17 17 0 0 6 0 1 16 21 15 0 14 16 30 36 0 2 0 2 0 15 36 26 29 30 14 22 14 0 
0 33 0 0 0 0 0 0 0 35 49 0 0 9 28 0 8 0 12 0 0 24 5 0 13 6 0 0 0 5 3 15 11 0 5 0 0 0 7 5 0 0 64 41 35 24 
12 5 13 49 0 35 12 12 0 0 0 0 0 11 9 0 8 0 65 5 17 0 9 12 29 0 17 0 0 0 1 20 0 0 32 0 0 9 15 5 35 23 0 25 13 0 
0 1 22 5 0 37 19 0 39 6 26 0 0 29 0 21 0 16 1 0 0 0 0 3 10 21 3 17 13 0 0 0 12 16 0 0 27 4 0 19 0 16 87 13 0 0 
29 6 0 15 15 14 16 20 8 0 0 11 4 0 38 2 4 0 6 0 0 12 11 0 0 15 0 20 0 0 5 3 19 0 8 5 0 0 0 0 0 41 8 3 0 0 
77 1 3 0 16 19 10 0 6 14 38 3 0 0 6 4 18 0 17 21 6 9 24 11 0 0 3 0 18 40 0 6 0 3 0 0 3 0 11 31 0 36 2 25 0 19 
0 5 11 40 16 7 0 0 0 0 7 0 31 11 2 19 2 0 45 15 1 0 2 10 19 6 6 0 11 5 0 13 5 4 5 18 0 3 6 8 26 12 0 59 0 15 
26 0 0 0 0 35 0 0 7 0 10 0 3 0 5 0 0 0 32 1 10 0 2 10 0 4 26 0 0 13 15 0 10 0 0 0 7 6 5 0 25 7 13 0 0 27 
0 14 39 8 53 0 0 3 7 3 0 3 3 0 10 26 25 9 15 4 39 10 3 20 0 7 0 0 0 0 8 13 8 15 7 0 6 0 0 19 20 30 10 0 0 0 
0 0 0 4 0 36 1 1 6 31 8 18 26 19 16 13 6 2 13 3 0 0 0 16 0 10 0 4 0 0 0 1 19 18 5 0 0 15 9 17 30 9 15 0 0 0 
0 15 0 0 0 0 34 30 0 30 12 0 11 39 11 0 25 0 0 15 14 13 22 0 0 4 0 0 12 0 0 0 19 20 28 0 0 43 23 30 0 1 7 5 3 10 
32 0 5 0 14 11 12 20 6 33 8 0 27 13 2 0 1 0 10 10 0 11 0 7 0 6 23 0 6 0 2 1 66 0 0 0 0 0 0 6 0 2 0 11 0 9 
7 0 0 37 0 18 35 0 0 4 2 10 28 12 3 19 27 0 0 4 0 3 1 9 10 0 12 0 2 0 2 0 19 24 8 0 0 0 5 0 28 35 39 40 0 29 
0 0 15 24 0 0 0 0 16 0 2 28 28 4 0 0 45 15 10 0 8 0 4 31 17 1 2 0 15 1 18 7 0 0 11 0 20 0 0 20 16 15 0 0 0 0 
0 1 0 0 0 0 33 56 0 3 4 0 0 4 0 18 6 0 0 12 4 8 9 6 0 1 16 0 0 10 10 0 19 18 5 0 1 0 4 10 10 6 0 0 0 19 
0 1 7 19 29 25 21 0 0 0 2 0 0 9 11 0 6 16 5 20 14 0 19 3 12 0 19 0 5 0 53 18 3 16 0 0 0 0 0 10 21 35 0 12 0 43 
29 0 4 1 0 0 12 19 20 34 47 0 0 0 7 0 0 12 8 1 0 10 4 0 0 0 37 0 5 40 17 23 24 0 13 0 0 4 25 9 0 0 0 21 0 14 
15 0 0 0 0 0 0 21 21 0 16 20 0 0 0 0 12 8 28 24 0 0 8 12 14 22 0 0 27 21 0 0 10 0 2 0 2 8 13 0 10 0 16 24 0 35 
5 0 3 9 37 24 0 0 0 15 5 0 0 31 0 4 18 0 12 0 5 15 5 0 9 5 13 0 0 2 0 22 0 28 0 0 0 1 22 36 5 50 3 0 41 5 
21 0 0 1 1 13 8 0 2 29 30 0 32 0 23 7 0 4 0 0 16 21 6 14 39 0 0 7 3 14 0 0 18 0 2 0 26 23 4 6 16 16 5 13 0 21 
26 0 43 0 4 0 0 23 25 0 7 18 9 7 16 0 0 2 0 10 6 0 4 0 0 8 2 0 0 20 28 0 0 33 26 0 23 34 14 0 0 2 0 30 0 3 
0 0 37 10 2 10 58 0 5 0 0 23 21 1 11 21 5 0 0 24 8 0 0 0 0 30 13 0 0 0 0 6 0 0 0 0 0 0 0 17 0 0 23 20 0 24 
153 3 45 0 14 0 39 7 26 0 35 21 11 0 29 0 0 23 27 0 16 24 5 16 8 0 0 0 2 0 20 21 22 28 26 23 1 0 1 9 63 4 0 7 0 31 
0 0 0 0 15 0 0 0 8 0 8 0 0 3 0 21 13 0 0 0 0 24 5 11 0 0 0 0 11 0 0 0 30 17 32 0 0 22 22 26 0 0 0 4 0 2 
2 0 0 3 35 0 17 0 4 26 11 0 31 7 0 20 7 0 0 28 0 0 0 20 1 0 22 0 0 0 11 1 0 0 0 26 0 24 0 15 36 0 0 0 0 17 
0 0 49 0 0 11 22 38 0 32 1 0 10 26 0 19 1 9 40 0 15 20 0 18 1 0 15 0 31 0 0 12 11 0 0 52 0 9 24 35 0 57 3 26 0 40 
