46 26
2 25 39 0 0 22 37 28 0 0 0 0 8 18 24 0 0 16 24 19 6 20 12 21 0 13 19 15 0 33 0 32 25 7 0 0 0 16 7 27 7 0 24 23 0 19 
16 28 35 0 17 25 11 20 0 0 0 11 19 2 0 0 0 0 0 0 10 0 17 15 0 0 0 0 2 22 8 3 1 33 0 33 0 0 7 0 0 0 42 0 0 0 
0 17 16 0 10 4 0 28 1 20 0 15 0 30 10 0 17 14 24 2 4 6 20 0 11 0 0 0 6 5 0 40 0 22 18 1 0 0 14 5 7 0 26 52 0 0 
0 0 11 34 0 12 18 11 25 0 0 37 0 2 0 10 0 26 0 15 42 0 16 4 0 0 0 25 20 0 7 1 12 26 22 10 3 30 1 0 29 0 14 23 18 25 
17 0 1 0 38 21 27 23 3 0 0 16 23 18 19 0 19 20 0 13 0 0 0 6 0 20 4 30 0 0 0 11 24 4 0 30 0 2 18 2 32 1 42 13 10 0 
0 13 0 38 0 10 0 0 28 0 0 0 0 0 13 7 0 26 0 37 0 0 7 0 0 0 10 2 8 2 0 8 20 14 0 7 38 2 0 3 0 38 23 26 1 18 
0 29 0 0 0 0 0 29 0 29 46 0 2 11 0 0 0 9 0 0 0 0 9 0 4 0 9 17 0 0 29 0 0 0 0 0 38 0 1 0 5 14 0 16 16 10 
0 5 0 3 51 0 0 0 9 0 0 7 11 0 3 0 0 2 0 0 0 0 4 0 0 0 16 0 0 10 3 0 0 0 0 10 0 1 4 0 0 3 38 0 0 0 
1 41 4 48 0 6 17 0 0 15 0 0 0 10 13 2 0 14 0 11 0 0 19 15 15 0 3 0 27 13 8 4 29 32 0 0 0 0 7 0 0 0 2 0 0 0 
0 18 11 6 13 11 5 0 22 0 23 1 8 15 19 18 24 16 10 29 28 5 3 0 13 0 12 0 19 9 0 0 0 35 0 20 31 2 11 62 7 0 0 9 0 31 
12 5 0 35 33 12 54 6 0 8 2 4 10 1 0 8 9 0 0 12 2 18 8 5 0 9 0 11 0 0 0 12 26 2 28 35 0 0 0 18 18 0 2 8 8 41 
0 0 2 0 51 0 37 23 0 0 0 0 8 31 0 4 0 0 10 0 3 0 0 0 0 7 0 11 10 19 2 7 0 2 0 1 5 0 8 0 0 0 28 38 0 10 
2 15 1 0 26 0 23 0 0 5 0 1 1 6 0 0 15 1 12 28 21 0 22 9 0 0 4 0 0 0 0 0 0 2 0 39 34 0 0 0 0 1 0 0 0 0 
3 12 0 21 41 0 0 2 6 34 6 10 12 2 28 6 0 20 0 0 27 29 12 7 12 19 7 8 8 2 19 0 17 22 1 4 22 7 0 17 20 0 10 8 0 0 
12 12 0 0 9 0 40 16 29 3 10 5 5 35 22 0 0 17 5 14 3 0 0 21 4 0 0 13 0 10 11 25 0 0 3 9 22 49 22 10 0 0 11 4 10 0 
0 0 7 8 3 54 0 50 0 0 0 44 15 11 0 4 0 8 0 0 0 5 30 5 4 0 12 29 0 2 0 12 21 1 24 4 31 2 45 11 0 16 0 11 9 38 
36 0 5 0 28 0 14 31 9 6 0 12 4 3 0 30 0 26 0 0 35 0 18 2 0 6 7 0 0 18 5 0 21 0 0 18 20 0 44 7 21 24 16 0 0 30 
0 16 27 47 0 0 15 5 1 20 0 4 0 22 15 0 0 0 5 13 6 27 18 0 2 13 1 14 0 32 8 16 0 0 3 9 20 0 41 0 0 0 0 17 0 42 
0 42 24 6 35 0 18 18 57 0 32 3 23 25 4 16 6 0 18 31 9 13 20 0 9 8 0 11 0 5 0 0 13 0 12 10 21 0 0 9 0 0 17 6 10 24 
0 0 34 0 27 0 0 18 25 30 10 0 5 0 0 0 0 16 0 0 0 1 0 0 0 16 0 2 0 13 1 27 24 0 2 2 3 0 8 13 15 1 8 0 0 4 
0 37 0 0 21 0 0 29 3 0 33 7 7 22 17 0 0 0 0 0 0 5 18 0 0 18 7 0 0 20 16 3 4 44 0 19 28 11 0 0 0 14 2 34 1 12 
2 42 0 7 27 0 18 3 0 0 24 14 0 0 22 0 0 0 1 0 0 0 0 0 23 0 0 7 0 11 28 0 14 0 23 0 22 6 9 11 1 0 0 4 18 15 
1 8 6 7 40 28 0 0 45 25 26 0 0 0 0 52 15 6 0 2 11 31 3 8 13 8 0 19 1 14 0 3 9 0 0 0 33 27 0 0 25 0 3 112 3 15 
0 17 0 46 10 25 3 42 0 0 0 0 26 0 11 0 19 41 0 0 4 14 0 23 0 0 0 6 0 7 35 0 0 0 0 8 17 0 0 7 23 0 0 7 32 18 
0 1 0 6 12 0 0 1 2 0 32 10 0 0 14 14 0 15 0 5 0 24 0 13 0 18 0 0 0 12 12 24 24 15 20 0 25 14 0 22 0 0 49 47 9 0 
0 5 34 30 16 21 0 1 41 0 17 0 0 0 0 0 0 5 27 26 0 1 10 20 0 0 18 4 6 19 11 3 15 30 0 18 6 5 0 0 0 0 0 0 18 1 
