46 26
24 8 0 0 5 0 38 0 13 17 8 10 23 0 4 0 12 12 7 13 11 20 0 17 0 8 17 0 36 0 1 10 2 8 34 23 2 0 0 7 0 11 12 36 0 0 
20 4 12 30 3 15 36 31 12 31 16 43 26 9 8 8 14 10 14 7 16 13 8 14 14 17 16 27 22 50 12 0 21 30 0 3 37 8 5 28 0 22 28 9 20 0 
0 21 0 6 4 0 0 7 0 0 0 0 0 7 28 0 28 0 14 0 0 0 12 0 6 0 0 0 0 0 6 0 0 10 0 0 22 0 35 0 0 0 0 40 15 20 
39 33 0 2 20 0 0 13 0 36 10 0 7 0 15 0 6 8 0 0 0 0 25 1 20 0 0 27 7 8 0 8 23 0 0 32 0 22 0 7 13 29 15 0 0 0 
28 0 6 21 1 20 0 0 13 49 12 14 33 2 0 0 0 0 0 0 5 0 0 0 30 14 0 0 28 0 4 0 0 3 0 26 13 0 8 7 4 0 33 0 0 33 
0 17 0 30 36 28 9 0 0 16 2 0 20 0 0 8 44 0 19 18 0 0 0 2 0 18 0 19 6 0 0 0 32 19 37 0 3 0 11 2 55 2 0 27 0 0 
0 0 2 21 5 37 27 19 4 1 14 3 0 0 0 7 0 31 0 0 22 4 0 12 29 18 0 0 11 0 24 0 1 5 0 16 3 3 0 0 31 24 68 0 21 0 
65 40 0 14 23 0 50 14 0 20 21 25 0 3 7 14 6 20 0 0 0 14 0 11 0 11 0 60 0 20 11 0 0 0 33 0 35 20 38 0 0 11 40 6 0 3 
0 17 1 1 3 6 13 0 22 5 9 31 30 0 12 13 10 0 0 15 0 4 18 8 23 4 30 3 0 0 2 4 0 0 0 0 0 5 30 0 31 1 60 11 10 28 
0 0 0 15 0 8 54 15 0 0 4 14 0 7 0 11 17 2 0 4 8 20 0 0 4 14 5 0 2 0 13 20 0 0 15 12 30 1 0 4 6 0 11 10 8 39 
13 42 11 0 11 32 0 2 14 23 19 7 15 40 7 11 31 11 0 15 0 0 0 3 7 8 0 3 0 7 16 8 7 18 0 0 15 32 53 5 7 25 3 53 17 5 
0 0 0 28 41 0 0 9 0 12 0 0 5 8 0 3 9 13 0 0 24 3 0 0 0 0 0 0 19 2 0 20 0 18 0 0 0 0 17 7 5 10 0 6 0 41 
10 17 0 13 0 0 86 0 30 11 70 0 0 0 8 0 12 9 17 4 0 0 41 23 0 0 13 0 0 10 12 0 0 9 0 10 1 1 30 16 18 66 48 2 0 23 
0 0 0 0 0 12 0 0 4 0 14 0 0 19 0 51 0 1 12 5 10 0 0 3 22 0 0 0 0 7 6 3 19 9 1 0 0 0 0 3 8 0 0 0 29 0 
7 33 0 32 0 6 0 2 0 16 0 22 0 24 4 0 0 23 4 10 13 0 0 0 7 0 0 1 7 2 3 9 9 2 1 42 29 14 2 21 24 1 0 40 0 0 
0 8 1 1 9 0 0 20 10 8 0 0 0 0 0 26 0 0 0 18 0 0 0 0 0 5 0 20 0 2 3 0 2 0 4 5 11 26 0 4 0 25 9 6 13 8 
2 15 0 14 17 2 0 29 4 2 12 3 23 24 0 4 5 14 13 6 46 3 8 31 3 7 0 0 0 0 14 0 0 6 0 0 6 28 15 0 5 0 22 16 21 58 
2 0 33 0 27 16 0 7 12 0 0 0 0 5 7 25 29 0 0 0 0 6 0 10 16 0 0 47 12 18 0 27 0 0 0 0 5 0 2 3 21 0 0 6 5 57 
0 10 8 0 21 2 0 0 8 16 0 0 9 2 6 13 33 12 5 27 10 24 16 10 0 4 16 0 13 17 7 7 4 12 10 0 0 0 16 31 0 0 2 0 23 0 
5 43 0 1 0 0 10 9 8 20 9 9 19 0 17 45 22 1 8 0 6 0 0 0 0 0 23 9 17 20 0 0 31 24 22 0 0 8 37 2 6 0 27 8 7 0 
17 0 33 1 28 15 0 0 28 0 14 0 19 0 0 0 5 0 0 14 21 0 0 0 11 0 6 0 0 16 0 0 21 14 0 33 47 1 4 0 4 0 0 0 4 19 
1 4 7 55 0 1 14 37 0 25 29 13 29 16 0 0 8 20 0 0 29 0 11 0 10 6 0 4 0 5 6 14 0 2 0 12 62 0 29 20 7 0 22 1 78 8 
0 11 0 0 0 34 0 6 0 0 34 2 0 27 0 0 0 0 0 0 0 0 0 10 0 8 0 0 8 0 0 0 24 8 0 26 37 0 25 7 35 0 0 0 51 0 
33 0 9 15 0 1 17 22 0 8 7 9 2 26 21 0 0 7 0 34 18 0 2 0 3 0 23 14 0 0 0 0 0 0 0 1 0 0 25 20 18 14 39 0 0 0 
40 15 0 2 58 20 0 14 14 2 12 12 1 20 6 0 40 0 19 1 4 11 2 0 16 3 0 8 15 14 27 0 10 22 8 10 0 10 7 0 40 0 0 0 0 16 
0 0 8 0 0 27 96 19 10 0 29 0 24 0 7 0 0 0 0 7 0 4 9 0 1 0 0 17 0 0 18 0 35 23 0 0 37 0 2 0 8 0 36 0 1 40 
