46 26
0 10 0 3 3 0 29 20 0 1 10 18 4 21 11 3 19 0 0 7 0 9 0 5 0 5 0 0 18 12 5 0 0 11 4 0 55 14 0 0 7 47 23 0 25 45 
37 27 27 26 17 10 1 3 32 7 64 0 0 0 12 1 8 3 11 0 10 22 0 46 0 0 0 0 0 29 15 87 22 13 10 10 31 16 33 0 1 47 1 33 44 62 
21 11 17 0 80 22 33 0 0 0 25 0 3 0 13 1 31 0 12 0 0 2 0 2 11 0 10 18 0 0 34 5 28 5 4 21 32 2 0 45 16 0 0 1 0 0 
0 0 14 11 19 0 4 61 0 0 10 0 0 0 13 3 1 2 15 0 10 0 0 3 7 23 18 26 22 0 1 9 0 11 0 0 18 0 0 0 32 0 0 12 49 31 
20 33 32 0 6 19 3 40 0 0 27 0 0 11 0 9 12 4 16 14 12 5 13 0 1 1 0 0 6 1 11 12 12 8 7 0 9 0 0 0 0 36 10 11 37 0 
0 16 25 4 31 38 0 17 25 19 0 0 35 1 6 0 6 0 18 11 0 11 11 11 3 25 1 26 13 2 8 8 2 15 17 28 18 26 0 18 0 0 0 38 32 0 
54 0 12 0 0 0 5 17 0 7 0 16 3 3 0 0 7 0 0 10 0 0 0 7 0 14 9 0 18 7 0 4 5 0 1 2 2 0 0 0 40 15 13 9 0 13 
0 0 5 16 1 0 0 19 34 0 5 7 0 6 4 3 7 0 3 4 13 2 12 0 0 0 7 24 0 0 0 21 15 0 12 73 16 16 2 0 0 0 0 0 0 0 
15 16 0 36 3 0 6 8 0 10 0 8 11 0 0 10 1 14 0 8 0 0 0 0 18 0 10 27 0 25 8 0 0 0 0 0 0 0 0 36 0 0 0 0 0 0 
28 0 30 4 0 0 39 0 26 8 0 16 0 0 4 2 27 13 2 11 3 0 22 12 7 5 4 1 38 0 18 0 38 0 4 2 0 3 2 0 16 1 0 0 0 39 
0 10 0 4 0 0 17 18 0 4 10 0 0 15 0 30 8 20 0 0 0 0 0 0 13 5 2 0 0 2 0 0 0 2 0 29 0 48 5 0 0 0 0 0 0 29 
9 0 0 0 7 0 0 0 0 0 29 22 23 25 0 0 17 0 0 1 0 1 0 13 5 2 0 0 5 19 0 8 0 5 16 0 0 0 1 5 0 13 0 0 5 1 
0 22 0 5 4 0 3 12 6 28 29 10 26 6 0 0 0 20 0 6 16 14 0 0 23 17 10 0 4 20 0 0 0 5 0 0 16 41 38 29 0 0 0 0 7 0 
68 65 6 6 0 0 0 6 0 7 13 0 0 0 0 19 10 0 3 19 0 11 12 17 24 16 17 0 0 31 0 13 0 0 9 0 16 0 0 10 22 0 11 1 43 6 
0 12 20 11 6 0 6 2 5 33 6 0 5 1 12 12 0 11 21 0 3 20 20 3 0 0 13 8 0 10 0 5 1 0 19 0 0 0 2 7 0 0 0 0 0 36 
27 0 0 0 83 0 3 0 41 44 15 0 3 12 0 1 8 0 0 10 14 6 10 0 0 9 13 27 10 5 4 0 0 0 12 31 0 0 6 14 0 33 0 14 0 43 
15 43 0 0 28 0 0 26 0 7 0 7 9 13 0 0 0 14 13 12 15 0 0 11 14 37 0 18 20 9 36 28 23 4 14 0 5 0 3 27 13 5 0 0 78 0 
0 31 0 46 0 0 31 12 0 18 29 46 0 26 0 3 0 13 0 29 12 0 8 16 0 2 0 18 17 6 14 20 10 15 0 0 0 12 0 58 1 1 23 0 0 0 
2 0 11 5 35 0 0 0 2 0 0 0 0 7 13 11 6 0 0 0 3 11 14 20 0 13 0 13 0 0 0 0 0 6 3 0 2 0 0 0 0 4 0 20 0 0 
0 32 24 21 12 0 6 6 9 18 0 0 26 0 0 7 16 5 0 17 15 0 20 0 0 2 0 11 26 0 2 12 2 46 0 9 16 0 0 0 28 0 20 27 0 19 
46 72 0 0 0 0 0 0 11 31 4 0 0 0 4 0 0 13 17 0 12 19 5 6 0 0 0 2 23 15 0 1 0 0 1 7 0 0 37 0 0 0 0 2 0 38 
0 3 15 0 18 0 0 0 0 0 43 21 11 21 18 30 30 1 0 14 35 3 2 3 9 13 0 19 26 0 0 13 0 9 1 0 21 15 0 4 0 5 0 33 0 16 
0 40 33 0 0 0 12 2 0 0 6 0 14 3 0 4 0 14 6 0 15 0 4 0 6 0 0 0 0 0 0 0 16 0 0 22 0 1 0 19 0 26 0 8 19 0 
24 21 0 11 22 0 20 17 49 13 1 7 11 0 12 1 0 0 0 0 12 0 0 7 15 13 54 2 13 2 0 0 28 0 0 0 19 1 0 3 17 1 23 0 0 37 
45 11 3 23 2 22 2 2 0 0 7 0 48 17 14 0 9 0 12 16 23 0 0 0 0 0 8 17 18 7 17 31 0 0 18 17 0 25 7 32 0 13 0 5 0 0 
30 0 24 0 6 0 0 46 0 8 0 27 0 15 2 3 2 4 0 73 0 0 4 0 35 21 0 3 40 29 0 0 0 7 10 0 25 0 0 0 0 0 0 36 25 0 
