46 26
0 49 22 0 12 0 1 0 0 0 21 0 25 20 0 0 13 17 0 0 23 9 14 8 21 3 0 5 6 0 0 0 20 7 18 10 0 29 0 0 0 31 0 0 12 14 
0 19 40 0 24 0 1 3 61 28 0 12 5 0 0 10 18 16 0 0 2 0 5 12 0 5 0 11 0 0 14 9 7 35 0 0 0 34 21 4 15 2 75 6 17 1 
0 23 8 0 16 0 16 0 29 32 22 19 0 3 9 13 33 1 27 6 7 0 19 69 4 0 9 18 36 0 32 0 0 0 0 27 0 0 4 38 0 45 0 40 31 27 
2 25 34 0 24 13 0 22 0 0 17 13 0 17 0 0 0 0 4 0 14 7 0 0 0 0 25 0 31 9 0 0 0 0 22 5 59 0 6 28 0 0 0 0 8 0 
2 0 0 3 1 0 2 3 28 9 0 14 0 44 0 17 0 8 40 2 0 16 0 0 30 29 26 0 3 21 9 8 19 0 18 4 0 0 5 4 9 26 8 8 26 19 
38 27 36 0 0 106 0 35 19 27 2 0 23 15 11 17 0 0 0 20 0 0 9 0 5 23 0 17 13 0 23 30 7 0 5 2 17 44 63 0 35 22 23 43 2 15 
26 7 0 0 19 0 0 0 14 0 2 10 5 0 0 0 0 0 0 1 18 0 0 11 9 0 26 11 0 0 0 0 0 0 0 7 8 14 14 12 0 0 7 0 8 9 
8 0 1 1 0 0 0 17 20 0 0 0 2 28 0 0 14 15 0 0 0 0 5 0 15 0 15 0 0 17 31 0 0 0 0 0 18 0 0 0 15 44 0 15 14 0 
8 9 25 0 0 0 18 0 12 0 9 7 3 13 0 3 0 0 8 12 1 0 0 8 16 0 13 29 0 0 0 16 0 15 0 0 0 0 0 15 0 6 0 0 0 0 
13 38 0 2 2 30 2 30 3 9 24 0 0 5 0 0 0 4 33 11 22 16 15 0 16 25 16 9 9 5 7 0 0 33 18 5 9 0 3 5 0 12 17 0 0 41 
0 17 0 31 12 77 0 13 29 8 3 10 34 25 15 0 36 4 17 7 11 14 20 0 4 0 5 0 9 0 13 0 17 0 34 1 5 36 25 9 24 5 37 12 22 0 
0 6 30 11 0 6 14 38 4 0 9 6 0 13 0 29 0 1 0 17 0 7 34 0 7 0 1 5 0 0 23 24 30 0 0 12 0 1 6 8 0 0 20 0 0 0 
0 21 2 15 47 0 6 1 11 0 52 0 10 0 7 0 9 0 2 0 0 8 7 0 2 0 29 1 24 31 0 0 0 0 3 0 0 0 0 5 0 32 2 0 0 5 
8 1 10 0 1 0 0 20 0 0 40 29 25 0 16 0 29 0 8 0 7 1 23 11 6 5 0 14 0 4 44 6 22 0 15 13 0 9 0 47 21 10 0 6 1 29 
27 0 0 3 11 0 3 12 0 0 0 63 62 1 0 3 0 4 0 4 0 5 21 0 0 0 11 28 16 0 0 23 20 0 23 26 23 14 0 0 0 6 0 101 1 2 
0 0 24 11 0 2 22 0 10 16 33 4 0 0 0 14 13 0 9 0 7 0 13 1 15 9 16 14 22 14 0 0 0 10 25 3 0 0 4 0 0 45 0 10 0 10 
8 0 0 0 0 7 0 0 0 0 10 0 19 0 22 22 26 0 0 2 10 20 0 0 0 15 0 15 7 15 0 22 8 0 8 0 11 22 0 0 8 20 27 1 0 0 
2 0 0 0 0 0 6 0 4 0 0 0 0 0 0 0 0 17 0 0 0 0 0 26 0 16 0 0 0 0 0 0 0 0 0 0 10 3 0 0 0 0 5 0 0 0 
40 5 0 14 0 29 27 2 12 8 16 0 0 0 0 0 24 18 0 0 10 7 14 0 7 13 0 6 0 0 0 0 0 33 4 2 0 3 4 0 16 0 0 0 16 0 
35 2 45 0 0 0 0 25 1 12 0 0 11 0 7 13 0 11 11 10 0 49 11 6 11 0 5 0 2 0 4 22 2 8 28 11 2 14 2 7 0 0 7 4 37 39 
10 0 0 0 0 0 19 49 15 21 7 10 11 5 7 5 0 21 0 3 12 16 0 0 0 10 0 0 0 0 21 25 0 19 9 0 0 11 18 0 0 34 0 0 0 15 
13 40 12 0 32 0 0 9 0 0 44 4 0 13 6 17 24 8 9 1 0 5 0 5 0 14 0 18 0 0 14 10 0 5 0 34 32 8 0 18 0 0 32 0 0 26 
5 1 0 11 40 0 0 13 12 5 19 6 8 20 6 3 13 9 20 16 10 0 0 0 0 0 18 2 0 21 9 2 0 9 0 0 0 3 71 9 18 0 9 3 1 10 
0 28 64 0 0 13 0 4 4 0 3 0 5 22 7 0 9 0 0 42 0 0 0 0 17 0 18 10 21 0 3 0 0 15 0 29 0 13 19 37 19 6 0 0 0 67 
34 0 9 0 60 1 0 18 7 0 7 1 11 14 19 0 2 0 18 5 68 0 9 0 0 5 6 8 22 18 0 0 15 0 24 8 4 0 4 14 93 0 3 0 28 0 
33 40 24 0 36 0 14 22 1 2 0 23 15 2 15 1 30 5 0 15 0 0 0 0 0 0 27 15 0 10 1 0 1 22 7 0 0 0 10 0 0 32 17 0 12 6 
