46 26
9 11 0 29 0 11 0 0 0 15 0 11 0 0 0 0 0 0 5 2 0 8 32 0 37 4 0 24 0 15 0 8 0 18 0 21 0 0 0 0 0 0 0 9 26 0 
8 21 1 0 0 18 13 0 0 0 14 0 6 32 0 2 0 11 22 4 0 19 36 0 0 0 12 0 23 0 20 0 5 23 0 0 36 0 49 0 1 1 2 0 0 23 
25 3 31 41 13 0 16 0 0 0 1 1 0 0 0 1 2 8 10 0 1 19 25 21 4 38 0 23 6 0 1 21 18 4 1 7 18 14 8 5 19 0 11 0 61 23 
34 4 4 20 0 0 0 7 23 0 4 1 0 0 0 0 0 0 0 12 0 0 0 20 56 37 0 6 27 0 1 23 11 22 35 3 0 0 10 0 6 0 16 3 42 5 
0 34 33 0 0 0 0 0 6 0 8 7 0 0 0 1 17 3 31 0 0 0 0 0 51 5 5 7 9 0 11 15 0 0 0 32 0 15 10 21 0 0 0 12 0 0 
6 12 13 9 26 0 19 9 6 0 15 0 0 0 11 22 25 0 8 16 8 8 20 19 0 1 19 0 0 27 0 9 0 0 0 26 18 0 21 14 63 0 15 25 44 41 
4 0 34 0 0 0 12 23 18 26 18 0 0 1 1 0 0 11 0 0 8 43 0 0 13 5 18 0 18 5 0 12 5 11 7 27 18 0 0 0 0 0 16 3 0 24 
0 0 0 0 5 0 0 0 0 7 27 8 11 14 22 6 15 3 8 0 0 0 0 31 13 2 14 0 2 0 10 22 0 15 0 0 9 9 2 0 26 11 9 20 10 0 
0 0 0 0 0 0 0 0 25 0 0 0 0 0 0 7 20 0 0 22 0 0 7 0 0 1 0 0 0 0 0 18 0 0 1 19 0 0 3 0 15 12 0 0 0 0 
17 16 41 19 33 2 39 19 0 27 27 33 0 0 26 10 0 8 23 3 9 10 30 29 22 27 14 26 31 14 8 37 18 23 28 11 12 17 7 25 2 35 2 60 94 13 
9 0 2 6 31 18 0 5 26 7 11 9 0 0 1 0 0 1 18 0 14 3 5 5 11 11 5 23 7 11 0 5 0 0 32 7 1 0 0 1 11 0 6 0 1 0 
0 16 0 0 0 11 30 62 25 60 12 16 8 8 30 2 12 5 6 0 0 13 9 0 5 0 16 7 0 0 41 0 24 0 0 21 30 26 0 31 0 34 36 24 31 0 
10 11 40 69 12 6 37 11 5 15 0 6 19 26 0 0 28 0 5 0 0 0 19 0 6 0 0 0 11 8 0 0 9 4 5 0 0 4 15 26 0 0 42 36 40 0 
1 7 45 0 0 3 45 0 0 0 6 16 0 2 0 0 0 0 5 17 6 0 3 5 0 0 26 0 17 0 1 1 0 2 7 1 11 0 7 0 0 0 38 9 38 0 
0 29 0 16 0 10 8 13 0 36 11 6 29 0 0 3 11 7 14 0 9 14 5 1 16 0 3 0 3 9 39 0 3 0 0 0 21 9 7 4 31 0 0 3 2 0 
37 38 14 0 0 0 0 42 0 0 0 1 22 20 5 0 7 10 15 0 3 0 11 8 4 7 0 0 0 0 0 0 0 28 24 5 0 32 0 0 5 0 0 0 0 38 
35 0 17 0 3 0 4 0 22 5 0 0 0 0 0 0 0 0 24 0 0 4 6 0 20 14 0 0 12 1 2 0 0 0 0 35 0 0 1 0 0 3 33 15 2 0 
52 43 0 0 40 3 0 0 10 0 8 6 5 16 0 0 0 10 8 17 12 0 0 0 13 0 4 0 3 2 1 2 0 20 12 0 20 13 1 0 0 33 0 35 23 0 
0 0 7 0 29 8 0 0 0 0 0 0 0 0 0 0 18 0 37 0 0 17 0 16 8 3 0 0 14 5 8 27 0 5 0 4 0 19 1 12 1 0 0 0 0 10 
0 38 33 11 0 27 0 14 37 0 12 21 0 29 11 0 26 22 9 3 22 14 15 11 0 14 0 0 0 24 0 0 9 0 1 33 10 0 0 74 3 8 18 0 39 37 
0 0 18 41 0 3 0 8 5 3 0 0 0 26 26 20 20 0 0 1 3 32 2 2 29 0 0 0 9 8 0 3 0 5 20 41 39 64 0 0 4 0 5 0 29 38 
33 8 0 29 0 0 0 6 0 15 25 15 0 14 0 0 17 0 26 0 6 1 20 0 15 0 15 0 0 4 0 0 0 22 31 12 0 0 0 0 0 0 0 0 26 0 
10 35 0 0 0 0 0 54 0 0 3 0 11 28 0 0 15 0 17 0 16 0 0 0 26 3 0 0 4 22 10 0 13 19 3 19 37 13 0 37 13 0 0 0 0 0 
42 11 47 2 33 32 0 9 7 3 10 4 0 0 0 1 26 20 32 7 24 16 0 0 13 5 17 9 13 27 0 14 0 15 6 12 18 10 11 0 5 0 84 0 2 0 
27 21 0 0 22 10 0 27 8 0 0 19 16 6 18 1 7 21 0 5 0 0 24 0 0 1 1 40 29 20 33 0 0 0 0 7 0 36 55 0 0 0 13 20 1 18 
16 9 7 38 0 21 0 0 0 13 24 0 0 0 0 0 28 18 14 0 2 0 3 6 11 22 0 0 8 0 0 0 0 2 0 11 8 0 4 0 17 14 13 0 0 4 
