46 26
0 0 18 4 0 51 0 0 0 0 7 0 17 8 0 21 21 7 0 3 2 4 0 21 5 13 4 0 0 7 5 28 0 0 15 45 31 0 0 0 0 21 0 8 34 12 
0 11 54 1 4 0 0 19 68 3 16 21 11 0 6 2 14 17 15 12 1 22 12 5 28 22 27 0 6 0 9 0 17 28 1 1 24 3 30 11 14 0 38 4 0 3 
0 4 0 1 27 0 0 0 8 0 3 0 1 17 7 0 8 0 0 39 0 7 0 0 0 0 0 2 0 0 0 57 0 20 2 34 0 1 11 0 0 4 0 0 25 0 
4 14 5 0 30 5 24 5 19 12 0 0 6 16 14 2 0 9 9 4 18 3 0 1 17 7 9 0 9 11 26 0 20 0 1 0 27 0 20 38 37 18 0 0 0 40 
0 0 38 5 24 0 0 0 0 11 21 0 0 8 0 0 0 14 0 5 19 6 32 6 6 12 18 0 24 0 19 14 13 0 34 12 6 3 0 14 56 0 2 0 18 7 
0 0 25 5 4 32 0 21 29 9 0 0 11 6 8 0 0 0 2 26 7 20 5 28 0 0 0 23 0 3 23 0 2 1 6 14 0 3 1 0 20 3 0 26 5 0 
1 0 16 21 0 31 0 35 13 6 10 20 19 0 0 0 5 15 12 0 1 12 3 0 18 41 7 12 0 6 29 19 0 20 0 6 0 0 12 12 0 2 15 2 19 21 
48 17 0 0 31 0 15 36 11 0 30 11 10 24 11 27 47 25 29 19 5 20 10 23 8 12 26 0 9 25 0 2 10 4 0 36 0 3 26 15 7 0 24 0 20 27 
33 8 0 0 51 0 0 0 0 1 34 0 25 1 3 10 1 0 0 3 3 20 9 1 0 7 11 8 5 5 11 0 3 71 0 0 0 0 31 36 3 10 0 24 20 37 
0 0 0 51 31 0 0 0 27 22 0 1 24 0 5 0 23 0 27 21 9 0 16 0 0 0 0 24 20 5 9 0 0 0 21 13 24 0 7 14 0 33 0 40 0 27 
56 9 0 44 29 0 0 0 0 5 9 0 8 3 0 0 0 0 16 2 0 16 0 0 0 21 12 0 10 1 0 0 0 1 1 0 0 0 38 10 0 0 31 10 35 42 
0 0 0 13 0 34 0 0 0 9 7 31 0 6 24 0 4 1 16 21 8 0 0 0 4 13 6 5 3 0 5 0 4 9 6 15 0 0 29 41 21 0 22 0 0 31 
2 0 12 0 0 14 11 14 0 6 1 4 10 0 23 0 0 0 14 0 9 5 6 32 1 0 2 0 2 0 0 11 14 0 0 7 0 9 14 15 33 0 33 36 0 12 
0 0 20 15 3 15 0 9 12 26 10 32 7 21 8 0 27 1 0 16 23 0 17 0 12 12 0 0 4 0 0 28 29 0 6 29 0 0 16 9 24 0 0 22 0 0 
0 0 0 38 0 0 0 19 0 0 0 0 32 26 29 1 0 0 15 0 0 1 1 0 0 4 19 0 0 0 0 0 3 1 0 0 0 0 0 5 0 42 27 29 0 0 
0 25 0 0 7 9 0 0 0 26 31 10 7 2 28 1 0 0 15 10 0 4 0 8 15 0 29 25 15 1 4 0 14 19 5 4 0 0 10 5 14 27 28 7 3 18 
0 0 0 0 0 31 0 2 48 4 15 2 11 21 0 0 22 0 14 10 13 2 0 11 3 25 5 5 12 0 0 0 0 13 12 1 59 1 15 0 0 1 7 33 0 2 
31 14 0 0 0 0 0 0 13 0 0 27 46 8 6 0 0 0 0 0 4 8 8 0 0 0 0 0 1 0 3 31 0 6 0 0 0 0 37 9 10 29 3 0 9 0 
43 0 0 42 0 0 2 2 41 35 0 0 32 0 0 0 0 17 21 0 0 0 20 7 0 13 0 28 0 0 0 0 0 0 0 7 39 0 11 15 2 4 0 44 32 96 
0 0 0 1 20 0 14 0 0 9 1 0 14 16 0 0 0 6 9 11 19 6 0 6 6 0 23 0 11 16 0 0 0 15 0 7 0 6 1 6 0 0 15 1 23 0 
0 12 0 1 8 30 0 4 0 11 3 4 48 0 19 0 12 0 0 0 10 18 0 4 0 9 15 14 6 14 0 0 0 21 6 30 0 0 0 9 0 58 3 14 5 0 
36 0 0 3 21 35 0 0 22 0 7 1 0 0 5 2 21 0 3 0 19 0 2 0 0 21 0 7 14 0 22 25 1 33 12 0 22 0 0 0 0 0 0 1 0 31 
0 0 0 0 7 0 0 35 12 26 16 57 0 0 0 0 0 0 0 1 13 5 22 11 9 8 15 9 11 22 0 0 0 9 4 13 9 0 11 69 0 30 0 1 22 9 
56 23 0 8 37 11 12 13 2 5 30 0 3 0 14 12 2 0 0 19 27 3 2 34 0 0 0 0 0 0 17 0 26 6 0 0 0 0 6 3 48 57 55 10 24 22 
8 42 0 0 0 38 30 0 8 19 18 8 6 0 0 0 0 13 7 8 0 0 0 3 1 24 0 13 0 17 25 0 22 14 0 0 0 19 0 0 13 0 36 80 0 0 
0 63 0 16 0 0 0 0 55 32 0 24 2 0 6 21 5 5 0 3 0 0 0 35 0 0 18 19 15 28 0 19 0 0 0 10 58 6 13 7 0 0 0 15 5 9 
