46 26
0 69 32 14 0 5 30 34 0 0 26 25 31 19 18 43 0 24 15 13 0 25 21 0 42 1 24 22 0 28 7 6 23 2 46 0 42 33 35 17 16 60 4 32 6 30 
26 0 40 0 20 1 0 0 13 30 0 0 19 7 0 0 22 23 21 7 26 4 0 5 1 17 50 3 31 0 7 15 0 0 24 0 4 10 1 27 15 18 4 21 24 16 
17 24 17 0 13 17 0 34 0 0 0 0 0 11 28 16 0 0 0 0 0 0 0 20 0 14 0 2 0 0 16 0 0 31 0 49 11 0 0 37 0 44 0 3 8 44 
0 0 0 0 0 6 0 0 22 0 0 1 0 0 0 3 10 0 3 0 2 13 17 0 9 6 15 0 2 0 0 0 0 0 13 18 8 0 0 36 1 0 0 0 0 0 
7 31 0 9 20 16 25 0 6 0 31 0 14 15 49 11 1 13 11 0 5 13 16 30 10 25 0 0 3 22 58 42 15 3 22 18 13 0 3 2 0 18 41 14 4 31 
0 12 30 0 0 35 0 0 0 6 12 0 0 10 0 18 10 0 0 0 0 5 0 0 0 0 0 0 11 26 16 0 0 29 32 17 14 28 2 5 2 28 17 58 11 0 
11 0 15 0 0 0 0 15 5 20 0 14 2 0 9 5 6 5 18 7 0 12 0 11 0 13 0 0 0 6 13 0 2 19 0 1 23 0 0 13 0 11 0 9 0 9 
17 7 37 46 0 18 5 42 0 0 0 17 0 26 0 20 0 10 22 0 0 0 0 18 11 15 0 14 21 0 0 9 3 12 31 30 0 0 0 7 0 2 0 0 37 0 
10 25 3 0 34 22 0 0 3 17 5 1 6 28 5 18 31 22 1 15 9 11 9 8 5 16 25 0 0 0 13 4 40 13 21 0 0 8 20 10 24 6 8 0 0 24 
0 0 56 0 33 7 4 3 8 1 15 0 0 0 22 17 0 0 0 20 5 0 25 0 6 6 0 30 20 27 6 29 0 0 0 2 9 21 0 20 18 31 0 4 0 40 
0 2 0 10 0 0 18 14 16 28 0 0 14 16 8 0 26 5 0 0 0 10 0 0 7 0 0 12 7 12 0 0 0 0 5 0 27 8 0 7 0 17 14 10 0 0 
0 0 0 11 0 7 0 7 14 37 4 18 0 0 7 0 0 0 0 0 9 7 0 23 1 0 17 0 5 20 0 0 0 5 11 4 8 14 19 10 0 5 3 1 2 0 
22 18 0 1 0 35 21 3 5 7 0 2 0 0 11 15 15 0 10 18 17 0 1 0 0 0 7 0 0 6 3 0 0 27 0 0 0 0 12 12 0 36 0 6 0 0 
0 5 16 0 0 17 1 0 0 15 13 4 5 0 8 24 7 11 16 0 0 0 38 27 18 16 0 0 5 10 2 0 2 8 0 20 0 0 0 1 12 0 0 0 0 12 
0 87 0 0 0 4 0 43 4 0 0 8 6 0 0 2 0 0 0 3 0 19 18 6 0 3 0 0 21 0 0 7 3 7 33 0 7 6 0 32 19 0 0 0 0 10 
0 0 8 0 13 0 75 0 0 16 4 0 28 4 24 0 31 5 0 0 18 0 0 0 0 34 0 0 0 10 2 1 0 0 10 10 0 21 38 0 28 5 36 4 29 39 
6 13 1 70 3 22 16 3 0 0 0 0 1 0 0 14 8 0 26 0 15 0 7 0 0 0 0 0 4 0 0 28 10 0 31 0 16 0 0 0 0 0 39 0 38 0 
53 36 26 36 0 0 0 30 8 14 0 34 0 13 15 0 0 0 14 0 0 2 12 17 6 3 0 25 0 0 0 0 21 0 16 15 0 17 0 36 0 0 0 0 0 12 
0 0 33 0 0 4 52 0 4 25 0 0 0 1 53 0 0 28 9 0 0 0 19 18 0 0 17 9 28 18 16 0 0 0 3 33 30 0 0 0 0 10 8 17 11 38 
42 14 0 0 32 46 5 7 9 32 12 4 24 26 14 15 16 0 30 0 0 0 0 0 0 34 19 0 0 0 0 13 0 0 9 0 63 9 12 7 0 26 6 11 13 6 
16 12 12 36 12 0 9 5 0 15 3 5 19 7 3 1 18 0 1 17 4 10 13 3 15 0 0 9 1 0 0 0 36 4 0 13 3 4 9 55 0 0 0 8 16 5 
0 0 15 0 0 5 0 0 2 0 23 21 0 9 13 0 21 0 1 20 0 34 3 0 0 19 0 17 0 7 10 5 0 5 10 34 9 48 3 28 6 0 19 0 23 20 
0 0 0 0 34 3 3 0 0 0 0 32 0 15 1 0 0 0 14 0 11 10 0 37 22 1 16 0 15 1 3 19 0 0 0 0 25 0 5 0 0 0 9 0 0 0 
0 0 8 33 0 0 51 0 1 0 29 20 31 0 21 0 0 0 0 0 0 2 0 2 12 19 17 0 19 19 19 0 0 0 20 1 23 0 32 29 0 2 15 70 0 0 
33 0 19 13 14 1 0 10 68 0 0 1 14 0 7 4 0 23 34 0 9 19 0 5 1 5 0 0 39 4 19 0 20 21 31 27 0 2 7 25 0 21 0 0 20 52 
0 7 0 32 0 35 18 0 23 0 20 3 9 0 27 13 8 0 0 12 0 22 0 7 0 0 5 0 16 23 28 12 1 5 0 20 0 16 17 25 44 25 0 3 0 2 
