46 26
0 15 14 0 38 0 0 0 56 21 0 5 0 0 0 0 1 10 0 0 0 0 4 0 0 1 3 1 0 9 16 0 0 0 16 0 0 0 5 0 23 0 34 30 23 0 
12 19 0 37 14 60 0 29 0 12 0 0 17 25 0 0 7 5 6 5 0 0 20 0 13 17 22 11 12 0 18 10 0 28 18 13 9 32 33 10 33 29 2 14 0 17 
0 8 8 24 18 1 0 13 0 9 16 2 15 20 9 0 11 15 0 26 11 17 22 9 16 21 6 11 0 0 21 1 0 0 0 0 20 0 0 12 16 21 0 12 11 22 
12 53 0 33 20 10 10 30 9 9 34 0 35 0 12 4 16 2 0 1 19 0 35 7 0 1 19 2 14 20 21 12 1 13 0 25 11 30 37 17 50 0 5 1 34 17 
8 0 0 0 0 17 11 0 19 0 0 0 16 21 7 9 0 6 8 0 0 23 3 4 16 0 0 4 6 0 0 3 0 26 0 7 15 0 1 0 0 28 4 0 23 0 
1 0 0 11 0 5 9 29 7 20 13 65 5 19 0 8 0 5 6 19 15 0 23 0 0 14 4 12 20 0 4 0 13 4 28 1 55 4 28 1 0 19 6 9 16 0 
0 43 0 4 46 2 0 54 0 2 5 0 30 0 2 19 2 0 0 0 0 7 0 0 0 29 22 26 17 0 0 30 0 0 19 0 2 1 30 0 39 43 30 0 0 2 
3 0 13 0 0 0 18 0 0 0 0 2 23 18 20 13 0 25 0 0 0 13 0 16 0 0 0 0 0 0 7 0 7 2 20 22 0 17 0 16 0 0 25 0 0 0 
40 0 0 0 34 2 6 0 0 0 0 0 6 7 0 14 11 2 0 5 4 0 8 0 9 0 6 0 0 11 3 15 0 0 6 6 10 0 48 0 31 0 0 0 4 9 
0 0 0 2 5 43 6 12 0 5 2 33 6 21 0 0 0 12 0 17 0 0 13 0 22 0 5 0 0 9 0 0 0 0 0 22 4 4 8 3 0 0 0 0 24 8 
90 0 8 1 0 0 7 0 0 26 0 0 5 2 26 0 0 28 0 4 0 0 0 0 12 0 0 9 29 0 0 0 0 36 34 0 12 9 6 8 0 11 42 2 30 36 
57 13 1 2 0 0 0 2 0 10 8 0 0 9 15 30 0 0 17 0 20 0 0 9 0 24 0 0 0 36 3 24 4 24 3 0 0 45 15 35 20 0 4 0 0 16 
0 39 0 10 0 11 14 15 14 10 0 0 0 0 0 0 0 0 8 9 24 0 0 0 0 0 0 0 2 7 0 32 0 0 26 6 6 0 9 8 37 0 24 0 0 0 
20 49 12 9 0 2 5 32 29 5 0 10 0 56 12 10 15 0 10 4 0 31 8 7 18 6 0 0 12 26 23 10 0 20 1 26 0 24 35 32 4 32 5 0 41 44 
35 14 18 0 0 0 0 74 12 21 0 33 0 6 0 3 0 49 0 4 6 0 11 9 0 0 1 0 2 15 21 3 1 0 6 22 8 0 0 5 0 25 25 15 9 38 
16 0 21 7 15 34 27 19 18 0 7 0 0 2 0 0 0 8 15 15 0 16 17 21 4 9 20 27 0 0 8 39 0 0 53 3 12 35 0 0 0 9 0 0 8 14 
41 0 0 45 0 5 0 0 13 39 0 6 11 6 8 0 15 28 0 8 8 0 9 0 21 14 9 24 0 0 16 9 0 12 16 9 2 0 5 0 2 9 0 2 0 42 
0 1 1 40 29 0 3 0 0 27 18 12 2 28 20 0 0 0 0 0 0 0 0 12 21 6 19 0 11 0 0 10 0 21 20 1 11 0 6 0 0 10 4 85 0 13 
0 15 0 6 0 2 13 3 0 18 4 13 0 7 3 0 15 8 0 10 7 19 14 0 19 0 0 0 0 3 10 0 2 0 6 3 10 0 0 8 16 0 0 15 0 0 
0 14 29 0 0 0 0 0 0 18 0 0 16 0 25 0 0 0 0 22 0 12 21 0 12 12 0 10 9 10 43 6 0 36 0 0 19 2 2 0 1 22 0 6 0 0 
0 54 0 0 41 5 31 0 0 18 30 36 23 0 5 0 0 6 0 15 18 12 22 1 19 2 0 3 6 0 27 3 0 0 14 23 50 0 0 29 26 0 0 13 15 57 
18 0 9 0 12 12 76 3 73 2 8 9 0 0 10 18 13 20 31 2 16 0 0 14 0 13 18 0 2 18 0 0 4 21 4 5 7 0 32 30 8 0 0 37 0 76 
0 0 7 0 31 7 0 0 0 2 27 32 4 20 25 1 0 5 0 3 34 0 2 10 0 2 24 12 0 0 5 0 10 0 0 10 34 27 5 22 4 0 38 5 21 34 
9 0 33 31 36 27 12 50 18 22 5 18 0 0 0 0 22 20 7 10 17 0 18 16 6 0 20 17 0 12 52 0 0 26 19 46 2 35 22 0 11 0 0 0 36 0 
11 0 4 77 22 0 13 0 1 11 0 0 0 2 20 7 0 0 13 0 15 0 15 2 0 0 0 0 0 0 0 0 10 0 29 32 11 0 0 0 0 10 39 0 0 9 
21 0 0 22 0 0 18 0 1 24 31 0 0 0 9 19 0 24 0 0 0 0 11 0 16 22 26 0 26 29 0 0 0 6 8 35 0 9 0 4 0 28 5 0 0 5 
