46 26
34 21 0 27 0 0 4 11 2 13 2 17 0 15 2 11 0 0 18 0 0 20 5 25 19 0 0 0 0 12 42 18 0 1 29 20 0 19 0 0 0 16 0 0 0 17 
32 0 0 2 0 11 0 35 7 19 14 6 0 2 6 0 15 7 14 1 15 2 1 0 18 11 4 11 0 3 12 0 32 26 0 0 14 0 0 0 20 14 0 18 69 0 
15 34 36 13 0 0 9 0 0 0 7 0 17 0 20 3 0 8 6 0 21 0 1 0 2 0 0 13 0 0 0 0 2 0 22 34 12 19 45 17 0 25 0 44 7 0 
40 6 0 2 11 34 0 6 0 28 22 2 0 25 0 11 0 68 0 0 0 4 0 0 1 28 0 0 18 23 6 20 0 18 0 0 0 48 25 50 0 6 0 0 20 0 
0 8 0 0 14 2 4 15 0 8 1 0 0 19 0 30 2 0 2 23 13 19 0 10 0 5 0 0 0 17 0 0 6 30 0 0 0 0 17 0 19 0 23 0 0 30 
16 0 15 0 38 0 0 23 12 0 4 7 0 47 23 0 0 22 73 11 0 20 18 0 0 15 8 0 0 11 0 24 19 0 8 14 0 37 0 43 20 34 41 0 27 4 
11 5 0 9 17 57 39 0 0 0 24 0 0 6 10 2 10 3 1 0 3 30 0 0 6 0 5 14 0 9 19 0 0 0 24 11 0 0 7 15 38 2 29 38 17 0 
0 0 19 0 28 0 31 14 0 12 0 9 10 0 11 0 25 0 5 0 16 63 10 0 0 6 0 0 7 0 15 7 28 11 0 15 0 31 0 0 7 26 17 21 1 1 
16 0 39 4 26 2 0 0 12 23 0 5 0 3 8 8 0 15 0 0 0 0 11 0 0 0 19 0 15 0 26 0 23 0 0 5 5 0 0 6 0 50 0 1 0 0 
0 1 12 27 53 19 35 5 13 7 24 4 0 0 9 1 7 32 9 31 5 2 23 0 2 16 20 14 0 10 0 0 0 0 8 10 1 0 28 0 32 64 30 0 8 33 
0 1 28 8 0 5 12 9 0 0 18 42 0 12 13 0 5 8 22 0 0 10 0 13 4 0 0 0 0 7 22 0 0 0 0 0 13 13 4 3 5 17 22 32 8 0 
0 19 0 0 0 42 36 7 0 4 11 0 8 8 26 13 0 0 0 7 8 26 0 0 3 7 1 0 0 8 12 32 1 9 14 1 2 6 5 23 46 20 12 10 1 0 
11 24 0 22 0 7 0 0 1 35 0 35 0 0 0 5 25 6 0 21 5 6 0 0 0 38 3 12 0 39 19 0 24 5 11 11 1 12 5 0 3 22 26 1 8 24 
19 0 7 5 0 0 38 8 0 33 26 4 50 0 9 0 0 45 6 9 0 0 0 22 11 0 14 0 2 11 12 0 0 2 25 1 5 0 0 23 6 0 36 8 2 28 
11 0 0 12 0 0 39 0 0 0 0 14 0 0 56 6 0 25 0 0 0 0 14 5 7 8 32 18 17 0 0 17 3 0 12 0 12 10 12 0 17 14 0 0 0 22 
17 2 30 16 67 1 0 29 20 8 23 9 0 15 0 19 5 22 35 11 34 0 8 7 0 5 0 18 2 0 2 0 0 20 10 0 32 10 20 32 33 36 0 35 2 25 
8 5 3 2 1 12 11 0 0 0 0 33 12 0 10 0 2 11 0 11 0 1 2 0 0 21 0 6 0 12 2 0 0 0 0 4 0 0 35 6 29 4 0 5 0 0 
26 0 0 4 0 17 0 0 0 12 3 0 26 14 12 20 1 6 0 0 18 12 19 6 6 19 12 22 16 14 0 11 3 5 0 0 9 2 4 6 0 39 12 0 0 24 
0 14 0 1 2 0 0 15 0 26 0 10 0 7 0 0 38 28 9 0 4 9 0 7 0 0 13 2 0 5 19 0 0 19 3 8 0 0 2 18 13 34 8 2 5 34 
28 1 86 22 37 0 0 27 0 23 0 3 12 8 0 0 30 0 0 17 4 0 30 0 9 22 12 30 40 10 17 0 28 8 33 47 6 14 0 16 8 31 9 18 18 0 
0 25 42 22 0 3 0 59 0 14 3 0 0 3 0 6 26 11 0 1 12 0 20 21 9 11 37 5 0 18 0 0 29 3 5 31 5 3 0 0 4 36 13 1 4 0 
16 12 32 37 0 3 0 15 1 0 3 5 2 0 0 14 9 9 0 11 9 0 0 0 0 6 6 0 0 7 0 0 5 18 0 0 0 35 5 0 39 4 0 27 0 0 
39 3 9 0 3 4 0 0 13 0 0 9 7 8 0 0 0 19 0 7 0 2 0 8 6 0 13 0 19 0 9 18 0 0 35 16 2 0 1 0 0 1 3 14 0 7 
0 0 4 0 18 0 0 0 0 8 0 27 3 20 13 0 0 9 36 1 16 7 18 6 0 0 0 0 7 0 14 0 11 1 13 24 0 3 7 0 9 7 15 0 10 0 
21 33 1 0 0 12 0 0 30 0 21 0 14 45 5 30 0 55 41 5 3 0 0 0 0 0 11 17 0 0 0 0 0 6 5 0 0 10 30 17 0 51 15 0 40 1 
0 0 0 40 0 19 16 0 18 15 0 0 0 0 0 0 0 0 12 16 0 0 16 13 15 0 3 0 0 7 25 25 0 0 12 12 0 10 0 59 0 17 1 0 0 0 
