46 26
31 26 14 0 0 7 0 0 68 9 21 12 5 28 0 24 1 13 39 8 6 8 0 0 3 7 6 0 3 22 10 0 14 2 0 0 46 12 0 24 6 41 16 25 21 0 
0 24 0 13 0 19 0 0 26 0 11 51 1 21 0 0 24 0 0 15 0 20 0 0 9 41 0 0 0 5 0 0 0 10 7 19 0 0 0 0 53 0 0 2 0 24 
0 25 11 36 11 15 0 0 0 0 58 0 30 10 18 20 17 15 23 3 11 7 22 21 0 11 4 15 28 18 19 0 22 0 24 3 16 0 0 13 6 5 12 12 5 0 
0 36 0 1 9 11 25 0 3 82 0 0 22 0 0 9 0 19 0 0 0 0 0 13 12 0 6 0 5 0 0 25 0 5 0 3 1 36 41 0 0 0 33 0 0 7 
0 34 0 0 0 0 14 0 28 26 0 31 0 0 6 2 27 4 0 0 16 15 16 0 2 5 0 0 0 0 15 12 12 0 0 23 28 0 16 0 0 0 12 15 0 0 
0 0 0 0 63 22 14 19 0 0 0 0 15 21 0 0 0 0 4 22 15 0 18 0 0 33 19 7 18 0 15 18 0 0 56 3 0 24 0 3 0 16 11 1 0 0 
31 0 0 18 0 0 0 0 33 24 44 0 12 0 0 44 9 0 9 0 1 19 0 0 10 15 11 0 18 16 0 16 14 24 0 0 0 1 0 27 0 6 10 18 43 5 
0 20 0 30 8 9 8 32 13 0 0 0 8 19 54 24 28 0 7 7 4 7 6 16 6 5 0 3 0 0 1 17 19 6 0 20 0 1 10 12 17 34 0 67 0 2 
0 20 0 0 0 0 3 0 19 0 0 0 0 5 12 6 0 0 15 8 0 26 2 0 2 0 16 5 0 12 0 0 3 26 0 0 0 0 9 2 22 0 0 0 11 0 
0 0 7 18 0 40 8 1 15 9 35 34 15 17 18 0 0 0 0 7 13 26 0 23 0 0 6 0 18 17 15 0 0 0 1 4 0 0 0 11 0 0 0 0 0 89 
42 0 0 0 0 30 28 29 0 41 1 0 13 23 31 1 7 9 9 15 0 11 2 0 18 18 9 3 8 8 10 7 7 8 35 30 37 3 0 11 0 30 28 10 9 24 
0 37 0 0 0 12 3 0 17 6 3 0 0 1 0 2 0 0 3 13 0 2 0 0 0 0 0 0 3 0 22 7 13 0 4 0 0 0 41 11 2 0 14 0 0 0 
35 10 0 1 11 50 0 0 0 1 9 6 10 0 0 30 0 0 0 19 0 1 10 1 0 21 0 17 4 24 0 9 0 33 0 0 0 0 12 0 0 6 0 0 56 36 
25 41 12 14 24 36 31 0 23 28 0 5 0 0 0 0 0 23 14 0 8 9 16 1 6 22 16 11 0 9 1 7 28 2 0 12 5 15 7 0 20 41 0 6 7 0 
0 0 14 13 0 20 0 0 3 0 0 0 0 0 0 0 0 0 4 0 4 4 2 1 4 6 12 0 0 0 1 0 0 0 6 0 0 0 5 10 17 0 0 0 0 9 
7 21 36 0 23 33 0 9 0 0 7 2 7 23 0 0 21 15 9 22 0 9 12 2 15 0 0 23 0 29 0 5 13 0 22 3 0 0 33 28 15 22 0 0 9 0 
17 0 4 14 37 28 0 6 0 0 0 0 0 20 23 8 0 26 0 20 17 16 0 5 11 0 11 0 3 0 0 0 6 37 1 10 0 2 0 33 2 81 1 9 0 0 
2 13 39 18 5 18 46 0 38 17 13 19 0 6 0 34 26 0 28 8 16 26 28 27 13 3 29 9 4 14 30 22 0 5 5 18 0 17 6 0 0 36 18 25 29 76 
4 0 16 0 9 0 12 0 0 3 51 3 0 3 8 3 17 0 27 14 0 0 8 0 13 6 3 16 5 9 20 7 6 29 0 1 0 0 0 0 5 31 0 10 20 0 
0 19 0 8 0 7 14 0 32 26 29 42 9 12 1 0 17 16 3 11 0 29 23 2 7 0 9 4 4 10 15 0 13 4 0 26 23 19 15 41 62 0 2 6 26 39 
16 0 0 0 18 0 3 26 37 0 35 0 0 20 8 18 10 1 1 15 0 12 0 5 2 0 2 0 18 18 16 3 7 26 6 0 6 7 0 1 0 2 32 33 0 0 
27 38 0 8 0 4 4 0 0 3 84 0 28 0 0 0 0 1 0 7 12 4 0 0 11 7 18 44 3 0 0 30 1 21 0 2 0 25 4 48 49 19 0 0 21 0 
32 22 0 36 17 28 26 0 2 16 7 1 11 0 14 0 15 0 14 0 13 15 0 0 6 24 0 0 2 17 5 0 28 45 5 0 15 0 3 19 7 0 0 10 0 0 
38 19 30 0 0 25 0 17 14 26 0 22 3 11 0 6 0 7 7 0 11 0 4 41 7 14 0 18 17 0 1 11 33 0 0 0 0 14 36 17 4 16 19 33 5 27 
0 0 22 18 43 0 2 0 0 15 0 0 16 24 0 0 10 0 0 19 16 0 0 0 25 0 10 0 1 26 2 0 6 0 0 0 0 24 0 29 1 0 18 0 0 0 
66 39 3 0 0 38 0 11 0 9 0 3 9 0 14 1 4 0 15 0 15 19 5 2 0 15 3 5 23 7 0 0 32 0 10 0 0 0 0 0 24 2 20 32 0 0 
