46 26
0 0 43 0 41 42 0 31 8 0 0 16 19 11 0 34 1 15 0 0 0 7 0 0 10 0 0 21 15 0 28 19 12 22 10 8 9 22 31 30 27 20 0 8 33 64 
14 0 21 0 0 7 4 0 15 0 44 27 0 0 35 18 11 9 8 17 6 0 4 0 18 8 27 5 0 0 16 0 7 0 0 0 10 0 31 13 30 10 18 13 0 0 
0 0 9 1 9 18 23 14 4 0 41 3 16 0 47 7 31 23 16 0 4 10 15 8 3 0 0 10 34 0 2 21 10 4 28 0 8 0 15 7 24 27 24 11 0 21 
84 23 4 3 0 44 19 0 0 30 0 5 0 29 30 15 22 0 21 0 20 19 16 0 44 0 26 0 26 8 0 8 4 17 0 10 0 24 38 0 13 0 19 4 30 1 
13 0 10 0 12 6 14 37 3 16 32 3 3 21 0 0 21 0 23 0 3 16 21 0 8 0 0 39 0 0 0 0 0 0 0 19 0 0 0 0 0 10 32 4 37 0 
3 4 35 7 36 0 0 20 30 27 7 11 34 0 11 12 0 24 0 1 8 31 7 8 22 25 0 34 14 2 11 0 22 0 0 1 8 21 28 0 36 6 0 5 23 0 
0 22 0 0 8 31 18 2 0 0 0 34 0 0 5 17 0 0 23 0 4 16 1 33 0 4 10 1 7 2 0 41 21 4 14 14 9 14 18 0 0 2 0 38 0 59 
35 14 4 24 14 0 0 0 12 16 15 16 3 0 21 0 9 0 0 24 4 27 0 0 4 0 0 2 0 0 0 24 13 0 0 0 8 4 38 0 0 0 42 20 0 0 
37 9 8 35 33 32 7 25 2 11 12 0 32 4 22 33 17 3 0 25 26 10 5 7 10 13 30 44 8 8 5 16 22 21 9 31 21 13 35 25 15 0 5 21 24 0 
0 1 37 2 2 32 5 25 5 4 0 4 0 5 2 0 0 17 21 0 0 10 10 4 15 10 0 0 19 0 0 1 31 15 2 0 0 32 0 58 38 0 0 0 1 11 
11 32 0 5 0 7 1 12 17 0 18 12 0 50 8 0 0 0 0 0 11 0 0 0 0 0 0 0 18 0 13 18 32 0 2 0 7 26 6 0 0 0 0 5 0 0 
0 0 0 0 52 0 3 0 0 15 0 0 0 0 0 23 13 2 0 0 3 0 0 15 0 0 6 9 14 20 14 19 29 0 5 8 3 0 38 11 0 6 15 19 1 0 
24 0 6 10 0 7 0 33 2 31 4 5 36 20 6 44 12 1 0 9 0 0 0 0 4 0 11 10 10 0 0 0 0 20 4 0 0 7 1 0 2 26 39 1 7 0 
30 0 0 14 6 7 0 0 0 0 5 0 5 15 0 7 12 6 0 0 13 0 0 8 18 0 6 12 16 0 8 21 0 18 6 2 8 0 1 0 0 0 23 0 0 0 
16 8 10 0 14 30 31 8 0 4 0 0 0 31 0 34 9 6 26 24 0 0 0 0 0 0 0 12 0 0 0 20 0 7 0 30 0 31 0 0 13 1 0 11 31 0 
0 3 5 5 4 35 0 16 14 0 44 21 6 0 0 13 22 0 1 0 12 7 0 16 8 20 0 13 2 0 0 0 1 0 0 0 1 24 28 0 30 4 0 11 0 0 
3 0 0 20 28 0 0 0 0 36 9 0 4 0 0 0 10 0 8 7 10 21 0 20 0 0 13 11 0 8 7 0 8 0 0 19 0 0 11 13 19 37 2 0 14 36 
0 9 8 1 11 0 0 0 2 0 13 21 0 10 0 23 0 2 0 0 0 0 15 20 1 0 0 0 0 2 0 3 0 0 0 0 0 28 1 0 0 0 0 8 0 0 
0 3 17 0 0 0 0 31 8 4 9 0 18 0 0 13 0 20 0 17 3 0 0 0 9 18 0 14 0 0 0 1 0 0 27 0 0 22 31 24 0 0 7 16 0 2 
4 50 0 10 0 0 22 0 0 0 0 2 8 30 20 37 16 14 0 25 5 0 14 12 7 0 22 21 14 0 0 12 0 30 30 54 18 14 1 0 0 2 0 74 82 0 
43 2 5 11 0 35 0 25 0 3 21 0 17 0 9 6 0 6 0 0 0 0 0 0 14 15 0 7 2 0 2 14 21 23 12 0 0 0 0 0 0 0 0 71 0 30 
0 6 0 0 65 0 15 0 16 16 5 26 27 0 19 1 0 24 0 9 11 5 17 0 0 0 4 1 0 16 8 0 0 14 0 3 0 0 41 35 0 22 0 13 0 7 
18 5 26 15 0 7 0 14 7 0 0 3 11 0 13 13 0 0 0 0 0 31 0 5 0 0 14 0 13 0 0 0 65 0 0 5 0 0 31 16 5 0 8 0 2 63 
32 38 16 19 0 0 25 0 0 6 7 0 28 0 0 0 26 35 3 13 10 20 19 0 15 7 0 0 10 0 0 0 7 0 0 37 31 20 0 38 15 0 25 23 0 0 
27 62 0 0 0 0 24 0 16 0 0 3 16 0 4 0 16 5 0 2 6 2 0 0 11 0 0 32 14 0 0 28 19 0 0 3 0 0 0 15 0 0 1 1 0 0 
0 3 4 8 26 68 13 0 0 4 0 29 14 9 0 0 9 35 5 0 0 7 4 0 0 12 5 21 14 0 14 26 0 0 0 0 4 12 0 34 35 21 5 1 15 0 
