46 26
6 7 25 0 0 0 11 0 0 16 88 0 28 30 0 24 0 20 0 34 5 0 16 16 0 6 7 0 0 11 10 10 0 9 0 0 2 8 28 0 28 0 6 6 16 23 
0 27 37 0 0 7 0 35 7 18 0 0 0 35 42 0 63 7 0 0 24 12 0 10 13 0 44 18 1 15 0 0 18 24 24 3 1 1 0 69 0 19 28 42 26 24 
35 0 1 19 14 15 0 0 19 1 7 8 0 0 5 0 0 0 17 5 20 27 0 3 0 0 0 8 14 6 9 0 0 0 0 13 5 0 0 6 14 0 0 0 8 6 
44 17 21 22 8 3 5 27 17 1 28 10 0 11 30 0 2 0 8 10 0 0 14 3 16 26 0 0 0 20 13 0 5 18 0 5 0 36 20 20 0 0 0 0 58 0 
8 35 0 39 0 20 9 0 0 0 0 12 28 8 10 1 20 0 21 14 32 8 0 20 41 17 4 0 12 0 0 11 17 1 0 4 0 0 7 34 28 0 0 4 20 12 
18 31 8 0 0 0 21 1 0 1 12 13 9 0 2 0 6 27 5 0 11 9 0 3 8 0 2 6 0 0 11 8 31 0 0 27 26 45 0 4 0 5 35 41 0 0 
11 0 7 31 4 3 21 0 20 41 0 2 7 2 37 7 9 45 14 5 15 6 19 2 4 22 0 12 32 6 0 0 0 0 45 0 8 17 22 2 0 40 0 21 0 26 
0 6 0 0 11 0 0 0 26 24 2 0 2 0 0 11 0 7 0 0 13 0 0 0 7 16 0 0 0 0 5 0 0 24 36 2 1 0 3 14 0 28 6 0 0 0 
0 40 10 0 25 7 15 0 2 16 0 0 10 8 0 0 0 12 0 0 20 9 0 14 12 0 0 0 0 15 0 6 5 4 0 5 30 24 17 2 20 28 0 14 0 41 
9 0 0 28 20 0 0 4 0 0 3 16 0 0 1 0 5 0 12 0 0 10 0 0 20 0 5 30 2 3 0 28 3 0 0 0 0 8 14 2 11 0 2 0 0 0 
13 34 42 0 24 11 36 14 0 9 0 0 12 9 10 39 9 59 25 13 10 5 0 0 0 3 7 0 6 13 2 10 17 15 0 0 19 52 21 0 0 17 7 0 22 20 
3 1 0 19 0 0 1 0 11 0 0 8 9 0 23 0 0 0 2 0 0 5 58 16 0 25 0 0 0 0 10 1 0 2 23 0 0 23 0 16 0 0 0 0 8 0 
18 27 22 44 0 8 0 10 31 0 12 1 0 0 0 12 3 11 7 36 25 0 8 0 0 0 0 0 28 28 5 1 0 0 0 39 28 0 0 9 6 0 7 0 13 0 
82 0 7 0 10 0 0 0 7 0 0 43 8 0 46 7 0 0 0 3 9 7 0 1 0 9 0 0 0 0 28 0 0 2 0 12 0 49 27 18 26 0 0 29 14 45 
0 31 0 0 0 0 9 0 25 0 0 5 8 16 8 0 9 0 21 5 7 5 0 0 0 6 5 7 33 4 8 0 0 25 33 9 0 0 23 2 39 0 14 0 22 0 
0 0 0 0 0 23 0 4 0 9 5 28 0 0 0 1 26 0 1 41 8 24 0 0 1 30 9 1 31 7 12 3 0 0 5 3 0 14 22 29 0 0 17 0 0 35 
24 0 0 0 0 29 0 0 0 29 0 3 0 3 18 0 35 29 0 2 23 5 19 0 20 9 9 8 13 0 21 5 18 6 9 14 0 3 1 21 10 2 11 0 43 0 
0 0 5 21 8 0 0 1 1 0 3 5 8 24 23 30 1 14 11 11 0 28 11 0 2 33 22 0 3 19 1 0 2 25 2 10 0 63 37 12 13 0 0 18 43 11 
4 0 55 37 0 40 8 0 6 25 45 3 13 0 4 4 0 12 0 0 9 13 20 0 13 9 1 0 0 16 28 0 16 0 39 33 22 0 3 0 8 8 12 0 0 0 
28 0 0 0 32 0 25 4 0 0 6 56 0 0 9 0 9 24 34 20 0 21 0 0 20 9 4 14 20 0 0 25 13 0 0 2 21 8 3 25 0 33 24 0 36 0 
22 17 28 0 0 11 10 8 0 0 19 0 0 2 15 2 11 15 17 0 0 21 3 0 0 0 8 0 16 26 37 0 2 0 17 0 0 0 0 0 11 10 1 0 3 0 
11 0 0 0 16 0 0 6 0 0 9 28 2 6 10 27 0 0 0 0 0 3 0 0 0 0 11 0 24 0 0 0 0 39 0 0 0 0 0 18 1 0 7 0 0 0 
12 19 0 0 0 0 14 0 11 0 0 5 4 0 25 18 0 0 0 18 0 0 0 0 0 0 0 3 13 0 9 17 0 6 0 0 0 0 0 0 0 0 0 0 3 0 
20 22 0 45 4 0 45 0 0 0 0 27 9 0 3 15 1 1 7 0 0 18 12 10 9 8 0 16 18 26 8 0 0 0 10 0 13 0 23 22 0 7 0 22 6 0 
0 0 0 0 0 12 24 21 0 16 27 21 0 19 1 24 20 20 13 15 20 17 0 0 0 0 0 5 12 0 3 13 35 1 16 0 0 24 10 0 3 20 0 0 0 0 
0 27 11 0 41 22 3 0 25 11 31 14 4 0 31 23 8 1 18 5 11 4 22 0 7 29 14 3 38 0 1 0 0 24 35 20 7 33 49 2 0 45 22 9 39 14 
