14 8
0 7 11 0 0 0 2 0 4 0 0 4 0 18 
0 3 0 0 0 0 0 4 0 1 1 5 11 0 
6 2 9 9 4 0 4 5 7 0 7 2 0 4 
12 2 2 0 0 0 0 0 2 0 12 0 0 0 
6 4 0 0 0 0 3 8 11 0 9 1 0 0 
11 3 4 0 2 0 6 2 10 2 0 13 5 7 
11 0 6 1 0 0 0 2 0 0 0 2 0 0 
0 4 0 0 3 0 2 0 0 0 0 0 0 12 
