14 8
15 0 23 0 4 4 2 6 6 3 2 5 0 20 
0 3 11 0 0 0 0 0 0 0 6 6 1 10 
0 0 8 5 0 2 1 12 0 0 11 8 5 10 
0 0 4 9 0 4 2 1 0 0 5 0 6 3 
11 3 3 0 0 4 0 0 0 0 0 11 0 0 
5 12 0 0 0 0 2 0 0 3 0 0 5 12 
6 0 6 0 0 2 2 4 0 0 4 1 3 0 
0 0 5 5 0 2 0 7 0 0 11 9 8 7 
