14 8
0 0 7 0 7 0 0 4 2 0 2 7 0 0 
0 0 0 0 9 0 0 3 0 0 3 2 3 10 
9 0 2 5 2 4 0 4 5 11 0 0 0 0 
0 0 10 5 0 0 3 0 0 7 7 0 3 0 
12 9 0 3 8 0 2 7 5 6 16 1 9 0 
2 0 23 0 2 3 0 0 3 7 0 3 0 7 
12 2 0 5 0 12 2 6 0 2 2 1 9 0 
0 0 2 0 0 0 0 0 0 0 0 9 0 0 
