14 8
0 0 0 2 0 2 0 0 0 0 0 0 0 0 
0 11 3 13 0 4 2 0 6 5 0 0 7 3 
0 0 0 12 0 5 0 2 0 2 1 0 10 0 
0 0 12 1 0 7 0 0 0 0 0 9 0 0 
3 0 2 4 1 0 0 0 0 3 0 0 0 3 
3 0 2 1 2 8 0 2 1 1 3 6 0 5 
4 0 0 0 8 1 0 0 0 6 7 0 0 0 
16 4 0 3 2 11 3 12 7 0 2 4 4 19 
