14 8
1 4 0 4 2 5 6 3 0 2 0 5 0 0 
0 0 0 0 9 7 0 3 0 3 3 0 4 3 
2 0 0 0 2 0 0 0 0 0 0 0 0 0 
0 0 0 5 3 0 2 4 8 0 0 2 3 0 
28 7 0 3 4 0 0 1 2 9 12 11 1 0 
0 0 0 4 0 12 1 2 2 0 0 2 0 8 
10 0 4 0 0 2 1 7 1 1 12 2 5 2 
0 0 0 3 1 1 2 4 5 3 2 0 0 6 
