14 8
0 9 0 6 1 8 0 0 0 7 8 0 3 11 
3 14 5 5 3 0 0 0 0 1 9 0 10 1 
1 0 0 0 0 0 0 0 0 0 2 0 0 1 
4 1 0 0 8 1 9 0 0 5 2 0 1 3 
0 0 0 14 0 2 2 0 0 6 0 0 0 10 
9 2 0 0 0 0 1 1 0 11 0 2 0 0 
3 11 3 20 2 0 6 6 4 5 8 9 5 12 
0 1 1 0 0 0 0 0 0 0 0 0 4 0 
