14 8
9 0 0 3 3 0 0 0 0 4 0 7 3 2 
0 8 0 6 1 8 0 5 0 8 0 4 6 5 
0 12 0 0 0 0 0 0 0 0 0 0 3 17 
0 12 11 10 0 0 1 2 8 1 2 2 4 16 
4 13 0 3 9 8 0 7 0 1 0 4 1 34 
0 1 0 6 0 0 0 1 0 4 0 5 3 3 
0 0 0 1 0 0 0 8 0 0 0 1 1 5 
7 8 0 7 0 0 0 0 4 12 0 4 0 0 
