14 8
0 6 4 0 3 0 4 0 5 3 4 0 0 7 
17 1 7 0 4 0 0 7 6 2 0 0 16 10 
5 0 0 0 0 0 0 0 0 1 4 0 0 0 
15 0 0 0 9 0 0 0 0 0 5 0 0 13 
1 0 13 3 4 0 4 0 6 0 5 0 0 3 
15 0 6 2 0 0 4 0 5 0 0 9 12 0 
3 5 1 6 1 5 0 4 0 1 3 0 5 0 
4 0 0 1 7 0 3 3 8 1 13 0 0 10 
