14 8
8 0 6 0 1 3 5 0 13 7 6 5 4 11 
3 2 2 13 0 5 6 0 0 0 7 0 0 2 
0 0 0 1 8 8 7 0 0 0 0 0 0 12 
1 1 3 10 0 0 0 0 0 0 0 0 1 8 
10 3 2 0 14 0 0 0 0 0 4 0 0 9 
0 0 0 0 1 0 5 0 0 4 5 3 0 1 
5 1 4 0 1 16 1 6 6 0 0 6 5 6 
5 0 0 9 6 18 3 4 0 0 5 6 1 10 
