14 8
0 0 0 0 6 6 0 0 0 1 1 19 0 0 
0 0 0 0 0 4 0 0 4 0 3 0 5 3 
5 9 0 2 0 8 6 0 4 2 10 2 7 0 
10 0 0 2 0 3 0 0 0 0 4 0 0 0 
5 12 11 2 0 2 1 15 0 0 3 4 3 4 
7 0 11 0 1 13 3 7 7 0 2 0 5 19 
0 0 10 8 4 0 0 0 4 5 8 4 14 11 
0 5 4 0 0 0 11 3 3 0 4 4 3 0 
