14 8
13 4 0 0 2 4 0 0 4 0 0 0 0 8 
1 0 5 4 10 3 7 1 0 0 0 0 0 16 
0 6 15 1 1 0 5 3 3 0 2 9 0 3 
2 1 2 0 0 0 3 0 0 2 0 2 1 2 
1 0 0 2 0 2 0 3 0 1 1 3 0 0 
13 7 0 0 9 0 7 2 10 0 3 0 0 12 
26 0 0 8 3 0 3 0 4 0 7 0 12 11 
16 0 0 6 4 5 0 0 8 0 0 3 12 9 
