14 8
5 4 0 6 0 0 0 5 0 1 0 0 5 0 
5 6 0 0 7 5 0 0 0 1 6 6 1 0 
0 3 0 3 0 0 0 0 0 6 0 0 0 0 
0 0 0 0 1 6 0 0 0 5 6 7 1 2 
0 11 0 4 1 1 2 6 10 0 1 0 2 8 
12 14 0 2 1 5 0 1 8 8 10 2 20 10 
5 0 0 5 0 4 4 0 0 4 0 0 0 5 
0 2 0 3 0 5 2 0 5 2 6 6 2 8 
