14 8
13 4 8 10 0 9 0 11 0 6 3 1 0 2 
6 1 6 1 15 0 0 4 12 0 10 5 4 21 
8 3 4 8 3 0 3 10 6 0 2 0 9 1 
0 0 0 5 2 3 2 0 3 0 0 0 0 0 
4 0 0 0 0 3 0 1 0 0 7 0 2 8 
0 0 0 3 0 5 0 0 7 0 0 0 4 0 
0 0 7 15 3 2 1 8 0 6 1 8 5 0 
11 6 0 0 6 0 0 3 0 0 1 11 0 0 
