14 8
6 10 7 6 0 9 4 4 4 0 0 10 4 0 
0 0 0 8 4 1 0 5 4 3 0 1 10 0 
5 5 8 3 2 3 5 0 5 0 9 0 0 0 
0 0 0 0 0 0 10 2 0 0 1 2 0 7 
24 0 0 4 8 9 1 3 1 0 10 11 8 0 
1 0 0 0 8 5 5 0 3 0 0 7 6 0 
6 2 0 4 0 0 0 3 0 0 3 0 2 0 
5 0 3 2 3 2 1 2 8 0 3 0 3 13 
