14 8
0 18 0 7 4 3 9 2 7 5 5 0 1 12 
0 0 0 2 0 1 6 1 3 3 0 0 1 0 
0 7 0 9 0 0 3 5 12 4 0 4 0 10 
0 0 0 6 0 2 0 1 3 2 2 0 0 0 
0 6 0 4 4 2 3 4 6 3 0 0 0 0 
0 11 0 3 0 7 1 0 0 7 2 0 11 4 
4 1 1 10 10 8 5 1 7 5 1 0 0 0 
0 0 14 8 0 0 1 0 7 0 4 0 0 11 
