14 8
6 1 4 4 0 1 5 0 6 0 6 1 2 0 
7 0 2 3 0 5 0 0 4 0 5 1 2 5 
3 0 10 0 1 0 3 0 0 0 0 0 10 2 
1 17 2 2 1 5 5 1 1 0 0 0 0 12 
12 2 0 1 0 4 1 1 1 0 1 1 21 12 
4 0 1 3 0 0 3 10 4 0 0 0 4 0 
0 12 1 4 0 0 0 0 0 1 11 2 0 5 
0 0 0 2 1 1 3 4 4 0 4 0 10 7 
