14 8
16 0 0 4 1 0 2 7 0 11 1 3 0 0 
2 9 3 5 3 0 0 4 1 2 9 0 0 0 
8 1 5 2 1 6 10 8 0 6 4 1 6 7 
0 0 0 1 7 1 0 4 3 0 0 0 9 0 
0 7 0 0 3 2 3 1 7 0 4 5 1 0 
0 8 0 2 0 0 1 0 0 9 1 1 0 0 
4 0 0 10 0 1 0 0 3 4 4 1 0 10 
0 6 10 4 5 2 0 6 4 4 0 6 10 4 
