14 8
0 7 11 0 0 0 0 4 0 11 1 9 13 6 
17 7 6 0 5 0 0 2 6 1 15 11 8 0 
3 3 7 7 0 0 5 2 7 2 0 10 10 10 
0 17 3 0 6 7 0 6 2 0 8 2 5 1 
1 12 1 1 0 0 0 0 3 0 0 0 0 7 
16 0 8 0 10 0 4 5 1 1 0 1 8 13 
0 0 3 0 0 0 0 5 11 0 5 2 0 0 
0 0 17 1 8 3 5 0 3 0 3 7 0 14 
