14 8
6 3 0 5 1 16 2 0 4 1 3 11 0 8 
6 10 0 10 8 0 6 4 0 0 0 3 0 10 
6 0 5 0 0 0 7 4 2 4 0 0 13 4 
4 14 0 0 5 0 6 2 0 8 0 3 17 5 
1 3 6 0 0 3 0 3 1 0 1 1 11 1 
0 0 9 0 0 0 0 4 0 2 2 8 1 3 
3 1 20 0 2 8 0 9 0 7 0 9 0 12 
6 0 5 0 0 0 1 3 3 0 0 6 0 3 
