14 8
7 4 0 17 0 0 6 7 2 1 4 5 9 4 
3 0 2 2 13 0 5 0 1 0 8 0 0 9 
6 0 0 4 0 3 0 1 6 1 1 11 2 1 
17 1 14 0 7 0 0 0 7 0 10 4 0 11 
21 4 11 6 0 2 0 0 9 5 1 0 0 28 
0 0 0 0 4 0 0 9 0 0 0 4 8 0 
0 20 10 2 4 8 2 1 4 15 0 0 0 20 
5 8 6 2 0 11 0 8 4 0 0 10 14 0 
