16 9
0 0 0 0 0 0 4 0 0 2 0 0 3 4 5 0 
11 26 0 10 9 0 21 0 0 0 7 5 0 12 0 25 
0 0 1 3 0 0 1 0 0 0 0 0 0 0 0 1 
0 6 1 0 11 0 0 6 0 0 3 7 0 2 0 0 
0 0 11 4 0 6 1 1 1 4 2 4 0 15 0 0 
4 0 10 0 10 0 0 0 4 15 0 0 10 5 0 6 
0 0 0 0 0 0 5 0 0 6 5 0 2 2 0 5 
0 0 12 0 4 0 0 0 6 0 0 0 9 1 20 0 
0 14 0 7 3 0 11 0 0 0 2 0 13 14 8 0 
