16 9
0 5 8 0 6 2 8 6 0 5 7 0 2 4 4 11 
0 0 1 4 0 1 0 11 0 0 0 0 1 0 7 8 
6 0 6 11 0 5 0 0 0 0 7 0 10 0 11 0 
7 0 3 0 10 10 0 10 0 0 0 7 5 0 0 12 
0 14 0 0 13 5 8 0 0 4 5 7 0 0 2 14 
0 34 3 3 0 3 11 3 0 8 0 0 3 12 13 18 
4 0 0 0 0 0 0 7 0 0 0 1 1 0 0 0 
0 0 0 0 0 0 0 0 0 0 0 0 0 0 0 6 
0 0 0 12 10 0 0 0 0 4 8 0 3 0 18 12 
