16 9
0 0 4 6 0 0 1 7 0 4 1 13 9 12 2 9 
15 0 1 0 2 13 4 5 1 1 6 2 5 0 0 5 
2 7 2 4 3 0 0 8 0 8 0 2 3 0 0 8 
0 0 0 0 3 0 0 8 2 0 0 0 1 0 4 11 
0 0 13 4 0 0 0 8 7 0 0 0 0 0 0 12 
12 25 5 0 0 7 0 0 0 0 3 0 35 2 0 14 
5 0 1 10 3 5 0 0 5 0 5 0 0 0 0 0 
0 0 0 0 0 0 3 0 0 2 4 0 0 0 5 0 
6 0 0 6 5 0 6 0 0 0 0 0 0 0 0 0 
