16 9
2 13 4 0 4 6 0 10 3 2 6 0 0 0 12 7 
6 4 0 0 0 10 6 1 0 0 6 0 0 0 0 0 
20 2 19 9 0 8 0 1 9 6 0 6 3 6 2 18 
4 0 4 0 0 5 0 0 0 0 0 0 0 0 5 0 
2 0 5 5 2 3 0 0 7 0 0 0 0 0 0 0 
0 1 1 2 0 0 10 1 4 0 0 0 0 0 0 9 
0 0 0 0 1 4 0 0 1 0 1 0 0 0 0 0 
8 0 28 0 0 6 0 0 5 0 6 3 0 11 0 13 
4 0 16 3 0 0 0 0 3 5 10 14 10 0 3 8 
