16 9
0 0 0 0 8 22 1 0 0 7 5 0 5 0 1 0 
5 10 0 0 9 16 5 9 0 5 0 5 1 11 6 10 
0 0 15 0 0 0 4 0 0 4 0 0 2 15 0 0 
10 3 0 0 4 0 7 0 2 10 0 2 0 4 0 8 
0 10 0 0 4 4 2 0 0 0 0 12 0 0 0 0 
0 13 0 0 0 0 0 0 0 0 0 0 0 0 13 2 
0 19 0 1 1 6 11 0 0 0 0 2 6 2 13 0 
4 11 0 0 3 0 0 0 0 8 0 0 8 0 0 3 
14 2 0 0 7 12 1 2 0 13 0 0 1 7 23 11 
