16 9
0 0 0 2 0 0 0 0 0 0 3 0 8 0 6 0 
2 0 1 0 0 7 4 8 8 6 0 1 14 8 3 2 
0 6 0 5 7 4 0 0 0 0 0 10 0 0 0 0 
5 0 1 0 0 0 3 3 5 0 3 0 5 11 1 8 
0 0 3 0 7 0 0 0 6 0 0 7 0 2 6 1 
0 13 13 2 1 0 1 0 0 0 0 0 4 0 12 14 
0 0 4 1 0 0 3 5 0 0 0 0 0 2 6 0 
18 11 4 6 0 0 0 0 1 16 0 2 6 1 0 15 
4 0 10 1 6 0 0 0 5 0 0 8 1 0 0 0 
