16 9
0 4 0 0 0 0 0 0 0 7 1 0 5 12 0 2 
15 0 0 0 1 1 0 0 0 6 5 0 7 0 0 15 
0 2 0 3 2 10 5 4 4 2 2 2 1 0 6 17 
0 0 0 0 9 3 0 0 1 0 0 0 1 9 0 0 
14 20 8 0 2 0 0 3 12 0 0 0 32 5 0 0 
2 0 11 0 0 0 0 3 1 1 0 0 5 0 0 0 
2 0 7 0 5 2 3 2 6 3 0 0 0 0 0 0 
9 0 7 6 0 8 0 3 0 5 0 0 0 11 0 15 
7 0 7 6 10 2 0 10 0 10 8 0 0 0 9 0 
