16 9
1 1 0 8 0 3 5 2 0 0 0 11 0 0 0 0 
0 10 0 2 1 2 0 2 1 0 10 10 0 0 7 0 
0 6 1 2 9 2 4 18 1 0 3 0 8 0 4 8 
0 0 0 0 0 0 0 4 0 3 0 0 0 0 0 0 
3 4 0 3 0 0 9 4 0 0 0 9 0 3 0 1 
0 0 6 1 0 5 1 0 6 4 2 0 0 0 3 1 
0 18 1 0 0 5 0 1 7 5 1 0 0 0 0 8 
0 0 0 0 0 2 0 17 0 4 8 7 0 3 0 0 
1 10 0 6 0 2 0 7 0 0 0 0 0 1 18 0 
