16 9
7 0 0 0 11 0 0 6 1 0 0 4 0 0 0 0 
3 1 2 0 8 1 0 6 8 0 0 0 0 1 0 0 
17 1 13 0 6 0 6 6 2 8 8 0 3 1 2 34 
1 0 0 0 0 0 3 5 0 8 3 2 1 1 18 0 
0 14 0 0 0 0 0 0 0 2 0 4 0 0 0 14 
3 0 0 0 7 0 0 7 0 4 5 0 0 4 7 5 
0 10 0 0 6 3 0 4 0 0 0 1 1 0 0 14 
4 0 3 6 2 2 0 1 4 6 0 0 2 0 6 0 
1 0 7 0 0 3 0 0 10 1 1 0 12 6 2 0 
