16 9
14 0 4 0 3 0 0 2 2 0 0 0 0 0 20 0 
17 2 0 18 0 8 0 4 5 6 0 0 5 1 14 13 
0 0 0 0 0 0 0 4 0 0 0 0 0 0 0 0 
0 0 0 0 12 0 0 1 6 3 0 0 11 0 0 1 
0 0 6 5 8 0 4 2 18 7 4 0 3 0 3 16 
2 0 0 0 4 8 0 3 0 0 0 0 3 0 9 0 
10 0 0 12 0 5 0 0 0 0 2 3 0 3 3 7 
8 4 0 1 0 2 3 0 0 3 0 0 9 0 3 0 
5 0 6 5 0 2 1 6 9 3 12 0 7 0 0 5 
