16 9
0 11 0 0 11 8 5 7 4 6 0 10 0 0 0 0 
0 3 0 4 2 0 2 0 0 0 0 0 3 3 0 0 
0 0 0 0 9 0 0 4 3 0 0 0 0 9 0 0 
0 10 1 0 4 1 0 1 11 0 0 0 2 0 5 14 
0 3 3 4 4 4 5 6 5 0 0 0 4 1 0 1 
0 5 1 3 3 0 4 2 10 6 3 0 2 0 3 6 
8 0 0 0 0 0 15 3 11 4 0 1 6 0 0 9 
0 12 3 0 0 0 0 4 4 0 3 0 5 0 0 5 
0 0 5 0 3 16 1 2 0 0 4 0 0 3 12 0 
