16 9
7 0 0 6 0 0 10 0 7 12 0 0 0 7 0 13 
0 13 0 0 0 13 0 0 0 0 5 4 7 5 16 0 
3 0 11 1 1 2 0 3 0 0 2 6 7 11 0 0 
0 5 3 4 0 15 0 4 1 1 5 1 0 0 0 10 
0 0 0 10 0 5 0 0 0 0 3 1 0 13 0 2 
0 0 0 0 3 0 0 0 0 0 0 1 0 3 1 0 
11 0 2 9 4 4 0 7 0 7 0 10 1 2 0 8 
0 0 4 0 0 5 4 3 0 0 0 5 7 0 0 0 
8 2 7 5 9 0 0 2 7 7 0 4 1 1 0 11 
