16 9
7 0 3 0 0 2 0 7 0 4 0 0 0 0 8 2 
5 0 0 2 18 4 9 0 0 2 0 7 0 0 0 7 
2 5 2 4 0 0 9 4 0 0 0 0 0 0 1 9 
9 4 2 11 2 7 2 4 3 19 4 5 5 10 11 7 
4 10 0 3 4 6 3 0 2 0 6 10 2 8 0 0 
2 3 9 0 6 0 0 0 3 0 1 19 0 0 0 5 
9 0 0 12 1 1 0 0 3 6 3 0 0 0 3 17 
16 4 0 0 1 0 0 0 0 0 0 11 0 0 0 0 
0 6 0 5 0 7 0 0 0 5 0 0 5 0 3 0 
