16 9
0 0 14 0 0 0 7 5 11 0 2 3 0 9 0 15 
0 3 1 5 5 6 1 0 5 0 7 6 3 0 0 6 
5 0 11 8 0 2 5 0 0 3 6 8 9 0 0 0 
12 0 9 0 0 1 0 0 0 7 8 0 7 5 1 6 
0 7 10 0 0 0 3 0 0 3 0 0 11 0 0 0 
0 6 0 0 0 0 0 5 0 5 3 0 3 1 0 0 
3 0 9 3 6 1 4 3 0 5 6 3 8 1 0 0 
14 2 0 0 0 0 9 2 0 0 0 1 0 0 15 16 
0 4 9 0 11 4 0 0 2 1 4 4 8 0 0 2 
