16 9
0 0 0 0 0 0 12 0 0 0 0 0 3 1 8 0 
0 0 0 9 3 0 3 4 0 0 7 0 0 1 0 1 
13 0 6 11 4 0 9 0 4 2 0 0 8 18 0 7 
2 0 5 3 0 0 2 0 4 2 0 0 0 0 0 0 
0 0 9 13 0 0 3 6 0 1 0 0 5 0 0 0 
0 0 0 0 0 0 0 3 0 2 3 0 0 0 0 2 
23 0 1 6 0 4 1 2 0 7 1 0 2 0 14 0 
4 0 1 11 4 0 14 3 12 4 0 6 0 10 5 2 
0 6 9 5 0 0 1 9 0 5 15 1 2 0 0 5 
