16 9
0 0 14 1 0 0 9 1 5 6 4 0 2 8 0 17 
0 8 0 0 4 0 2 1 4 8 0 5 0 0 0 0 
20 0 5 16 0 5 0 6 5 0 0 11 5 21 0 2 
4 5 13 0 8 4 0 9 9 2 2 0 0 0 0 20 
8 0 11 10 1 0 0 9 7 2 1 0 1 25 0 0 
18 2 0 3 2 0 8 0 0 0 3 1 4 1 14 2 
6 6 0 0 0 0 0 5 0 9 2 1 0 6 7 0 
0 17 5 0 0 1 0 6 0 0 0 1 19 0 2 0 
6 0 0 0 0 0 7 0 0 0 0 0 0 0 0 0 
