16 9
0 0 8 0 9 0 9 5 11 5 8 5 13 0 0 5 
11 11 1 0 12 1 2 1 1 0 2 4 0 3 1 1 
4 5 4 0 6 0 9 6 4 6 3 0 4 0 3 2 
9 0 0 0 0 0 2 4 0 8 0 1 0 0 0 0 
2 1 0 3 0 4 4 0 0 0 2 7 0 3 0 0 
8 2 0 1 10 0 7 3 11 0 0 9 0 12 3 0 
0 0 0 3 11 7 10 4 0 0 3 0 0 7 9 11 
14 0 0 0 7 0 0 1 1 4 5 7 0 0 8 1 
0 0 9 2 0 0 0 3 0 0 3 9 8 0 0 0 
