16 9
0 1 0 0 0 2 0 7 0 0 0 0 2 0 6 0 
0 7 7 0 10 8 0 0 1 2 9 9 11 0 0 11 
2 4 2 17 0 4 0 0 0 6 1 0 0 0 11 0 
1 1 0 14 0 1 4 4 0 0 4 1 10 3 5 0 
2 0 2 0 0 0 0 0 0 0 0 0 0 0 0 0 
0 4 0 0 0 0 0 1 8 5 0 0 0 2 10 3 
1 10 8 1 0 11 0 1 0 6 3 0 6 0 20 10 
26 1 0 0 6 1 2 12 0 9 13 0 1 7 6 0 
0 0 0 5 0 0 14 0 5 0 2 5 1 3 1 12 
