16 9
0 0 10 4 0 0 0 15 2 5 8 4 9 6 5 5 
5 1 0 5 2 0 1 7 0 4 5 0 12 0 0 0 
0 13 0 0 1 5 10 0 0 2 0 1 6 0 0 14 
0 0 10 0 0 0 6 0 0 0 2 1 2 0 3 0 
0 0 0 0 12 12 4 1 1 5 8 0 7 9 0 5 
1 0 0 10 9 0 0 5 0 3 0 0 0 21 1 0 
3 10 6 4 0 7 6 2 6 6 15 12 0 5 11 4 
0 0 0 0 3 5 0 3 0 3 0 0 0 2 0 0 
0 10 4 6 0 2 4 8 0 0 4 2 0 0 0 0 
