16 9
1 6 1 0 2 0 8 5 0 0 5 11 24 6 0 5 
9 0 0 0 0 0 7 1 6 0 0 0 0 0 0 0 
19 2 0 1 14 3 4 0 5 0 2 0 0 13 1 16 
0 0 0 7 0 0 0 0 0 0 0 8 0 6 0 0 
0 2 4 12 1 0 13 0 0 6 0 0 4 11 11 8 
4 24 1 7 0 0 0 0 0 0 7 0 11 4 13 14 
5 1 1 0 6 0 4 0 5 0 0 0 6 1 0 0 
4 18 4 0 1 1 9 3 0 0 0 0 11 0 0 0 
12 1 16 18 9 2 3 0 5 0 7 0 1 31 11 13 
