16 9
6 0 4 0 25 3 1 0 0 3 6 0 0 0 3 12 
0 12 3 12 0 6 0 3 1 7 5 4 0 12 5 7 
0 0 0 6 0 0 0 0 0 1 0 0 0 0 3 1 
13 12 1 0 10 14 3 2 3 10 1 4 10 7 7 16 
3 0 1 3 2 0 4 0 1 2 0 3 0 0 0 0 
0 12 0 5 0 0 0 2 6 0 0 4 0 12 0 0 
0 7 0 0 0 0 0 0 3 8 5 13 11 0 4 3 
10 0 12 0 0 2 7 6 3 0 2 8 1 1 0 0 
14 0 0 11 8 0 7 0 2 6 4 4 0 0 2 0 
