16 9
7 0 8 8 3 0 2 11 3 0 3 0 0 3 0 0 
0 1 0 2 0 3 0 0 0 0 3 0 0 3 0 0 
1 6 0 0 2 1 0 0 0 0 0 0 0 0 0 0 
12 8 0 5 4 4 0 0 0 18 0 0 0 22 9 14 
9 13 13 0 1 7 4 0 0 12 1 0 0 12 4 0 
0 0 12 0 0 0 0 0 0 2 0 0 10 0 0 2 
10 9 2 1 11 4 3 3 0 2 2 5 0 8 3 4 
14 5 10 0 4 7 8 0 0 2 7 0 7 0 6 0 
2 11 20 13 8 4 5 3 0 3 0 0 6 0 12 0 
