16 9
0 8 0 0 0 0 0 0 9 2 0 1 9 1 0 7 
0 2 0 0 0 0 10 5 7 6 0 1 0 0 0 6 
0 11 0 0 8 0 7 5 3 7 0 4 20 1 6 5 
12 3 8 0 2 3 1 0 1 9 0 12 9 3 2 3 
0 0 0 0 0 0 0 0 0 3 0 0 0 3 0 0 
5 6 0 8 1 1 0 14 2 1 2 0 20 2 10 1 
0 12 0 0 3 8 4 11 3 0 12 0 1 15 0 1 
0 6 0 0 0 0 6 6 0 3 1 4 5 0 4 4 
14 3 0 0 0 0 5 3 0 0 0 0 8 0 20 0 
