16 9
16 0 0 3 4 0 10 0 0 9 0 0 0 9 2 0 
0 11 0 7 0 2 0 2 5 7 0 4 0 2 13 0 
0 0 0 0 0 5 0 0 0 1 5 0 0 0 2 0 
0 0 0 0 5 2 0 4 0 5 2 0 0 1 2 0 
10 0 4 5 4 4 1 3 0 4 17 1 1 4 4 0 
0 2 25 11 0 2 6 4 0 3 2 3 4 0 14 2 
7 6 9 4 5 8 6 2 3 0 6 1 9 2 12 0 
0 7 0 0 0 0 3 5 7 1 0 2 1 0 0 0 
8 0 1 0 8 2 3 0 8 3 5 6 3 13 12 0 
