16 9
15 0 7 0 1 0 0 0 0 8 7 0 0 0 0 34 
0 14 0 0 0 0 0 0 2 0 3 1 3 4 0 8 
0 11 25 11 0 0 0 0 6 0 15 1 1 15 1 8 
2 11 3 8 7 1 1 0 2 0 7 5 2 12 4 2 
0 0 0 0 0 0 0 0 5 1 1 0 0 3 0 0 
15 0 0 1 0 2 0 7 3 2 3 1 3 4 18 29 
0 0 13 1 6 0 0 1 5 0 0 0 0 2 1 19 
4 0 12 1 7 3 2 1 9 0 5 2 3 1 0 13 
0 14 5 0 0 0 0 0 5 8 3 4 0 0 0 2 
