16 9
12 0 0 7 11 2 8 3 3 9 0 6 3 0 10 0 
3 14 7 0 11 12 0 0 3 0 0 9 0 9 4 0 
2 0 0 5 0 0 0 2 0 0 1 3 3 0 0 0 
0 0 6 3 5 4 0 0 0 1 0 3 0 0 0 0 
22 0 4 0 8 12 6 0 0 4 0 0 8 13 0 0 
8 4 3 3 7 8 8 0 20 0 1 10 7 2 23 13 
4 0 6 0 3 0 0 0 5 0 1 7 0 0 5 0 
4 1 3 5 4 12 0 0 2 0 0 1 0 0 9 0 
8 7 8 3 6 0 0 0 0 0 0 0 8 0 12 0 
