16 9
0 9 6 0 0 5 4 2 2 4 10 0 2 0 5 8 
0 16 6 0 0 5 10 0 0 0 7 6 0 0 2 3 
0 13 11 0 0 1 8 9 0 5 1 5 7 1 45 5 
0 4 1 0 4 4 0 0 7 8 1 4 1 12 5 4 
0 0 0 0 0 1 0 0 4 0 1 3 0 0 0 6 
0 0 3 0 0 7 4 7 3 2 0 0 0 0 7 4 
0 15 9 0 13 0 0 0 0 5 0 5 0 12 1 0 
0 0 6 0 4 1 6 5 0 2 0 0 0 0 0 0 
0 15 13 0 0 13 0 2 0 8 0 0 7 1 6 7 
