16 9
0 0 0 1 1 0 2 0 2 2 0 8 0 0 5 10 
0 0 6 0 0 4 0 9 0 4 0 1 10 0 0 0 
21 3 8 1 2 0 1 0 0 3 1 3 10 19 0 0 
0 2 8 0 1 0 2 2 4 0 7 1 2 0 0 3 
4 0 2 0 1 0 0 1 2 9 0 2 3 0 5 0 
6 14 5 0 0 9 6 3 1 5 4 4 0 2 5 1 
1 0 5 0 7 0 0 8 2 1 0 0 0 0 0 0 
0 0 6 1 1 6 0 0 1 0 0 2 0 0 1 0 
0 9 1 1 4 0 4 1 6 0 0 0 0 6 11 12 
