16 9
2 2 3 0 8 0 4 4 1 17 15 3 0 6 3 11 
0 0 0 6 0 0 0 0 1 0 2 2 0 2 0 4 
0 0 2 0 4 13 0 4 0 2 4 2 7 3 1 0 
2 35 0 2 4 0 5 17 0 14 5 2 0 3 0 14 
0 0 0 0 0 0 0 4 0 0 0 4 0 0 1 1 
0 2 3 2 1 5 5 3 6 0 9 3 0 6 0 10 
0 0 12 6 2 0 2 0 0 0 7 0 0 0 0 13 
0 4 1 11 4 2 0 8 0 0 5 6 0 6 5 5 
5 5 3 3 4 18 2 0 0 15 5 3 9 0 12 5 
