16 9
0 7 0 0 0 7 0 0 0 1 6 0 3 0 4 3 
0 0 20 0 1 4 5 15 0 2 8 0 1 4 12 2 
0 0 0 5 0 4 0 0 0 0 5 0 2 5 0 9 
0 0 0 0 6 7 0 0 0 0 5 0 7 0 10 0 
12 0 3 1 7 14 2 1 7 0 8 6 11 7 0 11 
0 0 4 8 12 5 12 1 7 0 14 0 0 7 10 7 
0 11 14 0 0 2 2 0 2 0 0 0 1 0 9 6 
0 9 0 8 5 7 0 6 6 2 0 2 5 5 9 12 
0 0 8 0 1 4 0 7 0 0 13 5 1 3 0 0 
