16 9
14 8 0 4 3 0 15 0 0 0 0 0 0 7 25 3 
15 1 3 0 0 1 8 8 1 0 0 4 0 7 1 7 
19 0 2 0 12 10 2 7 5 0 0 0 11 0 16 11 
0 0 23 12 0 1 3 0 0 5 0 3 0 2 9 19 
3 2 12 6 2 2 9 3 0 0 0 4 6 2 0 9 
0 0 17 0 2 0 0 4 6 2 0 6 0 11 0 0 
0 14 1 0 9 0 0 0 6 0 0 2 11 9 6 0 
9 0 1 15 7 0 9 4 5 2 0 3 17 2 0 3 
0 10 0 2 2 0 2 0 4 6 0 4 2 0 0 6 
