16 9
0 0 0 0 9 0 0 0 7 8 0 0 0 9 0 1 
9 6 0 0 2 4 2 4 0 5 0 2 0 7 0 14 
9 0 10 0 0 0 3 1 3 11 4 0 10 0 0 5 
0 0 0 4 1 4 5 1 4 5 2 0 0 0 0 0 
12 1 12 1 3 0 0 3 1 1 6 3 10 0 0 0 
2 7 5 1 3 4 7 2 3 2 1 0 0 7 3 0 
9 6 7 0 1 1 5 6 0 12 1 0 0 6 0 0 
0 0 0 12 4 0 1 3 1 1 5 2 0 3 10 6 
7 0 9 0 7 2 0 6 5 0 4 9 1 2 3 2 
