16 9
18 1 2 1 1 1 6 0 3 4 1 2 2 2 4 5 
10 18 3 0 2 1 2 0 8 6 6 0 0 12 1 0 
7 10 11 0 0 11 1 7 0 5 2 10 0 0 36 10 
1 11 4 8 1 0 11 5 11 0 3 19 14 1 20 0 
4 0 1 0 4 5 1 9 4 3 0 0 5 0 9 2 
0 0 0 0 3 0 0 7 1 0 0 0 0 0 7 0 
2 1 9 1 0 1 0 0 3 6 8 0 6 0 0 2 
0 6 0 10 0 12 0 0 0 6 7 0 1 1 9 0 
6 0 2 0 3 0 5 4 3 4 7 0 5 0 6 0 
