17 10
0 0 0 0 8 0 0 0 0 0 6 0 14 5 0 0 5 
2 0 0 0 0 0 6 0 0 9 8 5 0 0 1 0 0 
4 0 0 0 0 0 0 0 2 0 6 0 1 2 5 6 0 
11 0 0 8 0 0 0 13 3 1 0 6 2 0 2 21 9 
0 5 0 9 4 0 2 4 0 0 6 0 9 0 0 0 0 
2 14 1 5 6 7 3 0 23 2 4 5 1 0 5 1 6 
11 0 14 3 1 8 5 0 0 0 2 5 0 11 4 15 24 
15 1 0 0 0 0 0 0 0 0 0 4 0 0 14 0 1 
15 0 0 0 0 0 0 3 0 0 0 0 0 0 7 9 8 
3 5 0 11 4 3 0 0 1 0 8 0 7 0 1 6 0 
