17 10
1 11 0 0 5 5 16 18 5 0 1 10 6 2 6 0 10 
0 0 3 2 0 5 0 1 0 0 0 0 0 0 1 0 0 
0 0 0 0 2 3 1 8 0 0 7 0 0 4 2 0 0 
0 0 0 0 7 0 4 0 3 0 4 0 6 0 0 0 0 
0 13 2 0 0 5 2 6 5 0 2 6 1 12 13 13 0 
0 0 9 15 9 4 1 6 7 4 0 0 0 11 3 12 9 
0 9 0 2 0 0 4 5 6 0 11 0 0 1 3 0 0 
0 17 0 0 11 0 3 0 7 0 7 10 0 0 0 11 1 
4 2 0 0 1 5 0 11 3 0 2 0 0 8 3 0 1 
9 6 2 0 2 6 6 3 0 0 17 0 0 0 0 0 0 
