17 10
1 9 14 9 0 2 0 0 0 3 8 0 1 3 1 0 6 
5 0 1 3 0 0 4 0 10 7 4 0 1 10 7 0 0 
2 0 0 0 4 2 0 0 0 0 1 0 0 0 0 2 0 
0 3 0 15 7 3 6 0 8 3 5 0 0 10 0 0 0 
0 9 0 0 5 6 0 0 0 0 8 0 0 0 0 3 0 
0 0 0 4 0 0 0 0 1 0 6 0 2 0 0 0 0 
0 6 2 22 3 0 4 0 8 1 6 0 0 10 0 17 15 
6 0 0 10 4 0 4 7 0 2 2 1 9 9 0 0 0 
6 4 0 3 0 0 0 6 0 0 0 0 0 10 0 0 0 
6 13 11 5 3 5 2 0 2 0 6 2 12 10 15 0 1 
