17 10
4 6 1 13 8 9 0 7 5 7 0 0 2 5 6 8 9 
0 0 2 1 6 0 0 0 0 0 0 7 0 0 2 0 1 
0 0 0 11 8 0 2 0 7 0 0 0 0 0 14 2 1 
3 0 3 3 0 1 2 0 0 2 8 0 0 0 0 0 3 
11 5 1 0 0 3 1 0 2 2 0 0 0 0 0 2 16 
0 1 3 1 3 2 2 3 0 2 0 0 0 0 3 1 1 
0 7 0 0 0 0 0 0 0 2 2 0 0 0 0 0 0 
0 0 21 0 8 1 1 12 2 5 0 0 0 0 7 0 0 
6 1 12 3 3 11 21 5 0 1 2 8 8 1 3 8 1 
5 0 2 0 2 15 1 0 0 0 11 0 0 0 0 0 0 
