17 10
11 10 0 1 0 5 2 4 2 7 6 19 0 7 5 1 0 
4 13 0 6 0 0 0 0 0 9 1 0 3 0 0 10 13 
6 1 4 2 5 5 10 7 0 0 10 0 10 4 0 0 9 
0 0 14 0 4 1 11 0 0 0 0 0 0 4 0 1 23 
5 4 2 0 4 1 5 4 0 2 0 3 0 0 0 3 0 
0 0 0 0 0 1 0 0 0 3 1 0 3 1 5 3 0 
16 0 10 0 0 0 0 0 0 0 0 0 14 3 0 0 20 
4 3 3 6 2 12 4 6 0 6 13 2 2 4 0 0 13 
6 12 14 0 11 0 5 0 0 3 2 10 2 0 0 11 20 
0 0 2 0 4 0 4 6 0 0 6 5 0 7 0 9 0 
