17 10
0 2 2 8 0 2 6 0 0 10 2 0 4 0 0 0 2 
1 15 0 12 1 0 0 0 8 26 7 1 1 0 11 3 13 
10 7 2 0 3 2 0 6 2 1 16 0 0 14 0 5 6 
0 0 3 2 1 5 0 0 2 0 6 0 0 4 1 1 0 
12 13 8 9 3 0 5 0 4 7 3 0 11 0 1 3 0 
0 0 0 8 0 0 2 1 1 3 0 8 0 0 0 1 0 
6 0 11 0 0 0 6 1 1 6 11 0 3 0 2 1 5 
6 0 0 12 0 9 8 5 0 0 0 0 0 9 9 12 0 
14 0 0 0 0 2 0 0 5 9 13 0 2 8 17 17 0 
0 0 0 0 3 6 2 0 0 9 0 0 0 0 0 0 7 
