17 10
9 8 1 6 9 2 6 1 1 5 6 0 0 3 13 0 3 
10 0 0 3 0 0 5 10 0 0 1 5 4 6 0 2 5 
0 0 0 3 6 0 2 0 4 2 1 5 9 12 2 2 4 
6 0 0 2 8 15 0 2 0 3 1 0 4 6 9 15 0 
0 0 0 7 0 0 0 0 0 1 7 1 3 0 0 0 0 
5 7 1 3 5 0 0 19 0 2 7 5 9 12 4 0 5 
1 0 0 3 0 14 0 2 0 0 13 0 2 8 0 0 0 
14 0 0 1 1 5 1 0 8 5 0 3 3 0 0 0 0 
8 14 0 6 0 0 1 9 0 0 0 0 0 0 0 14 0 
0 0 0 0 0 9 4 4 0 0 2 4 1 21 3 0 6 
