17 10
20 6 17 0 8 9 0 4 0 0 8 5 1 0 3 15 5 
5 3 0 0 8 1 7 7 0 4 0 4 0 7 1 0 0 
0 4 3 2 2 5 0 0 1 2 0 0 0 0 2 0 5 
2 0 3 0 2 4 2 7 4 0 0 6 0 0 3 1 0 
9 14 0 1 6 6 8 0 3 2 0 7 11 2 7 7 11 
1 6 3 0 13 1 5 4 0 7 0 5 1 0 13 0 0 
2 6 0 0 12 0 0 0 0 0 10 7 9 13 3 0 6 
0 0 0 3 0 7 0 0 0 2 0 0 0 0 0 0 0 
0 20 1 2 5 5 0 0 0 7 0 4 0 2 0 16 7 
0 0 9 0 1 11 0 0 0 0 0 6 0 0 4 1 6 
