17 10
9 0 5 9 0 9 0 8 0 2 7 0 3 3 2 2 9 
14 8 0 0 0 7 2 0 0 2 1 0 7 0 14 0 0 
11 13 0 0 4 0 0 8 0 0 2 0 0 0 13 0 0 
2 6 0 0 0 0 9 10 0 16 5 6 0 6 0 17 7 
0 0 2 2 5 6 9 0 6 2 5 1 2 0 2 6 1 
0 7 0 0 0 5 0 0 7 0 0 0 0 0 0 0 1 
3 0 0 19 0 0 5 0 0 5 0 6 0 0 0 12 1 
0 0 0 0 8 0 0 4 0 0 4 2 8 0 0 0 0 
4 1 12 1 5 7 0 7 0 0 3 2 5 3 5 1 6 
16 4 2 2 3 3 11 8 8 6 4 8 2 0 1 2 0 
