17 10
0 5 0 0 4 11 0 6 0 0 6 0 8 0 0 0 10 
18 0 0 15 8 3 5 5 3 1 4 0 0 13 2 0 13 
0 0 8 0 0 0 5 3 4 0 8 4 6 1 0 10 0 
0 0 8 5 0 3 6 5 0 0 0 0 1 5 2 0 0 
2 0 1 6 5 3 8 2 5 6 3 0 0 0 8 6 0 
14 5 7 6 0 0 0 4 0 13 0 0 2 2 16 0 0 
0 0 3 6 3 2 9 10 0 11 4 0 2 3 5 1 0 
16 0 2 4 4 0 9 6 9 0 0 0 0 1 1 0 10 
9 6 3 0 1 0 5 3 7 9 0 0 8 5 0 5 1 
0 4 16 0 1 3 16 3 7 7 0 0 27 3 0 12 0 
