17 10
0 0 2 2 0 0 0 1 7 0 4 0 0 0 0 7 0 
0 6 0 1 0 4 0 0 1 22 0 0 12 1 13 8 7 
0 0 8 2 0 0 6 4 5 7 6 1 13 0 1 4 8 
0 0 0 0 11 0 4 0 1 3 0 0 0 0 0 11 1 
0 9 1 4 0 0 4 0 2 3 5 2 2 6 2 0 1 
0 15 11 5 13 0 5 3 5 0 0 10 9 11 15 0 0 
0 3 2 0 12 0 3 6 11 7 2 5 6 0 0 0 19 
0 12 0 3 5 2 0 1 6 5 0 4 0 0 0 14 1 
0 3 2 20 3 0 0 3 0 2 14 1 12 2 5 2 20 
0 3 0 2 0 0 6 0 0 8 0 0 8 0 0 8 0 
