17 10
0 0 0 15 0 5 4 4 0 0 0 4 0 0 11 3 0 
3 8 0 8 2 0 9 16 2 0 3 2 6 0 4 5 9 
0 29 0 10 0 0 0 5 7 0 9 4 0 10 13 5 0 
0 0 0 0 5 5 2 2 6 0 0 7 4 0 0 0 7 
7 0 2 1 1 12 3 5 7 1 9 9 1 0 11 28 7 
0 15 0 0 11 1 0 6 1 0 1 1 5 9 10 3 15 
8 0 13 8 0 0 0 2 8 2 5 6 7 0 5 5 0 
0 0 0 0 2 0 2 5 0 2 0 11 1 0 6 0 0 
0 3 0 0 3 8 6 0 0 0 0 5 2 0 0 0 0 
11 2 0 8 4 0 2 7 0 6 4 1 0 0 0 3 6 
