17 10
9 0 0 7 6 3 0 13 4 9 0 0 2 0 0 0 2 
32 8 7 4 4 8 0 6 8 15 0 11 0 6 0 10 16 
4 0 0 10 5 2 0 12 6 1 4 0 16 10 1 0 2 
0 0 0 1 0 0 0 0 1 0 0 4 5 0 0 5 0 
0 0 13 14 0 0 0 4 5 1 0 0 2 4 0 13 8 
3 0 0 0 0 7 0 0 0 6 0 0 5 0 0 5 0 
0 6 6 0 1 0 0 6 5 1 0 0 0 0 0 0 0 
19 1 13 3 3 9 7 8 0 17 4 3 10 12 7 17 2 
1 19 4 0 0 13 1 8 0 1 4 2 5 10 0 6 0 
0 14 0 8 9 0 3 8 0 2 7 0 0 7 0 14 7 
