17 10
8 5 2 10 5 3 2 5 5 6 0 4 4 15 7 0 4 
18 3 19 9 10 4 2 5 0 8 6 3 12 10 19 3 27 
0 0 0 5 9 0 2 4 5 0 0 7 6 1 2 0 4 
0 0 0 0 0 0 3 0 9 0 4 3 2 0 0 0 0 
13 0 8 0 0 5 7 0 0 0 13 7 0 13 6 0 0 
4 0 6 3 4 4 0 1 11 4 0 0 0 5 4 0 0 
0 1 0 0 2 3 0 4 4 3 2 2 2 3 8 7 1 
1 20 17 3 2 1 8 2 6 1 6 6 0 9 7 2 21 
7 11 0 2 4 2 0 2 0 2 0 3 6 12 3 15 7 
3 0 0 3 2 0 0 0 2 0 4 0 0 0 11 0 0 
