17 10
17 5 0 0 1 0 3 0 1 7 0 0 6 14 0 7 3 
14 0 0 0 0 9 2 8 12 10 5 0 5 1 34 0 0 
0 2 15 6 0 0 3 3 0 12 6 0 0 8 1 9 2 
0 3 0 0 3 5 0 0 3 0 0 0 3 0 0 1 11 
13 1 12 2 0 0 3 0 1 2 9 0 0 10 10 0 4 
0 1 0 0 0 4 3 0 0 4 0 0 0 1 2 5 0 
0 7 18 3 1 1 1 0 8 0 4 0 0 1 0 0 13 
0 0 0 1 1 4 0 5 7 1 6 0 0 5 3 0 1 
12 0 1 0 9 5 0 0 4 5 0 0 0 13 1 0 5 
8 1 18 0 0 1 5 9 12 0 6 4 11 3 1 0 18 
