19 11
0 1 7 7 7 10 0 0 0 0 0 0 0 5 1 10 0 4 0 
6 11 1 0 0 5 0 0 0 0 7 10 1 1 1 0 0 0 6 
7 0 0 0 2 0 0 7 0 0 0 0 0 0 5 4 1 2 0 
2 13 16 14 0 7 0 0 10 0 2 10 4 0 0 0 1 14 4 
0 0 0 0 3 0 0 1 6 0 0 0 0 0 6 0 0 2 0 
0 0 0 0 1 1 0 0 0 0 4 0 0 0 4 0 0 0 4 
48 7 0 0 26 11 12 2 8 17 3 6 0 5 14 22 7 13 20 
18 0 7 1 0 2 0 0 0 0 0 6 0 0 16 1 15 14 13 
0 0 7 0 6 0 0 11 0 0 4 0 0 0 0 0 1 0 12 
1 16 7 13 0 15 0 1 0 0 0 16 0 5 9 0 1 14 25 
1 0 0 8 0 4 0 5 0 5 0 14 0 0 0 0 8 1 0 
