19 11
9 12 0 0 0 0 3 0 0 0 10 11 0 12 0 0 0 17 0 
0 0 0 0 0 7 0 0 0 0 5 0 0 9 4 0 2 0 0 
0 0 0 7 0 4 0 0 0 11 0 7 6 3 5 0 8 0 0 
0 12 2 12 5 9 17 5 7 15 3 0 3 2 16 14 2 0 9 
0 5 0 4 4 0 0 0 4 0 0 0 0 0 0 0 0 0 0 
3 12 5 0 0 5 6 5 0 9 4 0 3 11 13 0 0 4 1 
12 0 10 7 6 9 0 0 0 0 5 1 30 0 6 1 1 5 0 
0 3 0 0 0 1 0 0 0 0 0 3 0 0 2 0 0 0 0 
0 14 0 0 0 8 5 4 0 0 0 4 5 5 2 14 0 0 11 
5 0 0 10 0 0 0 0 5 0 1 1 5 8 20 0 2 0 0 
17 0 0 6 0 2 5 7 12 0 2 5 0 14 3 6 0 15 10 
