19 11
0 0 0 11 12 10 8 0 0 9 0 18 0 0 2 1 1 0 21 
0 0 0 8 0 0 0 0 0 0 0 1 0 0 0 0 6 3 0 
27 12 0 7 0 1 0 0 0 7 7 0 0 6 8 0 3 24 4 
1 0 0 0 0 0 3 0 3 0 0 4 7 4 0 2 0 0 1 
4 0 14 10 0 7 12 6 0 0 4 0 7 6 9 5 12 11 30 
11 3 0 16 0 3 0 0 9 0 1 7 0 0 5 5 3 9 15 
0 16 0 5 0 3 3 0 0 0 0 0 0 4 0 1 2 12 0 
0 0 0 2 0 9 0 0 0 0 0 7 0 0 0 0 5 0 13 
6 8 0 31 0 1 0 2 0 7 0 0 0 0 0 0 17 14 6 
0 0 13 12 0 3 0 3 0 5 3 11 0 10 14 13 5 0 0 
0 0 4 14 10 11 6 0 2 0 2 10 0 0 19 2 0 16 10 
