19 11
8 0 0 0 0 2 5 10 0 0 0 7 2 0 1 4 0 0 0 
0 0 10 0 7 0 3 9 0 0 1 0 12 0 0 0 0 7 0 
0 0 7 17 0 7 0 0 5 5 6 2 8 26 2 3 6 0 0 
19 0 11 0 0 5 0 2 0 0 6 0 8 0 9 6 5 3 1 
6 0 12 0 11 9 10 0 0 2 0 0 6 5 0 10 0 11 16 
10 1 0 9 0 0 0 4 2 3 2 0 3 0 0 5 0 0 0 
3 7 0 0 0 2 0 7 1 0 0 14 1 1 4 0 0 16 0 
2 0 4 0 0 3 3 0 6 0 0 0 5 0 0 7 14 20 0 
3 0 0 0 9 0 1 5 3 0 0 0 0 0 0 0 12 0 0 
0 12 7 6 0 6 2 8 0 3 8 0 0 15 0 5 13 10 0 
5 9 7 0 0 0 0 13 0 10 0 4 0 6 0 1 0 0 5 
