19 11
0 9 7 0 0 0 0 0 0 7 1 2 0 4 0 0 0 6 0 
6 9 2 0 13 0 0 4 0 3 1 0 0 6 2 2 10 0 0 
14 1 1 0 0 0 0 0 0 0 0 9 0 0 14 0 0 5 7 
0 7 1 0 9 0 0 0 4 0 6 15 10 0 2 2 1 13 2 
11 11 2 2 10 0 1 0 1 7 0 4 6 0 2 9 0 27 9 
20 0 1 7 4 0 0 0 0 6 3 0 0 4 0 0 0 6 18 
0 9 10 1 0 4 0 0 0 0 0 0 0 11 0 0 15 4 0 
10 0 2 0 1 1 7 10 8 0 10 0 4 7 0 15 2 2 0 
0 21 0 0 18 1 0 7 0 0 3 0 0 0 0 2 12 5 0 
0 2 2 9 1 0 0 10 0 0 21 5 6 0 0 0 5 12 8 
0 9 5 0 0 0 11 14 0 0 0 0 0 12 13 0 0 21 0 
