19 11
14 0 4 5 9 3 3 2 9 11 8 0 0 7 16 0 8 0 9 
11 3 0 0 3 14 11 1 1 7 0 11 0 5 8 0 0 0 10 
0 0 5 5 0 3 0 0 15 4 0 7 3 4 2 12 10 0 7 
0 0 10 0 0 0 12 5 0 3 0 0 2 0 0 3 0 0 8 
0 3 0 6 4 5 21 11 0 3 0 0 6 0 0 3 0 11 5 
14 0 0 11 4 6 3 10 4 0 0 3 0 0 6 0 0 0 13 
14 0 6 0 2 1 10 1 0 7 0 3 0 4 14 1 17 2 0 
13 0 5 0 3 9 0 0 0 0 0 5 0 20 9 5 5 0 0 
2 1 6 0 0 0 7 14 3 2 0 0 0 0 0 2 0 0 0 
0 27 0 4 0 13 11 4 0 1 1 3 6 0 0 0 15 12 0 
13 0 0 0 0 0 6 0 0 0 0 0 7 0 0 15 0 0 0 
