19 11
5 11 0 8 7 4 10 0 0 3 6 8 12 6 9 9 0 0 14 
0 13 16 1 0 0 2 0 19 5 0 0 4 8 8 6 1 0 6 
0 4 0 0 10 0 0 0 7 0 6 0 7 0 0 0 7 0 0 
0 5 0 0 0 0 5 0 0 8 0 7 3 7 6 6 0 4 0 
2 0 0 0 0 0 1 5 0 0 0 0 0 0 4 0 1 3 4 
13 7 0 7 15 4 4 9 1 5 16 3 2 5 9 0 9 0 5 
10 6 11 13 0 0 0 0 8 0 14 0 0 0 0 0 0 14 0 
2 6 3 0 0 0 0 0 0 5 10 0 12 0 4 0 0 0 0 
0 0 0 0 6 0 0 0 8 0 0 8 0 3 1 0 11 4 0 
0 0 0 9 0 13 9 5 0 0 0 6 6 4 8 17 11 0 18 
6 7 1 3 0 0 21 1 16 0 0 5 0 4 0 0 0 15 5 
