19 11
0 0 17 0 2 0 0 0 4 0 8 0 0 0 0 0 0 16 0 
0 0 4 0 8 0 4 0 33 0 2 6 0 0 0 0 0 16 0 
0 3 13 0 2 3 3 0 0 0 2 0 0 5 1 6 0 0 0 
5 0 1 15 1 3 0 0 16 0 0 6 0 1 9 0 8 14 1 
12 0 0 0 0 0 0 8 0 1 0 0 3 16 6 3 3 0 6 
1 8 2 24 0 4 0 6 14 8 6 0 4 8 0 0 7 0 0 
2 5 2 1 0 1 6 4 3 0 16 14 6 0 0 0 0 0 0 
0 0 13 0 13 1 2 7 2 3 0 0 0 0 0 13 0 10 14 
5 2 2 3 2 7 10 10 2 0 1 1 0 6 11 7 19 14 0 
0 0 4 0 8 0 1 4 8 0 0 6 0 0 0 6 0 0 5 
0 4 8 0 2 2 0 1 15 0 0 9 0 5 7 9 8 0 0 
