19 11
15 13 1 2 0 0 0 7 0 0 7 0 1 13 0 0 0 1 0 
6 0 0 14 0 12 9 7 3 3 0 4 0 0 0 0 9 8 7 
0 0 0 2 0 0 0 4 5 2 7 2 8 2 1 0 3 0 0 
0 0 0 0 0 0 2 2 0 0 0 0 4 0 0 0 0 0 0 
5 0 0 0 0 0 2 8 5 0 0 3 0 0 0 2 0 2 0 
25 15 0 12 0 22 4 9 8 0 0 0 2 1 6 15 33 14 16 
19 2 12 30 12 0 6 15 0 0 5 8 4 27 1 0 15 39 11 
0 1 0 0 0 4 0 2 3 3 1 2 1 1 8 0 2 12 8 
8 1 2 18 0 0 0 0 0 7 2 0 0 2 0 0 7 0 15 
5 0 3 0 0 8 0 0 3 4 1 2 0 4 0 5 0 0 0 
0 0 12 0 0 13 0 9 0 4 3 6 18 2 5 6 7 4 11 
