19 11
9 22 9 7 0 0 6 0 0 0 0 0 6 5 2 7 5 24 0 
0 0 8 0 0 0 10 0 8 3 0 0 0 0 0 0 10 1 10 
5 6 0 0 0 2 5 0 9 0 0 0 0 2 0 0 0 11 0 
13 5 16 15 0 8 0 0 13 4 9 0 0 11 1 0 8 5 21 
8 0 14 0 0 2 4 0 14 5 0 0 0 0 0 0 18 0 0 
13 0 0 0 11 0 6 0 9 5 2 1 1 21 6 15 0 0 2 
12 9 0 0 0 0 3 0 7 2 7 0 16 2 0 1 2 6 10 
5 12 0 7 0 4 5 8 2 12 0 4 1 9 6 11 3 10 0 
6 1 0 0 0 0 7 0 0 0 5 7 0 0 5 0 0 3 5 
10 4 1 0 0 1 9 0 0 0 0 0 1 0 1 0 0 2 0 
0 15 1 0 0 13 2 0 8 2 8 7 3 0 1 0 2 0 10 
