19 11
0 13 0 11 7 1 3 0 0 3 13 0 2 0 21 0 0 0 18 
9 12 4 8 2 0 5 9 13 0 0 0 2 28 7 7 0 0 1 
0 0 0 8 0 0 0 0 0 0 0 7 0 0 0 0 7 0 1 
0 0 4 1 0 3 0 0 0 0 8 0 0 0 0 0 0 6 8 
3 20 7 8 6 4 0 0 7 0 1 8 0 1 4 5 3 0 0 
1 0 0 1 0 2 0 2 0 6 0 0 1 0 4 12 0 3 0 
1 11 1 14 3 9 5 0 6 1 6 5 6 0 4 0 4 32 0 
0 10 0 3 9 0 5 0 0 1 3 10 1 5 0 9 1 3 1 
20 0 0 6 7 2 0 2 0 3 0 11 0 0 0 4 1 0 0 
8 0 0 7 5 11 0 0 7 0 0 8 4 0 2 0 2 20 0 
9 2 6 13 1 0 0 5 1 3 0 3 2 0 3 5 4 3 10 
