19 11
3 14 0 12 0 8 9 15 15 4 10 0 0 4 0 2 0 0 11 
4 0 9 11 0 4 9 0 0 13 3 7 0 0 11 6 7 1 12 
10 0 0 0 9 0 2 2 3 0 7 0 0 9 0 0 2 3 1 
0 10 0 11 0 1 0 2 3 0 0 10 0 4 10 1 0 2 0 
0 17 6 19 2 1 11 6 1 4 10 9 0 7 15 2 0 15 7 
7 9 6 0 0 6 0 3 10 0 8 6 1 2 1 8 0 2 0 
6 0 0 0 0 5 1 10 3 5 8 9 1 9 5 4 0 0 12 
7 6 3 4 0 12 7 12 7 2 11 4 0 1 20 0 9 0 4 
3 4 0 0 0 8 0 3 8 0 0 5 0 0 0 0 0 0 0 
13 0 0 0 5 0 0 0 0 0 0 3 4 13 8 0 0 0 0 
0 0 9 3 0 9 14 0 0 0 7 2 0 0 3 0 6 0 0 
