19 11
0 0 13 0 0 3 5 11 8 8 3 0 0 11 12 0 0 0 11 
4 8 6 0 0 0 0 0 0 0 0 0 0 0 0 0 0 0 0 
3 0 0 5 0 7 0 12 0 0 11 11 0 0 10 3 8 1 11 
1 2 3 0 0 4 0 6 0 0 3 5 0 0 0 0 5 0 0 
0 10 5 0 0 0 10 3 6 0 0 4 0 0 0 0 10 20 0 
1 9 31 3 21 0 7 2 0 4 9 0 8 0 0 2 0 4 16 
0 0 0 3 0 0 0 2 0 0 3 0 0 0 0 0 0 0 0 
0 4 27 31 13 10 16 1 2 9 5 15 0 0 3 14 14 22 2 
5 0 4 0 0 0 0 7 8 8 1 3 0 8 4 0 0 1 0 
2 7 14 16 0 7 12 4 8 12 2 10 9 12 0 9 35 5 0 
25 16 15 39 20 8 0 7 0 0 7 23 0 2 11 14 13 21 19 
