19 11
2 0 0 0 9 0 3 0 0 2 0 6 0 9 8 1 0 0 2 
26 11 0 1 1 2 0 7 6 3 10 0 4 0 10 13 5 0 0 
40 9 8 0 0 5 0 0 0 0 9 0 3 3 1 0 19 17 2 
6 4 10 0 7 8 10 2 7 2 8 7 2 0 0 2 23 2 16 
9 7 11 0 4 1 8 0 0 0 0 1 0 2 5 5 0 16 0 
0 2 1 0 0 4 0 0 0 0 0 0 0 0 0 4 0 0 0 
0 3 2 0 0 1 1 3 0 0 1 11 0 5 3 0 11 15 2 
20 9 0 0 4 0 0 0 6 2 0 0 0 0 0 0 16 0 0 
14 1 5 1 2 7 2 12 8 6 6 6 0 8 15 0 0 0 0 
15 2 6 1 0 1 4 0 9 6 4 0 0 4 4 9 7 4 0 
0 2 0 0 0 1 0 6 1 1 0 11 0 6 0 0 9 0 0 
