19 11
0 0 0 0 0 0 1 3 8 0 4 0 0 0 0 5 3 0 0 
0 0 10 0 0 0 5 0 9 0 2 0 0 0 0 5 14 0 0 
0 7 1 0 14 3 9 0 4 8 7 0 8 0 0 1 0 0 3 
0 0 0 2 3 7 0 0 5 0 7 7 0 0 0 0 5 0 4 
13 0 0 2 4 6 4 8 4 0 5 3 3 6 0 2 21 6 15 
0 14 11 2 0 0 3 4 0 0 8 8 0 9 0 23 5 4 0 
18 11 18 0 11 0 4 7 7 3 11 4 1 0 0 13 0 0 44 
7 0 0 2 0 5 2 3 0 4 5 13 0 9 0 2 0 6 2 
0 0 6 4 1 4 4 1 0 0 2 0 0 0 2 5 0 0 0 
3 5 0 2 6 13 1 4 6 4 13 3 0 0 11 2 5 8 13 
3 5 0 0 0 5 0 6 19 0 5 0 4 0 4 0 0 0 0 
