19 11
9 0 0 5 9 9 0 0 0 12 0 10 3 2 0 0 0 1 2 
12 7 1 8 2 0 4 6 0 1 21 10 0 0 6 0 0 0 0 
0 0 11 0 13 10 9 0 5 7 0 2 0 3 0 19 4 0 0 
5 5 0 0 4 4 0 9 0 9 0 0 0 1 7 7 0 7 6 
0 1 0 0 0 0 6 0 2 0 0 3 0 0 0 2 5 0 4 
0 0 0 19 14 11 7 0 3 18 0 2 0 17 9 0 3 4 14 
4 15 7 0 4 0 0 0 10 0 0 0 0 5 8 1 0 16 3 
3 0 0 2 0 0 3 6 4 16 0 7 1 6 1 1 5 0 9 
12 5 0 8 13 6 5 6 0 0 2 2 12 6 2 0 0 13 7 
7 0 0 0 16 33 5 0 11 0 0 16 4 8 9 3 0 0 3 
1 9 0 13 0 0 1 0 0 15 7 8 0 0 0 7 20 1 0 
