19 11
3 0 0 0 0 15 0 0 7 4 0 6 0 0 5 0 0 0 0 
9 0 4 0 19 16 4 5 2 4 1 0 5 9 0 1 0 12 15 
20 1 21 22 5 8 0 0 1 5 1 7 6 10 9 26 0 1 36 
16 12 10 0 13 13 0 0 3 0 0 11 4 11 13 1 0 9 12 
6 0 0 0 0 2 0 1 0 9 0 6 0 0 0 8 0 1 10 
18 0 5 0 10 1 4 0 7 12 1 3 3 4 4 11 0 0 0 
15 1 4 5 7 6 0 0 7 4 0 10 0 0 3 4 0 0 3 
7 5 0 3 11 4 0 0 2 0 0 0 4 0 6 0 6 0 0 
0 8 0 0 0 7 0 4 1 7 0 10 0 0 0 2 0 0 13 
14 0 0 0 0 7 11 0 3 0 0 6 0 0 0 4 2 17 11 
0 0 14 0 12 7 1 0 0 7 0 0 0 7 10 0 19 0 0 
