19 11
13 9 15 0 1 0 0 3 12 20 3 0 34 8 0 7 8 16 7 
7 17 5 19 14 4 21 5 3 19 0 2 1 4 2 2 15 1 0 
4 1 0 0 0 0 22 0 7 8 0 0 16 8 0 0 10 5 12 
13 6 0 24 9 0 8 6 1 4 0 0 0 0 0 15 13 13 1 
0 13 0 0 3 9 6 0 0 0 6 0 2 1 8 0 6 16 1 
0 0 0 0 6 5 0 6 6 0 11 0 3 6 6 0 0 0 0 
4 0 16 0 5 0 1 0 3 12 0 0 4 0 12 0 0 6 0 
7 0 15 9 0 0 6 26 0 0 0 2 4 0 0 2 0 5 5 
0 14 0 5 3 0 5 7 0 8 0 0 14 0 7 7 0 0 1 
9 9 6 6 5 1 3 0 8 1 9 9 0 0 14 2 1 8 2 
17 0 0 0 0 0 8 3 3 0 0 3 10 8 0 0 1 6 0 
