19 11
0 3 25 15 1 8 0 0 0 11 3 0 10 11 0 6 2 16 6 
5 3 0 7 4 3 8 0 3 3 0 0 6 6 0 2 0 0 12 
2 0 0 1 1 1 0 8 3 2 0 0 4 0 4 7 13 0 4 
4 19 18 0 6 10 0 5 7 2 0 0 3 14 0 13 0 0 0 
0 1 0 0 6 0 5 0 0 9 0 2 4 0 0 0 0 0 0 
0 13 0 2 4 6 0 6 15 0 9 0 0 4 0 0 9 0 0 
5 0 1 7 0 9 10 0 6 3 10 0 0 3 14 0 6 11 17 
5 19 0 0 4 0 4 0 0 0 4 0 2 6 3 14 5 0 0 
9 3 7 0 0 0 0 8 1 20 0 0 4 4 2 2 0 0 3 
0 7 3 9 8 12 1 18 9 4 0 0 2 6 0 9 9 13 0 
0 0 4 15 6 0 0 0 5 0 3 0 5 0 2 7 8 19 10 
