19 11
8 12 9 2 21 9 8 10 3 3 1 2 11 2 1 6 8 8 14 
8 0 0 0 6 0 14 2 0 0 0 6 0 4 4 10 0 10 3 
0 3 13 0 6 5 3 8 0 7 0 10 0 0 8 14 2 8 0 
4 5 2 14 15 13 0 1 0 8 0 4 0 0 1 0 1 14 27 
0 4 0 0 8 14 0 1 4 0 3 5 0 4 1 0 8 12 3 
0 0 19 0 4 0 0 5 0 3 0 5 0 1 4 0 14 3 0 
6 1 1 0 0 4 1 4 6 0 0 6 12 0 0 0 0 0 0 
18 3 21 15 8 7 0 0 6 0 0 10 0 0 7 4 0 4 33 
23 6 0 2 3 0 6 6 0 0 0 0 8 0 0 3 0 12 0 
23 7 22 3 4 7 10 9 6 5 1 8 1 0 13 16 5 0 0 
0 10 0 3 0 0 0 0 0 6 5 5 0 0 0 1 0 0 0 
