19 11
8 0 2 0 0 6 8 0 2 0 0 0 1 0 0 3 0 3 0 
2 16 14 9 0 13 14 0 6 3 0 1 5 0 9 4 13 15 25 
0 4 6 3 4 0 3 7 5 0 0 0 2 0 9 7 0 4 0 
15 17 11 0 3 7 16 3 0 2 9 0 3 1 0 2 0 3 0 
5 0 0 0 0 0 1 5 8 1 7 0 6 12 0 5 0 0 6 
0 24 16 20 0 3 8 1 19 6 0 0 9 0 13 3 11 11 11 
0 23 0 10 1 9 8 0 10 3 4 8 0 0 3 7 0 15 0 
13 15 0 12 7 1 1 4 5 7 6 7 5 16 0 7 34 2 0 
0 0 6 0 0 0 1 6 0 0 0 0 5 0 0 7 0 0 0 
17 8 0 4 13 13 0 6 8 11 6 0 0 6 0 8 6 1 13 
15 0 0 0 0 11 0 0 0 0 2 0 2 0 6 18 11 0 0 
