21 12
12 7 3 0 0 5 16 21 0 1 10 5 0 0 0 0 0 13 12 0 3 
21 2 0 2 0 0 0 0 2 1 7 11 0 0 0 0 0 0 0 11 8 
10 0 0 16 0 1 12 7 8 1 16 0 4 10 0 2 4 19 0 0 0 
36 1 0 1 0 0 0 4 6 4 0 0 0 13 1 5 5 1 3 1 13 
0 0 0 0 4 0 0 0 4 0 0 0 5 0 0 3 0 0 0 0 4 
4 18 2 2 2 16 0 1 4 0 0 5 5 5 0 2 3 0 0 10 1 
5 0 0 15 0 0 6 2 0 4 0 0 9 0 0 0 0 0 0 0 0 
29 7 0 0 12 0 7 0 0 0 6 0 0 6 4 3 32 0 2 0 6 
17 0 0 0 0 0 0 0 6 0 0 0 1 3 0 0 1 16 0 0 0 
0 0 0 8 11 1 0 16 9 1 0 7 4 4 6 11 0 0 10 0 12 
37 0 0 0 19 6 7 1 2 7 0 3 6 18 3 11 7 17 18 7 10 
0 0 0 0 0 0 0 0 0 0 0 4 0 0 0 5 0 0 0 0 0 
