21 12
5 0 10 0 10 1 9 5 1 0 0 1 2 11 5 6 4 0 0 0 0 
2 18 9 0 4 7 13 22 25 14 9 11 3 19 0 0 4 0 13 16 17 
17 7 0 7 0 0 0 6 5 0 5 0 2 4 2 0 0 17 0 0 6 
0 0 0 0 0 2 13 0 0 1 1 0 0 1 5 13 0 0 0 13 4 
3 0 12 0 2 10 5 4 2 3 10 11 0 11 7 6 9 6 0 3 0 
4 0 14 0 0 5 8 0 0 0 1 0 0 0 13 0 16 0 0 0 2 
0 11 2 0 15 9 2 0 0 0 0 0 17 4 5 0 4 0 0 14 23 
0 0 8 16 0 1 2 0 1 1 7 0 0 6 3 0 2 0 0 10 0 
17 0 2 0 0 1 0 0 0 0 3 0 1 2 6 3 0 17 3 1 3 
6 11 0 0 0 0 4 0 0 0 4 0 0 0 0 0 0 16 0 0 0 
0 0 0 0 3 2 0 9 9 0 0 6 0 0 0 10 0 0 0 0 0 
0 0 11 0 7 10 2 0 0 0 7 18 6 0 4 17 0 0 0 0 0 
