21 12
4 8 4 3 0 0 3 3 0 0 13 0 0 0 0 9 0 8 0 0 3 
20 13 16 3 0 1 15 4 13 9 1 3 0 9 13 0 5 0 16 19 2 
0 16 19 0 13 0 3 0 18 12 0 0 0 4 3 5 0 24 8 0 6 
0 0 0 0 0 11 0 4 3 0 0 2 0 8 0 1 0 7 0 0 4 
6 2 23 2 0 0 0 12 6 3 9 3 0 0 0 3 0 1 0 9 2 
16 1 1 2 0 7 2 0 1 6 0 22 0 0 23 0 5 1 0 8 4 
5 0 0 0 12 1 0 4 0 0 0 2 0 0 0 10 5 0 0 0 0 
0 7 0 0 0 0 2 0 19 16 6 6 0 1 1 6 2 0 0 0 14 
0 4 15 0 1 1 0 0 6 10 0 0 0 0 0 0 0 5 0 25 3 
3 0 0 3 0 1 0 0 14 0 0 3 0 0 0 0 0 8 0 17 1 
2 0 8 0 0 7 0 0 0 0 14 6 0 15 0 4 10 0 0 0 0 
0 0 0 0 0 0 0 0 0 15 0 0 0 0 5 0 1 2 9 0 0 
