21 12
20 21 0 0 0 0 16 8 3 0 0 12 14 4 0 10 0 0 0 0 11 
0 5 0 0 0 0 5 0 1 0 0 0 0 0 0 0 0 0 0 0 0 
1 0 0 0 0 0 1 0 8 2 4 3 0 0 12 5 1 0 2 3 0 
12 13 0 0 11 19 8 0 4 1 0 5 19 3 15 6 0 17 4 14 0 
6 6 0 8 12 0 1 6 4 0 0 6 0 0 0 0 0 6 0 10 16 
0 5 1 0 0 0 0 18 2 3 0 0 5 0 2 0 0 0 0 12 0 
0 0 13 0 0 0 4 2 1 1 0 9 0 4 4 2 2 0 0 2 0 
0 0 0 0 11 8 0 0 4 1 0 8 1 6 0 7 0 0 4 0 0 
2 8 1 15 5 13 0 8 11 8 0 6 2 0 2 13 2 0 1 0 0 
7 18 27 0 0 0 17 0 0 2 4 0 0 13 6 0 2 1 18 17 15 
0 18 14 0 0 11 0 19 11 0 2 0 5 6 11 0 31 4 0 10 0 
0 11 0 0 0 0 2 0 0 2 0 0 11 0 0 11 0 1 0 0 0 
