21 12
11 0 16 8 14 0 0 0 0 0 0 29 5 0 2 7 0 0 13 0 9 
0 0 11 0 2 0 0 0 8 0 7 0 0 5 10 0 8 0 0 0 8 
1 6 14 9 0 0 0 0 5 0 7 0 0 6 9 0 18 9 0 0 0 
0 0 0 3 0 0 9 0 0 0 0 3 0 0 2 0 2 0 12 0 0 
0 0 0 0 0 0 0 0 7 0 2 0 3 0 2 7 0 0 3 0 0 
0 18 0 15 20 6 4 0 0 0 0 5 7 4 0 0 0 6 16 45 0 
15 1 0 0 16 11 13 3 12 2 3 5 0 4 0 0 9 6 0 5 5 
0 10 6 2 9 0 1 0 7 0 0 0 0 20 0 0 1 0 0 1 0 
0 0 14 3 0 0 4 0 1 0 7 0 3 9 0 0 0 18 0 0 3 
0 4 9 0 4 9 2 5 8 7 0 0 13 0 16 17 10 1 0 4 20 
0 0 14 0 5 0 3 17 0 3 0 0 0 0 1 1 0 3 0 17 2 
12 2 26 5 5 5 3 9 0 0 5 4 10 0 3 9 0 8 0 0 0 
