21 12
0 0 0 6 12 0 0 0 0 0 0 0 8 0 0 0 12 7 15 0 6 
5 0 0 0 0 5 0 0 0 0 0 0 0 2 1 0 0 2 0 0 9 
7 0 3 10 7 9 0 11 0 8 5 3 0 0 4 5 5 0 3 0 8 
7 0 8 7 0 8 1 9 11 12 10 0 1 5 5 0 0 4 0 13 0 
20 9 0 2 0 11 0 1 3 0 0 0 0 3 0 0 5 16 0 0 14 
2 0 10 0 15 0 6 0 4 0 5 0 4 3 3 0 5 0 3 0 12 
0 3 4 0 1 0 0 13 3 2 0 2 0 4 0 0 0 0 0 0 19 
1 0 0 0 5 0 0 15 0 20 8 4 3 2 0 0 2 15 3 0 0 
0 0 0 0 3 0 0 13 0 0 7 0 4 6 0 0 14 4 0 3 14 
7 26 13 6 0 11 5 0 7 9 12 0 5 2 2 27 16 2 14 7 5 
15 0 0 7 0 0 0 12 0 0 3 0 12 0 2 0 2 0 0 0 23 
0 0 13 0 0 3 10 0 0 0 0 2 0 8 0 13 2 3 0 2 0 
