21 12
9 0 1 0 0 0 22 0 14 10 4 0 12 6 2 3 5 9 0 23 9 
0 0 16 12 0 0 0 11 4 10 6 0 9 8 0 4 0 19 5 19 0 
0 0 5 0 0 4 2 0 0 6 0 18 0 0 9 6 5 0 0 0 0 
0 0 0 0 0 0 11 0 0 0 0 0 0 0 0 3 0 14 0 0 0 
8 0 2 5 4 0 2 0 15 0 0 0 4 0 0 3 0 5 0 0 0 
4 0 0 13 0 2 0 10 9 5 0 15 0 4 0 7 15 14 0 3 9 
0 14 0 0 0 8 0 2 0 13 0 5 0 8 0 14 0 3 5 0 11 
36 10 11 1 0 3 5 3 2 9 3 10 3 0 0 0 0 0 0 17 20 
20 0 0 0 0 6 6 1 14 0 10 0 0 1 6 0 11 2 0 12 10 
18 0 0 0 0 0 0 0 2 4 6 3 0 3 20 0 6 14 2 0 5 
0 0 0 0 6 0 0 3 0 5 3 8 0 6 0 2 0 9 0 4 0 
13 0 2 0 1 26 15 6 12 6 7 5 1 16 0 10 4 8 2 25 0 
