21 12
0 5 4 19 0 18 0 3 0 4 0 2 9 10 6 0 7 0 2 8 2 
9 2 16 2 0 0 0 0 0 0 0 0 0 0 6 0 0 0 20 0 0 
0 8 0 0 3 1 5 0 3 1 6 13 0 12 0 0 0 15 0 2 8 
6 0 18 3 3 0 13 1 0 0 19 5 0 0 0 0 0 0 0 0 8 
0 0 25 3 0 0 4 4 0 7 11 0 2 0 1 6 2 2 0 8 19 
0 0 0 0 0 0 0 0 0 0 0 0 0 0 0 0 0 0 4 4 0 
3 7 0 8 4 6 0 0 7 0 0 0 7 1 4 0 0 0 0 1 1 
8 0 7 2 10 0 4 0 15 0 10 0 0 0 10 0 0 0 0 11 1 
20 3 26 1 20 8 1 0 0 5 8 0 0 0 0 2 10 0 0 0 3 
2 14 0 5 0 0 10 6 0 0 0 0 0 2 9 26 10 0 5 12 0 
9 5 9 1 21 3 10 0 6 0 7 0 2 10 29 6 9 2 33 2 8 
0 4 0 5 1 3 1 0 9 0 7 4 0 5 0 4 1 7 1 0 0 
