21 12
0 11 0 14 0 0 11 0 0 0 0 0 0 0 0 0 5 2 25 0 0 
0 6 0 0 11 0 5 13 0 0 3 16 0 0 0 11 3 10 7 0 30 
0 19 0 0 0 7 8 0 0 4 4 2 4 0 8 7 12 0 3 0 26 
2 0 0 0 0 0 3 0 0 10 7 0 0 0 0 6 4 0 9 0 4 
0 6 0 0 0 8 0 4 0 0 3 0 5 0 2 10 13 5 1 3 0 
2 2 6 2 0 0 3 0 0 0 0 0 3 0 0 0 2 0 3 0 0 
1 14 0 0 1 0 0 8 0 0 4 5 0 0 1 9 3 3 1 0 0 
23 0 0 3 0 17 10 0 0 4 0 2 0 4 2 3 31 0 15 1 0 
7 7 18 0 25 0 5 8 1 3 9 8 5 4 0 11 6 0 12 2 18 
14 0 16 6 3 18 0 0 0 6 0 1 0 2 14 0 3 0 14 0 1 
3 29 0 10 10 17 0 8 0 2 8 2 7 12 10 22 0 0 10 4 19 
10 17 4 0 16 4 0 0 0 0 10 0 17 0 4 0 6 3 32 7 0 
