21 12
0 24 0 10 5 11 13 12 7 2 6 3 0 0 3 0 0 4 11 31 0 
18 11 10 15 11 9 3 3 6 3 0 1 8 4 1 0 0 8 9 1 0 
0 7 11 1 6 1 0 6 3 7 0 2 0 11 0 4 9 2 26 2 0 
0 3 18 0 2 5 0 0 3 2 1 1 0 10 0 0 0 0 14 1 18 
0 8 0 0 13 6 0 0 0 11 0 0 5 0 1 0 0 12 2 0 6 
7 5 0 0 0 15 0 0 16 0 0 0 0 13 0 0 0 0 4 9 1 
1 0 22 0 0 10 0 0 0 10 0 0 2 5 2 0 0 0 0 7 1 
19 15 14 0 4 1 0 0 0 8 1 0 0 9 0 0 8 8 2 22 0 
0 0 3 0 0 5 0 3 8 4 4 0 0 0 0 0 0 0 0 3 0 
2 13 13 4 0 12 0 15 0 7 4 4 0 0 1 7 7 19 4 0 0 
0 0 0 10 0 4 1 0 4 0 0 0 0 0 0 0 0 9 1 0 0 
0 11 12 0 2 19 2 2 8 7 0 6 0 6 0 0 0 0 0 0 12 
