21 12
0 29 8 0 10 0 1 7 0 11 8 0 3 0 0 16 0 4 17 0 0 
10 9 0 21 9 6 1 0 0 8 10 6 2 0 0 0 0 9 25 0 16 
4 0 0 11 11 0 0 7 0 9 0 0 0 0 18 0 0 1 9 3 1 
0 0 0 10 0 0 0 10 0 0 0 0 2 4 0 0 0 3 2 0 13 
18 4 4 0 1 0 1 4 20 8 0 4 2 2 4 2 5 9 18 11 0 
0 5 0 4 9 0 15 1 0 3 0 1 8 0 10 0 0 8 2 3 0 
15 13 0 0 1 11 0 0 9 0 0 6 0 2 0 23 0 10 0 1 4 
0 0 3 0 6 0 0 0 5 0 0 0 3 0 0 0 0 0 0 0 0 
7 6 1 0 0 4 0 0 1 15 0 4 1 4 13 0 0 1 1 0 0 
0 21 13 8 6 0 3 1 7 2 18 6 0 7 1 4 5 11 1 18 8 
17 0 0 0 2 0 0 0 3 0 8 10 2 9 6 10 6 13 0 0 9 
0 0 15 0 13 0 10 0 7 8 10 0 0 4 5 5 10 6 3 5 0 
