33 19
15 6 14 29 1 0 0 11 22 0 20 0 9 4 0 18 15 0 8 0 2 0 5 0 2 15 0 0 25 2 0 20 0 
22 27 0 0 26 10 0 0 0 9 6 0 0 0 0 0 13 0 0 0 4 0 3 0 4 0 0 0 2 13 36 3 0 
0 0 29 2 0 0 0 0 13 0 0 0 19 2 0 5 0 13 0 3 2 1 1 4 0 0 0 0 0 0 0 46 0 
9 14 11 0 2 0 16 0 15 0 8 0 0 0 10 2 0 0 3 0 5 7 20 15 31 0 0 0 0 7 4 17 17 
1 9 8 3 27 15 13 0 18 13 21 0 7 22 1 0 7 7 5 4 40 0 13 18 8 12 18 15 1 0 0 18 22 
1 16 0 1 0 2 12 4 0 4 0 10 0 0 0 0 0 10 12 0 2 0 0 16 0 5 0 0 0 12 5 0 1 
0 6 13 0 40 0 11 0 0 15 16 0 0 6 7 0 0 0 19 1 8 13 6 0 30 3 0 23 40 0 0 0 12 
9 23 24 17 0 0 0 1 6 0 11 0 18 7 5 1 0 1 0 0 17 0 12 4 19 0 16 4 18 0 29 0 28 
11 4 29 4 0 13 22 22 0 0 4 11 3 0 0 11 0 1 2 8 1 6 1 18 0 0 0 0 0 23 0 29 25 
0 0 3 0 0 23 0 0 11 29 20 6 5 8 0 0 0 2 10 2 0 1 9 9 0 0 5 0 23 0 16 1 0 
0 0 47 0 0 11 0 0 0 0 1 0 10 7 2 0 2 5 16 2 0 0 1 14 4 0 0 0 0 0 7 0 8 
15 8 7 27 5 9 16 6 12 4 5 10 18 3 16 4 12 6 8 2 1 0 28 0 13 20 11 2 14 0 65 11 8 
6 1 38 7 0 19 0 15 14 7 0 1 13 0 0 3 15 14 3 0 0 5 13 7 41 36 0 24 0 0 3 0 0 
0 14 15 0 0 25 2 2 0 2 0 8 0 0 13 0 15 16 0 1 1 0 16 0 15 4 0 13 0 0 58 0 8 
11 25 12 7 2 20 14 0 0 11 0 0 2 3 12 11 8 19 11 5 29 2 4 0 4 20 21 1 0 0 12 0 0 
10 0 12 0 11 0 13 7 36 2 0 0 0 0 0 4 0 31 3 17 0 22 0 17 6 6 0 13 7 0 0 30 0 
36 0 0 0 0 11 4 0 0 22 1 10 2 0 12 0 11 0 0 8 0 2 0 0 16 12 14 0 8 0 0 22 0 
17 0 2 25 0 3 20 0 17 5 42 6 0 1 9 0 7 0 18 0 4 0 0 0 7 18 0 0 6 0 20 17 22 
0 0 0 4 0 0 0 0 0 0 0 0 22 0 0 0 0 0 4 0 2 0 17 9 0 13 0 0 0 0 0 0 20 
