33 19
0 22 0 26 4 8 0 18 0 3 6 11 24 16 9 3 5 7 0 3 0 5 11 0 29 0 0 4 0 16 0 24 10 
15 0 0 34 0 0 1 0 0 35 14 0 7 0 0 4 0 11 0 31 0 15 13 7 7 1 2 24 0 0 0 17 0 
0 18 30 14 2 15 42 6 14 4 36 6 7 8 8 15 4 16 6 11 3 9 12 0 8 1 12 18 0 8 0 10 4 
0 0 11 28 0 0 12 9 3 0 0 11 0 11 0 8 11 0 12 3 3 0 11 0 0 2 0 0 8 0 0 28 0 
12 21 31 25 2 0 8 25 1 0 9 0 7 0 21 1 14 7 11 0 3 0 16 0 1 18 0 0 24 10 0 12 38 
11 21 7 0 27 21 5 25 10 7 16 25 34 8 7 16 15 9 10 12 2 5 11 10 21 3 20 21 13 0 0 40 3 
0 2 0 4 0 0 20 5 3 23 10 0 0 0 0 0 2 11 0 4 0 0 16 0 0 0 10 1 19 8 0 8 0 
0 0 0 9 4 0 0 0 4 14 0 2 3 0 2 2 2 3 0 0 2 4 0 11 0 2 0 6 0 0 0 10 0 
32 32 26 3 4 12 20 0 9 0 8 0 0 0 0 2 0 12 0 0 16 0 0 6 8 15 29 7 12 6 0 20 29 
0 0 0 0 9 0 23 16 0 4 5 0 9 2 13 2 0 0 4 0 0 4 0 7 0 0 8 2 0 23 0 2 0 
0 22 0 0 0 0 0 6 15 0 0 0 0 19 3 0 8 2 0 0 3 0 11 21 7 0 9 0 8 0 0 0 10 
0 27 29 40 0 0 0 4 7 0 7 6 4 0 0 0 7 3 0 0 0 11 0 0 0 0 0 3 26 0 27 27 11 
5 0 0 17 4 16 19 0 40 12 7 0 2 0 0 0 0 9 0 0 7 1 3 0 19 4 33 10 4 8 22 22 8 
11 0 23 0 0 0 0 18 4 7 0 2 0 0 22 0 5 4 16 4 2 19 8 0 0 24 0 0 4 0 0 3 0 
0 0 0 0 2 23 19 0 0 0 0 0 0 12 8 3 8 0 0 4 15 1 8 13 4 12 0 0 23 8 0 8 0 
0 0 36 11 20 13 14 2 8 0 27 8 10 0 0 0 0 5 0 0 0 0 14 10 20 0 0 0 3 0 0 3 30 
1 0 0 17 20 0 10 0 0 6 0 13 4 0 15 15 16 9 4 8 0 0 4 0 23 0 10 8 0 0 0 8 18 
17 1 0 0 0 5 18 12 16 0 20 2 0 2 0 3 0 3 4 4 1 17 10 0 14 0 12 0 4 0 0 31 0 
31 0 0 0 0 0 16 2 7 0 10 0 0 6 0 0 10 0 0 0 0 0 4 9 0 0 14 0 1 1 0 66 1 
