33 19
0 8 7 0 46 0 0 9 2 13 29 20 11 0 28 0 9 0 0 8 0 0 0 17 0 33 3 1 18 0 10 27 0 
19 22 0 32 0 17 0 0 9 0 8 8 0 0 5 0 0 11 1 18 0 4 14 8 8 0 0 24 5 0 0 0 11 
0 2 0 0 8 0 0 0 17 7 0 10 0 14 34 2 7 3 11 27 1 10 13 0 0 0 2 21 8 5 0 0 18 
6 0 0 0 18 0 3 20 5 0 9 0 0 0 10 5 0 14 1 5 5 0 28 3 6 0 0 0 21 2 0 14 9 
15 11 1 36 37 47 25 0 0 5 0 4 0 0 8 19 0 0 12 13 5 4 13 0 8 16 6 55 10 0 0 18 9 
1 0 0 23 19 16 17 1 0 0 19 12 14 0 17 0 0 3 0 5 7 12 0 13 0 21 46 0 1 22 0 30 6 
37 2 1 0 17 29 2 2 1 0 0 0 0 6 14 3 0 0 0 5 1 0 22 3 24 0 18 0 0 11 0 0 0 
0 23 5 4 9 17 10 0 0 0 10 0 8 5 7 0 28 9 12 16 18 0 38 0 1 6 9 1 6 3 0 0 6 
1 24 17 7 1 0 5 32 0 6 15 18 0 0 7 0 0 0 10 32 0 4 0 0 3 59 4 7 10 1 4 2 25 
17 0 0 18 0 5 14 0 7 7 14 5 24 9 0 19 7 16 1 3 7 15 0 0 3 0 4 0 0 6 43 16 0 
2 16 29 38 21 12 1 15 3 0 7 25 18 0 0 12 25 9 1 7 0 2 0 13 22 22 19 11 0 0 28 2 9 
0 30 0 0 0 21 0 0 24 0 0 0 0 0 9 0 0 2 4 0 0 3 0 0 0 0 29 9 11 2 13 31 25 
18 16 5 5 0 1 1 12 0 0 20 4 0 0 0 0 0 0 18 3 3 20 0 13 6 0 13 0 0 0 30 5 0 
4 0 0 3 0 1 0 8 9 13 2 1 32 11 0 7 0 0 9 11 5 3 6 7 0 4 14 0 0 0 27 8 0 
0 0 22 0 0 7 0 8 0 0 0 23 0 2 0 0 0 0 0 3 0 0 0 0 29 0 0 0 0 18 0 7 0 
11 8 0 0 1 0 0 0 0 0 0 0 5 13 0 0 5 0 0 0 0 17 4 2 0 0 0 11 0 0 0 0 0 
7 12 17 0 0 0 4 0 9 0 0 6 0 0 0 13 0 22 0 11 0 1 0 0 6 0 0 0 0 0 12 0 0 
0 0 0 2 13 0 21 10 0 0 8 1 8 3 54 3 0 25 0 45 6 6 2 4 5 3 2 32 6 8 7 9 10 
0 0 45 0 0 17 9 0 0 0 18 0 0 0 0 0 0 11 0 3 23 0 14 0 0 18 0 0 29 27 9 0 0 
