33 19
25 24 0 10 11 0 0 0 0 0 0 16 6 7 12 12 3 0 13 7 18 17 0 0 8 1 8 16 0 0 14 25 22 
0 0 0 18 0 0 20 0 0 5 12 1 1 2 7 15 0 0 0 0 0 15 0 8 0 20 25 13 0 0 0 5 0 
4 1 0 26 25 0 16 9 0 8 0 0 19 0 13 0 9 0 0 0 0 18 16 0 0 26 10 0 2 0 0 19 0 
0 0 7 0 3 10 37 22 0 9 4 5 3 0 4 0 22 29 0 1 3 4 0 0 40 19 2 0 0 22 0 7 15 
17 0 0 0 49 15 0 25 0 11 0 20 9 8 10 0 0 17 0 3 0 0 3 0 2 5 25 0 2 9 0 7 25 
0 0 15 7 10 0 12 0 5 2 0 18 0 0 8 7 4 29 0 8 0 1 7 10 16 9 41 3 0 0 0 43 3 
0 14 0 36 24 0 5 24 5 23 8 0 3 9 0 12 3 36 2 6 7 1 0 4 0 21 0 7 0 0 28 27 0 
4 31 10 3 24 0 0 11 0 21 0 2 11 11 0 17 0 0 0 0 0 12 0 0 5 26 3 0 15 7 0 0 56 
0 0 26 0 25 13 0 1 5 10 0 10 2 5 3 4 0 0 13 10 0 2 0 0 5 11 6 0 27 31 0 5 9 
0 15 0 12 0 0 0 0 0 8 0 2 0 0 0 1 30 8 0 2 0 5 1 8 5 5 0 0 1 13 0 0 17 
0 18 2 10 3 12 0 0 5 8 18 3 4 9 18 16 2 15 13 3 0 11 8 0 0 9 12 0 18 0 0 13 13 
4 28 2 0 3 5 5 0 0 0 0 6 0 0 0 0 0 6 0 0 0 0 0 0 0 0 0 2 0 28 0 1 5 
31 30 0 7 0 6 0 9 0 2 0 8 9 0 12 40 2 0 7 11 0 0 0 5 3 18 22 0 13 0 15 29 0 
13 21 27 4 0 10 5 14 6 1 19 3 18 18 1 0 4 4 5 5 0 0 21 0 3 0 17 7 18 26 0 28 2 
0 12 0 27 12 0 25 1 0 5 8 4 12 0 7 0 0 0 2 5 2 9 0 0 0 4 5 3 0 13 27 37 14 
14 3 29 14 12 0 3 8 0 19 0 0 16 0 21 0 0 2 3 10 0 9 0 10 0 3 0 0 0 8 0 49 10 
0 2 0 5 20 26 10 28 0 14 0 1 0 0 2 0 29 0 17 0 10 5 6 14 42 18 16 0 0 22 14 1 0 
0 0 18 94 3 24 19 0 0 31 4 0 0 3 12 0 7 8 0 0 0 17 19 24 1 22 0 24 0 1 0 28 23 
23 3 15 15 0 9 14 0 0 0 0 4 5 27 17 0 0 0 14 8 0 9 8 28 13 7 0 0 0 16 20 10 0 
