33 19
0 0 4 26 0 24 4 0 3 0 0 9 0 7 0 0 0 0 0 7 7 0 0 0 0 9 0 0 0 26 0 0 13 
0 3 21 28 4 6 1 10 23 13 5 15 18 6 12 24 10 1 0 0 0 8 7 6 22 1 0 0 0 28 18 35 0 
11 31 27 6 26 34 23 23 8 6 11 3 0 13 1 26 0 1 12 0 12 8 1 0 23 0 9 8 4 9 28 0 0 
0 0 16 20 0 0 6 0 3 1 0 0 0 0 0 15 1 0 0 17 0 2 16 20 0 9 0 11 5 13 0 10 0 
21 1 25 41 0 4 7 22 0 7 4 0 0 0 6 13 15 22 0 12 0 29 12 0 0 0 0 0 0 0 0 14 18 
28 27 0 30 4 0 0 0 12 0 8 8 0 18 0 0 0 0 0 0 0 0 0 6 0 2 0 0 11 26 10 12 7 
26 15 28 0 0 12 0 22 1 1 1 9 4 0 10 0 14 0 7 1 23 0 0 0 0 24 36 16 0 22 0 29 0 
0 0 27 18 0 7 1 5 14 3 13 0 0 2 25 10 0 0 2 10 1 15 13 14 1 4 0 25 0 19 1 0 11 
21 0 7 0 0 6 0 0 3 0 16 1 0 3 0 15 8 1 2 5 11 21 0 4 0 7 0 22 0 3 4 0 2 
0 0 0 3 11 27 16 27 11 0 0 13 0 5 11 11 0 14 2 0 0 0 23 14 2 0 11 0 21 7 0 0 21 
0 5 0 47 0 0 8 12 29 14 7 8 0 0 6 0 29 14 0 0 17 0 0 7 15 0 19 7 30 26 21 1 16 
24 25 6 2 0 0 0 0 1 10 0 0 0 0 0 7 0 5 0 0 0 0 10 0 24 0 24 26 8 0 4 0 20 
0 17 11 26 5 0 5 0 0 0 0 10 0 0 0 12 3 16 5 1 3 0 0 2 6 0 0 0 0 0 0 0 7 
24 29 12 0 0 21 54 18 0 0 2 14 6 0 21 11 0 13 0 2 1 3 0 5 18 3 21 0 33 0 3 0 0 
2 38 4 3 0 0 0 0 17 27 0 0 0 0 7 0 0 0 0 6 3 0 3 14 0 23 0 5 23 13 0 0 2 
5 1 0 0 0 15 0 0 4 0 0 0 0 0 0 0 0 0 0 0 2 0 0 23 0 7 0 4 28 0 5 10 0 
6 28 0 11 4 13 8 0 0 4 4 12 0 12 18 0 6 21 0 2 0 0 15 9 1 14 0 1 0 29 16 0 0 
9 54 0 1 5 11 25 25 1 8 16 7 10 6 16 1 2 13 4 4 4 2 16 10 0 23 14 6 4 7 10 56 4 
0 0 12 1 0 1 0 0 0 0 0 15 0 0 0 22 0 0 0 0 11 2 0 1 6 0 15 0 4 0 0 1 1 
