33 19
22 0 2 0 10 0 3 0 13 0 1 0 9 9 10 8 0 2 19 7 0 5 0 4 24 15 0 0 8 11 0 0 0 
0 0 0 0 0 0 16 0 0 4 0 0 0 0 0 0 9 1 0 0 6 0 37 10 3 19 0 0 6 5 0 0 0 
8 0 0 0 0 0 0 0 0 14 0 0 0 0 0 0 0 1 0 10 0 0 0 0 0 0 0 7 0 0 0 0 0 
48 1 6 52 0 0 9 0 9 0 0 9 0 15 5 0 0 8 16 0 0 23 0 0 0 4 13 8 25 0 30 0 0 
15 1 29 21 3 9 12 8 50 8 22 4 14 2 23 17 6 10 0 15 0 10 13 0 23 5 43 1 0 14 12 23 33 
12 2 0 2 0 0 3 5 24 7 19 0 4 6 1 0 11 0 0 5 8 0 4 0 0 15 0 10 0 0 0 1 24 
23 0 27 0 0 0 0 15 0 32 4 2 0 1 9 0 16 0 0 10 0 7 15 0 0 0 3 0 2 27 0 23 32 
6 0 29 1 0 26 6 0 3 0 3 0 3 3 0 0 12 0 0 4 8 6 11 0 8 7 10 0 17 0 11 4 4 
59 11 9 1 0 0 3 2 0 23 21 5 9 0 12 4 12 10 3 12 12 25 10 4 13 2 10 23 5 0 5 1 60 
0 0 29 12 0 4 0 0 0 0 0 0 8 14 9 0 7 3 13 0 0 10 8 7 12 1 2 7 1 6 2 37 0 
8 0 7 0 10 0 0 4 0 0 0 6 3 6 8 0 35 3 0 0 0 0 0 0 5 1 5 3 0 13 0 0 0 
0 0 0 2 13 27 0 6 1 26 17 2 20 3 8 15 3 10 0 0 0 9 0 10 5 13 0 17 19 5 15 0 41 
0 17 2 16 2 14 0 12 9 19 0 2 3 0 4 9 0 0 26 14 7 2 0 0 0 10 4 0 5 0 0 3 6 
37 28 5 18 19 0 0 5 0 17 12 9 5 8 17 3 0 0 11 0 0 2 12 0 20 0 17 0 4 39 0 22 0 
10 0 2 0 1 0 7 0 0 2 0 0 0 3 4 0 3 0 0 6 0 14 0 0 6 0 0 0 5 0 0 0 0 
34 19 0 13 0 0 14 0 0 0 0 18 0 5 0 0 0 0 2 0 33 0 4 0 8 0 0 10 25 17 0 0 8 
0 21 27 24 23 0 14 8 0 3 17 0 0 0 4 7 24 0 12 0 3 8 21 3 0 2 3 8 0 14 10 0 5 
18 0 0 7 25 0 20 9 13 0 7 4 0 0 5 5 0 0 0 0 14 0 0 0 9 0 0 6 24 13 0 0 0 
6 9 5 39 7 34 39 21 18 0 0 0 3 25 5 17 0 8 3 0 13 0 22 0 37 24 0 24 37 16 6 25 20 
