33 19
0 0 41 1 0 0 5 9 0 0 30 0 0 0 0 11 9 15 9 0 0 8 0 0 0 25 17 0 0 19 0 0 15 
4 17 33 3 12 8 32 4 19 29 2 0 8 0 17 4 0 0 3 17 7 7 0 2 0 1 23 4 18 21 14 9 2 
13 15 23 1 9 0 12 0 0 24 0 0 2 11 15 0 0 0 15 6 7 0 10 3 0 55 16 17 3 20 24 15 0 
0 9 36 0 0 10 0 9 13 8 0 5 0 18 13 0 9 0 0 0 0 2 4 0 0 0 0 25 0 0 17 0 0 
3 1 16 1 1 10 0 0 24 0 0 0 7 18 0 0 0 10 10 11 0 6 0 0 0 5 0 2 0 1 1 8 0 
15 4 0 8 45 5 1 23 11 12 11 11 8 0 9 6 0 13 0 0 17 3 0 0 0 6 10 9 46 3 11 0 1 
12 0 14 1 2 29 0 0 0 11 22 9 0 0 6 0 0 0 16 5 13 8 0 5 4 0 20 0 0 24 3 0 23 
29 0 3 1 0 3 2 0 3 0 1 4 0 9 14 0 13 6 0 19 0 0 7 0 4 7 7 11 6 29 16 0 2 
23 6 4 0 1 0 16 0 0 11 0 2 0 6 0 11 0 8 0 0 11 9 0 6 6 0 0 0 17 25 30 2 3 
0 36 3 31 16 26 0 6 0 8 0 0 0 0 0 0 0 0 9 0 0 15 3 8 0 3 0 25 0 0 47 4 2 
0 0 14 0 0 11 0 0 12 21 0 1 0 3 0 0 14 0 0 4 13 6 3 14 0 4 0 0 0 0 21 9 0 
0 12 0 0 32 0 0 0 11 0 6 6 0 1 10 1 0 3 7 1 0 3 0 9 3 17 0 0 0 0 23 1 31 
0 1 9 11 0 2 11 22 0 0 0 5 10 0 0 1 1 2 0 0 10 9 0 1 0 3 9 3 4 0 3 1 26 
0 0 10 4 13 24 11 0 0 0 2 4 0 10 12 6 0 9 0 0 0 1 0 10 0 0 6 0 2 24 25 1 0 
0 6 2 13 3 0 0 30 7 0 0 13 9 6 0 0 0 6 3 0 0 7 9 0 26 0 0 0 0 0 0 10 0 
20 0 0 0 6 24 22 19 2 10 3 0 2 35 13 3 9 3 14 2 21 10 6 1 0 2 28 13 14 0 10 0 1 
0 0 48 0 0 0 0 0 2 15 0 0 0 0 13 0 0 3 0 0 3 0 2 8 22 0 0 0 26 0 0 0 0 
40 0 16 5 20 2 0 22 13 55 20 6 3 0 1 8 0 6 19 14 7 23 1 24 15 17 16 15 0 35 4 12 0 
40 17 18 0 4 3 11 23 0 0 3 13 6 0 16 0 0 0 1 1 12 9 5 1 0 15 33 15 26 0 26 0 0 
