33 19
0 0 27 5 25 0 9 0 5 44 0 10 13 0 1 25 9 8 4 0 9 10 19 7 15 13 4 7 3 17 21 34 6 
15 0 8 17 0 0 12 0 0 6 0 0 27 11 1 15 3 0 0 0 0 12 3 9 11 0 13 8 0 4 0 16 0 
0 2 0 9 0 5 3 0 7 0 15 8 0 5 0 27 4 0 8 13 8 18 3 2 11 8 6 4 9 16 3 6 14 
0 0 12 15 6 0 1 7 0 0 6 5 0 25 0 4 1 0 0 0 18 10 0 0 0 0 0 0 0 0 7 8 13 
0 9 5 0 27 0 1 0 2 13 9 9 3 0 0 2 9 3 6 0 9 2 8 3 0 9 3 8 0 17 0 27 26 
10 21 13 10 32 28 3 6 2 2 21 13 0 34 0 3 16 1 10 0 13 6 0 2 20 0 25 0 5 24 0 38 0 
0 0 25 23 0 0 15 0 10 9 0 0 0 3 0 9 0 0 8 0 0 13 6 0 0 0 23 25 0 11 0 0 0 
7 2 59 0 13 22 0 23 2 15 5 0 19 17 16 15 6 3 3 12 6 10 12 21 31 11 23 34 0 5 36 14 18 
10 10 19 1 2 3 0 0 0 0 1 17 0 0 0 0 7 0 0 17 6 9 0 0 0 0 5 0 0 0 0 0 0 
0 0 20 1 0 0 31 0 22 0 0 19 0 0 0 3 0 0 16 0 0 4 1 8 0 1 0 0 26 0 13 0 2 
5 0 0 16 0 20 3 4 11 0 4 32 0 5 6 4 13 6 4 26 18 1 1 16 0 1 3 0 0 12 4 0 6 
0 0 27 0 0 0 0 0 9 2 0 0 10 0 0 0 12 22 0 0 9 6 0 0 4 0 4 0 0 6 4 0 2 
30 5 2 0 14 2 15 0 0 2 0 9 1 8 6 22 1 15 0 0 6 17 0 8 0 0 11 1 0 0 30 11 0 
0 10 4 2 2 0 10 0 2 2 3 6 0 8 0 0 10 6 17 0 8 6 4 0 0 9 25 5 0 0 0 0 16 
12 4 37 18 1 4 0 0 24 7 0 17 4 13 19 0 1 7 0 0 5 18 0 1 25 23 0 12 16 13 0 0 44 
0 0 26 10 23 13 0 8 0 0 0 0 0 0 8 0 0 4 5 0 0 7 22 4 0 0 22 15 6 2 8 2 0 
9 0 9 11 11 0 3 40 1 2 9 9 2 0 9 20 0 0 0 0 0 0 17 0 0 0 0 0 4 22 0 16 23 
0 8 4 14 2 0 13 0 0 0 7 0 22 0 0 0 0 20 14 13 0 7 3 1 6 0 8 0 0 8 8 16 0 
34 0 0 2 1 6 0 9 0 4 17 40 17 22 13 16 5 0 7 0 11 1 17 13 21 7 26 6 0 0 17 32 9 
