33 19
3 35 25 20 10 7 0 18 21 0 9 5 7 0 11 5 0 11 0 28 12 0 3 27 0 29 0 0 17 1 1 0 14 
24 28 0 8 0 0 0 0 3 0 19 8 0 12 4 0 0 0 0 0 0 0 0 22 20 17 17 15 0 0 0 17 11 
13 0 0 0 27 0 2 29 3 28 1 1 12 31 6 14 5 1 1 0 0 0 0 0 17 1 1 4 16 35 23 27 21 
10 16 0 42 0 0 6 7 3 0 20 3 0 6 13 0 3 8 0 23 24 0 6 0 23 9 11 0 1 27 29 11 0 
0 0 0 20 1 15 0 0 3 6 3 12 0 0 0 0 5 9 0 0 0 5 12 30 1 0 5 5 1 1 0 28 0 
6 7 0 22 30 10 0 25 13 0 4 0 6 0 0 5 0 7 10 1 1 0 7 4 11 25 0 0 0 0 0 0 3 
0 0 5 0 0 31 0 0 0 7 0 13 0 0 0 0 4 1 7 0 3 0 10 8 0 7 21 15 0 24 25 12 7 
0 6 1 0 5 11 22 0 16 0 0 2 15 25 0 0 0 3 0 8 9 5 0 15 0 21 9 13 0 5 0 4 37 
4 0 9 0 0 1 0 5 6 0 0 7 0 15 33 0 2 3 0 0 9 0 10 1 0 4 1 0 0 3 33 17 7 
47 24 0 2 3 5 6 6 27 1 1 19 16 6 0 11 14 0 0 0 17 13 25 4 2 28 0 5 14 19 8 0 3 
0 0 8 4 32 1 0 4 0 12 7 22 5 14 0 0 9 15 11 9 0 15 6 0 0 0 0 25 24 0 0 14 21 
15 0 6 0 0 3 0 7 22 3 6 0 7 14 11 0 9 1 12 2 3 5 3 0 21 1 2 9 2 4 1 0 0 
4 34 6 0 33 0 5 0 0 15 9 5 0 0 0 0 15 0 0 15 0 1 21 0 17 0 0 1 0 0 1 26 6 
0 23 3 0 13 14 0 4 20 7 9 0 4 12 0 14 16 3 0 20 0 7 1 0 30 6 2 11 20 10 9 1 1 
0 14 0 0 18 0 0 0 0 19 0 0 0 0 31 0 0 0 0 0 0 3 21 0 2 0 11 0 19 6 29 0 18 
14 0 15 9 15 13 0 0 0 13 0 0 0 11 14 9 0 0 38 15 0 0 0 0 33 1 4 0 0 1 2 0 7 
8 14 1 5 0 0 4 0 14 15 1 0 13 9 8 0 0 4 0 0 1 21 34 0 0 21 0 0 8 9 0 4 3 
0 12 0 0 25 15 0 4 5 17 5 9 11 44 8 0 0 3 13 0 3 32 8 18 0 0 0 5 0 11 0 8 18 
12 6 35 0 0 0 8 9 6 0 0 0 7 7 8 0 0 3 0 7 3 15 4 1 15 0 4 25 21 0 0 0 0 
