33 19
20 8 9 29 3 0 0 8 5 8 21 0 12 5 0 3 18 0 0 0 0 0 0 0 0 15 6 0 0 9 1 20 6 
17 0 3 0 0 16 29 24 15 3 2 0 8 3 12 17 3 2 10 0 7 41 6 16 0 14 2 0 37 0 0 0 26 
0 26 11 0 0 12 0 6 12 10 0 1 1 11 0 0 14 6 0 3 12 16 0 3 12 0 14 26 1 2 14 0 24 
0 25 9 4 7 11 19 2 9 0 13 25 18 0 0 4 0 0 0 0 8 0 15 13 0 23 24 0 49 5 0 29 0 
16 1 1 34 0 16 0 1 0 0 0 0 0 0 0 7 15 12 0 0 9 0 3 18 5 0 1 24 0 16 0 0 0 
21 26 5 0 25 0 0 21 0 2 0 8 9 6 12 5 10 0 0 0 24 21 0 3 13 10 20 3 0 21 4 5 0 
13 3 11 7 3 0 25 6 0 0 0 0 0 24 0 0 0 0 25 7 6 11 0 0 0 6 1 0 0 0 28 36 11 
0 23 2 36 0 0 0 0 0 0 0 0 0 0 1 1 1 0 0 3 8 18 4 0 19 4 23 13 0 6 0 0 5 
19 18 2 2 18 0 0 14 4 0 10 7 2 0 13 0 0 0 11 9 25 4 25 0 0 18 0 20 0 5 28 24 0 
39 22 42 1 6 12 0 1 8 0 15 2 17 2 9 0 5 9 0 22 12 0 53 4 6 10 40 0 1 26 14 0 11 
0 0 6 1 24 22 0 0 7 0 29 0 0 0 12 11 6 0 2 4 4 0 9 0 0 7 33 20 25 0 4 23 0 
9 0 0 3 7 0 0 14 0 13 13 7 5 0 0 0 11 0 3 0 0 0 13 13 24 24 0 0 10 6 0 25 0 
0 14 0 5 12 3 0 37 5 0 0 21 11 11 2 0 15 10 6 18 0 15 9 11 2 0 6 7 21 2 4 7 0 
9 2 35 16 0 24 0 21 0 19 6 12 20 3 6 0 2 5 7 3 24 1 5 0 13 0 7 11 2 45 0 49 8 
26 0 54 0 14 18 0 0 23 0 0 8 1 17 2 0 12 2 2 0 0 0 7 0 21 5 26 10 0 18 2 32 0 
18 0 41 0 0 15 1 10 12 0 0 14 0 2 14 6 4 0 0 0 40 11 0 9 18 4 0 8 28 14 0 0 11 
0 4 7 0 0 0 1 13 1 3 0 0 3 12 9 0 12 3 24 0 11 0 9 9 11 0 32 19 6 0 0 0 14 
0 0 0 0 0 0 0 2 0 8 0 14 15 26 0 8 3 8 0 0 7 8 0 8 0 13 11 15 16 0 0 16 0 
0 0 3 0 0 0 0 18 0 21 8 0 0 0 0 7 0 13 4 10 13 16 2 0 2 18 0 0 0 0 4 0 0 
