33 19
0 8 3 36 0 10 18 33 16 7 8 0 0 5 15 0 22 0 4 9 5 6 1 2 6 5 23 10 4 0 2 14 0 
23 31 19 0 4 24 15 0 2 0 0 25 11 16 18 12 15 0 5 0 15 0 0 16 1 0 9 27 30 10 19 0 31 
2 31 3 0 15 11 7 0 0 10 31 10 7 19 2 4 0 8 0 26 1 0 0 10 7 20 3 0 6 6 23 0 22 
23 8 6 28 9 4 0 0 1 15 0 2 10 2 0 0 7 15 0 0 0 0 10 8 0 0 0 3 7 0 2 28 9 
0 0 10 0 0 1 0 0 0 9 6 12 29 11 7 17 3 0 0 10 0 2 0 0 21 13 0 0 14 8 0 19 0 
21 10 3 40 6 10 0 0 0 0 0 36 0 5 13 0 2 13 0 8 7 19 0 19 0 14 0 10 17 0 3 0 8 
11 0 32 17 0 2 0 13 0 13 3 31 10 15 9 1 5 7 18 0 23 10 1 7 7 0 0 8 3 0 4 21 1 
16 10 0 0 0 0 14 6 0 2 0 6 0 0 0 9 16 2 0 6 8 0 0 0 0 0 0 0 5 0 0 0 0 
0 0 8 24 5 0 7 28 13 0 1 3 0 9 0 7 0 10 13 9 1 38 10 0 0 18 22 12 19 0 0 6 0 
0 0 0 27 0 1 23 1 0 6 0 0 5 12 0 0 8 0 0 9 0 0 0 0 1 10 0 6 0 0 60 0 8 
0 0 0 0 0 1 0 0 13 4 0 0 1 4 0 0 0 0 1 0 0 18 0 5 6 0 0 0 8 0 0 10 6 
1 24 0 15 0 6 0 9 0 0 14 4 13 11 0 5 2 0 24 4 5 0 0 3 8 39 10 0 0 0 0 0 0 
1 0 2 0 30 10 24 1 0 0 0 0 21 0 0 0 2 0 0 0 16 12 1 2 12 19 0 1 13 8 24 5 32 
0 0 23 0 0 0 20 0 9 0 0 0 18 4 0 5 12 12 0 0 5 1 0 7 4 23 20 1 6 0 18 0 8 
5 5 19 9 0 2 5 4 0 4 0 11 2 7 0 0 2 0 18 7 6 1 1 20 13 0 0 0 0 0 0 1 0 
28 13 14 20 22 21 3 1 20 9 17 1 2 0 3 11 10 13 0 0 5 15 0 33 9 0 46 33 42 5 0 38 0 
9 0 31 23 15 0 0 4 0 12 20 5 0 5 3 0 11 15 0 14 0 6 10 7 0 2 7 18 0 0 29 21 26 
0 38 28 0 24 15 0 0 5 0 0 0 7 5 16 0 6 0 0 1 0 5 0 0 0 3 1 0 19 3 0 5 8 
0 0 1 0 0 6 5 7 11 0 4 6 0 0 0 11 9 0 12 11 0 0 0 15 0 18 11 0 8 0 0 0 0 
