33 19
0 0 0 4 0 0 23 0 18 0 0 7 5 0 0 0 0 55 2 0 12 0 7 6 8 15 18 0 13 23 4 5 3 
6 3 0 8 0 5 0 0 5 13 0 6 13 7 0 5 4 0 7 0 8 0 18 0 13 12 0 0 0 11 0 0 0 
6 8 0 42 1 0 0 0 0 8 0 7 12 0 0 0 7 0 5 14 14 9 34 15 0 5 0 0 0 7 2 0 0 
3 0 6 1 23 22 0 3 0 2 3 0 4 0 0 10 3 12 1 0 0 0 0 7 21 0 0 47 0 1 0 15 14 
5 20 1 2 11 23 0 18 29 0 0 11 10 22 6 0 1 5 12 3 2 0 7 1 0 0 1 6 4 26 4 4 0 
3 0 0 7 22 16 2 17 1 3 1 29 5 0 4 6 2 0 0 17 0 21 0 0 7 0 1 10 24 0 0 25 5 
0 0 0 0 2 7 18 21 0 0 10 0 0 8 0 0 0 2 2 12 15 10 16 6 4 0 0 0 25 0 10 12 0 
6 22 11 12 2 2 3 6 8 7 9 7 1 6 3 11 4 19 8 14 0 0 7 6 4 0 7 0 2 0 0 0 0 
6 25 0 4 0 10 0 0 0 0 0 8 2 0 0 0 0 8 7 18 0 0 4 0 0 0 21 5 11 11 2 26 5 
0 0 6 23 0 12 0 23 0 0 0 0 22 4 4 6 0 23 14 6 9 5 8 17 3 7 11 0 2 7 0 7 23 
0 50 1 26 12 0 5 18 3 4 26 3 11 0 4 0 5 0 0 0 6 5 1 5 5 14 0 0 0 32 29 0 11 
17 23 0 0 0 9 40 20 3 9 0 10 5 0 1 0 5 22 3 1 12 10 4 0 20 0 0 5 0 5 10 25 4 
0 0 4 7 8 13 18 0 0 0 0 0 6 7 1 1 10 0 6 3 11 1 5 2 2 5 0 0 22 9 0 0 0 
9 0 0 28 2 0 0 0 24 9 22 0 5 4 0 11 0 0 10 0 4 2 2 8 2 1 14 2 26 0 11 31 26 
0 0 4 13 16 0 14 26 0 14 9 5 0 29 0 14 3 7 0 15 10 5 2 4 0 12 0 13 21 15 3 0 19 
0 14 0 0 3 22 17 0 0 12 11 7 0 0 9 0 0 27 35 0 19 16 13 22 0 17 0 10 1 11 0 0 26 
0 0 0 25 0 27 21 0 9 0 18 0 0 0 0 0 0 16 0 14 14 10 0 0 0 0 3 21 4 0 2 10 27 
13 0 0 0 0 0 0 38 0 0 0 0 16 0 0 0 0 17 0 8 0 0 5 9 8 0 0 14 9 0 0 0 8 
12 3 11 0 0 0 0 11 0 7 0 0 0 0 2 11 3 0 0 19 6 7 0 0 6 18 16 0 0 1 5 0 0 
