33 19
0 10 25 0 6 0 0 6 11 21 6 4 1 2 0 11 2 0 0 12 7 0 9 0 0 5 1 24 17 12 21 0 0 
20 0 0 0 26 0 2 0 2 33 6 17 0 0 0 0 0 0 0 11 6 12 0 4 0 3 1 0 20 4 32 0 19 
0 8 9 16 11 0 15 0 0 2 0 8 8 6 11 0 14 0 0 0 2 14 0 11 0 32 1 25 19 27 7 0 16 
6 32 8 23 33 0 0 1 0 0 22 0 14 19 0 12 2 10 40 0 2 35 0 1 0 11 16 35 0 25 0 0 20 
0 0 0 0 0 5 0 0 4 0 5 0 0 0 0 2 11 0 0 12 3 0 0 0 0 1 7 0 4 0 0 12 11 
11 0 0 15 22 2 15 5 0 2 0 32 12 3 5 12 0 0 19 0 5 18 2 4 1 4 23 0 4 0 18 0 23 
10 5 0 8 16 1 28 1 0 0 10 6 6 7 4 2 24 0 4 0 0 0 2 0 0 0 10 0 0 0 0 0 5 
3 17 15 15 11 17 18 15 3 5 8 14 0 2 3 10 0 14 19 17 35 0 16 0 22 5 4 3 15 4 8 11 40 
0 0 1 1 9 6 3 0 0 0 0 9 0 11 4 0 1 13 5 0 13 27 2 0 0 0 8 22 11 8 0 0 0 
45 0 6 7 0 0 0 0 12 1 2 0 0 8 18 0 0 0 10 0 9 1 1 10 0 0 0 0 0 0 0 0 14 
1 8 0 3 0 6 0 21 27 0 2 4 0 9 10 0 6 6 24 0 13 0 2 24 8 0 2 0 20 11 20 21 22 
0 0 18 0 0 0 0 33 0 4 0 0 6 15 18 2 0 15 11 0 0 11 15 0 0 0 2 10 9 14 6 29 20 
18 15 0 1 0 23 37 0 3 18 10 5 26 4 0 1 21 0 3 1 4 17 7 0 0 5 14 44 19 21 51 0 31 
11 15 0 0 0 12 0 10 0 0 10 0 5 12 15 0 0 18 0 0 12 0 0 0 0 0 0 0 0 13 0 0 12 
0 0 3 0 0 4 0 0 15 0 10 8 0 12 0 0 11 1 0 10 0 0 26 8 0 9 0 0 0 0 0 9 4 
8 0 11 0 0 0 10 0 15 0 0 9 0 28 0 0 1 5 0 17 7 11 9 13 0 0 12 0 4 0 0 0 23 
16 0 16 7 0 2 6 5 0 0 6 0 0 23 0 0 0 1 20 10 1 13 1 8 0 25 0 8 26 3 0 8 26 
0 13 5 5 13 19 0 14 5 0 0 18 5 36 19 1 6 0 17 0 0 0 5 16 0 5 25 5 0 0 6 17 19 
0 15 0 0 1 1 0 24 0 11 0 20 5 0 0 0 4 0 0 0 2 0 0 8 0 0 10 0 0 0 11 20 10 
