33 19
1 0 16 10 11 10 0 0 0 0 4 0 3 0 1 12 14 21 0 0 18 5 0 0 4 8 26 4 0 0 0 20 0 
0 29 0 0 3 0 5 0 0 0 9 0 8 0 16 0 28 0 0 0 12 2 0 2 0 0 0 22 9 0 32 0 26 
23 23 1 0 0 23 0 2 2 4 2 0 0 13 17 0 15 0 0 0 0 21 8 0 0 0 0 0 0 0 0 17 0 
13 6 1 14 0 20 19 6 0 7 0 0 3 13 7 6 0 8 0 0 12 0 0 0 2 47 2 0 0 15 0 0 12 
12 26 24 0 0 0 0 2 6 16 5 1 14 0 9 9 6 34 3 0 1 5 5 9 11 26 9 17 0 8 3 21 2 
0 0 0 0 25 24 3 10 7 19 0 0 0 6 0 7 4 11 0 6 2 12 0 0 0 0 20 0 27 65 0 0 11 
5 0 3 0 13 7 5 0 0 6 10 9 0 0 8 29 0 16 18 0 10 0 0 0 2 0 0 1 9 29 0 0 2 
0 0 8 9 29 16 0 19 0 4 9 1 14 0 9 2 12 7 2 10 1 9 18 11 8 0 22 10 13 0 7 0 8 
8 3 25 4 0 24 0 6 1 10 0 0 16 0 0 4 5 0 3 4 8 16 0 0 12 22 0 23 27 4 0 0 20 
29 19 27 9 28 27 26 1 0 0 0 7 13 6 1 8 3 13 7 0 10 20 8 0 0 8 6 0 0 56 20 30 36 
17 23 14 0 20 0 0 15 6 0 23 6 3 0 5 9 2 35 0 8 0 0 5 10 34 3 0 0 36 0 3 21 0 
0 0 0 0 14 24 0 0 5 0 0 0 3 0 12 0 0 0 13 0 0 0 0 0 0 1 1 4 1 18 0 4 0 
49 0 24 0 0 21 25 0 0 1 2 17 0 3 0 10 6 0 2 4 0 16 1 0 3 0 50 11 8 29 0 25 0 
0 0 13 6 13 0 18 0 0 6 0 0 18 0 17 1 12 0 5 5 4 11 9 1 23 0 0 23 1 14 12 17 17 
1 0 2 0 1 12 0 0 0 1 0 0 3 8 11 1 5 2 0 3 0 3 0 0 0 3 16 0 1 0 4 0 7 
9 0 0 0 14 0 0 24 0 5 4 6 14 22 0 0 11 17 2 0 0 0 0 0 9 4 21 0 3 16 23 18 14 
22 0 12 10 13 0 0 18 6 16 14 9 16 0 15 6 12 1 7 11 7 0 0 13 7 5 31 9 0 0 14 1 55 
28 14 0 14 6 10 11 7 1 4 19 4 0 4 1 34 8 0 12 10 0 14 14 10 9 0 0 0 23 8 21 25 0 
0 0 20 0 0 0 0 0 0 12 1 17 8 0 0 12 17 0 0 0 8 0 20 0 10 0 3 17 0 18 0 0 0 
