35 20
14 2 27 8 11 0 0 0 17 0 0 0 2 21 21 2 23 1 0 0 8 0 0 20 40 20 8 0 20 0 0 1 19 0 11 
0 0 13 20 0 0 26 0 20 8 2 0 0 8 18 0 0 8 15 0 0 1 0 5 15 0 0 0 20 0 0 8 37 0 0 
10 29 0 2 0 0 0 15 0 5 0 0 0 0 0 7 0 17 9 6 13 1 22 4 32 17 29 0 0 11 4 3 8 0 25 
0 1 0 1 0 0 0 0 2 11 36 4 0 2 0 12 0 0 0 0 8 0 11 2 0 3 0 12 0 19 0 0 0 11 0 
5 8 0 17 0 0 15 0 0 8 8 0 0 0 0 0 0 3 0 0 1 10 0 3 2 0 5 9 0 0 2 0 0 0 0 
1 1 41 0 18 0 4 0 1 6 11 3 4 11 17 3 2 14 0 8 0 12 2 2 8 6 1 8 0 19 0 3 26 3 0 
13 30 24 30 0 0 30 0 0 23 3 0 1 13 9 0 0 0 3 3 3 16 11 38 10 0 0 5 0 3 0 24 28 0 0 
2 0 0 0 0 20 0 0 36 10 0 6 0 0 0 0 2 5 34 0 12 2 0 7 7 7 4 9 0 2 0 0 39 0 26 
6 0 7 27 10 0 13 5 34 9 4 7 0 0 4 16 14 11 2 0 0 0 32 13 15 0 0 3 12 45 3 8 21 27 0 
5 30 0 14 0 0 0 26 0 20 6 17 9 0 9 6 3 26 0 0 0 0 0 10 8 13 2 0 4 50 0 30 0 58 0 
6 0 0 22 0 0 15 0 0 9 0 0 0 0 0 0 0 5 16 11 8 0 0 4 1 21 20 2 0 2 11 6 0 8 16 
8 0 0 2 11 0 9 0 0 0 13 0 0 0 0 4 0 8 6 6 0 9 0 25 13 6 6 5 18 0 16 10 0 10 0 
0 0 0 0 0 5 13 27 0 0 9 9 3 4 0 0 0 2 0 15 0 4 0 6 0 0 0 2 0 0 0 1 12 7 16 
0 0 0 17 7 1 1 12 5 0 3 21 1 19 3 6 14 1 8 11 1 6 0 0 5 12 0 9 0 24 0 0 9 0 0 
32 15 4 0 0 10 0 0 0 8 0 22 1 0 6 25 19 0 0 5 0 13 8 0 0 6 9 0 0 0 0 0 0 25 18 
1 13 11 0 0 5 8 0 0 18 0 15 3 8 16 0 8 1 0 16 0 10 22 38 13 0 15 6 0 10 0 12 0 0 7 
3 16 0 0 0 0 0 0 0 0 11 13 0 0 0 0 0 12 0 0 0 19 11 0 12 3 0 0 24 0 0 0 0 11 0 
0 0 0 5 0 5 23 23 18 8 5 7 0 0 0 0 6 7 0 0 11 13 4 30 9 5 19 0 0 12 0 0 21 12 0 
0 28 0 0 22 0 11 0 10 0 13 10 0 3 0 0 0 1 0 0 8 0 0 12 18 1 33 0 0 51 0 0 0 15 0 
18 3 15 0 0 11 14 14 0 25 1 0 0 13 4 0 23 19 0 0 19 10 0 0 4 2 17 0 0 2 0 11 0 0 25 
