35 20
34 14 0 0 0 0 1 0 19 0 0 0 0 0 12 0 0 0 0 0 0 0 4 0 0 0 1 7 5 0 0 0 0 0 31 
0 38 1 9 34 22 7 0 9 0 19 10 11 4 1 22 19 0 20 18 0 9 13 0 9 13 0 31 0 10 13 50 10 3 3 
48 30 0 26 16 0 0 7 7 0 0 0 0 0 0 7 7 6 1 1 17 1 16 13 21 0 0 0 0 28 0 0 32 0 1 
0 14 0 0 11 12 0 1 0 5 0 19 0 4 0 19 0 16 17 8 4 14 10 22 4 0 0 0 8 0 0 16 10 0 38 
25 93 21 0 59 0 0 8 21 0 0 0 7 12 0 0 0 4 16 0 13 2 24 3 2 30 15 11 1 2 27 65 0 1 26 
0 44 0 26 5 0 5 11 16 13 5 9 5 5 4 27 30 15 14 0 3 0 0 0 0 4 10 76 5 20 0 5 1 18 0 
16 5 0 0 3 0 0 6 11 15 0 0 0 10 1 1 17 0 16 0 0 0 0 0 15 8 0 0 19 0 0 0 1 8 16 
8 5 0 5 0 0 3 0 0 11 0 0 0 13 10 0 10 0 0 10 18 0 3 1 9 5 0 7 0 0 0 0 0 0 0 
0 0 0 0 20 1 17 8 0 0 19 0 0 6 0 0 0 0 7 6 0 5 0 3 0 0 0 0 3 12 0 0 0 0 6 
0 26 0 30 5 0 0 7 3 0 0 3 2 14 3 0 8 4 0 0 0 7 0 0 0 0 12 24 12 1 11 3 3 34 0 
0 16 6 18 0 27 1 8 13 12 0 8 11 30 0 1 3 16 0 0 11 34 19 11 0 0 6 0 0 1 23 9 14 9 13 
6 17 10 0 2 4 1 16 0 37 0 26 17 0 0 4 10 0 0 0 0 9 0 40 5 2 2 8 22 0 0 2 0 28 4 
5 0 0 0 8 0 8 0 0 0 6 9 4 0 8 4 6 11 4 7 5 9 18 6 6 3 0 0 3 0 0 0 0 11 0 
0 4 0 10 23 23 0 0 8 0 0 0 4 36 0 12 12 0 0 0 9 0 0 24 12 23 2 0 0 0 17 1 4 4 0 
14 14 0 28 1 1 0 25 12 0 0 0 0 11 7 1 0 5 3 1 3 0 2 7 11 31 0 9 0 13 7 27 0 0 16 
13 52 0 0 0 0 0 0 1 4 15 0 0 13 10 11 0 17 0 17 6 11 0 0 9 15 19 11 0 0 0 0 0 0 13 
38 0 0 23 0 3 0 15 10 5 0 0 0 17 0 0 8 0 4 0 0 0 0 0 13 3 23 0 12 0 47 0 13 33 34 
0 4 0 0 0 2 1 24 0 25 0 15 4 9 0 2 10 19 5 10 0 10 9 5 0 0 0 16 0 22 0 10 0 0 8 
41 16 0 2 22 8 4 14 0 13 20 0 11 8 14 0 0 0 0 9 16 0 0 0 0 25 13 0 14 10 0 0 0 23 0 
0 12 0 0 20 10 0 8 0 5 6 0 0 0 28 18 0 0 0 0 15 0 9 0 0 24 0 0 0 0 10 40 16 0 20 
