35 20
0 0 0 0 0 0 0 0 0 0 0 0 12 10 9 0 3 0 17 0 2 1 0 1 3 0 2 0 0 0 0 0 0 0 0 
13 0 0 0 25 0 0 7 23 27 0 19 16 0 0 0 0 0 0 12 0 31 0 0 15 5 11 2 3 3 2 54 10 0 9 
0 34 0 0 0 0 0 0 0 0 0 0 11 1 4 12 9 0 0 0 0 16 21 0 0 0 4 0 0 14 0 17 16 0 0 
0 0 0 34 21 0 13 26 8 0 0 17 14 13 0 4 8 5 0 25 0 11 16 11 13 0 13 0 25 0 0 0 21 0 12 
0 0 0 0 11 0 0 0 13 30 0 12 7 5 0 0 0 0 5 0 12 12 0 15 0 13 22 18 0 0 0 15 8 0 2 
18 0 22 0 8 0 0 0 0 19 9 0 39 0 0 0 0 0 4 0 0 0 7 15 2 0 4 0 0 0 7 8 12 0 22 
34 7 22 0 0 0 0 0 7 1 0 2 0 0 3 13 3 12 0 12 13 0 0 0 0 1 8 0 0 30 0 2 2 4 49 
30 0 33 20 24 0 0 0 5 0 0 0 22 14 0 31 14 0 6 3 0 0 19 23 24 0 0 15 0 29 3 2 8 2 8 
0 11 0 0 0 0 0 0 0 3 0 0 0 0 0 0 5 7 1 0 0 4 0 0 0 0 7 9 0 0 6 0 1 0 0 
0 0 26 13 6 0 22 4 5 10 0 61 6 25 3 0 1 0 0 4 14 9 2 0 10 0 0 0 5 0 2 0 39 5 14 
9 19 4 22 29 0 4 0 0 19 0 4 6 0 33 0 0 0 9 5 18 0 0 0 0 22 0 13 0 0 0 0 13 39 23 
30 0 4 0 19 17 6 0 24 3 0 0 14 1 11 0 11 0 0 1 0 2 17 12 0 0 5 15 0 0 25 10 32 0 0 
5 0 0 9 7 0 0 0 3 14 1 9 9 16 14 0 17 21 1 10 3 0 14 10 3 4 16 0 3 10 23 0 2 16 0 
15 0 0 0 33 1 58 0 0 0 12 19 10 7 8 21 3 2 0 4 4 6 12 0 6 1 4 21 0 3 37 0 10 0 28 
0 0 0 0 9 0 0 0 0 5 32 0 9 2 15 0 4 0 4 0 0 12 0 4 9 11 0 0 0 0 6 0 0 23 0 
22 0 0 21 12 4 19 0 0 4 0 11 7 0 0 8 0 4 0 13 3 0 19 0 18 11 0 0 0 18 11 3 0 0 0 
36 32 11 5 0 5 0 0 5 0 0 12 0 0 13 0 0 15 16 0 19 0 4 0 0 0 0 4 0 0 0 48 9 2 16 
0 0 10 12 4 0 15 15 12 23 12 19 15 11 5 12 12 5 2 5 2 13 0 2 8 9 2 20 0 11 11 4 23 3 1 
0 0 22 0 15 0 0 0 0 19 0 5 0 0 0 0 6 1 1 3 0 25 3 0 30 0 0 0 19 17 0 3 0 0 1 
21 24 30 15 25 5 0 0 9 0 5 0 1 21 18 1 14 0 20 51 15 58 35 34 12 24 5 19 31 0 4 50 2 5 34 
