35 20
0 0 0 0 0 0 12 0 1 14 1 1 1 14 14 0 0 0 0 0 0 0 0 14 0 11 0 0 0 0 0 0 0 17 0 
0 24 0 15 12 11 9 37 4 0 21 27 0 0 0 8 5 11 16 0 0 10 0 0 0 9 0 0 36 19 0 24 0 45 17 
14 0 0 0 0 3 2 0 31 20 0 16 0 0 7 0 1 0 4 0 0 0 10 0 0 0 0 0 8 0 0 0 10 0 2 
16 0 9 0 2 8 53 0 0 0 0 4 9 5 0 0 9 5 0 0 0 0 0 7 0 19 14 0 11 0 7 11 8 27 0 
15 5 7 27 29 2 5 18 0 0 0 14 0 6 18 0 0 0 0 0 2 0 0 20 0 8 0 23 3 0 0 0 18 14 6 
0 0 1 11 0 3 0 1 25 2 12 10 1 4 11 0 0 16 13 11 17 0 12 10 0 11 0 0 0 0 0 13 0 0 3 
8 0 16 0 30 3 7 20 5 20 10 20 0 5 17 0 19 14 2 0 2 0 1 0 8 0 0 20 10 29 0 17 0 15 25 
10 0 26 23 0 15 35 0 0 1 0 0 0 0 0 0 0 7 0 0 3 0 0 6 0 0 0 0 0 0 0 8 29 0 28 
4 0 20 45 4 0 18 0 6 0 4 0 0 0 17 0 0 0 0 7 0 18 27 0 0 5 0 0 3 0 32 0 0 10 4 
0 7 34 28 24 47 2 4 11 6 0 14 4 13 0 0 1 0 0 12 13 20 21 8 0 36 0 22 24 16 0 46 0 31 0 
13 0 0 0 6 5 1 0 0 5 19 11 0 14 8 0 10 0 0 0 13 0 0 0 8 0 15 6 9 0 0 6 1 23 19 
4 40 21 27 56 16 2 2 0 0 0 5 22 9 0 0 0 7 0 0 17 5 0 12 12 3 0 14 24 2 28 30 26 6 17 
17 0 21 12 0 17 0 0 7 7 0 17 3 11 4 9 0 1 0 0 2 0 0 0 0 1 27 0 6 0 0 29 27 0 8 
0 73 26 19 0 0 0 6 11 8 12 0 5 10 14 0 0 0 17 0 3 0 7 9 8 23 0 0 12 0 0 0 8 0 33 
10 0 5 6 27 0 9 5 23 32 17 35 7 6 5 12 0 27 0 0 2 18 8 0 0 0 2 0 25 0 0 66 23 0 2 
6 39 27 21 5 16 1 0 19 23 0 12 0 0 1 0 19 12 0 5 0 3 25 35 20 2 15 39 5 13 0 6 0 0 22 
0 0 0 7 26 0 0 0 14 0 4 13 0 0 0 0 6 0 0 0 4 0 0 7 0 9 0 17 0 10 28 6 2 0 3 
0 0 7 0 12 0 0 0 6 14 0 0 0 0 18 0 18 1 15 0 0 5 0 0 0 0 0 11 1 0 10 3 0 40 0 
0 13 10 5 43 0 22 9 0 0 4 1 16 7 2 1 0 7 0 0 7 10 0 0 0 0 0 0 15 0 26 0 0 10 15 
29 0 6 0 3 0 0 3 16 0 0 23 16 0 0 0 0 0 2 0 2 0 0 0 4 0 0 0 52 0 0 5 0 0 0 
