35 20
0 0 8 0 0 0 3 17 0 21 0 6 0 8 0 0 2 0 0 9 1 0 0 16 0 2 19 0 0 0 23 0 36 0 6 
0 0 0 18 5 0 10 18 0 0 0 0 0 0 0 0 1 0 0 1 7 23 4 35 5 2 0 0 1 1 0 0 0 12 0 
0 0 0 26 3 0 0 13 0 0 14 6 1 0 0 0 20 0 0 3 13 0 0 0 0 4 17 15 0 22 4 0 0 4 29 
0 57 10 0 30 12 0 0 3 20 34 18 10 0 25 10 0 4 1 18 0 0 0 0 0 12 13 0 16 32 0 0 0 23 30 
3 27 12 30 25 0 0 5 7 16 10 8 0 13 0 8 5 6 13 0 19 3 7 16 8 12 4 0 41 40 0 20 7 30 0 
28 6 23 0 19 4 11 0 0 3 18 9 0 0 10 0 0 25 0 1 0 11 22 1 11 38 9 0 68 0 0 18 5 0 10 
34 11 0 34 5 24 8 4 3 0 4 2 11 11 23 5 0 0 6 0 0 21 0 0 24 8 3 0 0 24 0 13 13 11 28 
36 0 11 0 2 21 3 0 0 3 0 0 37 0 22 15 17 13 0 0 0 21 24 0 0 6 28 6 21 0 0 19 15 20 0 
20 18 8 0 5 14 0 0 0 0 9 4 15 22 0 0 0 0 16 14 27 0 4 0 0 0 0 30 28 0 12 0 0 0 0 
0 5 5 0 23 28 0 11 18 0 0 0 14 37 0 8 0 0 11 0 0 8 4 0 0 11 24 0 6 16 0 31 0 0 39 
0 20 0 0 8 38 5 0 0 0 20 5 9 4 0 3 4 0 16 1 14 20 0 0 0 0 0 0 0 24 0 0 0 8 14 
2 32 25 12 0 0 10 0 0 0 0 0 0 0 1 17 0 0 0 0 5 0 4 9 0 4 0 0 7 25 6 0 31 0 0 
32 3 32 3 0 0 0 0 0 7 0 0 5 0 11 6 0 0 6 3 0 11 3 0 0 0 0 0 2 0 21 6 15 32 13 
0 29 0 7 17 11 0 3 0 14 6 21 8 0 0 0 14 12 15 8 4 0 3 27 0 24 0 4 2 2 29 0 15 3 0 
0 0 0 0 0 4 0 0 14 4 0 0 0 3 14 0 0 0 0 0 0 4 14 0 0 3 10 0 13 1 0 0 0 0 0 
0 26 0 14 0 0 0 0 0 0 3 0 22 15 4 4 11 10 0 17 0 3 0 0 0 6 13 47 7 25 0 0 0 0 22 
0 4 12 28 0 0 5 3 0 45 14 0 0 12 3 10 0 3 6 15 12 11 2 0 4 38 2 0 11 0 21 28 0 24 15 
0 0 0 0 16 0 21 0 19 1 8 5 10 0 21 0 7 0 13 8 6 7 0 0 0 13 0 4 14 0 6 0 0 0 15 
0 2 21 22 0 0 1 8 0 18 3 0 10 22 7 0 0 2 17 2 7 0 16 36 2 23 5 0 1 0 0 5 0 13 1 
31 16 7 0 0 0 0 11 0 0 0 32 0 0 24 0 0 9 4 17 10 0 0 6 0 9 65 27 28 0 6 20 7 0 0 
