35 20
0 0 0 0 0 14 0 17 0 0 28 10 10 0 12 0 0 8 0 7 0 0 0 1 4 14 12 0 0 7 1 12 23 0 24 
0 0 6 0 16 0 0 0 6 3 0 0 0 4 0 0 0 1 1 4 11 0 8 2 0 2 4 0 6 4 7 11 0 0 0 
0 7 0 0 17 0 0 2 5 14 0 37 5 7 25 0 8 0 0 0 0 7 17 9 15 2 0 0 27 0 0 19 1 1 23 
0 7 2 0 21 2 0 0 15 21 0 14 18 8 0 0 0 0 0 0 0 11 12 19 16 0 0 26 0 0 39 0 34 1 32 
0 23 0 2 50 0 8 16 21 0 4 7 12 0 8 0 15 0 7 43 0 0 2 24 8 22 0 5 0 0 0 12 20 29 14 
0 24 2 0 7 16 0 9 11 11 0 1 3 0 11 0 9 8 15 2 26 0 0 1 2 1 0 27 3 6 0 2 1 41 0 
0 0 0 0 21 5 0 0 0 0 5 0 1 0 2 5 2 0 10 9 8 0 0 5 31 24 0 0 10 24 0 0 3 0 9 
23 0 49 41 11 7 0 0 8 0 17 0 9 5 0 10 6 8 0 2 0 0 5 23 9 12 0 8 7 23 28 28 4 8 0 
0 0 0 0 0 0 27 0 0 10 6 6 3 0 0 0 2 8 0 22 0 5 13 10 0 11 0 0 0 13 13 0 0 14 0 
0 7 13 5 29 0 4 0 0 0 26 6 0 0 0 0 0 17 13 0 15 0 0 5 7 0 0 5 0 17 3 20 25 8 12 
0 0 17 0 5 0 0 0 0 0 2 21 1 0 0 0 0 15 0 15 0 0 10 3 13 0 0 0 0 0 13 0 10 0 0 
0 0 0 0 2 0 0 0 0 0 0 7 12 0 0 0 0 0 0 0 0 6 7 7 5 13 1 0 0 0 3 0 4 5 0 
7 14 54 0 10 11 4 6 1 0 1 22 0 5 16 3 0 24 4 7 3 0 24 0 24 0 1 13 0 0 2 0 11 31 0 
2 0 3 0 14 4 0 0 0 6 12 1 16 0 0 7 12 0 4 7 0 0 35 22 4 5 7 20 6 0 0 0 22 0 0 
0 0 28 10 20 7 0 5 0 0 0 1 0 11 0 1 0 0 2 0 10 10 10 0 14 14 6 0 8 5 0 0 14 0 16 
0 0 0 0 11 10 0 23 11 1 2 0 1 21 0 16 8 0 2 0 0 1 9 0 0 0 4 2 0 0 13 0 0 20 0 
11 0 38 0 0 11 8 0 0 6 11 15 12 0 11 0 16 21 4 0 0 11 16 1 1 20 0 1 0 12 8 0 28 31 0 
0 7 17 0 6 28 20 0 20 0 0 1 9 0 0 7 11 5 0 5 18 8 7 0 0 0 3 11 5 5 0 0 5 23 0 
0 0 0 44 16 0 18 0 0 19 0 12 0 0 16 18 18 0 7 8 5 0 1 1 12 12 0 5 47 9 0 16 24 48 18 
24 18 29 0 9 0 0 0 19 0 0 0 0 5 0 0 0 0 29 5 0 0 11 11 24 3 0 16 3 0 0 0 14 31 18 
