35 20
0 12 6 18 21 0 0 5 3 29 0 0 15 10 0 0 0 0 13 11 0 0 0 0 17 4 13 15 8 22 15 13 6 0 0 
2 0 0 0 0 18 0 1 22 0 0 4 0 0 0 4 11 0 9 0 0 10 0 0 4 1 19 37 0 6 22 5 0 0 4 
0 0 12 30 0 0 27 4 0 0 6 0 12 13 12 0 12 0 5 0 15 9 0 0 0 14 0 0 2 0 0 0 0 27 0 
23 6 18 0 0 8 0 5 10 0 0 7 2 18 19 0 0 0 17 8 0 4 4 0 22 1 6 0 0 0 38 8 1 26 0 
8 0 13 0 0 4 21 0 30 4 22 44 0 0 0 0 13 4 0 0 0 14 0 7 0 12 0 8 4 18 19 1 18 0 0 
6 18 1 36 14 2 3 19 0 0 28 1 9 6 11 38 19 2 0 34 1 1 0 17 6 4 15 0 5 14 4 1 0 0 19 
10 7 0 15 0 0 30 0 0 0 9 0 6 0 0 0 0 0 6 0 10 0 6 0 0 0 2 0 0 0 0 25 0 5 0 
0 0 3 30 32 4 2 0 0 4 28 8 0 12 7 6 3 2 10 7 11 3 0 0 20 29 5 1 0 6 4 10 0 0 0 
13 0 24 0 1 12 47 0 0 1 31 8 6 6 14 4 11 0 6 9 0 19 0 3 6 0 27 21 8 0 0 0 19 23 0 
0 0 0 0 5 0 0 21 0 0 0 10 0 0 0 37 4 2 0 13 11 14 6 18 0 0 4 5 12 10 5 8 12 28 0 
0 7 3 15 6 10 0 2 0 0 0 0 12 0 0 11 4 0 6 3 1 9 8 0 0 0 12 7 7 0 0 9 6 0 0 
26 6 0 8 0 19 0 0 8 0 9 0 0 0 0 0 8 0 0 3 12 0 0 19 29 0 4 27 0 5 0 0 0 5 0 
0 0 1 27 0 18 14 2 0 0 21 9 1 0 0 5 0 0 0 0 9 0 8 18 0 0 0 0 0 0 9 23 2 0 0 
0 0 32 5 29 0 0 0 0 0 0 0 0 0 5 0 0 0 0 0 0 8 0 0 0 0 5 0 26 0 2 0 28 0 0 
0 0 16 12 8 32 0 0 0 19 0 4 13 0 1 11 0 0 0 0 5 0 0 0 3 12 0 0 20 0 11 0 17 0 29 
0 0 4 16 14 0 3 26 0 0 12 8 24 8 0 6 1 11 14 10 17 0 0 11 4 4 0 0 12 20 22 2 0 47 18 
0 1 16 6 6 0 0 3 2 0 0 0 0 5 0 9 0 0 0 12 0 3 0 0 0 0 6 24 0 26 9 1 0 12 0 
2 6 14 4 42 4 0 23 0 7 24 11 10 13 0 0 12 5 11 2 15 0 8 5 13 22 1 0 0 11 66 13 17 3 34 
0 18 0 10 0 6 0 0 0 0 0 0 0 19 16 0 10 0 0 12 0 16 0 1 0 16 7 17 2 0 3 0 0 0 4 
2 10 3 1 14 18 0 7 0 25 7 10 0 19 0 10 8 4 0 2 0 12 0 1 15 0 23 0 0 10 0 25 0 0 0 
