35 20
16 0 0 0 19 0 16 4 0 13 17 0 0 0 0 3 11 0 4 8 13 0 15 9 21 3 8 23 4 23 0 3 28 0 14 
8 0 0 9 6 0 7 24 0 0 4 8 9 2 0 15 0 0 17 1 5 0 3 0 0 8 6 7 17 5 44 35 6 0 0 
0 14 11 14 3 0 0 19 0 0 0 6 0 14 0 14 0 0 4 7 0 10 8 0 0 0 8 17 0 1 0 13 0 0 4 
4 0 17 6 0 10 18 0 24 57 0 2 0 10 0 7 0 8 17 3 13 19 1 0 31 33 0 0 0 5 5 29 13 8 0 
0 0 30 29 7 0 0 0 2 4 2 0 14 3 0 0 11 0 4 13 0 0 10 0 0 0 0 9 16 6 3 0 6 13 0 
0 0 0 11 0 0 0 0 0 0 13 0 6 10 0 8 0 0 7 0 0 7 0 0 2 0 12 14 0 0 20 4 17 0 0 
19 0 0 8 0 28 10 0 0 0 4 4 17 5 0 17 0 0 0 6 2 9 4 0 0 0 0 0 2 7 0 0 49 48 6 
35 0 0 6 17 0 0 0 0 15 0 20 0 0 12 0 5 0 0 9 8 0 0 0 0 0 12 27 10 0 0 22 26 17 0 
0 30 0 26 2 0 3 3 0 7 5 6 14 19 8 0 7 5 3 12 7 4 8 15 8 0 0 4 13 22 0 45 8 11 0 
6 30 30 23 0 13 0 8 0 21 0 0 0 3 0 9 0 0 6 0 0 0 17 0 0 0 23 0 0 0 24 30 35 0 8 
20 33 8 4 10 0 0 3 0 3 0 1 15 11 3 7 0 14 0 6 17 52 0 4 7 2 0 4 8 2 0 3 0 5 13 
15 0 0 0 9 0 0 1 0 24 0 9 1 16 0 26 0 0 3 8 8 0 0 0 9 0 0 0 0 0 0 6 28 24 51 
0 0 9 13 22 2 0 4 20 10 1 32 0 9 0 0 8 0 7 1 9 11 0 0 8 22 0 7 0 0 27 0 34 6 0 
0 0 0 13 1 41 4 0 5 0 14 0 0 0 0 2 0 13 0 0 10 10 17 13 0 0 4 19 0 0 42 0 24 0 0 
0 2 11 18 1 0 2 12 0 4 8 6 0 4 0 25 0 0 0 8 0 1 10 0 0 13 0 0 14 1 5 2 6 8 0 
47 0 26 0 0 0 0 0 11 8 5 14 0 3 8 25 0 0 7 22 0 0 22 0 4 6 0 13 5 13 0 0 3 11 0 
12 7 0 6 12 0 2 20 6 0 18 0 8 19 0 12 0 7 0 14 22 0 3 0 0 0 0 0 1 6 0 0 32 32 0 
0 0 3 0 0 0 0 19 0 0 17 2 22 5 19 0 0 0 15 0 9 0 0 0 7 0 19 0 0 3 0 0 13 10 13 
18 5 8 40 10 0 12 0 0 1 9 3 9 0 0 4 0 0 4 7 8 3 0 0 0 0 0 0 8 14 2 2 1 0 31 
0 0 0 6 3 0 9 0 0 6 0 8 17 1 12 0 0 11 17 0 0 10 3 0 16 5 13 34 0 1 0 0 3 0 0 
