35 20
29 5 0 0 25 6 0 4 0 0 30 2 0 0 0 14 11 3 15 0 0 10 0 0 7 0 8 0 11 68 0 2 1 18 0 
17 16 0 0 0 4 0 6 12 9 0 5 21 8 0 0 0 13 0 10 0 20 0 4 0 0 8 0 4 0 18 5 0 21 0 
14 0 20 0 5 0 0 0 8 0 0 0 10 0 3 0 0 0 0 0 0 0 20 0 0 11 32 3 0 0 0 0 0 0 8 
0 0 0 0 0 0 3 0 0 0 0 0 5 2 0 3 3 0 3 0 0 1 0 0 0 0 0 2 0 0 0 0 0 0 0 
39 0 0 10 3 0 0 7 0 9 10 0 0 0 7 15 0 4 18 0 10 16 7 13 3 0 0 0 25 8 15 0 32 12 0 
0 5 1 0 0 15 0 1 0 4 3 0 0 13 17 7 0 22 1 0 0 4 5 0 9 7 10 26 26 0 0 1 19 0 20 
0 0 0 0 26 4 3 0 17 13 3 6 19 3 1 12 2 2 3 6 0 0 11 0 0 17 8 7 2 0 26 19 0 0 0 
0 26 11 0 28 20 4 25 0 6 7 23 14 5 14 2 13 25 7 10 2 3 2 9 15 0 12 4 11 27 0 14 23 0 5 
0 0 8 0 0 25 6 0 0 6 12 14 1 20 0 0 0 0 1 0 9 10 0 0 0 14 0 0 0 0 25 18 0 20 0 
31 14 0 7 0 18 7 0 0 7 18 10 4 12 0 10 4 4 3 0 0 0 4 10 0 24 0 0 5 0 0 31 2 5 0 
0 0 0 5 0 0 2 22 7 42 24 0 0 21 22 9 8 5 4 0 0 7 3 0 11 13 0 3 12 30 5 5 41 0 45 
1 22 0 22 44 7 34 0 19 12 15 0 10 0 11 1 7 9 0 14 1 15 29 35 0 32 6 27 44 12 18 11 2 29 0 
8 3 0 29 0 0 0 3 0 3 0 6 33 0 0 0 0 1 0 0 9 7 0 11 0 0 1 0 0 5 0 0 37 0 22 
2 0 0 0 0 17 4 0 0 7 3 0 0 0 0 6 5 8 5 0 0 1 13 0 0 0 11 3 0 9 0 5 18 5 0 
14 9 0 14 17 18 0 0 0 6 20 0 0 0 0 11 0 15 14 3 0 6 0 18 21 0 1 0 0 0 0 0 0 4 0 
20 19 0 23 0 0 8 3 0 7 0 19 0 19 4 0 0 3 2 9 0 0 0 22 0 0 45 9 34 4 19 5 19 0 0 
1 8 0 0 0 4 6 0 21 20 3 0 21 0 17 10 0 0 0 0 0 21 10 8 26 10 7 4 0 53 0 13 14 14 0 
26 0 0 31 0 0 26 0 25 0 0 30 1 12 0 9 6 0 29 0 23 0 44 12 3 15 6 4 13 0 0 9 0 26 47 
6 0 31 11 0 25 1 24 0 18 7 0 0 3 0 6 5 5 5 2 1 17 20 0 2 12 0 2 1 2 3 5 5 18 0 
0 0 0 27 0 0 11 8 17 0 0 21 0 0 0 0 6 11 0 18 0 7 5 10 6 18 0 3 1 0 24 0 46 0 10 
