35 20
8 16 4 12 0 5 0 5 2 20 11 0 0 8 16 0 0 17 0 11 2 10 7 0 6 2 24 0 0 24 11 21 0 0 0 
0 0 26 17 13 9 25 1 0 19 6 0 0 2 0 2 0 21 13 0 27 1 1 17 11 0 6 3 4 0 0 49 46 0 0 
5 0 0 2 4 11 14 19 17 9 0 11 3 0 32 20 0 17 9 0 0 0 7 13 0 17 21 22 20 22 0 6 17 24 0 
8 15 0 0 5 17 10 16 20 0 20 0 0 10 3 3 21 0 3 4 2 0 8 16 14 0 1 5 20 7 20 0 5 9 0 
24 24 10 6 20 10 4 0 7 0 0 10 1 7 15 8 2 0 10 0 0 15 3 3 4 50 10 0 10 3 0 4 0 0 0 
0 0 4 26 12 16 11 30 10 3 27 22 3 0 14 17 13 12 18 1 3 2 0 0 8 0 24 20 1 0 20 0 0 31 4 
0 0 0 2 29 21 4 0 21 18 7 0 0 0 4 0 0 18 3 0 0 0 5 0 0 17 34 32 5 0 0 27 0 0 0 
38 0 0 27 0 0 0 0 3 3 0 9 0 0 9 25 2 0 0 0 0 7 0 0 0 0 5 10 2 0 44 0 0 3 0 
5 0 0 0 16 54 2 15 43 21 0 0 0 0 8 0 0 27 0 14 8 0 21 18 0 11 5 22 0 21 1 13 0 0 17 
0 9 0 0 0 0 0 0 9 0 0 0 0 9 5 0 0 0 0 0 1 0 10 0 15 0 0 0 0 0 0 0 7 0 14 
0 10 0 8 0 0 4 10 10 22 22 8 6 4 6 5 0 1 12 0 6 0 10 0 8 1 0 3 0 11 2 0 25 4 25 
0 0 0 0 0 0 0 0 6 0 6 0 0 0 27 13 0 9 0 0 10 0 0 16 0 0 22 6 0 0 7 0 0 0 0 
0 0 0 23 0 0 6 5 22 0 15 1 2 7 0 2 0 6 5 0 0 0 2 0 0 1 22 1 6 0 22 0 11 9 17 
0 24 0 0 4 29 0 10 8 5 9 5 0 0 0 5 0 17 0 0 27 1 9 0 19 44 11 0 0 0 0 0 12 0 0 
1 0 4 3 0 59 23 6 0 4 0 0 25 14 28 8 12 0 0 21 0 1 8 4 17 10 8 17 19 15 0 0 22 23 0 
21 0 0 0 10 6 0 0 11 15 0 6 23 21 0 0 0 2 10 6 20 17 0 10 3 13 3 0 0 0 0 0 0 0 6 
29 0 42 0 27 0 14 2 1 0 3 0 26 0 0 0 2 15 0 0 0 0 0 0 8 0 0 7 0 2 3 35 35 0 0 
33 9 0 31 0 12 0 0 12 19 0 9 6 0 17 10 0 6 21 0 21 0 24 0 16 7 0 24 58 0 0 12 0 15 29 
12 0 32 0 0 23 16 0 0 9 10 0 0 0 0 0 0 10 0 0 0 13 44 0 8 20 0 0 19 0 0 29 0 0 12 
12 0 0 0 0 0 0 16 14 0 0 21 13 0 0 8 0 17 0 7 0 13 10 16 16 24 6 0 0 9 0 0 21 0 0 
