35 20
13 13 1 6 39 14 0 2 26 5 19 9 0 8 0 4 1 9 3 0 0 12 0 11 0 0 17 18 0 5 0 0 0 0 52 
0 0 1 0 1 2 20 2 0 0 0 0 8 0 8 0 0 9 26 0 0 3 0 9 0 0 11 2 10 0 0 10 0 0 6 
12 0 13 0 35 27 0 17 8 0 11 11 0 2 19 29 18 11 0 4 0 0 5 0 17 9 0 0 0 0 8 9 17 34 38 
16 9 4 17 25 12 3 0 0 0 0 9 13 4 0 7 30 6 2 15 6 5 2 12 0 14 0 2 0 25 24 12 0 14 35 
0 6 0 7 0 0 0 7 26 0 0 0 6 0 0 10 10 0 6 0 0 4 0 1 0 10 0 0 6 0 0 0 0 0 20 
9 28 8 0 7 0 5 0 0 9 0 0 2 21 1 7 0 0 2 2 1 0 0 0 8 13 0 0 9 0 0 0 0 14 12 
13 0 0 24 0 10 0 6 19 2 0 4 0 21 28 4 13 0 0 3 0 0 8 0 0 8 18 0 1 2 5 0 0 8 0 
0 20 4 0 35 4 10 15 0 32 0 6 1 5 0 0 4 0 3 0 4 10 12 3 15 0 0 5 23 28 0 1 5 5 0 
5 0 32 0 10 20 0 0 19 9 5 13 0 6 0 0 0 6 11 10 0 0 8 0 27 0 0 0 17 8 25 23 0 0 32 
31 28 0 11 7 0 9 24 0 1 0 4 0 0 11 11 23 0 0 8 0 5 0 3 7 7 1 0 0 37 9 5 0 9 5 
16 6 0 0 0 0 8 9 12 8 0 6 0 3 11 1 7 0 0 0 0 0 13 26 0 13 0 0 5 0 22 0 0 0 34 
0 6 2 31 30 2 2 6 0 0 0 1 0 2 0 0 0 2 0 0 5 17 0 0 5 0 6 0 0 0 0 3 0 0 15 
29 11 32 0 30 0 0 0 1 3 0 23 17 9 0 11 5 0 0 3 0 20 7 16 4 0 0 7 15 25 15 0 4 21 25 
43 16 8 0 0 2 30 13 7 23 14 9 0 34 0 28 0 4 0 10 29 6 7 11 0 0 8 0 0 7 23 0 5 1 28 
35 0 0 20 0 5 0 0 0 0 4 14 0 0 9 1 29 0 16 9 0 0 11 11 1 9 0 0 2 0 0 0 0 33 8 
12 8 13 0 4 39 19 3 5 0 3 0 12 21 9 1 0 0 0 3 20 0 8 18 1 0 0 0 0 9 24 18 0 0 12 
0 0 0 0 31 5 5 19 0 9 0 0 8 0 10 0 3 12 0 3 0 0 33 0 23 0 19 0 20 4 0 0 0 17 0 
14 24 0 0 0 0 0 0 17 15 0 16 0 0 16 0 0 10 0 0 2 8 2 0 0 0 0 10 0 1 16 0 23 4 0 
0 2 18 5 8 3 0 3 8 0 0 18 0 19 12 0 0 0 0 10 0 10 8 0 0 6 0 8 0 25 13 1 0 0 0 
23 0 42 0 4 0 0 6 14 21 19 2 0 11 0 0 12 8 1 3 0 0 0 16 2 0 2 25 0 0 6 0 0 14 0 
