35 20
22 0 5 0 0 1 1 19 0 0 5 0 0 7 0 4 0 0 6 13 2 14 56 0 16 0 0 0 0 0 3 0 17 3 13 
0 0 15 0 17 16 8 1 16 22 0 0 2 46 8 3 24 12 3 16 14 41 15 0 17 0 10 0 3 0 0 22 0 20 7 
0 0 0 0 0 0 57 8 5 0 0 0 7 9 7 27 0 0 0 6 0 0 0 0 0 0 0 14 0 8 0 2 11 0 32 
0 0 24 3 2 23 2 14 25 0 10 0 4 0 0 0 6 0 0 0 7 9 3 16 1 23 12 4 5 2 0 4 0 25 12 
0 0 0 23 9 0 19 6 0 12 0 2 1 7 6 3 18 7 7 1 0 11 8 0 28 23 25 1 1 1 18 0 4 11 20 
12 0 0 0 0 17 10 0 32 15 7 8 19 0 0 0 0 7 13 4 0 0 0 14 4 17 6 1 14 2 1 32 35 25 0 
0 0 24 41 8 2 4 4 16 8 4 0 17 5 0 0 0 6 21 0 13 3 6 5 17 0 66 0 12 16 10 0 0 0 0 
24 0 4 31 7 0 8 6 0 0 0 16 16 12 8 0 0 0 5 0 0 2 12 0 35 0 0 0 0 5 0 0 2 0 53 
0 0 7 0 0 0 2 0 2 0 6 0 0 6 0 0 4 8 13 6 0 3 0 0 10 0 0 3 0 5 0 0 0 0 7 
0 0 19 26 0 2 4 15 18 27 1 17 0 6 18 21 0 6 0 5 0 17 5 0 20 7 1 0 11 18 17 0 3 0 19 
11 17 21 20 0 4 23 0 10 0 1 0 5 0 10 29 0 0 14 8 0 8 0 7 6 19 0 0 0 8 8 0 31 0 0 
0 0 2 0 51 0 9 0 0 4 2 2 6 12 0 0 1 1 0 0 0 0 0 6 0 6 0 3 1 25 26 4 0 8 0 
17 0 27 0 0 0 2 0 15 0 0 7 22 4 0 0 0 17 2 0 0 0 3 21 0 8 0 0 3 20 0 0 7 8 22 
0 47 0 2 0 0 8 3 0 0 0 13 0 4 0 0 14 20 17 19 12 0 0 0 10 14 0 13 15 5 0 30 8 20 3 
0 0 0 2 9 6 12 5 3 21 0 8 17 0 8 0 18 0 0 0 21 0 0 12 0 0 0 12 6 0 0 19 0 2 62 
5 28 20 2 1 0 5 0 11 0 0 8 28 0 6 44 16 0 3 4 12 1 12 15 1 13 12 0 25 0 28 20 12 4 34 
8 16 0 3 0 11 6 0 24 0 0 12 0 0 0 0 0 8 0 0 0 11 1 0 13 7 26 0 3 1 10 0 24 0 3 
40 0 1 0 0 0 2 0 0 0 0 4 0 7 0 0 2 15 0 0 0 0 6 6 0 1 0 0 39 13 5 0 0 3 0 
8 0 15 0 0 0 4 0 8 23 16 0 0 0 0 0 13 0 13 0 0 11 12 6 7 0 7 5 0 13 1 1 2 7 0 
25 4 0 3 0 4 6 3 4 10 10 3 0 15 0 9 0 2 18 2 0 0 27 16 19 18 0 0 2 0 0 0 0 13 0 
