35 20
40 10 5 0 3 43 7 15 4 39 0 8 16 13 14 3 9 11 0 10 16 25 0 3 3 0 6 14 0 0 34 4 19 0 29 
25 0 0 0 34 13 0 2 2 10 0 0 0 20 0 6 0 0 2 3 19 15 13 0 1 12 1 0 0 4 23 2 7 5 15 
17 0 27 0 13 2 7 0 27 9 21 0 0 0 0 17 4 0 5 13 13 8 0 0 0 25 0 0 8 27 0 31 23 0 0 
3 0 0 0 0 0 0 0 1 1 0 6 0 0 0 15 0 6 16 11 1 7 2 0 0 0 1 0 0 0 0 3 6 0 15 
0 2 32 5 19 9 9 14 10 1 0 7 0 0 0 7 1 11 0 0 1 2 17 8 26 7 0 3 0 8 0 8 5 12 24 
0 0 40 24 9 0 0 3 0 0 1 0 12 18 10 5 24 0 1 0 3 17 4 0 10 3 0 24 0 0 13 0 43 0 21 
9 7 0 0 0 13 0 35 9 19 7 0 20 1 0 0 2 0 14 8 2 14 9 5 16 3 0 8 1 0 1 1 9 17 14 
1 10 0 13 0 0 0 0 0 0 0 8 17 17 0 0 0 10 0 1 0 8 6 0 0 0 15 7 0 17 1 9 0 9 10 
10 0 0 0 29 0 10 0 9 0 0 2 17 15 0 8 10 0 0 0 3 10 11 0 16 1 0 0 23 0 0 0 7 29 22 
7 0 0 3 14 28 2 0 0 0 5 0 18 0 20 0 0 19 26 8 28 0 0 2 0 4 0 0 15 0 5 6 0 18 20 
8 7 0 3 0 0 17 0 7 6 19 14 15 0 0 1 18 1 0 0 0 14 1 8 0 8 0 0 17 33 2 7 8 1 18 
6 6 0 0 0 9 0 10 0 22 0 7 2 8 17 0 0 17 1 0 0 14 3 2 9 0 0 13 3 0 1 17 0 17 0 
13 0 0 0 0 0 22 0 0 0 0 4 0 8 0 4 2 0 0 0 0 8 0 0 8 0 0 0 26 0 11 0 0 0 8 
6 39 0 16 12 7 0 14 14 3 15 0 5 0 8 35 0 4 8 5 0 10 0 25 8 4 0 0 6 28 22 23 0 0 73 
33 10 0 0 0 14 10 22 0 3 5 16 0 0 0 5 2 0 0 9 0 0 2 12 13 6 0 8 7 4 2 3 0 8 0 
4 0 2 0 19 0 0 1 0 0 0 0 12 14 0 0 0 0 0 0 0 16 0 15 3 0 0 23 4 0 0 19 0 0 0 
27 0 0 20 0 15 0 0 6 9 0 8 16 0 1 0 11 7 18 0 1 8 1 23 0 0 3 0 1 0 2 3 0 10 0 
6 16 75 0 0 15 0 0 0 0 0 0 10 0 0 13 9 15 0 8 15 0 0 21 0 25 0 2 0 0 0 0 0 21 1 
60 12 0 0 0 0 0 35 0 0 0 0 0 3 0 15 7 0 0 4 21 0 0 19 14 11 1 0 21 44 13 0 32 7 0 
40 24 0 0 44 21 0 11 15 0 0 0 0 0 0 0 0 0 12 0 0 19 2 27 0 24 43 0 4 25 0 0 0 33 6 
