35 20
25 0 11 0 0 0 5 0 0 9 0 2 0 11 0 0 16 0 0 0 0 5 11 0 0 9 23 10 0 13 0 0 0 17 0 
0 0 7 13 25 41 0 0 14 0 0 2 18 4 4 0 0 4 4 0 16 5 14 0 0 22 16 2 0 0 32 0 30 29 0 
0 0 27 3 5 0 30 11 2 43 3 0 5 0 1 10 8 11 10 17 0 0 12 0 21 0 11 0 21 18 1 29 0 0 17 
30 24 30 15 0 15 26 2 13 39 10 5 12 0 15 1 12 0 30 0 12 2 24 14 0 0 18 0 5 41 36 22 30 10 0 
29 52 28 2 21 12 0 2 20 16 28 0 0 0 0 4 11 8 1 11 12 0 3 4 0 11 0 0 24 28 0 30 30 33 9 
0 24 0 5 42 0 5 0 30 7 7 0 0 0 12 0 0 0 0 7 20 5 0 0 0 28 7 0 1 12 0 5 0 0 26 
0 7 16 0 1 0 0 0 24 21 0 8 0 0 0 18 0 0 1 0 0 11 4 0 0 5 0 0 0 0 3 0 24 30 0 
12 50 0 0 12 0 10 2 0 3 0 0 0 0 1 14 12 0 0 5 0 2 0 0 0 24 0 55 0 34 5 0 0 0 0 
0 31 30 16 0 26 11 0 0 6 0 0 0 0 7 0 0 13 0 14 3 0 0 16 0 4 0 0 5 3 2 26 31 0 0 
0 4 8 14 0 13 5 0 0 5 5 2 0 0 4 0 0 22 4 10 1 8 0 28 0 9 0 0 5 2 0 7 1 10 0 
8 0 13 16 0 0 26 0 20 26 0 9 23 13 5 13 3 4 0 15 16 0 4 7 0 23 0 6 4 0 27 19 47 0 0 
3 0 10 0 0 6 14 1 0 21 0 6 10 0 12 0 0 0 1 20 6 4 6 0 0 5 19 5 0 3 15 9 0 14 0 
25 0 0 1 0 11 0 0 0 7 9 3 18 0 0 0 11 0 1 0 0 0 0 5 0 2 0 4 0 0 18 0 9 30 31 
0 4 0 3 0 0 11 11 0 12 0 13 6 4 16 0 4 19 7 4 8 0 0 0 5 0 1 1 6 2 0 0 0 0 0 
6 2 18 10 11 29 24 0 1 22 25 2 0 0 7 8 0 7 3 0 0 0 4 0 33 1 11 6 5 9 24 9 22 11 39 
0 0 0 0 0 11 6 50 2 6 11 0 15 0 7 6 22 0 0 0 2 0 0 0 0 0 10 0 0 0 37 0 17 0 27 
0 0 0 33 29 0 14 35 8 42 0 0 0 0 5 8 0 0 0 0 0 0 0 0 0 4 17 10 0 13 23 7 6 25 0 
0 9 0 0 1 1 10 0 22 0 0 0 0 0 2 13 0 0 0 2 2 8 8 5 10 0 6 0 13 0 27 0 19 17 0 
14 19 28 44 0 0 28 0 3 19 0 0 3 15 0 0 7 0 0 3 12 18 1 1 2 15 0 0 20 0 0 13 0 0 60 
5 22 0 0 0 14 2 21 21 3 0 16 7 0 19 17 0 0 0 8 0 0 0 6 4 7 0 0 4 10 11 23 0 33 0 
