35 20
0 0 9 0 0 1 25 22 14 18 0 27 7 0 0 0 0 0 0 14 0 0 0 0 0 1 3 0 1 21 19 25 0 17 0 
0 0 0 15 0 10 0 0 0 17 0 0 0 0 0 0 2 0 41 1 2 0 0 0 0 1 17 0 0 0 0 0 0 13 16 
0 0 32 3 0 38 0 8 10 9 0 2 0 0 0 10 0 0 8 6 0 0 0 0 2 0 0 0 0 0 0 0 0 27 32 
15 0 39 0 2 33 38 1 1 0 26 6 16 23 0 4 0 17 1 2 1 0 0 13 7 29 12 24 5 0 1 3 19 43 29 
49 2 41 23 0 2 0 0 19 1 0 0 29 0 0 0 0 12 13 0 1 0 9 0 24 7 6 18 26 12 12 31 33 0 9 
21 2 31 26 6 21 14 0 5 17 2 3 26 0 0 0 1 0 1 19 14 0 6 11 0 5 21 0 10 27 18 1 24 2 14 
0 28 12 21 29 5 49 0 20 4 0 17 25 0 11 0 0 3 0 17 3 12 0 0 3 25 20 0 36 0 18 0 26 2 10 
6 0 24 5 25 0 0 0 17 0 2 0 7 4 0 0 0 0 14 32 8 0 4 4 1 25 18 5 0 25 28 1 1 11 0 
7 4 2 0 0 0 0 0 0 0 0 0 0 18 0 5 3 0 0 0 0 0 0 0 0 0 0 0 0 0 0 14 0 0 0 
0 16 0 0 8 0 6 7 0 46 0 0 0 12 10 0 0 0 6 0 0 0 0 2 6 9 0 0 0 0 21 0 0 0 25 
0 24 77 17 9 0 0 0 5 0 8 0 26 0 0 0 10 0 0 8 17 3 14 0 1 30 0 0 16 0 0 31 30 5 0 
5 17 0 0 10 24 0 27 0 0 0 4 8 0 8 1 16 25 13 3 0 0 3 0 0 9 0 3 6 0 25 1 5 0 39 
8 0 0 0 5 0 9 0 16 0 0 0 0 0 0 0 12 0 0 0 2 19 7 2 1 0 0 5 0 0 9 0 0 0 0 
8 16 5 0 0 8 3 27 2 0 3 0 8 0 0 8 11 15 6 2 3 14 4 13 0 0 16 33 10 0 3 3 0 0 4 
2 0 2 26 0 14 0 0 30 0 0 0 0 0 6 0 0 7 11 5 0 4 11 5 0 8 0 2 0 37 0 0 0 12 17 
1 1 12 0 0 12 12 0 0 15 0 11 0 0 10 0 0 0 0 9 2 0 8 0 18 9 6 3 0 0 0 1 28 11 0 
12 26 1 0 0 76 3 9 15 39 2 0 10 12 12 1 8 3 0 12 0 0 3 10 50 0 16 12 23 7 3 14 2 24 15 
0 0 0 41 0 0 0 0 2 17 4 0 0 20 0 0 15 18 1 10 11 0 10 0 29 7 0 0 0 0 0 25 15 10 21 
0 17 23 29 9 0 18 6 0 22 15 0 14 1 0 5 13 4 1 10 0 0 0 6 18 4 0 16 0 13 12 0 29 28 0 
33 10 4 2 7 2 15 0 12 2 0 11 0 11 20 4 9 3 0 4 14 7 9 7 0 16 0 16 5 0 0 0 0 32 20 
