35 20
0 0 7 0 0 0 0 0 0 0 7 19 0 12 0 18 9 9 0 0 0 0 0 0 0 12 10 16 14 7 0 9 10 3 0 
0 33 15 15 32 10 0 42 19 0 13 8 0 3 1 7 45 40 20 3 16 10 3 2 0 18 4 17 14 6 4 26 17 0 43 
11 20 0 0 0 0 5 20 3 0 7 14 5 0 0 0 1 7 0 0 0 0 0 0 0 0 0 20 0 8 0 9 0 4 3 
32 24 3 14 0 2 0 0 3 40 5 10 2 19 10 0 0 7 15 0 0 0 0 8 3 67 5 8 1 0 0 13 14 7 7 
31 0 20 0 3 28 0 0 0 14 0 1 0 0 0 0 20 0 4 17 0 3 7 0 0 0 21 6 26 3 0 16 38 8 5 
19 0 0 0 0 1 24 20 12 0 3 0 0 0 11 0 2 0 0 12 23 0 0 0 12 0 0 1 3 2 18 0 0 0 13 
0 0 0 0 5 20 2 14 40 0 3 0 10 0 0 0 18 0 15 9 0 0 0 18 20 0 7 0 9 0 0 7 24 0 30 
0 0 0 20 0 6 4 21 2 0 2 0 5 15 9 0 39 7 16 12 6 0 9 11 0 0 0 0 3 9 0 18 15 1 3 
0 3 0 0 35 1 19 0 20 0 0 17 0 1 0 11 0 11 0 0 2 7 8 1 0 7 0 8 42 23 0 0 0 0 0 
11 0 0 17 0 14 0 8 24 0 2 11 21 0 15 0 28 0 3 14 17 0 0 0 0 0 0 0 0 15 10 28 24 0 4 
29 6 8 8 19 4 8 21 19 25 0 6 23 2 8 6 5 0 0 5 6 1 18 0 5 4 5 11 0 30 5 5 26 19 47 
0 3 0 0 15 0 12 5 0 17 16 0 0 0 0 9 0 0 0 17 6 5 0 19 0 0 28 0 0 0 0 9 0 5 0 
0 41 10 1 0 0 0 20 4 0 0 7 0 0 0 0 0 0 17 4 0 0 5 27 21 7 0 9 28 5 4 0 8 2 16 
0 3 15 1 0 0 0 0 0 0 7 17 0 0 10 19 17 5 0 3 9 0 0 0 0 0 7 19 16 23 1 4 15 0 17 
0 0 26 0 0 0 19 5 2 9 0 10 17 5 0 0 13 0 7 7 0 0 5 0 0 8 7 4 13 17 0 0 0 30 28 
0 0 0 0 0 0 0 14 0 0 0 0 0 17 0 0 0 14 0 0 0 0 7 3 0 0 2 0 0 0 7 3 0 0 0 
50 22 23 0 28 3 0 0 15 0 8 0 12 0 11 4 9 0 2 18 8 0 2 0 7 6 8 4 0 0 0 22 3 33 24 
0 7 0 2 1 18 0 1 15 0 0 17 9 27 0 0 7 0 0 0 11 14 11 40 0 14 0 0 32 0 2 11 9 7 0 
31 25 0 2 28 8 0 0 0 7 0 31 2 0 11 18 0 17 27 0 12 0 1 0 13 15 5 0 0 18 13 59 17 0 12 
7 22 0 16 0 3 27 25 0 16 0 11 0 12 19 0 9 12 0 7 2 6 6 29 0 4 12 5 0 15 25 0 0 8 7 
