35 20
29 15 19 4 9 3 3 10 0 6 0 0 0 9 20 16 62 12 0 0 0 17 0 8 8 7 23 6 11 14 24 0 26 14 4 
18 10 19 15 17 22 0 0 4 0 0 0 17 5 0 17 0 0 11 0 10 37 0 0 4 0 0 52 0 9 0 0 12 4 5 
6 9 0 14 0 25 3 16 0 7 7 0 0 0 0 0 0 16 8 21 9 20 0 0 0 0 7 0 12 11 25 0 10 7 12 
1 25 31 0 5 0 0 0 21 9 2 32 9 0 10 3 6 0 0 0 10 22 0 1 33 25 25 8 17 0 0 20 0 31 0 
34 0 30 1 1 0 6 0 0 0 6 8 0 0 14 10 0 0 0 13 0 6 0 9 0 7 25 16 13 0 20 0 30 0 34 
0 0 0 0 0 0 0 0 4 0 0 0 0 0 0 0 0 0 0 3 14 1 0 5 9 0 0 0 0 0 0 14 0 0 0 
4 33 7 2 20 6 0 0 9 15 13 0 0 17 13 0 6 6 15 8 10 1 0 16 15 1 21 11 8 16 0 0 20 10 13 
26 23 0 8 10 0 11 5 0 0 27 0 0 0 10 16 1 29 0 7 0 0 10 0 25 8 9 24 0 5 0 17 1 1 17 
5 0 25 0 5 0 19 8 0 0 17 5 0 6 0 5 5 0 0 0 0 5 9 0 3 12 0 30 0 5 0 0 0 0 0 
4 2 31 1 13 2 0 27 0 0 7 0 17 8 0 7 18 17 23 1 20 12 7 0 15 0 11 3 14 24 0 11 13 12 0 
3 0 0 0 0 9 6 0 0 0 18 3 0 0 0 10 0 9 0 0 8 0 0 13 0 7 0 3 2 0 0 0 0 0 0 
0 10 0 21 0 28 5 0 2 6 25 7 3 3 0 5 4 0 2 2 9 10 0 0 17 17 4 15 2 42 2 6 24 29 9 
6 8 0 0 0 0 7 9 0 7 0 0 0 7 17 0 3 0 11 0 0 0 21 0 23 0 0 1 2 1 0 22 1 0 0 
15 0 0 26 0 0 29 0 15 0 5 3 0 0 8 0 0 0 22 0 3 12 0 2 6 4 5 6 10 29 3 14 1 0 11 
3 5 0 0 0 16 14 21 25 2 1 0 6 0 0 5 11 0 0 0 0 44 0 10 0 0 8 11 21 2 0 1 0 21 5 
0 0 13 0 0 0 3 3 0 8 0 0 0 2 13 26 0 10 0 0 0 0 8 0 0 8 17 0 0 21 0 4 8 0 0 
30 0 0 34 0 0 0 2 5 0 5 19 1 8 0 1 0 0 5 9 0 0 0 0 0 0 0 0 0 10 11 0 0 0 0 
16 0 0 21 0 0 3 14 0 6 0 0 0 8 0 0 16 0 0 0 0 14 0 10 6 5 4 0 25 22 0 2 29 30 5 
6 0 0 0 36 2 6 7 0 24 37 17 23 0 18 14 0 14 4 9 13 11 17 0 6 0 14 5 21 3 26 9 39 24 23 
1 0 29 12 0 9 0 7 0 0 20 0 0 2 12 0 19 9 0 35 14 0 0 0 11 0 12 18 0 0 28 14 10 0 0 
