35 20
15 14 28 32 15 6 0 1 25 0 0 25 0 0 0 8 5 9 0 37 14 0 19 0 4 12 7 1 3 0 29 5 0 11 15 
34 24 9 4 10 0 13 4 11 8 2 23 21 28 0 7 0 7 0 0 0 0 15 4 8 14 14 21 0 0 0 7 7 0 34 
34 4 0 0 0 0 55 19 0 0 0 8 18 10 17 6 27 4 0 0 0 1 4 10 0 0 0 20 0 0 15 32 19 27 62 
11 0 3 17 6 0 8 22 0 0 0 16 0 0 0 13 5 0 17 15 0 15 0 4 18 0 0 8 31 40 6 2 0 3 28 
0 0 0 15 0 0 0 0 0 3 0 0 10 7 0 6 7 0 1 0 0 2 0 0 7 0 0 0 0 0 0 7 0 2 0 
0 11 24 15 2 24 3 0 18 17 14 0 0 0 6 0 0 3 14 3 34 0 13 0 30 0 49 0 0 0 0 7 12 3 33 
0 10 0 0 0 0 3 0 26 7 0 4 0 0 0 12 5 0 0 0 0 0 0 0 4 0 0 0 0 0 19 10 24 4 0 
0 0 0 0 0 0 0 0 0 14 0 0 0 0 0 7 13 0 9 0 0 0 0 1 0 0 17 0 0 8 0 0 0 0 0 
8 5 1 15 0 30 7 0 1 4 0 0 7 13 4 12 0 0 5 3 0 4 0 0 4 8 0 0 8 3 0 8 4 28 0 
0 15 11 26 0 0 13 0 7 0 14 0 9 50 1 0 9 17 8 0 15 5 8 7 4 6 0 14 2 18 4 0 36 20 0 
3 0 31 69 7 0 13 0 0 4 22 23 0 0 0 11 4 2 0 18 0 1 6 3 4 28 0 30 3 33 10 0 2 27 0 
20 26 0 0 0 5 0 0 0 23 4 0 0 16 9 9 45 0 0 0 20 7 6 0 16 1 10 47 15 10 1 0 23 9 0 
0 0 4 13 0 0 27 9 0 4 0 10 0 18 0 0 12 0 0 0 3 14 12 0 4 0 0 11 0 5 1 10 0 25 9 
3 32 0 36 5 28 0 12 6 1 0 16 0 4 0 3 0 0 0 4 0 0 0 20 0 0 0 12 3 0 0 0 0 45 0 
33 3 17 3 13 0 6 11 6 3 15 0 15 2 0 2 26 0 13 3 9 0 23 1 14 0 14 3 0 3 13 13 0 19 0 
0 29 7 11 0 0 0 0 0 0 1 5 0 0 0 13 0 0 0 0 0 1 6 1 0 0 10 0 6 0 29 0 0 2 0 
24 0 2 46 0 20 15 0 0 0 0 2 6 21 14 13 18 14 11 0 2 1 8 8 9 3 0 0 22 0 9 42 21 7 7 
30 24 25 20 0 0 0 13 0 0 2 14 0 0 0 0 0 15 0 0 4 2 1 9 0 0 0 29 0 5 37 0 12 0 0 
30 0 0 2 0 28 48 18 0 0 6 0 0 17 16 7 2 17 0 15 20 0 13 17 0 1 5 0 25 0 27 0 0 62 23 
36 7 24 0 0 7 5 0 1 0 6 0 10 13 0 0 6 0 0 0 10 0 0 41 0 8 1 0 3 0 0 17 9 0 0 
