35 20
2 0 2 5 10 5 3 0 16 0 9 11 0 20 10 0 0 18 4 11 0 0 17 0 18 0 0 0 3 5 0 0 0 20 0 
3 32 0 1 2 28 0 0 0 0 3 7 4 10 0 8 0 0 0 0 16 0 0 18 12 5 0 0 0 0 9 0 0 4 0 
25 0 8 3 14 5 13 4 0 0 0 0 0 0 19 0 10 17 0 0 6 9 20 0 7 12 24 0 0 0 0 0 0 12 0 
54 0 16 3 1 7 2 0 8 0 0 6 0 24 9 8 8 16 20 11 0 18 2 23 20 0 0 0 3 0 30 18 0 14 0 
35 0 0 15 0 5 26 0 1 0 3 7 3 11 0 0 0 2 15 13 12 10 25 23 0 0 0 0 6 0 8 0 50 13 18 
3 0 0 28 4 0 14 4 0 0 24 2 26 0 0 0 16 1 12 8 13 0 37 0 2 0 8 0 11 0 0 28 0 16 11 
32 21 32 47 17 5 49 30 4 0 0 0 0 10 11 9 0 0 6 0 0 3 21 15 0 1 0 27 0 31 32 25 0 24 14 
8 0 0 0 0 11 1 4 16 15 23 9 0 6 0 0 25 3 4 0 15 1 0 5 13 0 2 13 10 24 8 0 0 23 11 
4 0 0 28 8 6 21 23 22 6 0 17 7 0 0 12 7 0 6 5 0 4 0 0 15 4 0 0 1 2 72 2 28 0 0 
0 0 23 12 4 11 0 0 23 6 0 24 0 13 13 28 3 7 5 14 0 0 5 7 6 14 13 13 17 0 1 24 17 0 0 
0 0 37 0 2 3 2 0 14 0 0 6 0 0 0 0 7 3 8 0 3 0 5 0 0 0 18 0 26 0 0 0 1 1 0 
6 13 15 26 16 15 0 0 9 0 0 8 0 5 13 15 0 3 0 5 19 0 5 4 0 5 0 0 0 26 3 0 8 0 0 
33 0 30 17 23 5 2 12 0 16 10 0 0 0 26 4 7 4 0 9 28 6 0 14 0 20 11 18 0 0 5 17 41 0 19 
0 0 9 0 0 20 0 0 0 10 9 8 0 0 2 0 26 0 0 9 0 0 6 0 11 20 8 0 0 17 14 0 0 9 0 
19 0 0 2 0 23 2 2 0 27 0 16 0 10 0 0 0 4 10 19 0 0 17 0 0 20 0 14 5 0 8 0 0 13 23 
8 0 1 22 0 0 0 8 13 6 12 9 0 0 0 16 7 0 0 0 9 13 32 8 0 3 0 6 7 0 14 28 17 5 0 
30 0 0 14 0 9 0 19 0 0 0 15 4 1 0 0 0 3 0 7 12 0 5 0 0 0 4 0 0 0 30 0 0 0 2 
16 4 5 1 51 13 6 4 20 1 3 0 6 1 18 6 6 6 4 0 21 11 21 22 0 0 0 0 11 8 26 3 2 24 2 
53 18 5 0 0 0 19 0 1 0 0 0 0 13 19 0 1 19 10 3 15 0 0 0 0 6 16 0 28 3 0 0 12 0 18 
0 21 9 11 0 0 7 0 0 24 23 0 0 17 11 11 7 12 0 6 0 11 12 3 17 6 11 5 5 0 0 0 3 54 0 
