35 20
1 7 5 14 17 0 18 3 2 0 24 0 9 5 2 15 0 0 0 2 0 17 0 0 0 0 0 13 0 1 1 0 0 4 24 
9 46 0 1 9 26 22 31 0 16 17 19 5 20 18 16 0 5 14 16 26 8 22 9 0 0 21 31 3 14 23 0 15 11 12 
0 31 15 0 0 14 3 0 0 15 10 0 9 14 0 0 0 0 0 35 0 0 0 4 5 0 25 4 15 0 0 0 1 15 0 
9 22 27 0 22 0 26 37 0 9 4 18 9 0 0 5 3 0 11 0 0 0 12 24 0 1 1 0 21 1 0 8 5 2 0 
39 16 0 0 0 8 8 0 0 2 0 19 0 0 14 0 0 0 3 0 0 0 0 0 0 25 0 0 11 0 29 20 8 4 0 
12 4 27 13 0 4 15 32 0 28 18 8 6 0 0 0 2 0 8 0 0 12 15 0 22 15 0 0 4 5 12 13 0 0 0 
0 5 17 1 0 23 0 0 12 19 0 0 0 0 0 8 0 0 7 10 6 0 0 11 18 0 13 0 9 0 0 0 23 0 11 
20 8 10 31 8 11 33 0 0 21 11 6 8 0 9 2 0 0 2 5 20 2 0 0 0 0 4 0 7 0 2 0 0 30 25 
11 35 0 0 14 19 0 12 8 3 16 10 0 0 0 3 8 0 20 7 0 10 0 13 11 6 22 9 0 0 7 0 31 0 0 
26 5 35 17 8 3 4 0 4 0 0 0 1 1 0 7 13 0 18 0 17 8 12 0 5 0 0 26 0 13 0 0 0 31 12 
60 0 0 0 0 3 8 0 2 13 15 0 16 1 15 1 0 9 14 0 16 0 0 0 17 22 0 0 0 33 12 31 12 13 5 
0 14 0 34 0 0 11 0 3 3 2 7 18 12 11 6 0 9 7 0 0 19 10 0 0 0 34 0 0 0 5 0 29 23 0 
29 1 31 0 0 11 9 0 6 0 24 5 20 24 0 0 6 9 8 0 7 0 0 6 11 14 4 0 20 22 0 19 12 54 0 
0 17 1 2 0 29 1 0 0 0 0 10 0 16 17 0 2 9 4 10 2 0 2 0 7 22 0 12 25 4 0 19 0 28 33 
43 0 0 0 1 0 0 0 3 1 7 0 0 0 0 7 0 1 8 15 0 2 0 6 13 32 6 3 7 3 3 6 7 0 0 
0 10 32 0 23 25 0 46 0 35 17 0 0 42 0 15 13 15 12 8 14 7 0 0 11 21 17 0 16 18 28 0 25 0 24 
21 0 0 5 16 0 4 11 0 11 9 19 4 15 0 3 0 9 11 0 0 23 0 0 0 18 13 0 0 4 24 18 26 0 0 
26 35 25 0 15 0 17 16 0 8 9 0 17 0 0 0 0 0 21 6 0 17 0 17 10 5 3 0 0 12 5 3 1 33 18 
0 0 0 0 0 8 17 0 4 8 12 0 0 5 0 9 5 0 0 0 0 7 5 1 0 0 0 0 5 7 0 0 0 12 0 
11 0 0 0 9 4 2 0 22 4 59 19 4 16 0 0 4 17 1 0 0 0 9 1 11 0 0 1 19 0 19 12 22 16 0 
