35 20
5 0 9 7 12 5 0 17 0 7 0 13 8 3 1 0 0 18 34 0 0 0 0 7 0 7 0 0 25 3 9 0 13 26 0 
58 19 17 11 0 0 14 5 0 17 0 23 27 0 0 0 17 3 2 0 69 11 3 0 0 8 1 19 0 10 14 33 32 58 23 
0 4 39 10 0 4 11 13 0 23 21 0 19 0 12 3 0 2 12 0 8 19 18 0 0 0 7 4 0 0 27 5 1 0 0 
0 1 7 1 40 0 7 0 0 6 0 1 0 7 19 0 12 16 15 0 9 0 0 14 1 4 0 0 6 0 0 42 43 10 6 
0 9 28 12 0 24 0 2 3 2 8 25 11 22 13 0 0 0 0 0 0 0 0 8 0 23 24 13 0 3 0 10 12 0 0 
0 8 0 0 18 0 0 15 0 0 10 0 0 0 0 0 0 0 0 0 2 0 36 0 6 5 0 0 0 0 5 0 14 13 0 
0 10 5 11 0 0 20 0 1 5 0 8 0 0 5 0 0 0 0 10 0 8 0 8 0 0 20 4 0 8 0 0 0 6 0 
11 16 1 11 23 0 0 0 6 4 5 2 0 18 0 0 6 0 0 17 4 7 0 3 2 1 7 19 0 6 0 33 2 12 0 
3 9 1 0 81 0 6 6 4 6 9 1 17 0 3 2 0 20 3 0 13 9 8 5 20 0 16 8 24 12 38 0 0 11 0 
0 0 0 2 0 33 8 0 0 0 5 16 0 0 0 19 10 12 0 3 5 26 8 4 1 0 15 16 0 3 0 10 6 1 4 
0 0 0 0 0 29 0 8 0 9 9 0 6 17 4 5 0 0 0 14 13 0 8 13 0 0 0 3 13 0 23 0 0 10 7 
0 0 3 0 11 0 0 0 12 0 0 6 11 7 0 11 0 0 5 0 4 0 14 11 8 0 9 19 0 7 0 0 0 0 8 
22 4 25 29 16 45 0 26 23 7 0 6 25 0 0 2 10 11 12 0 12 13 22 3 2 20 34 0 16 0 25 32 0 2 13 
0 1 1 62 0 11 1 4 0 0 0 13 8 0 17 6 15 0 0 0 5 3 0 32 0 9 5 12 5 4 0 34 0 0 11 
0 7 25 0 0 0 15 12 0 2 0 7 6 14 0 0 0 0 4 0 5 0 21 7 0 7 0 16 26 1 0 6 14 0 0 
0 3 29 0 0 18 2 17 0 3 7 0 25 12 1 0 0 4 0 0 0 0 0 20 28 2 0 0 0 0 0 2 0 32 22 
0 51 2 9 0 13 0 25 0 2 0 9 8 9 0 10 0 0 5 0 3 0 0 0 3 13 0 10 0 10 6 30 16 14 0 
0 0 2 11 0 1 3 17 0 0 13 20 16 0 0 2 0 9 0 0 5 4 0 11 0 0 10 0 6 26 0 5 12 0 7 
34 3 14 0 18 12 0 16 3 3 3 15 0 21 0 0 5 0 0 11 0 0 10 39 0 20 13 0 0 5 0 16 10 35 1 
0 0 0 22 0 0 21 0 5 15 0 0 3 15 5 0 0 4 4 10 23 0 4 2 9 6 0 17 0 0 11 6 1 16 14 
