35 20
2 21 19 10 4 28 15 5 44 0 3 0 15 3 16 7 5 14 2 1 18 47 7 16 21 14 15 19 0 17 0 26 13 31 26 
0 0 7 22 14 0 5 40 32 0 12 0 0 0 0 5 14 21 1 0 13 0 0 0 0 29 0 2 0 9 13 23 0 15 27 
14 2 0 0 0 3 8 10 0 0 5 0 0 0 38 1 0 4 0 0 3 11 0 0 0 1 0 0 0 9 0 6 0 0 17 
23 0 0 0 16 3 0 0 3 7 0 2 0 15 9 8 0 5 0 5 16 2 5 23 5 0 23 11 2 14 10 0 0 0 4 
0 5 0 0 0 0 5 8 0 0 4 0 5 11 0 9 8 0 0 0 13 0 0 0 8 0 0 0 0 0 0 0 0 0 0 
0 5 0 1 0 3 0 0 0 0 13 0 9 0 2 17 16 10 0 18 0 8 0 0 5 0 9 0 0 18 3 10 21 9 15 
0 10 0 21 0 0 5 0 0 0 1 0 6 0 0 0 0 6 0 18 0 0 0 4 21 6 0 0 0 4 1 15 9 0 0 
7 19 13 22 29 0 8 0 0 14 17 21 0 12 10 23 0 1 7 10 0 0 10 0 10 15 0 5 3 8 15 20 40 29 0 
2 0 34 21 0 27 8 0 0 0 24 7 0 22 0 14 0 6 4 0 15 0 0 0 5 4 0 32 16 9 0 17 27 0 20 
9 9 32 3 10 41 16 0 9 14 9 8 0 6 10 8 0 11 0 0 0 0 4 18 0 16 4 4 0 5 4 4 27 0 4 
33 25 29 0 0 25 2 16 14 7 11 0 0 10 6 3 1 0 0 15 14 30 0 21 2 0 5 0 0 9 23 63 0 45 17 
0 11 0 24 0 0 23 22 12 0 0 0 0 0 0 8 10 28 8 7 12 11 0 1 0 8 19 22 4 3 0 1 17 1 0 
0 30 0 27 0 0 0 21 0 2 14 0 3 0 0 0 0 7 0 5 0 0 0 0 25 5 0 12 21 3 27 0 0 0 4 
33 32 0 0 0 6 0 13 19 1 0 0 13 0 9 0 0 0 0 0 0 11 0 13 5 0 0 8 0 16 0 0 7 1 0 
33 28 0 0 0 19 6 0 0 0 16 6 0 15 3 0 0 0 0 13 1 0 0 0 18 1 20 9 7 27 1 0 22 42 7 
15 21 14 3 21 48 35 2 26 13 18 0 0 20 4 28 3 7 13 7 11 0 21 11 5 1 2 7 5 3 11 13 3 3 65 
0 42 0 16 0 0 0 0 3 9 0 0 0 9 19 0 2 0 0 0 25 4 1 0 0 2 6 25 0 0 8 14 40 0 0 
14 0 12 31 0 0 0 0 17 8 2 15 6 0 18 23 4 1 0 0 0 9 0 9 7 9 11 5 0 40 12 11 9 0 36 
16 0 18 0 0 7 0 0 14 0 19 0 25 0 5 0 16 4 0 0 18 0 14 4 0 0 4 5 1 6 22 12 13 3 0 
13 7 2 19 61 0 18 7 19 10 0 0 0 32 11 11 0 0 12 0 0 0 0 0 11 0 8 51 0 15 26 27 0 19 4 
