35 20
49 11 0 19 0 0 9 0 0 0 8 0 0 12 0 9 0 18 0 17 0 11 3 0 0 0 0 27 11 0 0 0 11 0 0 
13 0 16 0 11 1 40 6 2 3 21 4 0 13 1 1 0 0 16 0 4 17 0 6 15 0 0 0 17 1 4 9 3 27 20 
0 16 18 15 2 45 0 0 1 1 9 6 11 11 17 0 0 12 14 0 4 3 8 0 12 4 25 26 32 9 0 0 4 0 0 
0 6 0 0 1 0 0 2 0 4 14 0 16 0 0 0 4 0 1 0 6 1 0 3 0 0 0 0 7 2 10 0 1 0 0 
0 0 21 4 2 15 0 7 8 5 3 9 0 0 3 14 13 0 11 0 9 0 0 21 0 0 7 4 13 0 0 0 0 0 12 
11 1 19 0 11 26 14 21 0 0 8 1 17 0 3 10 6 0 9 0 13 9 0 12 6 0 0 3 22 0 3 26 0 0 12 
11 2 1 13 7 20 0 4 0 5 35 5 12 27 12 8 0 0 17 5 0 0 0 14 19 0 6 14 0 19 30 0 0 0 0 
0 17 18 31 0 6 0 0 0 4 7 20 2 11 0 8 0 0 0 0 0 0 20 0 0 0 0 36 5 18 0 0 0 0 0 
0 0 0 0 0 46 10 0 0 51 10 18 0 3 0 0 10 0 0 10 0 3 0 0 0 3 4 18 3 7 0 0 0 24 3 
18 13 0 30 11 8 4 30 6 12 4 14 0 16 6 0 5 20 31 10 0 10 15 4 1 0 0 6 0 15 0 0 3 37 1 
0 0 0 0 1 10 0 3 1 0 0 0 0 0 0 0 3 0 16 0 12 6 0 0 0 4 0 0 5 0 0 1 12 7 18 
25 23 1 0 10 4 37 3 2 27 1 25 8 7 17 0 1 0 0 0 4 5 6 3 2 28 10 7 38 23 16 4 30 10 25 
1 9 2 0 0 0 1 0 17 0 8 0 7 12 0 17 0 0 0 18 14 0 3 0 4 23 0 0 0 0 0 0 14 7 4 
1 5 7 6 23 9 0 30 19 1 11 0 0 0 0 13 11 4 22 0 7 6 0 12 26 0 15 0 9 3 0 0 10 0 16 
3 0 2 0 9 4 16 0 0 1 0 14 0 11 11 8 0 6 2 0 1 0 16 0 0 11 3 0 1 8 0 0 0 3 0 
13 8 1 16 7 0 0 0 5 0 13 8 14 12 14 11 0 0 9 16 0 0 11 0 0 11 10 9 0 18 0 0 0 0 0 
0 0 0 0 0 4 0 0 4 4 0 7 0 20 12 16 0 0 7 0 0 0 5 1 0 8 0 5 13 0 0 0 1 13 13 
5 0 16 8 69 28 10 17 1 24 37 28 21 0 6 0 10 0 0 17 0 12 0 12 17 13 0 0 4 25 2 0 0 23 0 
0 1 8 0 0 4 20 0 7 27 0 15 2 11 12 21 0 18 0 0 5 0 0 0 0 6 29 0 0 0 1 20 20 24 0 
23 12 26 19 17 20 6 0 8 3 19 14 35 0 4 10 0 0 0 0 0 22 0 3 14 13 0 0 39 20 2 8 34 7 14 
