35 20
19 6 0 0 17 9 0 0 27 19 0 8 16 1 24 0 0 6 3 8 12 12 8 0 0 24 0 0 0 17 6 31 0 4 0 
1 32 11 2 0 25 4 0 18 7 9 1 2 0 0 0 0 16 11 0 0 0 13 0 13 0 18 0 23 0 0 0 8 32 17 
19 0 0 0 0 16 17 2 7 47 6 25 0 0 0 0 10 0 3 6 21 11 8 10 0 4 7 0 13 11 19 2 2 32 25 
30 15 6 3 3 34 0 0 5 19 1 1 1 15 3 13 12 23 3 16 0 33 0 3 7 6 19 15 6 28 21 0 11 16 0 
0 0 2 0 19 0 12 0 4 12 25 5 6 18 6 9 2 7 0 0 0 9 0 0 12 0 1 0 11 13 26 39 0 0 8 
0 0 18 14 0 14 9 0 18 0 0 0 0 0 1 0 0 0 3 16 18 0 0 0 0 0 14 0 0 0 0 0 0 0 7 
0 0 0 17 3 9 11 3 26 1 0 16 0 13 3 0 5 0 0 0 6 0 0 0 5 0 0 0 0 28 3 26 21 0 3 
0 11 9 5 23 2 23 3 0 20 0 9 0 4 11 6 0 0 0 0 0 0 6 0 7 1 20 0 0 2 7 0 28 0 6 
5 23 0 0 0 0 0 6 0 0 0 0 0 0 0 0 0 0 0 0 10 0 4 0 23 1 4 0 0 0 7 1 0 8 0 
45 30 0 21 9 0 19 15 8 13 14 9 7 1 4 0 1 0 1 7 27 25 20 10 37 17 6 27 15 7 13 14 9 40 13 
6 3 0 0 0 0 28 3 5 0 2 7 0 5 0 0 16 0 0 0 10 8 0 6 0 0 16 0 12 6 10 21 5 0 9 
32 4 0 7 0 0 13 16 19 11 53 0 0 0 3 0 0 0 4 8 0 8 0 16 0 0 8 19 18 19 0 0 32 2 0 
3 10 21 11 30 6 2 0 0 10 7 23 1 0 7 4 0 0 11 15 0 0 0 22 28 0 7 0 0 16 6 3 0 6 17 
0 0 0 0 9 0 0 0 0 26 0 2 8 0 8 1 3 0 0 6 10 0 2 10 10 0 17 0 10 0 10 4 0 9 5 
0 0 10 7 0 0 11 0 9 0 0 0 17 0 5 1 8 11 0 4 14 12 6 3 30 1 0 0 11 30 1 0 17 0 0 
48 0 28 28 1 1 14 1 24 1 4 23 0 0 15 0 12 17 0 10 0 0 0 16 0 0 2 0 20 10 21 28 5 33 40 
14 27 0 34 16 4 14 16 2 5 21 12 6 2 0 12 0 14 8 0 16 0 0 2 14 21 4 1 27 3 27 19 0 2 6 
7 5 0 20 27 1 0 14 0 0 19 5 1 0 0 0 0 0 0 4 11 0 21 18 0 18 0 26 0 15 2 0 20 1 2 
0 0 19 2 0 18 46 0 0 0 0 2 1 21 11 0 0 0 0 4 0 4 0 0 0 19 0 0 7 6 0 0 0 6 21 
0 16 0 14 12 0 0 0 0 0 4 12 1 13 3 0 0 0 4 6 0 0 8 12 0 3 7 0 10 3 2 2 5 9 2 
