35 20
1 13 0 8 26 0 6 8 21 10 15 0 0 6 18 0 0 17 0 8 0 11 0 3 17 8 0 26 0 21 2 30 18 8 0 
21 15 40 0 20 8 19 5 0 0 0 1 7 21 0 0 0 5 3 0 0 5 12 0 33 15 14 0 16 0 0 5 0 12 15 
44 8 0 0 0 24 15 10 0 14 11 4 20 0 0 10 0 0 9 8 20 11 4 1 12 0 8 17 3 27 0 0 45 0 12 
40 6 0 0 19 0 22 27 0 19 0 0 0 13 0 0 2 0 11 3 0 7 0 3 0 0 20 0 41 0 23 10 32 0 0 
22 66 27 14 4 3 2 0 3 0 2 0 9 2 0 14 13 13 32 0 0 9 15 1 1 32 0 0 0 23 6 0 0 11 9 
28 12 12 0 5 4 42 22 8 3 0 1 0 0 8 14 18 3 1 1 0 0 0 0 0 19 23 9 0 7 0 10 32 0 20 
0 15 0 0 7 0 7 26 11 0 1 5 0 6 2 5 10 0 0 10 0 0 0 3 7 14 2 15 0 18 0 12 4 5 11 
0 0 31 14 0 0 7 0 0 0 0 4 0 0 0 0 0 14 0 2 0 0 0 12 13 0 5 0 19 5 2 0 10 31 0 
23 0 0 8 0 42 3 6 0 18 7 2 20 2 1 1 6 0 0 0 11 0 28 32 0 6 19 0 0 0 18 11 20 0 0 
8 0 0 8 3 4 0 0 0 14 0 0 20 13 0 2 0 3 3 0 0 3 0 11 0 0 7 0 5 11 6 0 1 7 0 
1 20 22 1 9 6 3 23 0 5 2 3 7 0 0 14 20 0 7 0 0 0 8 8 22 0 0 0 9 8 10 0 20 26 4 
24 9 0 7 17 28 2 0 0 0 7 11 22 7 0 2 0 0 0 11 0 17 11 9 26 0 1 0 0 0 0 0 0 20 22 
0 0 0 9 8 1 4 0 0 0 0 0 9 19 0 18 0 11 16 0 13 0 0 10 4 0 44 0 0 14 0 0 13 0 27 
13 17 0 1 4 0 18 0 35 34 16 29 3 9 0 5 0 19 10 8 0 4 12 0 17 0 0 11 19 0 13 7 0 25 21 
5 23 0 11 1 0 0 17 25 2 18 0 12 18 11 0 0 2 0 3 0 7 10 1 12 6 7 0 20 0 0 1 0 38 0 
12 18 25 0 4 0 0 0 19 0 0 7 5 6 12 0 0 0 0 18 0 7 0 0 0 8 0 25 10 6 12 9 0 5 0 
0 3 15 3 15 0 3 10 0 14 0 3 0 36 0 0 0 0 0 5 5 11 0 2 0 5 1 0 0 16 0 0 0 1 1 
5 12 5 37 0 0 11 3 11 0 0 0 0 0 0 1 12 1 6 27 14 0 0 9 12 1 19 11 10 0 0 0 33 7 13 
14 0 0 2 24 27 0 23 0 0 0 10 0 10 17 0 12 0 0 8 5 1 11 0 19 23 1 0 0 25 1 1 0 0 0 
0 29 4 20 28 0 0 0 1 1 44 14 0 5 0 0 9 10 0 0 0 0 11 18 14 9 3 17 15 0 29 13 9 0 0 
