35 20
0 0 23 0 16 6 0 0 0 0 8 30 10 0 6 2 16 29 0 0 12 0 27 18 0 12 8 10 0 0 14 0 16 0 28 
30 20 23 0 7 0 6 0 3 0 0 23 0 0 0 13 10 0 11 0 0 20 13 0 24 28 0 0 0 0 5 0 0 6 0 
23 7 21 13 0 3 0 1 38 2 15 6 2 4 12 4 14 0 0 6 2 14 14 15 0 0 12 0 0 16 5 0 10 0 15 
0 24 0 12 0 0 0 11 0 23 8 0 0 9 0 12 0 4 13 0 0 0 0 0 0 0 21 10 0 0 35 13 23 4 8 
5 0 0 0 0 16 18 0 28 3 4 0 0 0 15 0 16 17 12 12 2 16 0 0 0 17 5 12 11 0 8 12 2 25 60 
0 0 27 16 1 3 0 0 0 14 18 0 0 0 3 0 4 15 15 0 0 0 0 0 2 0 2 0 0 8 0 21 0 0 0 
0 7 41 1 12 3 7 0 0 10 0 7 3 7 0 3 18 0 0 0 0 0 0 0 9 2 0 0 12 0 0 0 0 12 32 
12 18 0 8 22 0 0 4 0 24 0 2 12 0 15 2 0 12 1 17 0 5 0 9 0 0 50 3 9 1 0 0 18 5 17 
1 5 43 12 0 5 1 2 5 13 17 0 1 6 0 25 12 0 0 9 0 0 28 1 0 1 17 8 5 1 0 0 0 0 44 
30 50 24 8 0 18 18 0 15 0 9 17 17 0 12 5 11 1 9 4 0 17 1 6 13 1 6 27 1 80 2 0 0 9 0 
18 1 0 0 0 2 0 0 0 9 4 2 0 2 4 13 0 20 9 12 0 7 3 0 0 7 0 12 22 0 4 0 7 0 10 
3 2 2 2 6 21 0 10 4 5 4 5 6 8 0 8 2 0 0 12 3 0 0 11 19 25 9 3 0 0 3 0 22 33 11 
1 0 6 0 0 24 0 15 2 2 1 7 0 0 0 0 12 6 11 6 10 0 4 22 31 6 3 0 6 24 2 1 17 0 34 
4 7 18 0 2 24 0 16 0 0 4 10 22 0 0 0 0 0 5 25 0 0 0 16 0 0 0 10 0 14 0 6 0 3 10 
0 0 1 5 2 0 0 0 5 7 4 11 17 16 24 2 14 0 17 0 0 0 13 0 0 0 11 5 23 33 10 0 0 22 0 
0 27 0 34 0 22 0 21 0 0 0 0 11 0 0 0 3 3 25 0 0 0 0 12 21 0 0 22 49 0 13 0 0 15 2 
0 6 30 14 28 30 0 15 5 10 0 2 23 0 0 0 8 0 0 7 0 14 2 8 7 14 17 0 5 0 25 0 51 3 42 
0 2 0 0 0 47 0 0 0 0 3 33 0 20 3 18 0 0 0 0 0 0 1 19 0 0 16 0 10 2 0 0 3 39 16 
23 0 1 0 34 19 0 17 3 3 16 6 8 0 16 0 8 33 3 16 12 14 17 2 0 18 0 24 17 32 10 3 0 0 3 
23 27 31 0 30 0 0 0 18 37 0 0 19 0 2 0 23 0 2 9 0 0 0 23 0 19 11 14 0 0 0 13 16 31 53 
