35 20
24 0 32 0 23 14 13 0 0 0 0 0 17 6 0 0 4 0 16 8 16 8 0 0 26 25 14 20 19 5 0 0 3 0 32 
6 1 11 26 0 0 30 14 12 2 0 0 9 0 0 12 7 15 0 0 14 0 12 7 8 0 0 0 0 2 24 0 8 0 30 
11 14 16 0 20 0 11 0 0 0 0 10 0 8 13 0 16 15 4 11 3 0 0 19 20 0 0 0 9 9 0 12 15 0 0 
27 2 0 23 13 0 0 1 11 6 0 7 2 0 5 7 28 10 0 6 1 6 5 4 14 22 0 3 0 2 9 28 0 0 0 
7 24 0 7 2 0 27 7 5 37 0 0 0 0 19 0 15 0 4 0 0 0 14 6 0 39 15 0 11 0 0 8 23 19 0 
30 0 4 7 1 10 22 18 12 1 7 4 5 0 0 0 1 2 0 2 2 14 0 10 0 11 0 18 0 3 16 7 26 0 10 
0 0 11 27 5 0 0 0 6 22 0 8 0 9 0 0 15 0 2 0 10 18 5 0 4 0 0 14 0 1 0 4 0 24 0 
0 0 36 8 2 8 0 0 23 1 1 6 2 4 0 10 0 6 11 0 9 8 0 18 0 0 0 25 0 4 0 0 0 0 26 
0 22 15 0 27 0 5 30 6 0 16 4 10 3 4 9 9 4 0 5 4 0 10 0 0 16 5 11 21 13 0 24 15 11 6 
18 8 9 0 3 0 0 21 1 6 17 0 2 3 6 22 20 14 18 4 7 4 0 0 22 0 9 5 21 13 4 5 0 18 0 
0 0 9 3 0 3 3 17 20 4 0 7 0 11 0 13 0 15 0 0 1 0 0 0 10 0 0 0 7 16 0 14 0 0 0 
38 0 2 1 0 0 0 0 0 2 7 33 0 0 0 0 16 2 0 0 0 10 9 5 0 0 0 11 9 29 0 9 37 3 0 
0 0 0 7 3 22 0 4 6 6 0 7 5 0 0 0 9 13 8 0 0 16 0 0 0 6 12 4 0 0 13 6 0 0 0 
11 0 10 17 11 3 5 0 21 3 6 52 6 4 20 0 7 10 6 13 3 0 0 6 7 0 0 0 0 18 0 8 13 0 0 
0 39 14 0 23 18 10 0 13 5 0 17 7 0 11 0 25 8 2 0 1 1 3 1 0 19 0 30 29 28 18 0 0 0 0 
4 17 10 3 4 35 16 12 0 0 23 3 6 0 3 0 0 0 17 0 2 0 0 8 0 15 0 0 22 0 25 0 0 0 10 
0 0 0 37 0 0 3 19 0 0 0 0 37 0 2 0 14 20 31 0 15 0 3 0 7 8 9 17 0 16 0 28 20 0 0 
0 0 0 8 0 0 3 27 0 28 21 0 0 20 9 0 2 0 11 0 2 0 13 9 13 7 8 0 0 0 0 21 0 44 27 
8 23 27 18 0 2 4 6 13 0 3 0 2 6 3 0 29 15 5 0 0 18 17 7 23 12 1 0 14 28 0 0 1 30 0 
0 18 0 0 0 1 0 0 0 0 6 0 6 0 1 0 28 10 9 21 7 0 3 4 10 0 27 1 24 0 4 0 0 11 14 
