35 20
0 11 33 7 0 0 5 6 8 0 18 0 10 15 0 29 13 0 16 6 0 0 0 0 0 0 17 0 0 27 14 13 6 0 0 
55 53 9 6 0 24 3 1 0 7 4 37 11 5 15 0 0 5 2 0 0 11 14 2 0 2 0 0 4 19 14 17 8 1 4 
0 5 0 43 16 0 0 21 0 5 0 0 3 0 0 13 12 9 0 7 17 0 15 20 21 10 19 0 12 1 17 22 0 1 13 
7 0 0 8 6 0 0 0 0 0 6 11 13 0 0 15 1 9 6 6 0 6 0 16 0 0 20 0 0 0 15 0 14 0 0 
13 0 29 9 0 14 6 0 0 0 0 4 2 13 0 0 19 0 2 7 0 0 1 5 0 23 0 8 20 0 14 0 10 0 0 
0 6 20 12 0 0 12 8 5 23 0 4 0 0 2 37 2 3 12 11 6 0 32 0 5 13 8 0 2 3 32 5 9 11 8 
0 0 6 9 17 26 4 23 0 8 20 3 18 1 6 12 3 0 10 6 4 0 0 0 0 1 6 0 10 0 1 20 6 29 1 
0 26 7 0 0 0 0 12 0 2 0 10 0 0 2 0 11 2 1 4 12 7 0 0 0 0 1 37 4 18 0 12 14 0 1 
23 0 21 29 0 18 0 1 1 0 0 11 13 5 39 3 6 0 4 3 4 0 0 5 0 0 0 0 4 15 2 0 29 19 20 
0 0 39 1 58 4 3 0 8 9 4 0 22 11 1 0 13 2 0 6 0 6 0 0 7 0 25 21 0 1 0 5 25 9 52 
51 49 18 4 0 5 11 0 6 21 9 11 14 0 1 0 14 15 0 16 11 0 0 0 0 3 16 5 31 0 0 41 27 0 2 
0 26 0 18 0 21 0 0 13 25 9 11 15 0 3 0 0 12 7 0 5 31 11 0 15 0 1 15 27 12 0 0 26 0 0 
8 0 0 0 0 0 0 0 8 9 0 0 0 0 0 0 7 0 0 13 2 0 2 0 0 0 0 0 4 4 0 0 16 0 0 
0 6 0 10 6 2 0 2 37 0 2 8 0 17 0 0 0 0 1 2 0 2 0 4 0 0 0 19 0 0 1 1 0 0 0 
13 2 3 0 0 0 8 0 0 1 17 13 0 0 3 0 0 12 6 11 0 13 1 4 0 4 0 11 0 0 25 8 12 0 0 
0 14 23 0 0 0 0 0 6 16 4 0 2 0 10 24 17 0 10 5 0 0 0 5 5 17 9 5 15 0 0 0 0 17 0 
14 17 4 6 3 0 0 31 0 11 0 0 25 19 41 27 16 10 16 7 5 0 0 5 0 0 12 10 17 1 23 19 34 0 11 
0 0 20 0 4 0 13 5 9 0 6 12 7 25 14 15 3 2 10 15 0 16 0 5 9 0 31 10 10 15 11 4 5 9 0 
0 10 25 0 30 14 44 28 0 8 30 19 0 0 0 10 11 8 15 9 18 0 15 0 9 17 2 9 14 0 5 1 12 2 0 
14 0 29 9 0 0 9 22 30 0 18 0 9 0 12 9 0 3 0 15 6 0 0 16 7 0 15 0 18 21 17 17 32 2 0 
