35 20
0 0 0 0 0 4 0 0 15 5 0 13 5 0 0 0 0 0 6 19 21 11 9 15 0 5 0 0 11 0 0 0 0 0 13 
20 0 6 8 41 27 16 28 8 13 0 21 5 0 3 11 0 13 18 0 4 0 3 3 0 5 0 0 4 10 3 0 26 10 0 
0 32 0 0 44 0 0 19 7 8 0 0 0 0 3 0 17 0 15 0 9 17 0 0 10 7 19 14 0 0 0 0 28 39 0 
0 0 32 5 1 0 41 9 3 5 2 15 0 13 8 0 5 9 55 0 8 0 0 3 13 0 11 9 8 15 22 31 13 0 0 
0 16 29 6 3 4 2 0 12 6 0 2 0 0 0 0 0 4 0 0 22 11 0 0 0 4 0 0 0 4 28 4 4 15 2 
0 40 4 0 6 0 0 0 0 8 14 2 0 0 9 19 0 7 0 0 0 0 13 0 7 11 0 0 6 0 15 0 2 32 0 
0 17 9 0 3 0 3 21 0 24 0 13 9 12 0 0 6 0 12 0 13 9 5 6 0 0 0 0 9 0 0 2 1 2 11 
18 20 0 0 0 4 33 0 10 24 0 2 9 0 0 0 0 8 18 2 3 1 13 4 0 9 0 0 5 28 24 3 10 12 33 
0 2 11 13 9 2 0 0 2 9 0 0 19 8 3 2 0 21 16 16 0 0 4 4 6 16 1 13 0 0 0 21 28 0 17 
18 0 0 11 0 0 0 0 7 5 4 0 9 0 5 0 0 0 10 0 0 0 40 0 9 6 0 0 0 15 0 12 0 0 5 
0 17 66 0 0 5 23 9 17 0 28 3 11 12 2 29 19 0 0 30 8 0 4 6 22 0 0 0 5 27 29 12 6 8 0 
0 0 49 18 1 28 0 0 0 0 27 0 8 9 18 8 0 10 3 8 40 6 9 0 0 6 0 6 11 0 20 0 2 7 31 
0 0 0 3 18 1 0 12 2 11 23 4 0 0 7 0 7 0 0 0 4 1 30 10 16 1 9 0 24 0 12 21 22 9 0 
4 8 39 0 10 0 0 3 13 7 29 0 0 3 0 0 0 0 0 0 0 13 0 0 0 7 1 4 0 0 12 6 2 23 32 
11 9 2 0 15 17 39 12 11 0 9 2 0 10 13 0 0 0 0 3 4 15 17 0 6 0 0 0 0 16 24 0 0 0 0 
0 7 0 0 0 12 3 0 22 3 0 0 0 0 4 0 0 13 4 0 5 0 12 0 0 8 9 0 5 0 3 0 0 0 12 
28 10 14 3 0 5 13 19 8 0 4 7 0 40 0 0 0 8 11 6 16 19 0 0 2 7 3 11 0 18 0 20 2 33 0 
0 2 14 26 9 0 0 18 7 0 6 0 0 0 0 7 0 0 0 0 0 0 6 17 0 18 0 24 1 0 2 14 7 0 11 
13 18 12 5 35 6 18 6 12 39 22 3 7 33 33 16 2 17 28 13 16 14 0 19 48 11 0 0 17 16 2 5 40 19 33 
0 13 0 26 0 8 16 18 0 1 6 14 20 8 2 12 2 0 8 19 0 10 19 0 0 0 6 0 12 10 1 7 27 2 0 
