35 20
67 23 26 0 27 0 0 11 2 0 12 0 0 13 4 0 0 13 27 9 0 4 12 0 19 37 0 0 11 2 6 13 18 0 4 
32 0 13 0 12 6 0 0 0 0 0 1 21 16 1 3 12 0 15 0 10 0 4 0 0 0 24 0 0 0 0 16 52 6 0 
26 13 6 12 24 19 21 4 38 22 0 0 1 6 6 31 0 16 29 1 26 13 2 0 19 16 3 24 3 2 12 14 23 8 1 
0 2 30 15 3 28 0 0 20 41 22 21 0 0 18 10 7 12 0 5 1 4 14 5 3 0 0 18 13 13 0 1 17 12 0 
0 5 0 2 0 0 19 0 0 0 0 0 23 18 2 0 11 0 0 12 5 0 0 0 10 12 0 11 3 0 2 5 1 0 18 
18 11 0 5 0 34 0 7 0 0 0 2 0 2 5 0 0 0 0 11 0 11 0 23 0 20 9 8 12 0 0 0 11 0 6 
6 29 0 26 9 0 6 6 0 0 0 0 0 1 0 19 0 0 6 0 9 0 0 10 3 0 25 11 0 25 2 16 0 0 0 
20 16 65 28 5 5 3 6 8 15 0 14 5 3 11 6 2 17 0 10 11 3 1 11 4 1 0 8 12 30 0 21 18 37 7 
10 0 7 0 0 23 1 3 11 0 5 21 7 16 4 0 0 19 6 18 8 0 6 0 0 1 0 9 10 0 0 0 28 0 0 
0 3 0 0 0 0 8 2 6 0 10 0 15 0 6 16 0 0 0 0 8 0 0 0 4 2 10 15 23 10 0 0 0 0 0 
15 0 0 42 0 0 9 15 0 0 6 0 0 13 0 0 0 5 4 11 0 0 11 1 5 8 1 1 0 0 17 29 5 0 0 
0 29 6 11 2 2 0 1 0 5 0 7 18 11 15 0 4 3 10 9 5 13 22 0 4 10 21 5 12 0 29 4 19 0 11 
2 5 39 4 0 20 17 0 10 21 0 3 0 20 2 4 0 3 14 0 0 0 8 15 3 25 0 7 0 0 0 22 31 21 7 
0 23 0 6 4 17 0 0 12 5 0 0 13 5 0 12 0 0 11 0 0 1 0 0 12 13 0 2 0 0 0 3 0 0 3 
3 2 6 10 4 2 0 7 0 0 0 11 0 36 2 3 0 0 8 6 5 1 15 0 0 5 9 0 0 0 0 0 0 0 0 
0 8 0 24 0 2 4 2 8 13 0 0 0 8 0 13 0 19 0 0 3 4 0 0 0 5 0 32 14 0 26 4 0 0 0 
0 8 2 22 0 25 7 0 4 6 42 11 14 0 0 19 0 0 0 9 8 0 0 4 19 14 14 6 7 0 35 0 0 0 0 
0 35 0 5 0 0 0 6 5 0 0 17 0 16 13 3 0 0 5 10 0 0 0 5 3 0 8 30 39 2 15 10 0 0 33 
23 0 13 2 0 10 0 0 0 0 0 7 0 0 8 13 0 2 0 0 0 0 1 2 7 14 0 0 13 0 0 0 0 33 10 
0 1 0 9 0 31 22 2 7 22 11 2 0 23 1 0 0 0 7 0 0 11 7 3 0 3 5 5 10 12 0 34 0 43 29 
