35 20
0 16 0 38 9 45 15 0 20 15 0 0 27 0 0 3 15 0 0 0 0 18 4 2 16 4 27 9 10 0 0 35 0 12 5 
7 17 8 0 5 15 20 0 25 0 27 0 0 15 0 0 16 18 21 10 15 0 0 0 9 11 20 0 15 19 0 11 16 16 0 
0 0 7 29 0 0 14 5 0 7 27 0 0 0 9 0 0 0 4 5 0 0 1 18 0 0 0 24 6 6 20 14 3 16 0 
0 0 14 44 0 0 3 10 4 0 24 17 19 0 0 2 32 2 24 0 0 0 0 1 4 0 23 3 15 0 0 55 16 0 24 
0 0 12 2 7 17 0 35 1 0 6 0 0 6 0 17 14 0 11 6 0 7 7 0 17 0 0 20 9 0 14 14 0 28 15 
0 0 0 0 0 0 52 0 2 17 6 0 1 18 13 18 0 0 12 0 0 1 0 11 0 0 0 21 0 20 0 1 16 18 39 
0 0 23 26 21 0 22 0 0 0 10 8 0 0 22 1 5 0 3 12 0 0 15 9 0 2 4 13 0 28 0 11 5 0 0 
0 10 10 0 0 16 24 7 0 0 2 1 0 0 5 1 11 0 5 0 0 0 0 0 5 20 11 12 27 0 5 7 0 0 16 
0 22 0 0 0 0 11 25 0 8 0 7 15 6 13 0 0 0 14 8 1 0 0 6 0 18 0 1 2 9 0 7 11 3 16 
26 0 0 31 0 0 0 0 15 0 0 0 9 0 18 0 0 9 0 0 8 0 5 0 10 3 18 8 11 0 0 0 1 0 65 
9 0 0 9 9 0 1 8 8 19 4 9 9 0 0 0 5 6 2 0 0 0 0 0 10 0 0 6 12 13 0 23 1 8 18 
0 0 0 23 0 0 16 0 0 0 3 45 7 8 0 16 5 0 6 1 0 1 16 0 1 0 29 8 0 6 19 16 10 0 0 
32 33 0 0 8 0 0 0 0 0 0 0 0 0 13 0 16 0 14 0 4 8 0 3 2 11 10 0 4 0 0 15 4 12 13 
7 30 4 0 29 0 2 27 5 0 12 20 0 21 14 6 0 0 0 8 20 9 0 11 20 0 5 41 5 0 29 26 0 5 8 
0 0 0 0 0 0 0 0 0 0 0 0 0 0 0 0 0 4 0 0 9 0 0 6 0 0 0 11 0 9 0 0 0 6 0 
0 18 0 4 3 26 11 21 23 0 3 3 3 3 2 0 34 13 27 2 14 0 18 2 3 4 0 0 0 1 1 56 28 41 45 
15 29 36 11 0 0 9 18 16 0 8 0 0 1 4 17 6 7 9 16 19 0 0 17 40 17 16 13 15 26 0 2 42 0 3 
0 4 20 0 0 0 0 0 22 35 13 7 3 0 0 1 14 2 0 0 0 0 2 0 10 1 0 0 0 14 22 0 0 0 0 
0 15 17 28 5 0 2 3 28 0 7 8 32 21 20 11 24 11 0 12 4 7 1 7 3 0 9 10 15 0 0 22 0 34 13 
27 0 16 49 44 19 17 0 0 0 10 0 2 6 7 3 0 3 31 6 18 2 1 6 0 0 0 7 24 0 12 2 0 30 10 
