35 20
33 65 24 0 0 2 1 29 5 2 29 22 5 16 11 35 9 10 0 10 19 0 4 18 0 3 42 0 11 10 17 20 24 24 33 
0 6 16 60 0 2 3 33 6 0 0 0 0 12 0 13 2 5 19 0 0 8 14 15 21 23 20 0 0 65 11 0 0 0 21 
14 0 0 6 0 0 0 0 0 6 10 0 0 0 16 3 3 8 1 8 7 0 0 6 0 0 2 9 3 9 11 4 40 0 2 
5 11 0 0 0 0 0 26 34 0 2 8 10 0 0 0 18 1 0 13 14 9 10 3 19 22 1 20 0 9 2 1 48 5 18 
0 21 0 0 0 0 16 27 14 3 0 10 18 16 4 0 11 0 20 0 0 14 5 0 0 0 0 0 0 3 17 0 0 3 0 
6 18 2 26 22 13 0 61 40 8 0 2 13 0 3 0 4 0 35 19 9 10 12 12 16 18 0 9 1 16 23 23 11 0 14 
5 0 13 1 5 3 0 0 22 2 0 2 0 0 12 6 7 0 1 17 3 9 0 1 0 1 9 3 0 0 0 0 28 0 0 
0 14 2 0 0 0 0 0 0 1 0 0 0 0 10 0 7 0 5 0 13 13 0 0 7 0 0 0 0 0 0 7 0 17 15 
27 0 13 14 0 0 0 4 16 1 24 18 0 11 1 8 0 1 0 0 26 0 5 23 0 0 18 0 0 25 0 0 0 30 35 
0 6 0 31 0 0 0 23 4 4 16 0 20 6 6 11 0 3 0 4 9 0 5 6 5 10 15 6 0 3 0 0 11 0 7 
6 27 28 0 0 25 1 0 13 12 0 0 0 4 0 15 20 0 11 3 0 5 3 0 3 0 0 2 27 14 43 8 0 0 0 
2 0 0 0 0 10 0 2 7 1 2 0 20 1 12 1 4 5 0 0 4 0 0 3 3 0 21 30 5 2 8 0 0 5 0 
1 0 0 5 0 0 0 14 9 0 0 7 11 6 0 7 11 3 0 0 9 0 3 15 9 3 0 3 0 9 7 0 1 0 4 
0 13 0 0 8 0 0 13 11 6 7 20 4 0 13 0 13 0 9 11 13 0 0 12 0 0 7 1 14 5 0 20 12 0 0 
18 19 4 4 0 0 5 24 18 8 0 0 0 0 0 19 0 2 21 1 0 0 0 0 3 13 1 0 0 20 5 0 9 0 14 
7 3 0 0 0 0 0 15 8 0 0 12 0 0 0 0 8 4 1 0 0 5 0 0 0 0 0 0 0 0 0 0 0 2 0 
4 10 0 18 0 0 0 0 0 1 4 0 4 0 0 0 2 17 2 13 0 27 4 31 14 13 0 0 0 0 0 0 0 16 7 
51 0 38 14 0 0 15 13 7 0 17 4 1 2 0 28 12 11 9 14 13 12 10 23 22 0 8 0 16 0 0 0 0 1 0 
29 3 4 23 6 0 0 0 0 8 1 0 27 0 16 18 0 11 0 0 5 11 11 9 0 9 18 0 10 35 17 0 44 11 2 
54 0 13 17 2 0 7 14 0 6 0 17 12 9 9 0 13 6 10 11 21 0 2 16 2 7 0 2 0 2 7 0 32 13 1 
