35 20
15 0 0 25 9 0 0 27 2 0 9 0 0 18 4 15 0 9 13 6 5 11 13 0 0 0 0 14 25 0 0 13 0 5 16 
0 0 29 0 42 16 13 7 0 0 0 15 10 0 12 1 0 10 0 5 0 16 6 0 0 3 10 0 20 9 4 17 0 16 0 
0 0 0 0 2 0 2 16 0 0 0 0 0 5 21 3 0 0 17 18 18 0 10 10 21 0 7 0 0 11 0 0 0 0 16 
2 0 34 0 3 0 13 3 16 0 8 0 20 19 4 0 10 7 0 13 1 0 8 0 9 0 16 25 0 0 8 0 5 0 0 
20 0 20 22 1 0 0 0 0 0 0 8 0 7 0 0 3 37 0 7 20 0 1 0 23 0 0 0 0 18 0 0 0 16 10 
2 0 18 0 6 4 19 3 0 0 6 0 18 0 11 0 6 0 1 1 14 0 0 0 0 11 13 9 7 0 0 0 2 5 0 
13 8 0 0 0 0 0 9 0 21 0 0 0 32 11 3 4 0 10 19 0 2 0 0 11 7 19 13 4 4 0 7 10 0 0 
12 18 0 3 3 18 0 9 17 7 0 0 21 30 29 0 0 0 3 18 5 0 8 18 0 17 2 0 6 0 25 0 2 18 20 
0 0 16 0 7 0 28 1 0 0 0 0 3 20 0 0 0 3 0 2 3 0 0 11 0 7 0 9 9 0 11 18 13 0 28 
2 4 6 3 0 4 0 0 2 2 3 0 0 0 0 0 7 2 0 8 4 0 14 5 23 0 7 2 3 0 0 0 0 0 0 
3 23 3 0 9 15 4 26 0 4 0 0 0 0 0 15 2 0 1 6 17 16 0 0 23 0 6 19 0 20 10 0 1 39 0 
2 0 0 0 0 0 16 34 14 3 15 0 4 10 7 1 0 8 6 13 7 0 12 0 0 34 9 10 0 0 0 0 38 26 7 
34 0 6 22 2 5 0 8 0 3 41 0 19 10 4 3 14 0 2 9 2 17 4 10 11 0 0 13 21 0 0 3 11 0 9 
29 4 6 5 18 3 19 8 14 9 3 0 0 3 6 27 5 11 5 6 3 15 8 5 0 3 6 0 3 0 0 31 10 3 25 
0 0 0 31 4 0 13 13 4 0 6 40 0 16 2 16 8 0 1 12 13 0 1 4 13 3 14 0 0 16 0 16 7 0 24 
0 0 14 0 7 26 0 0 0 0 27 0 0 5 2 0 0 2 20 1 2 2 2 0 2 7 23 0 0 0 0 26 14 0 3 
0 6 0 4 28 17 0 13 0 15 2 27 0 10 11 0 22 16 0 6 3 0 17 10 14 0 0 4 0 13 3 0 20 14 13 
21 19 27 0 0 1 28 0 0 0 0 0 0 19 1 0 0 0 16 11 0 27 5 0 0 0 7 8 3 15 0 15 19 0 22 
31 2 59 12 20 16 5 0 17 0 32 10 1 16 30 12 4 13 1 18 0 0 15 0 33 7 50 3 4 5 0 30 19 0 0 
0 2 31 0 18 2 2 15 2 13 13 0 14 13 17 0 0 8 0 6 1 0 0 24 15 10 14 15 0 28 11 0 0 31 17 
