35 20
8 9 0 6 11 0 0 1 0 16 0 39 0 18 10 26 9 0 0 6 20 12 0 0 10 13 0 24 17 0 0 0 0 25 0 
26 33 3 0 40 2 0 0 40 9 14 44 9 0 3 0 15 2 32 15 1 12 13 0 2 0 68 35 8 7 22 2 12 5 20 
0 0 40 0 0 10 19 8 5 0 13 4 0 13 0 44 15 0 0 29 0 0 17 4 9 18 0 36 0 14 0 15 1 2 21 
22 15 0 27 27 17 0 1 10 23 5 0 0 0 0 10 0 0 2 8 0 0 37 0 0 0 17 8 12 8 4 27 9 3 15 
0 29 31 0 0 0 0 14 4 8 14 0 0 0 13 0 3 10 0 0 0 6 0 2 0 0 0 11 4 0 0 4 0 11 1 
0 0 12 4 0 0 0 7 3 2 0 0 0 0 12 0 8 0 11 3 7 0 4 2 0 14 0 0 1 3 0 0 0 5 0 
0 31 41 25 45 16 4 9 0 0 0 0 18 0 0 0 0 8 12 15 5 16 10 8 5 12 23 8 0 0 0 0 61 0 30 
0 0 0 0 0 0 2 21 0 20 0 0 0 0 0 0 9 0 9 0 0 15 0 0 5 9 0 3 21 27 4 3 0 0 0 
7 0 28 11 0 0 17 0 17 12 6 19 9 0 0 5 5 7 7 13 0 14 3 23 16 0 0 4 0 4 47 10 0 0 15 
6 15 3 9 15 10 12 9 1 0 41 15 7 0 0 9 0 0 5 21 0 0 5 6 8 21 0 4 28 0 0 1 0 5 21 
5 32 36 0 26 42 0 13 4 7 3 0 0 3 9 1 0 2 0 0 11 16 5 11 5 4 0 31 3 0 0 28 5 6 41 
0 5 2 4 1 1 0 0 3 8 0 0 0 0 0 0 0 10 0 0 0 0 0 2 0 2 0 3 2 6 2 0 0 21 0 
32 8 3 0 2 2 31 26 11 0 2 5 0 0 6 2 16 8 18 2 13 12 1 6 0 8 0 0 6 3 0 10 22 1 36 
6 0 24 0 13 0 9 13 1 0 0 12 22 9 0 11 4 13 0 4 0 0 11 7 7 19 24 2 22 5 0 7 0 0 33 
12 2 0 9 5 0 0 0 9 0 4 8 14 0 2 17 15 16 0 10 0 2 16 0 0 13 0 45 0 10 0 11 2 5 0 
21 0 0 10 31 0 3 37 0 6 24 0 0 0 0 34 15 0 14 9 12 15 6 0 0 11 36 3 13 4 8 4 30 4 7 
32 13 0 8 2 18 16 14 0 0 21 6 0 0 0 1 0 11 17 18 0 5 12 18 7 0 0 17 0 29 0 7 2 22 23 
0 0 15 0 16 8 0 19 0 0 6 0 17 0 0 7 2 0 0 14 8 1 3 0 8 12 19 16 0 8 0 0 0 5 0 
0 15 14 0 2 0 6 3 0 13 3 0 0 12 0 0 0 0 15 16 0 3 13 13 0 0 0 16 0 0 0 8 0 17 15 
27 0 23 0 9 0 0 7 0 0 0 18 18 0 7 0 0 0 0 0 0 14 11 0 24 24 0 0 3 0 18 10 0 0 0 
