35 20
0 21 11 35 5 0 22 6 46 11 0 14 0 0 0 12 22 0 0 3 0 38 6 0 0 8 0 0 63 4 22 10 28 15 0 
35 39 0 19 0 0 0 0 0 0 9 3 7 0 14 0 5 0 0 0 12 22 11 0 10 0 26 14 0 1 9 13 0 5 0 
0 0 5 8 2 4 0 0 18 36 8 22 7 10 5 4 0 13 0 26 0 22 0 0 3 13 12 17 0 6 2 0 0 1 13 
16 4 0 1 0 8 6 0 0 1 4 2 0 10 0 0 3 0 0 10 0 0 9 10 12 0 0 0 3 30 0 0 16 9 0 
0 3 1 38 35 12 17 4 11 22 21 2 5 6 10 16 0 17 10 25 13 9 0 22 9 0 32 18 5 1 11 32 29 27 0 
9 21 10 0 22 0 0 0 0 12 0 0 10 12 0 11 9 0 10 19 0 0 10 2 0 0 22 12 10 0 13 0 1 0 0 
0 6 5 0 13 3 32 0 3 0 18 8 0 0 18 7 0 0 0 5 14 0 3 24 7 0 22 19 21 0 0 0 26 5 0 
23 11 32 0 14 0 2 24 2 5 1 10 9 3 0 0 0 0 14 0 0 5 0 25 5 4 15 0 0 4 0 4 1 3 37 
10 0 0 22 14 0 9 27 0 4 3 15 7 0 3 19 11 3 5 16 0 8 13 4 0 10 15 4 0 6 0 7 22 8 0 
6 0 0 16 1 0 0 19 7 0 0 0 0 0 15 0 5 0 4 5 6 0 3 0 3 0 19 9 0 0 36 0 28 0 28 
3 0 0 0 20 0 0 2 0 19 1 0 0 0 0 5 3 0 0 15 0 0 0 5 0 0 0 0 24 25 8 0 0 0 23 
15 7 22 0 5 0 5 3 1 0 10 22 14 0 11 12 4 0 0 17 2 0 2 10 0 0 20 18 5 8 0 10 0 43 2 
0 22 0 0 1 1 0 0 0 11 0 4 0 0 0 0 0 8 0 0 2 0 6 22 0 0 10 0 19 7 4 9 0 9 4 
23 0 30 15 0 0 3 0 0 0 13 0 11 0 0 5 3 0 3 25 12 0 0 20 2 0 0 8 18 0 12 8 28 14 2 
12 11 0 6 29 23 8 26 3 3 13 10 27 0 10 3 19 0 21 14 2 4 0 13 0 9 1 1 19 0 29 26 0 34 13 
47 7 31 15 4 0 23 0 4 37 0 0 0 9 14 1 14 5 17 0 0 0 24 0 11 12 0 19 27 7 0 0 2 35 1 
24 1 73 0 0 17 3 15 0 0 21 22 0 0 5 24 0 0 2 0 1 2 32 26 15 0 0 1 1 19 0 8 30 34 1 
0 18 1 1 26 0 0 0 4 10 11 0 0 9 17 0 28 0 8 0 12 17 0 1 10 0 14 8 14 0 3 0 2 19 0 
0 33 0 0 0 0 0 6 0 15 15 8 0 6 0 0 7 0 0 8 1 21 0 2 10 13 0 0 0 5 4 0 0 1 34 
0 0 2 17 15 17 0 27 0 22 0 17 0 6 17 0 2 0 16 21 17 19 29 0 18 9 5 25 7 6 8 29 4 15 11 
