35 20
0 7 0 0 23 0 8 31 0 0 12 0 3 21 0 1 0 0 12 0 10 0 0 0 3 0 10 38 0 13 4 0 0 0 17 
0 0 27 8 1 0 0 17 0 9 10 7 17 2 10 1 0 17 20 0 1 0 8 0 6 15 17 16 0 10 4 38 0 7 17 
27 26 0 5 15 0 17 15 37 3 0 0 0 0 0 0 0 5 1 15 1 0 9 10 13 0 3 32 8 5 7 0 8 0 0 
8 0 17 0 0 26 0 23 13 11 12 0 5 2 0 0 0 0 0 0 0 13 43 11 1 6 0 0 0 0 6 31 44 24 2 
0 9 1 21 0 0 28 4 0 0 0 0 0 16 0 0 3 3 1 1 9 13 5 5 24 0 0 8 0 7 0 0 0 0 28 
18 5 3 0 6 14 0 44 29 3 0 5 5 0 13 14 14 0 18 0 0 14 15 0 0 15 1 30 21 10 27 0 6 0 26 
0 24 25 0 27 2 0 9 0 0 11 0 0 11 12 0 14 0 8 10 6 19 3 3 0 3 18 0 0 3 0 0 1 0 0 
34 24 16 0 3 6 0 0 0 22 1 1 6 0 3 6 2 9 22 0 13 5 5 11 3 8 11 3 0 8 11 1 0 0 34 
9 8 3 24 4 10 60 30 11 0 0 1 0 0 18 9 10 12 12 4 19 5 0 2 25 9 5 6 0 5 0 8 44 6 27 
34 0 0 3 0 8 0 0 25 67 38 0 0 8 0 0 0 11 26 12 11 3 10 6 0 10 16 0 11 24 0 20 13 4 9 
0 6 1 74 12 4 1 6 1 15 14 9 3 4 30 0 10 1 15 57 39 2 9 4 22 26 3 22 17 34 13 9 8 0 10 
11 18 7 19 16 0 1 16 23 0 10 8 0 0 10 11 0 0 0 42 12 0 18 1 0 0 11 0 0 0 0 0 6 1 27 
1 1 4 1 33 6 5 11 10 23 5 13 0 11 3 19 0 0 7 2 13 0 8 5 6 5 0 8 0 5 15 27 23 0 0 
0 0 0 0 6 15 10 0 26 0 0 0 0 8 0 0 12 0 7 0 8 1 8 0 3 1 0 34 0 17 3 3 0 0 26 
1 2 0 13 0 7 0 0 0 23 6 8 11 0 3 5 1 0 0 0 0 23 0 0 0 24 0 9 0 0 0 0 0 0 25 
30 15 0 0 0 31 0 14 0 0 0 0 5 0 6 0 0 0 0 8 6 0 3 0 5 1 0 0 23 11 32 12 3 6 0 
0 40 9 0 0 28 0 0 11 10 13 8 15 1 8 8 0 0 15 4 0 0 3 6 23 9 0 4 17 1 0 15 22 4 15 
16 0 0 0 0 0 5 1 2 0 8 21 20 0 0 0 0 0 0 7 7 13 0 21 0 0 7 9 0 1 1 0 55 0 0 
0 0 14 4 0 0 0 16 17 0 4 0 9 0 7 0 5 7 0 6 6 6 15 11 2 6 21 6 0 0 22 2 12 0 0 
0 0 8 13 0 3 26 19 2 0 0 0 17 0 0 1 34 5 0 20 0 0 9 3 12 18 31 0 0 0 0 0 39 14 0 
