35 20
22 0 16 8 4 8 19 0 0 0 15 6 0 15 67 16 14 0 12 8 0 0 7 10 0 42 5 0 0 16 0 24 11 11 20 
12 25 0 1 8 15 3 27 14 0 0 12 9 0 11 0 0 0 0 1 0 18 0 10 4 3 12 0 13 30 0 1 0 9 7 
35 0 0 8 10 0 6 17 1 0 0 8 0 0 18 0 0 0 0 2 14 3 5 0 28 9 0 0 28 1 0 1 37 0 0 
58 14 7 0 4 9 0 0 4 0 7 8 13 2 22 0 0 15 0 8 0 8 0 10 23 18 0 0 28 9 0 0 8 13 20 
46 6 0 0 4 0 3 0 4 9 2 7 13 20 11 0 0 0 4 0 0 0 0 8 0 16 26 0 3 0 0 4 0 20 0 
31 22 25 11 0 19 15 0 19 14 3 18 0 18 15 10 10 0 13 13 3 15 0 17 8 0 15 29 0 0 22 31 5 17 31 
0 0 0 0 0 18 12 2 0 0 9 19 0 14 9 13 0 0 0 6 12 0 0 9 0 0 0 12 0 13 19 6 0 0 0 
21 3 0 5 59 6 25 0 0 12 12 0 2 13 3 5 0 0 0 6 0 3 0 5 0 0 0 0 0 7 26 19 0 0 66 
21 30 12 5 15 5 6 2 0 2 19 0 19 17 18 0 24 0 15 29 0 0 10 0 9 11 22 0 7 1 17 15 0 9 7 
23 8 8 9 22 0 0 0 0 8 23 2 2 10 8 8 0 6 0 15 0 8 8 37 0 16 1 0 0 0 0 0 0 1 0 
1 6 30 2 0 0 13 5 48 21 4 5 0 3 1 18 0 5 0 13 0 3 5 0 0 17 0 0 0 0 21 23 0 49 0 
2 53 12 20 0 28 0 2 1 0 0 31 21 5 0 13 10 0 6 0 12 9 0 15 0 2 15 0 3 18 39 0 11 59 0 
8 10 0 0 0 0 39 23 0 22 15 11 0 21 0 5 9 0 0 0 0 0 0 25 0 9 0 0 22 9 23 2 0 1 21 
12 1 12 0 0 0 0 13 1 9 5 0 0 23 12 0 13 3 1 11 2 0 0 0 14 7 0 0 5 39 0 6 10 1 8 
24 0 20 0 13 0 1 31 1 0 0 0 5 6 1 6 10 4 16 0 18 6 18 7 18 1 13 0 10 20 0 1 1 0 27 
54 0 10 36 0 0 14 0 14 0 0 3 10 15 1 0 1 6 0 0 12 0 15 23 4 5 3 10 2 0 0 6 0 0 0 
17 0 0 0 20 29 1 0 0 0 0 0 20 10 7 0 21 0 0 7 0 17 0 16 8 0 22 0 15 45 9 0 0 13 0 
0 1 42 18 13 8 24 4 0 0 6 3 12 0 4 0 12 0 13 11 18 5 10 19 0 7 0 22 0 0 0 2 0 5 32 
13 2 21 2 3 0 15 4 18 33 0 14 14 14 20 0 3 16 11 0 12 0 10 21 2 14 20 30 0 11 18 0 13 40 0 
10 4 8 0 1 4 36 36 0 11 3 0 2 6 14 13 2 4 0 4 13 14 16 0 21 19 27 23 0 40 23 24 0 0 5 
