35 20
0 1 1 0 0 0 19 0 0 10 0 18 0 32 0 0 0 0 3 4 1 3 0 0 24 0 0 0 9 18 2 0 21 0 25 
0 5 8 25 0 0 3 0 0 3 11 1 14 0 4 0 14 0 0 0 5 5 0 9 0 2 5 0 25 0 0 3 23 0 3 
0 12 0 5 0 0 0 0 0 0 14 0 0 8 4 6 11 16 0 0 10 0 2 0 0 0 0 0 0 7 0 0 0 0 0 
28 3 0 0 15 0 2 0 16 0 2 0 0 14 0 0 0 0 0 17 11 0 0 6 0 13 0 0 0 4 11 0 8 20 0 
0 44 24 4 0 0 9 1 19 23 0 0 4 0 8 7 5 6 0 17 13 0 10 42 4 0 1 15 0 13 56 0 53 10 15 
34 38 32 0 4 26 4 12 11 20 5 0 0 11 35 28 0 16 0 18 3 0 5 0 0 0 0 12 3 13 30 2 25 0 52 
39 2 2 5 4 5 0 4 0 11 40 3 7 21 16 13 7 2 15 0 9 11 0 7 0 22 14 2 30 0 30 0 20 23 21 
0 0 3 7 0 4 3 0 0 0 0 19 0 1 0 2 0 0 0 2 1 0 17 0 0 0 7 0 23 0 10 0 0 7 0 
3 18 7 3 30 27 27 0 0 4 5 0 0 0 1 18 7 10 2 0 16 5 6 2 0 0 2 5 3 0 0 0 33 27 17 
52 14 25 0 0 1 1 13 0 7 0 19 0 4 3 5 32 9 15 4 13 3 0 1 9 0 5 5 13 0 14 0 5 0 26 
17 1 4 0 0 12 6 19 0 28 3 0 8 0 15 3 14 10 10 8 18 1 6 3 12 0 10 6 19 19 6 0 0 0 2 
0 5 6 0 0 20 3 1 2 0 16 0 5 0 9 19 0 0 0 8 0 0 10 7 14 0 0 15 0 7 3 0 2 0 25 
0 9 0 0 0 0 16 6 23 0 9 0 0 12 7 0 3 2 16 14 9 0 16 4 4 1 2 9 0 15 16 23 15 0 1 
47 4 26 0 4 0 0 0 2 0 1 0 0 11 9 9 18 0 0 8 0 7 0 7 0 0 0 0 35 5 1 0 0 0 0 
0 31 0 0 10 0 3 16 0 6 0 0 0 14 10 20 0 0 0 3 13 2 6 21 0 0 0 12 6 1 13 1 0 0 0 
37 14 3 1 0 0 28 9 0 5 0 11 0 8 6 0 14 13 16 16 2 14 5 5 0 0 35 1 0 0 42 11 10 0 13 
0 32 0 0 9 54 27 26 0 2 10 0 0 7 8 1 0 3 1 5 2 4 6 12 2 28 0 0 0 0 7 0 1 1 29 
0 15 23 0 17 0 24 21 0 2 11 17 7 0 7 3 13 16 19 5 8 6 0 0 0 1 3 35 13 20 4 3 15 0 0 
16 4 17 0 54 0 0 0 0 2 4 1 0 0 17 0 16 15 0 7 16 0 0 0 6 6 0 25 12 26 1 0 13 0 0 
0 30 12 0 0 0 8 0 22 11 9 0 0 0 35 1 0 5 30 17 4 0 0 5 0 7 1 24 2 24 9 1 14 0 15 
