35 20
7 0 0 11 5 8 14 0 16 19 0 10 0 10 0 0 5 0 0 6 14 13 0 0 15 0 0 0 23 2 0 11 11 0 0 
0 0 26 28 0 0 0 0 0 17 23 0 11 18 7 0 12 0 6 0 4 0 1 6 1 0 17 0 28 19 7 33 13 23 0 
0 0 0 31 12 0 0 0 1 7 0 11 0 16 0 0 8 0 0 0 4 0 11 0 0 0 12 0 0 6 0 0 28 0 36 
0 0 55 10 4 15 0 2 17 16 4 0 0 31 0 0 0 0 0 0 11 19 0 10 7 0 1 24 25 32 1 12 22 5 0 
0 0 5 0 42 16 7 20 2 0 10 0 0 21 0 16 16 0 0 14 7 26 0 11 19 12 0 27 0 25 9 16 13 0 0 
11 0 8 1 11 0 0 0 0 0 9 0 9 13 0 0 0 4 0 26 16 7 0 6 22 0 0 2 5 0 0 7 8 0 3 
11 4 0 30 33 4 27 2 0 61 4 13 0 6 8 9 3 6 11 11 9 10 19 0 7 6 33 18 0 1 15 36 0 9 0 
25 25 30 0 0 11 3 0 0 32 0 0 17 5 2 1 2 0 6 2 0 0 13 0 11 0 14 0 0 17 0 7 31 13 39 
0 0 31 0 11 8 18 9 0 12 12 0 5 8 3 16 15 14 4 0 1 7 14 0 5 10 0 15 16 5 0 15 0 36 13 
11 27 20 0 15 21 13 0 0 17 0 1 0 0 0 14 14 0 14 2 0 11 3 0 0 0 21 6 10 8 2 4 23 0 0 
1 22 2 0 10 14 0 22 0 8 0 0 7 14 0 0 0 6 11 0 2 3 10 19 0 0 21 12 10 22 26 4 9 0 0 
0 17 0 26 0 0 1 8 26 3 0 0 33 9 8 6 10 1 10 16 5 0 7 11 16 0 2 12 0 2 0 2 0 0 22 
0 61 9 27 9 12 10 0 0 11 3 16 19 9 2 0 1 3 0 3 6 2 1 18 3 6 0 16 4 45 0 9 0 0 33 
0 0 27 7 7 0 0 0 7 23 7 0 1 0 16 12 0 0 14 0 6 4 0 7 13 2 0 0 17 22 0 10 8 0 0 
0 3 4 30 0 11 6 0 4 0 0 0 1 4 0 10 0 0 0 8 3 5 8 0 0 2 3 0 25 7 7 13 12 14 0 
34 18 4 24 44 38 20 0 0 16 2 0 21 11 8 0 15 0 12 3 3 17 12 0 0 16 0 20 0 0 1 65 17 0 101 
29 0 18 26 21 9 0 1 4 7 8 2 12 1 3 0 3 0 2 11 5 0 0 0 8 21 0 15 0 3 0 0 8 0 15 
0 0 0 6 0 0 0 49 0 16 0 2 0 0 0 0 0 5 0 6 0 29 3 13 0 2 0 0 11 0 2 2 25 0 0 
0 0 21 2 29 16 5 0 10 26 0 5 9 0 0 10 6 0 10 1 7 9 2 7 13 7 17 2 1 7 0 22 2 17 0 
24 19 4 19 0 0 0 3 4 19 4 16 3 11 2 10 1 0 0 9 36 0 0 0 27 2 8 17 11 0 0 16 0 12 31 
