37 21
9 0 16 18 22 39 6 6 3 0 0 5 0 0 1 20 0 2 0 3 12 11 7 70 7 0 0 0 11 16 23 0 19 10 0 0 13 
0 18 82 6 11 19 0 22 24 15 33 49 0 30 6 4 15 28 8 0 11 19 11 0 19 14 12 9 24 1 10 46 26 3 3 22 0 
0 11 23 0 0 49 0 4 0 2 0 0 0 0 0 13 0 0 0 13 0 0 1 4 0 0 0 0 0 0 25 0 0 10 18 0 1 
0 0 13 0 0 0 0 0 0 38 0 0 0 0 0 3 1 3 0 0 0 12 1 14 0 10 3 0 0 0 0 6 0 8 3 0 26 
0 11 0 0 0 4 0 1 0 2 2 0 1 23 8 12 0 0 0 2 0 0 0 5 0 0 16 17 16 0 8 13 5 0 0 22 0 
21 1 9 0 13 0 9 1 0 0 0 1 9 1 10 12 0 19 0 14 4 8 0 6 6 7 0 0 1 0 13 0 1 5 13 0 9 
31 0 0 12 27 0 0 4 0 13 0 0 0 11 21 6 0 0 2 6 2 0 0 12 0 0 5 0 0 0 16 4 0 18 0 10 0 
3 2 13 25 27 0 0 0 0 0 19 0 5 0 11 0 0 2 0 4 0 0 8 3 0 0 4 0 3 0 4 33 0 4 2 0 6 
0 1 0 4 0 3 3 0 0 7 6 0 0 0 22 0 0 10 0 14 0 0 0 6 2 0 8 7 1 0 0 0 0 0 11 2 17 
9 58 7 9 25 0 14 24 0 11 0 0 3 0 0 0 7 1 8 0 28 8 0 7 0 0 0 26 5 29 29 30 0 4 1 1 0 
0 0 31 17 31 0 16 6 0 17 7 0 24 1 6 9 0 1 0 7 0 18 8 14 0 5 5 24 0 0 3 0 0 43 5 30 0 
23 0 10 0 4 3 0 22 0 0 0 5 0 0 5 0 0 0 0 17 0 8 0 23 20 0 2 0 0 0 3 4 0 8 0 0 0 
29 18 0 30 28 2 0 8 0 0 6 0 15 2 28 5 0 8 3 4 17 6 0 7 0 0 0 2 10 33 17 0 2 10 15 12 0 
0 11 8 23 0 0 9 12 0 0 8 13 0 0 0 0 1 6 4 0 10 3 4 0 1 0 2 0 11 4 17 5 0 0 0 0 0 
24 0 62 0 0 0 0 0 0 9 20 0 9 2 0 2 19 0 11 0 5 10 0 14 16 0 6 0 3 27 3 13 0 3 1 20 9 
0 34 57 3 0 8 5 0 0 0 0 23 18 0 0 33 0 3 0 2 0 6 7 15 0 0 24 0 11 10 18 16 26 14 7 67 8 
0 15 0 7 0 14 0 0 0 0 7 13 21 0 10 0 10 0 0 8 0 0 5 0 12 0 9 6 0 4 0 0 1 21 0 0 8 
13 23 1 0 5 0 0 0 7 22 0 1 24 12 1 0 9 0 0 0 2 10 2 4 0 3 0 10 1 0 4 32 0 0 15 0 24 
37 6 22 8 13 17 9 0 0 0 4 19 6 19 1 0 0 15 0 0 9 9 1 18 13 0 26 0 1 0 18 26 2 2 14 11 25 
1 1 0 10 17 0 0 0 0 13 23 0 0 9 0 19 0 7 0 14 0 23 0 0 0 0 2 0 13 0 8 0 20 22 17 0 0 
0 1 42 0 14 0 0 20 3 14 19 3 0 0 0 0 0 0 14 0 0 0 0 35 0 4 16 0 1 31 0 0 4 3 0 0 0 
