37 21
10 0 26 3 7 0 4 0 2 17 0 32 49 3 0 2 6 10 14 0 8 6 0 16 6 9 10 4 42 0 13 3 15 0 0 0 25 
1 1 19 11 3 0 17 37 4 0 23 15 0 0 0 18 13 3 0 0 0 19 7 17 14 10 5 0 5 0 4 5 0 59 27 4 24 
0 0 28 0 0 0 31 23 0 0 0 19 21 17 0 0 0 7 0 0 0 15 15 28 7 0 5 0 0 6 3 11 0 21 5 5 13 
4 29 2 26 0 0 0 0 9 24 0 0 0 4 0 2 1 3 2 3 0 1 1 1 7 23 8 0 5 0 53 3 0 31 24 7 0 
0 4 0 1 6 0 16 0 0 0 0 0 18 18 18 15 0 13 12 0 0 0 0 0 0 0 0 0 0 0 14 18 18 0 0 0 0 
0 0 0 0 26 0 0 12 13 5 19 9 0 17 0 27 2 2 19 10 0 14 0 11 6 24 7 0 5 5 16 13 18 15 0 0 0 
0 0 0 3 2 4 18 0 15 15 0 1 3 25 0 21 8 0 21 7 0 0 18 7 21 7 21 0 10 0 2 0 0 25 0 0 2 
0 0 0 0 0 9 0 0 29 0 0 3 0 19 5 0 0 0 0 6 0 0 11 0 0 6 4 6 0 0 21 23 0 0 5 11 0 
0 4 0 17 7 2 6 22 0 0 0 18 0 0 16 0 0 0 0 9 23 13 7 0 10 7 0 1 20 26 0 22 1 0 21 1 0 
0 42 18 1 0 0 7 16 8 16 3 0 1 16 23 7 10 0 0 18 0 4 9 1 15 37 6 13 0 0 3 25 1 20 11 0 0 
70 10 0 0 1 36 0 0 0 0 3 0 0 3 0 21 0 4 0 0 15 0 0 0 26 5 0 0 28 0 1 0 32 0 0 0 21 
5 19 2 0 0 2 26 10 3 0 0 3 5 27 1 0 0 3 0 0 19 0 0 6 7 0 0 0 0 0 24 7 6 0 1 0 23 
1 0 13 32 0 0 9 0 26 0 0 0 0 11 8 0 0 0 0 12 0 18 11 19 0 0 0 1 0 0 15 16 7 11 27 5 0 
0 0 0 22 0 0 0 0 6 2 17 6 0 0 0 0 11 3 0 2 0 0 0 0 0 22 0 31 0 10 16 0 0 3 0 0 0 
0 0 60 11 0 12 8 21 13 14 2 6 2 0 25 7 12 9 0 9 0 0 6 11 0 0 12 0 18 0 9 29 0 0 3 4 0 
24 0 0 0 0 0 0 0 0 7 0 0 0 0 0 0 7 4 0 0 0 0 0 1 38 0 0 0 0 0 11 0 0 1 5 0 0 
18 0 0 23 4 0 9 17 0 0 0 11 0 0 0 7 10 0 0 7 0 6 13 29 7 0 55 0 0 0 0 0 0 44 10 0 10 
5 0 30 27 23 2 42 21 29 6 0 0 14 25 0 10 0 2 0 5 0 12 9 32 0 2 20 8 12 9 0 36 25 39 78 8 29 
12 0 0 1 6 0 6 0 16 28 6 0 16 1 9 0 0 8 9 10 0 13 4 1 0 0 0 27 0 0 5 0 0 24 0 1 1 
16 0 5 0 0 9 21 37 11 5 3 0 0 20 12 0 0 5 0 23 0 0 5 16 0 0 0 23 0 1 0 0 18 26 0 0 0 
5 4 0 0 0 5 19 37 0 0 0 0 20 0 11 3 4 6 0 0 0 0 0 0 0 5 19 20 6 0 12 15 3 0 7 0 0 
