37 21
0 20 0 46 0 19 0 0 1 7 0 0 22 4 16 0 0 0 5 0 0 41 0 20 19 7 0 0 0 42 25 0 0 0 25 0 0 
13 0 5 17 0 21 0 13 21 10 33 25 0 31 0 3 0 0 0 13 13 14 2 0 5 8 21 15 17 5 22 18 22 0 0 22 0 
0 10 20 7 1 8 14 45 17 25 7 10 9 0 4 0 23 7 16 17 14 9 0 0 8 16 0 2 21 0 8 56 0 0 21 13 21 
0 0 12 44 0 0 14 0 11 0 0 15 0 10 12 0 6 43 12 12 14 8 7 0 2 1 18 0 25 0 12 28 0 16 3 0 9 
14 0 20 9 6 0 0 0 6 0 3 0 29 0 34 11 0 6 12 7 0 7 11 14 0 15 7 0 6 0 12 0 0 0 20 0 25 
0 0 6 0 0 0 0 15 0 0 0 2 0 0 9 0 1 3 0 0 0 0 0 0 0 9 0 5 12 0 9 0 7 8 0 9 12 
26 22 39 13 22 21 0 0 0 4 12 0 24 0 12 14 0 0 0 0 0 0 0 35 12 5 48 1 0 11 3 1 30 7 6 1 14 
26 3 0 11 0 0 4 19 0 16 0 2 0 10 0 8 0 0 12 0 0 0 13 13 0 42 13 11 5 4 5 0 0 0 0 6 0 
17 0 0 9 0 26 0 7 0 14 19 0 14 14 7 0 0 22 3 0 0 14 13 0 0 3 13 16 0 11 23 23 0 0 0 0 27 
0 13 4 0 0 0 0 0 19 0 0 0 37 19 0 0 9 4 17 0 16 0 8 12 2 9 0 34 0 0 8 4 0 8 32 3 39 
0 12 1 3 0 19 0 5 0 4 2 1 0 0 0 0 0 0 0 0 0 9 0 25 19 9 13 4 21 0 0 1 0 26 8 9 5 
9 2 37 32 8 51 0 7 0 51 2 9 4 0 0 0 26 17 3 14 18 6 0 0 2 16 4 14 12 0 26 22 5 12 0 26 0 
0 5 2 0 14 0 30 27 7 0 2 0 0 0 0 7 0 25 0 2 2 12 8 0 0 0 0 0 0 12 0 8 1 0 7 0 37 
12 7 4 2 0 0 0 24 0 0 1 15 6 10 0 0 0 18 0 0 0 0 0 0 0 0 15 0 0 0 7 24 1 7 0 0 1 
13 0 8 33 0 6 4 0 5 0 10 11 0 34 26 0 0 2 0 17 6 0 11 0 7 6 4 6 15 15 0 15 19 0 0 1 32 
15 16 0 0 0 0 0 0 0 43 1 7 4 2 0 15 20 0 0 15 0 20 0 14 0 16 5 17 0 17 1 0 0 0 38 13 55 
0 0 0 1 8 11 0 0 0 0 2 0 13 0 4 0 11 5 13 7 0 0 0 0 0 0 23 0 0 5 5 3 21 0 26 0 0 
11 0 7 0 0 0 11 2 0 0 0 15 0 0 0 14 0 16 0 0 4 0 1 0 0 10 15 41 6 9 9 0 12 0 14 0 0 
0 30 22 44 0 0 4 0 0 0 12 0 0 6 20 0 21 0 8 0 0 0 8 0 0 0 8 13 0 18 0 27 30 22 2 0 15 
11 1 21 10 8 0 10 1 13 6 18 4 6 23 0 20 25 0 11 2 1 9 20 0 0 0 0 5 7 14 14 0 0 0 0 0 36 
2 10 1 31 0 0 0 15 0 21 10 0 0 0 16 0 0 17 15 0 1 12 8 0 10 0 0 0 0 3 18 8 0 13 31 15 17 
