37 21
34 15 20 0 13 7 45 0 17 20 9 7 4 21 18 10 0 38 0 14 0 2 16 22 1 36 0 27 34 18 2 26 11 8 24 0 13 
0 0 0 24 0 10 6 10 47 0 2 0 0 5 27 10 0 0 14 0 14 7 3 5 0 5 0 3 0 0 0 0 8 25 0 0 18 
0 0 20 10 20 5 0 13 0 4 1 26 0 10 9 0 1 20 1 13 0 2 32 12 26 12 9 0 0 0 0 12 0 9 2 12 25 
2 12 0 0 0 1 0 8 32 0 0 0 0 12 0 0 0 0 0 0 0 6 7 1 1 0 0 0 0 7 0 0 0 0 0 0 14 
13 4 3 0 0 14 0 0 0 0 0 6 0 12 1 0 0 0 0 0 0 19 0 0 0 0 0 3 10 0 0 0 0 0 0 0 0 
0 0 17 1 0 2 0 21 10 10 11 3 0 0 0 0 0 0 0 24 0 0 12 0 0 0 9 0 0 9 4 24 0 3 8 0 0 
0 0 0 16 1 0 17 9 0 0 0 0 1 1 0 0 5 0 6 4 0 15 0 13 0 15 0 0 0 0 26 0 0 8 0 0 0 
27 0 10 38 9 20 4 29 0 0 0 0 0 0 25 0 9 0 2 0 0 0 0 0 7 11 4 22 4 0 3 28 20 0 0 0 29 
9 4 14 7 28 0 21 0 26 0 0 3 3 0 4 0 0 25 12 1 4 4 3 23 22 9 6 21 0 2 20 5 11 3 43 4 0 
6 0 15 13 0 58 17 1 8 25 12 0 11 0 7 27 5 8 18 15 12 9 20 0 27 2 0 0 0 3 0 0 11 25 11 30 13 
25 0 5 19 0 3 10 0 25 0 0 9 20 0 1 1 3 0 4 21 0 17 0 0 0 11 2 22 0 4 28 10 47 25 0 41 1 
6 35 37 6 0 24 0 1 8 0 1 1 3 0 14 2 29 39 0 5 3 0 0 8 4 11 9 25 6 46 0 0 0 4 32 0 54 
30 17 30 54 0 0 0 0 0 13 22 0 6 0 29 17 0 0 23 2 15 7 10 0 3 47 8 0 0 5 8 0 40 0 1 32 2 
0 0 2 0 0 34 42 0 0 0 19 21 0 0 11 6 1 0 0 2 0 4 0 0 0 4 11 24 0 19 0 0 22 0 0 29 0 
14 2 0 5 3 7 0 12 0 18 0 0 20 0 0 4 0 0 0 0 7 21 0 0 7 25 7 18 10 13 0 0 13 0 0 35 0 
25 0 0 0 0 0 0 14 10 3 23 0 0 0 0 0 0 0 0 0 11 10 0 0 4 25 0 2 0 0 0 0 0 23 0 0 0 
32 0 0 10 20 0 0 1 0 2 0 20 28 30 6 10 0 17 0 0 29 3 0 0 3 0 0 12 0 6 0 39 32 0 17 15 0 
42 0 31 12 9 15 10 0 0 0 0 22 0 0 0 3 0 0 3 0 35 18 0 0 0 0 15 0 0 5 0 20 0 31 0 0 8 
0 0 0 7 0 0 5 0 13 13 7 0 0 0 0 4 23 0 0 0 1 3 9 6 9 0 0 0 18 13 0 8 10 0 0 0 0 
0 30 0 0 0 0 1 1 0 0 14 5 0 0 16 13 0 0 0 18 16 8 17 20 7 0 0 1 1 19 16 30 0 14 0 0 21 
0 14 28 18 5 10 4 20 17 1 0 0 12 1 1 17 6 0 14 0 8 1 6 0 0 7 0 46 1 0 0 0 30 0 0 10 0 
