37 21
0 11 9 19 13 0 27 1 1 16 46 16 0 5 0 2 33 0 5 0 0 14 23 1 22 16 18 2 0 28 3 0 0 20 0 20 51 
0 0 0 0 0 0 0 0 0 0 7 24 2 15 0 0 14 10 17 6 0 14 6 0 19 0 0 0 28 0 0 0 0 9 21 41 0 
0 0 0 13 0 24 0 5 0 0 21 0 5 0 0 0 0 0 0 7 16 7 0 0 0 0 12 0 17 0 0 21 0 0 6 20 16 
0 0 17 0 0 0 12 0 0 10 9 1 1 8 12 0 0 15 0 0 5 0 0 4 0 5 0 3 16 16 0 11 15 4 0 3 3 
0 11 0 10 41 0 18 0 2 0 7 12 11 10 0 11 0 0 18 0 13 0 0 0 11 33 0 0 0 0 0 0 0 1 29 1 1 
0 0 44 0 6 0 1 14 20 0 23 0 0 0 11 0 0 4 12 0 0 14 4 0 2 11 7 3 20 0 28 1 1 8 6 12 1 
0 10 19 21 8 0 0 0 13 12 5 10 0 0 13 11 0 0 0 0 3 23 0 0 21 0 0 0 24 0 4 8 0 0 5 0 0 
0 14 0 29 0 0 0 2 2 0 0 0 0 0 0 20 0 15 0 16 0 0 6 3 1 0 7 0 0 0 0 0 49 26 12 29 4 
2 0 9 11 20 18 0 0 1 4 0 3 4 10 13 0 14 12 0 16 2 6 0 10 26 0 0 32 0 33 3 29 11 4 24 8 0 
0 10 30 0 10 0 2 0 0 0 4 19 12 0 0 9 10 3 18 7 16 7 8 7 12 0 0 0 0 0 2 2 57 4 0 0 9 
21 15 0 68 0 8 0 0 23 5 3 4 9 15 0 1 0 0 3 0 19 18 0 20 4 1 19 5 13 0 4 0 4 9 25 0 21 
0 13 19 0 0 28 0 12 11 0 24 10 0 0 0 6 0 37 5 1 0 0 20 0 23 7 16 3 0 0 0 16 0 52 0 18 4 
27 0 0 0 0 0 15 0 0 26 0 0 0 9 14 8 0 4 4 10 8 0 0 0 0 0 0 0 0 0 5 0 13 0 0 31 7 
2 0 10 0 33 0 0 0 0 10 20 0 0 0 0 11 4 15 0 19 0 0 20 0 4 0 0 38 13 6 28 27 0 8 24 0 0 
0 0 0 17 0 0 3 6 0 3 0 0 3 24 0 11 0 0 10 0 17 0 0 0 4 0 9 4 0 0 0 10 0 0 0 9 0 
0 21 22 27 2 38 12 0 3 0 1 1 21 0 0 13 3 31 0 4 0 3 37 11 13 0 21 31 27 0 14 0 9 31 11 0 44 
0 14 22 0 11 3 0 0 6 0 9 19 0 12 0 0 27 0 21 22 12 0 17 0 0 12 0 25 6 0 3 2 0 5 0 24 2 
24 27 0 7 17 6 25 0 2 11 7 25 12 8 16 0 13 0 0 0 5 0 1 1 23 0 10 15 49 0 9 0 0 6 0 15 31 
0 11 0 0 21 16 0 0 20 12 1 0 12 16 0 0 8 0 0 3 0 2 19 13 0 30 0 5 16 16 1 0 24 3 0 14 3 
0 0 0 1 14 0 7 7 31 0 0 0 12 0 4 4 10 13 0 0 10 12 0 0 2 0 0 9 13 15 6 27 23 16 12 11 30 
0 14 5 30 0 21 20 29 0 7 7 0 5 0 0 26 0 3 12 18 11 0 32 0 19 2 21 0 19 0 0 0 6 48 0 0 25 
