37 21
0 0 2 0 0 0 28 0 0 0 0 0 12 5 16 4 0 0 0 5 0 0 3 0 12 3 6 7 0 2 16 6 6 0 47 0 0 
55 5 0 0 33 5 25 3 9 19 0 0 7 0 20 30 0 8 29 13 20 10 10 11 0 9 31 2 36 0 0 17 12 62 11 17 8 
0 0 39 0 18 0 0 1 23 6 0 13 5 0 11 0 0 0 0 14 0 0 0 0 0 0 24 0 25 0 7 23 13 0 0 0 8 
0 7 0 0 9 0 10 14 16 11 0 9 10 0 3 0 0 6 11 7 12 14 16 3 0 10 14 9 16 1 1 0 0 6 0 10 0 
0 13 6 4 3 9 5 4 29 0 5 14 9 0 8 4 8 21 10 6 14 24 17 5 10 13 31 10 2 0 0 0 0 3 0 0 10 
0 0 0 26 22 0 27 0 14 1 12 30 1 3 4 12 0 14 6 0 0 0 50 0 6 0 22 12 0 7 0 11 10 25 0 2 0 
0 33 0 0 0 0 7 0 4 0 0 10 20 7 17 0 15 0 4 12 0 10 2 0 15 0 16 0 12 1 0 12 20 0 0 0 0 
32 0 29 12 0 0 7 5 24 0 0 7 3 12 0 15 0 0 12 0 2 12 0 0 0 0 0 43 5 0 9 0 38 5 0 0 34 
21 0 0 18 9 0 7 3 21 7 3 28 3 10 10 4 11 0 6 16 0 32 0 12 19 0 7 0 0 39 7 2 11 12 5 0 5 
0 0 0 3 0 0 0 0 18 0 0 0 12 0 8 0 0 0 2 9 6 0 9 0 8 0 15 1 7 0 23 0 0 0 0 0 1 
18 28 23 26 0 0 22 22 8 0 13 4 11 22 0 9 9 8 0 0 4 0 26 13 2 6 0 0 38 9 6 28 0 9 22 22 0 
0 0 0 0 0 0 0 0 16 0 7 2 12 0 0 7 0 0 7 0 4 0 0 8 16 7 3 4 0 0 2 0 0 8 0 8 0 
6 0 8 8 11 0 6 5 0 0 0 0 30 25 12 7 11 0 0 0 0 0 0 0 0 0 4 6 0 0 5 0 0 0 21 28 9 
0 13 0 2 0 20 2 0 9 0 0 0 0 12 1 0 0 0 0 9 0 11 0 0 0 23 0 0 1 0 0 0 14 0 0 0 0 
6 0 13 24 0 0 40 0 0 1 1 0 14 3 0 2 0 0 21 0 11 0 12 13 12 0 39 24 0 0 24 0 0 0 0 0 25 
23 32 8 32 1 0 2 0 2 14 27 0 1 0 0 14 0 13 12 2 0 13 0 18 21 0 4 11 0 0 12 10 0 0 0 66 0 
10 16 0 0 13 0 22 5 0 9 14 11 21 6 3 0 0 19 0 0 0 0 16 12 7 0 3 0 3 0 6 26 0 21 0 2 0 
0 0 33 0 36 0 2 5 23 0 0 13 5 0 5 5 0 0 17 7 1 10 18 0 24 0 6 20 7 0 0 26 0 6 0 12 0 
17 0 0 0 0 0 11 0 4 0 7 0 21 18 0 0 0 21 2 5 0 0 0 0 0 0 17 10 17 0 0 0 0 17 0 2 0 
23 29 11 32 30 19 0 3 15 25 3 14 19 9 1 10 1 3 0 0 0 0 0 29 6 8 5 14 52 0 31 16 26 0 37 40 0 
31 0 5 21 49 0 29 12 9 0 8 35 5 0 0 19 7 0 9 16 0 3 0 21 12 19 0 24 0 0 0 20 0 12 1 31 12 
