37 21
0 0 0 14 0 3 0 0 0 0 0 0 1 1 14 6 0 0 0 0 1 11 1 0 6 9 0 34 0 15 0 0 0 8 0 0 0 
0 0 0 0 0 0 10 11 0 18 21 0 0 0 8 0 0 0 12 0 0 0 17 16 0 3 20 18 10 0 0 0 0 0 0 13 30 
0 18 10 23 1 8 0 0 0 0 0 0 21 0 11 0 0 0 0 0 0 0 2 0 9 19 1 0 35 8 34 5 5 15 0 5 5 
0 1 24 0 0 0 0 0 0 0 0 0 5 0 0 6 0 0 0 0 0 13 0 0 0 0 14 14 0 0 0 19 0 18 0 0 0 
4 17 16 0 1 0 0 8 5 6 0 0 0 0 0 8 11 0 17 3 14 0 0 0 8 3 0 0 15 0 0 0 0 0 0 0 0 
11 29 0 0 0 0 0 0 8 0 6 0 2 0 0 0 0 0 16 0 9 13 0 5 0 0 0 2 9 9 24 0 0 10 7 0 4 
6 2 1 0 5 37 0 0 6 18 12 10 0 0 12 19 11 0 0 0 8 10 0 0 0 5 2 0 10 13 25 0 0 0 44 30 8 
20 26 0 16 3 27 9 16 0 0 10 21 0 0 25 13 0 0 4 2 13 3 17 18 0 6 13 5 25 22 0 4 53 50 0 11 8 
9 35 0 2 10 18 0 0 4 9 19 0 0 5 32 0 0 0 9 1 1 27 15 4 2 0 0 26 12 0 3 0 3 17 24 2 72 
10 14 1 39 0 1 0 0 29 0 10 4 9 5 7 8 2 19 14 3 0 0 9 11 0 0 11 27 0 0 20 32 12 1 24 3 33 
0 0 24 17 0 15 2 0 25 0 19 2 0 2 13 24 0 15 15 0 15 10 8 0 0 2 0 0 0 2 2 4 27 21 0 41 0 
24 2 2 0 2 0 0 0 7 0 12 0 0 5 0 3 0 0 17 0 0 4 0 0 0 5 0 5 28 0 2 4 6 0 24 5 9 
27 7 4 16 3 7 2 12 14 57 11 4 2 9 20 0 1 0 0 3 0 2 25 0 4 9 18 21 19 8 1 0 29 0 12 17 0 
0 28 0 0 24 7 12 0 0 0 8 0 0 0 0 0 0 0 19 0 0 0 0 6 1 15 0 0 24 35 1 0 0 0 0 0 11 
6 0 21 43 0 16 0 0 28 3 29 5 24 0 5 4 0 0 0 11 0 17 0 34 4 2 6 14 18 0 20 0 35 0 0 6 1 
8 0 39 23 3 0 20 0 4 27 0 0 0 20 12 9 14 5 13 0 0 7 0 0 0 22 2 0 7 0 27 13 0 54 0 3 54 
10 0 28 1 19 0 0 3 6 32 10 7 0 1 0 0 0 1 2 0 0 12 0 0 0 9 1 8 0 47 4 0 0 0 0 34 0 
0 0 11 0 0 10 10 18 0 0 0 0 23 12 7 3 0 0 16 0 0 20 0 14 5 14 1 0 0 0 0 0 7 14 13 23 0 
0 0 30 1 2 2 0 0 2 0 12 0 0 0 12 12 0 16 2 6 1 0 0 8 0 11 0 0 0 4 5 0 0 24 0 6 0 
7 0 0 27 0 7 28 0 0 21 29 11 0 0 7 0 0 0 0 24 0 20 0 3 8 15 5 8 2 3 9 1 10 0 30 0 14 
0 0 76 24 2 31 10 0 6 5 13 2 0 2 19 2 2 15 9 15 13 3 4 35 0 18 16 44 53 7 4 0 0 0 43 0 23 
