37 21
4 0 0 0 0 0 0 20 24 0 0 10 0 10 7 17 0 0 15 0 5 33 9 5 0 25 5 0 8 0 0 9 18 0 0 0 0 
23 15 0 9 20 10 6 26 6 0 33 24 6 8 15 6 33 30 9 7 0 1 0 0 28 6 0 22 0 0 16 0 32 62 15 38 26 
0 0 0 15 0 47 0 10 5 0 2 9 0 5 0 12 0 0 0 0 2 5 0 0 0 0 0 5 0 0 25 1 0 0 14 0 13 
10 3 0 3 0 23 0 1 33 0 7 5 1 0 4 0 0 9 0 25 1 18 7 11 8 0 0 19 2 1 11 6 6 2 0 2 0 
10 51 25 13 0 0 9 19 19 17 34 0 0 7 0 5 8 0 0 0 0 7 0 0 14 0 17 56 6 28 23 2 22 0 0 0 0 
10 32 0 2 1 0 0 0 3 10 19 0 0 3 12 15 3 0 0 10 12 4 0 0 0 0 0 0 0 7 5 34 12 3 0 5 3 
19 0 17 0 1 0 0 0 0 14 0 3 8 0 4 3 21 0 0 6 20 0 7 0 2 10 12 0 6 0 0 22 8 0 0 10 0 
6 17 12 1 1 5 0 15 6 9 2 30 8 4 6 1 1 0 29 11 14 5 1 13 0 0 0 0 0 0 22 0 12 3 0 0 0 
0 7 1 2 24 0 0 0 7 0 10 0 0 9 0 0 0 0 13 5 0 0 9 0 0 0 0 23 8 0 0 18 0 0 0 0 0 
31 4 35 1 1 0 0 22 13 4 7 2 9 0 3 13 8 0 0 21 0 5 0 17 0 6 0 2 5 43 0 16 6 4 0 0 0 
0 0 14 0 53 3 0 0 1 2 7 9 3 0 8 0 14 0 5 8 0 0 0 0 20 0 0 0 10 19 0 17 42 0 0 0 0 
0 0 0 0 2 0 0 0 0 0 2 8 0 5 0 0 0 0 0 0 0 0 0 12 0 0 0 2 0 0 0 0 0 10 0 0 0 
0 34 0 0 0 4 31 1 0 0 0 0 9 0 0 1 3 0 3 17 0 5 0 0 0 0 0 0 0 12 0 19 3 1 27 5 3 
45 15 4 0 0 7 6 0 0 13 2 0 0 7 0 28 15 12 9 18 0 4 6 2 0 5 12 5 4 0 0 0 1 7 0 35 0 
10 13 6 32 4 13 47 0 6 13 4 17 0 0 7 19 0 0 8 0 11 11 0 0 18 10 0 1 23 26 0 20 25 0 0 0 4 
32 0 0 0 0 26 23 0 0 21 0 0 3 4 0 0 0 12 15 45 0 0 0 0 0 0 0 0 1 35 21 5 4 3 15 16 20 
25 7 0 2 0 0 0 0 0 12 0 0 9 4 13 15 17 0 3 0 0 0 0 0 6 0 0 0 28 15 0 0 0 24 14 0 0 
16 34 11 28 0 3 11 0 0 0 16 0 0 0 12 2 0 16 0 39 15 0 0 1 0 0 0 0 3 12 0 1 0 0 0 46 0 
23 14 21 30 1 54 25 4 0 15 10 0 24 0 9 0 11 8 4 22 12 15 0 15 0 7 8 0 0 24 4 29 24 27 0 0 39 
13 26 0 47 10 22 6 10 6 1 17 3 12 9 3 0 18 8 27 0 0 0 0 11 27 0 5 31 0 0 28 4 0 1 9 32 0 
8 11 46 30 37 40 0 19 11 0 2 56 0 7 10 5 0 14 5 0 0 10 0 18 16 10 11 0 10 0 17 0 28 33 32 0 0 
