37 21
0 6 5 14 12 16 0 19 12 0 26 0 0 20 22 7 2 14 5 17 22 3 0 0 29 0 0 1 0 0 0 10 0 20 29 0 26 
15 0 0 0 50 0 22 3 19 0 21 0 23 0 5 0 0 0 8 11 0 6 14 23 12 0 5 24 0 15 0 21 0 0 16 14 8 
0 0 16 23 3 5 29 0 0 12 0 17 0 28 10 8 5 13 12 26 0 13 5 17 0 0 12 0 0 15 12 0 18 0 0 29 0 
13 0 12 19 5 28 0 0 6 13 0 0 22 0 0 2 0 10 2 0 0 0 4 0 0 4 0 8 20 0 0 9 1 28 22 0 0 
0 0 29 12 0 26 16 14 0 18 0 0 18 0 0 0 0 0 10 0 0 7 29 0 10 18 17 18 29 4 19 55 0 0 19 4 0 
6 5 13 0 2 0 14 8 34 24 0 7 13 0 0 0 8 8 11 12 0 0 13 0 0 30 0 7 0 16 0 23 0 0 2 27 46 
0 21 6 0 0 18 0 0 16 0 12 4 11 22 18 7 0 0 40 9 0 3 18 5 9 0 5 0 26 24 0 0 0 0 29 27 7 
2 51 2 19 0 8 14 1 0 21 0 2 7 14 0 7 0 0 35 12 2 10 23 13 18 13 12 40 19 13 0 5 0 2 13 13 8 
0 0 0 0 0 0 0 0 9 0 0 0 0 2 21 2 0 15 0 0 0 20 0 0 0 0 0 6 0 3 5 0 0 0 0 17 0 
0 0 0 29 24 0 0 3 0 14 7 17 10 0 0 0 20 0 10 12 13 8 12 14 0 22 0 0 17 4 0 0 0 1 0 0 20 
9 0 0 41 0 0 0 0 5 1 7 4 3 8 0 0 0 3 0 16 3 12 0 0 0 17 0 0 0 10 5 10 0 3 0 2 1 
40 6 7 9 9 9 0 10 0 6 14 0 0 3 0 0 13 10 2 0 0 0 11 33 11 0 0 6 0 24 0 0 0 0 0 7 46 
10 0 3 1 21 3 5 0 0 33 13 10 11 10 23 0 0 6 0 35 0 3 11 10 14 11 0 0 0 7 4 0 23 13 8 2 17 
31 0 27 3 6 11 0 1 26 0 22 11 3 0 0 7 7 0 9 11 0 0 7 7 8 0 10 0 0 6 7 52 0 0 49 2 7 
0 0 0 0 9 0 0 0 0 4 3 1 7 9 0 32 0 10 0 0 0 6 17 2 0 0 0 5 8 5 0 0 0 6 9 0 21 
4 0 0 0 27 0 53 2 5 0 0 20 21 0 0 0 0 13 0 8 0 0 5 0 0 0 0 0 0 0 24 47 0 21 0 31 0 
13 0 4 14 2 0 0 0 0 18 0 0 0 0 0 0 0 0 9 17 0 0 9 0 0 9 0 16 0 3 0 9 0 4 0 0 0 
0 30 6 1 7 2 0 0 3 0 14 13 0 0 0 0 0 0 0 15 7 0 0 5 20 0 27 0 0 0 6 0 0 0 8 34 5 
28 26 33 0 12 0 1 0 4 30 0 6 8 18 15 21 5 25 9 10 4 3 4 16 11 0 25 11 14 35 0 29 32 2 0 0 2 
0 17 7 22 28 0 19 10 3 1 0 2 0 0 0 8 15 0 21 0 0 11 16 0 18 13 0 5 10 44 7 0 17 0 27 0 12 
26 6 0 0 15 2 0 6 0 1 2 7 40 18 20 12 0 0 6 0 0 0 5 13 0 7 36 0 0 0 0 19 0 6 43 0 0 
