37 21
8 0 23 0 0 23 16 0 2 8 29 2 16 8 14 5 0 7 4 10 32 22 4 0 0 0 24 0 30 15 0 38 30 10 24 15 9 
18 27 12 0 44 17 5 0 12 26 6 2 14 7 0 9 16 1 0 0 18 0 7 0 14 0 22 0 17 10 10 0 0 0 0 4 43 
6 0 6 0 0 0 22 17 0 0 0 0 0 0 0 0 0 1 0 0 10 0 20 15 0 0 7 0 0 0 10 0 0 0 15 0 14 
19 11 3 37 24 6 8 0 2 9 6 11 0 10 19 17 8 12 12 4 0 0 0 5 1 0 18 0 13 1 14 12 0 14 17 0 5 
2 12 2 0 0 18 0 0 0 15 0 6 0 0 10 0 0 3 0 10 3 0 2 16 34 0 0 14 1 24 14 0 9 0 0 24 0 
24 1 0 7 24 0 8 16 12 16 0 4 11 19 11 0 0 21 5 0 13 10 5 3 0 11 0 20 0 29 1 0 19 16 0 1 37 
32 0 31 13 0 0 19 0 0 0 5 1 0 0 11 9 11 0 0 0 4 0 0 4 0 0 0 50 0 0 0 0 38 37 8 0 0 
0 22 15 0 12 0 9 0 0 5 0 7 0 22 0 0 0 31 0 0 18 0 0 30 3 0 0 0 0 1 1 8 6 13 0 7 0 
27 0 6 0 0 1 7 0 19 24 0 2 0 0 0 0 18 0 5 11 9 8 8 0 19 20 1 16 6 41 0 3 0 15 9 24 7 
0 30 18 0 32 0 22 0 4 0 26 37 12 0 19 21 10 2 0 10 15 1 0 12 9 0 1 0 1 4 0 14 0 9 0 0 53 
16 6 2 5 0 0 0 0 0 21 7 10 1 0 15 0 0 0 0 1 0 0 0 0 21 0 0 18 0 0 0 20 0 0 0 0 0 
38 6 6 3 0 18 0 0 7 0 0 0 0 18 14 5 20 0 1 1 12 8 0 8 0 7 0 5 10 2 0 0 7 33 21 0 19 
0 0 0 23 6 8 14 0 0 7 7 6 12 8 8 0 2 6 0 0 7 12 8 0 4 23 0 6 0 0 7 0 13 6 0 1 12 
0 0 16 0 19 0 0 0 24 0 21 7 0 0 19 0 0 0 3 0 0 0 14 23 0 1 5 0 0 0 3 21 30 16 0 1 5 
6 11 18 28 0 0 11 0 0 0 11 18 0 7 11 0 2 0 0 10 28 9 0 7 0 5 3 8 0 24 7 28 0 0 2 0 0 
5 0 20 0 0 15 23 0 0 7 0 0 0 0 0 0 10 0 2 0 0 10 20 0 11 0 10 0 0 8 0 0 0 0 0 0 0 
34 14 0 0 37 22 4 0 0 10 16 11 8 1 4 0 0 16 0 10 4 7 0 30 0 0 38 22 0 0 0 22 4 0 0 0 10 
24 4 5 1 16 33 15 19 0 0 5 0 6 25 0 0 16 2 0 8 19 8 6 19 47 11 22 7 8 16 9 0 0 14 14 0 19 
0 4 0 0 27 13 31 0 5 0 10 0 17 2 14 16 4 9 5 0 24 10 0 14 8 12 0 10 14 0 0 16 0 0 30 0 0 
53 0 0 0 0 0 0 17 3 0 0 3 0 0 0 12 0 2 0 0 2 0 0 0 13 7 2 12 0 0 7 3 7 19 0 35 0 
22 24 0 26 15 0 0 0 17 17 0 1 0 0 44 45 0 0 0 0 8 6 50 6 6 11 17 19 0 44 0 16 0 3 18 19 7 
