37 21
6 8 1 0 19 0 0 21 22 0 21 45 6 0 0 14 1 1 0 8 0 3 0 10 16 0 0 0 38 0 24 21 1 9 30 5 25 
11 8 0 0 27 16 0 7 1 7 11 36 6 0 0 12 0 0 6 10 9 21 0 12 0 2 0 7 11 0 0 40 10 0 0 0 8 
11 9 16 3 30 0 7 5 9 3 10 37 8 16 44 0 0 3 0 0 8 11 2 0 11 0 0 0 0 0 0 4 2 1 47 24 22 
20 0 25 17 20 0 27 13 0 0 1 0 0 9 0 11 15 4 0 0 44 3 0 10 0 4 6 24 0 0 24 31 0 0 0 19 0 
32 1 15 38 30 0 0 3 11 9 7 0 4 0 28 0 0 0 0 0 0 0 10 9 0 0 0 13 0 15 0 0 70 0 31 32 2 
28 0 0 7 2 9 24 0 0 16 0 17 0 10 2 0 0 3 0 0 12 12 0 0 6 0 0 15 64 0 24 2 12 0 1 0 0 
6 35 0 19 3 1 0 4 0 19 0 23 0 0 1 0 16 3 3 0 3 0 9 0 15 0 17 0 17 0 14 4 19 0 0 0 2 
8 0 37 0 29 7 23 1 1 35 3 0 0 8 0 0 9 9 0 0 0 0 0 0 4 16 0 0 23 0 9 27 0 27 0 33 0 
22 0 26 0 0 0 6 12 0 6 0 11 0 15 0 6 2 11 0 0 7 0 11 0 0 0 0 8 10 0 13 0 0 0 10 5 0 
0 5 5 0 0 3 7 0 10 8 10 0 2 11 7 8 0 24 17 0 0 0 0 3 0 0 0 8 0 8 0 0 3 31 11 9 0 
26 0 4 0 7 0 0 0 16 1 6 13 23 8 8 0 0 0 0 0 0 0 14 10 0 0 26 22 0 0 0 5 0 0 2 23 0 
15 11 0 27 27 2 0 46 33 42 0 17 2 0 7 4 13 0 4 4 0 8 17 0 26 3 5 0 14 13 0 5 9 0 3 13 29 
0 31 30 9 29 40 1 1 4 12 10 8 10 0 11 2 0 0 0 5 24 12 15 0 14 0 0 13 14 0 0 2 31 35 2 0 0 
9 16 19 25 3 0 27 35 14 7 12 8 0 53 3 15 2 0 15 7 22 11 21 28 15 14 5 20 10 7 31 21 0 11 14 10 18 
0 0 6 21 0 0 0 0 0 0 32 12 0 9 20 9 4 0 0 0 6 5 1 0 10 7 0 0 3 0 16 0 7 0 24 0 0 
0 2 7 1 24 3 14 0 11 7 0 3 24 2 3 19 6 0 20 0 0 0 0 0 0 0 22 0 0 0 0 0 0 0 3 2 24 
0 8 0 9 0 0 0 11 46 8 0 0 0 10 5 0 4 0 0 0 3 1 6 0 16 0 0 3 8 0 8 0 12 0 18 0 0 
21 0 17 30 7 38 6 26 26 0 16 3 0 15 0 28 1 1 0 17 1 12 0 10 0 2 0 14 21 0 0 15 1 23 26 0 0 
0 34 16 0 0 0 0 15 19 0 9 8 0 0 0 5 1 0 0 3 0 0 20 0 0 10 0 14 10 7 0 0 5 0 0 33 0 
24 15 16 2 0 0 0 5 0 29 0 9 3 0 5 3 17 11 11 13 2 0 0 1 24 0 0 0 0 0 0 11 0 55 0 0 0 
21 21 2 0 0 0 45 0 0 28 1 2 0 16 8 13 0 0 0 17 0 2 21 1 0 19 0 34 9 0 0 0 16 0 0 0 27 
