37 21
0 0 0 9 0 0 0 0 0 0 0 0 0 12 31 14 0 8 0 3 14 6 21 0 4 0 0 0 8 0 2 24 0 0 0 0 0 
0 0 0 1 16 8 42 0 0 19 13 0 9 8 0 4 0 7 0 1 25 10 0 0 0 0 0 0 0 28 15 0 0 0 5 0 0 
20 0 0 0 0 13 0 0 0 0 7 2 0 16 0 0 0 8 11 0 19 15 0 7 6 0 4 16 17 0 9 10 0 0 1 18 18 
0 30 0 0 12 12 5 9 21 2 2 13 19 0 14 2 6 5 25 4 0 0 0 14 1 1 8 12 4 0 1 35 1 23 0 17 0 
0 0 0 4 0 0 2 4 2 0 0 4 0 0 0 2 12 2 0 0 6 0 0 4 0 0 0 4 0 0 0 0 0 0 0 0 0 
32 0 0 2 0 27 3 0 0 10 40 17 24 12 0 19 0 0 0 10 10 7 0 0 6 0 6 27 17 0 0 0 0 24 42 0 17 
0 37 0 20 0 0 0 23 6 13 5 9 0 3 14 36 0 8 10 0 13 6 17 32 1 14 10 15 35 5 4 1 0 0 0 32 6 
11 0 0 13 0 10 11 21 0 0 0 0 0 4 3 6 13 18 0 4 0 3 22 0 0 0 0 1 38 0 6 7 11 3 0 0 3 
10 9 0 40 1 0 5 26 27 31 58 7 50 0 11 0 12 22 0 1 3 0 1 13 10 8 0 1 8 0 3 31 32 67 1 5 2 
2 11 30 11 10 0 0 0 0 9 1 0 5 0 0 3 0 0 10 24 11 0 14 0 7 0 0 0 6 0 1 17 30 0 22 16 8 
4 0 0 0 0 0 0 2 0 0 1 0 24 4 0 0 4 6 0 0 21 0 0 0 0 0 5 0 0 0 0 9 0 0 0 0 8 
10 0 0 19 0 8 28 4 17 7 46 10 8 0 17 2 8 13 0 6 9 6 2 20 14 9 8 9 0 0 27 17 0 3 33 51 0 
10 6 8 0 0 0 0 2 6 0 3 2 5 19 7 3 3 1 0 12 2 15 0 13 0 0 5 13 0 8 0 0 0 0 0 0 0 
0 45 0 0 0 1 0 0 7 0 0 13 11 1 1 0 0 0 0 0 14 0 7 0 13 0 0 19 4 7 0 0 4 0 3 34 0 
8 13 0 48 0 1 5 40 0 16 20 1 0 8 11 14 2 14 0 9 9 8 5 29 5 38 0 0 2 21 2 10 0 4 1 0 0 
0 0 0 25 15 26 0 0 0 3 0 0 7 0 0 12 0 14 6 0 9 10 3 0 0 3 8 0 0 9 0 0 14 0 4 0 0 
0 0 0 22 3 0 2 0 40 0 0 24 0 0 20 0 12 0 0 0 0 0 9 12 16 0 4 4 25 0 4 6 24 11 14 36 0 
58 0 0 0 26 0 0 5 0 7 0 0 5 14 0 1 6 3 0 0 0 0 31 14 22 18 3 3 11 2 47 19 0 3 5 6 8 
26 6 0 1 0 0 9 17 0 10 22 45 9 0 0 5 10 15 0 0 14 0 0 0 17 0 26 9 0 0 14 0 12 34 13 19 9 
57 15 15 2 16 8 21 28 0 17 7 6 3 6 17 2 0 12 13 0 20 0 0 12 1 0 37 8 0 2 0 20 0 0 0 16 0 
14 39 8 45 6 4 19 0 1 31 15 9 3 18 27 27 0 3 0 9 5 21 0 0 9 0 25 9 13 3 13 0 8 0 0 50 18 
