37 21
0 55 1 25 0 0 19 0 16 0 56 0 0 4 12 6 19 18 3 0 0 0 18 1 4 35 16 3 5 19 0 19 8 0 27 19 0 
0 0 0 11 0 0 0 0 14 23 0 16 0 0 11 0 0 9 7 5 9 0 0 0 9 6 15 0 6 0 10 0 0 0 0 12 0 
0 0 23 19 9 0 10 18 14 0 6 0 0 19 19 10 0 9 12 9 0 0 9 19 25 7 0 0 0 4 0 0 18 13 0 16 0 
23 27 10 24 0 0 0 11 22 22 28 0 13 2 30 5 6 0 24 2 0 2 1 28 21 0 2 10 11 0 22 10 1 0 3 25 2 
0 0 0 0 32 0 2 0 0 0 16 0 0 8 0 0 0 0 0 0 0 0 7 0 0 13 5 0 0 0 16 0 0 0 0 0 42 
36 24 26 0 0 23 0 4 0 5 4 4 0 17 8 0 0 7 0 14 1 0 6 2 0 21 0 0 0 0 12 26 11 0 0 0 34 
4 0 0 28 0 24 13 30 0 5 0 0 8 8 14 0 0 0 3 13 29 0 0 0 15 0 2 20 19 19 0 28 4 0 9 2 0 
0 2 20 0 0 0 0 0 0 11 10 0 3 14 9 1 5 3 0 0 10 0 28 0 0 6 0 0 6 1 1 0 0 7 0 0 0 
3 11 21 24 0 2 26 40 13 44 6 4 9 19 0 7 5 6 11 2 52 4 14 28 21 22 9 7 7 33 14 0 45 13 0 14 8 
0 20 0 0 1 0 0 11 0 6 0 0 0 7 0 1 7 0 4 10 0 20 1 1 28 0 2 0 2 0 0 0 0 22 0 0 0 
5 0 0 0 9 0 10 0 0 0 0 0 23 0 1 0 2 21 4 14 4 2 0 0 3 0 2 11 0 0 5 17 4 14 0 23 19 
0 0 39 5 0 34 3 4 2 16 15 0 0 18 0 16 4 15 18 18 5 10 15 4 0 0 6 25 4 2 22 10 6 0 0 3 31 
0 0 0 0 0 0 29 4 2 0 0 4 2 15 22 0 1 4 15 0 0 0 0 3 0 1 12 2 17 2 0 0 0 15 0 20 11 
34 10 0 0 0 0 0 0 6 7 0 10 0 0 3 0 7 16 1 7 2 8 0 0 0 0 0 0 9 8 0 0 0 16 34 22 0 
27 0 3 16 0 25 0 0 4 9 14 0 4 0 5 13 2 0 0 15 10 21 9 8 26 2 0 22 2 0 10 28 14 7 0 0 0 
15 0 4 15 4 0 3 17 14 9 32 13 0 13 0 1 0 16 7 12 7 0 0 0 15 0 11 13 29 0 2 0 0 13 0 0 0 
0 6 0 0 0 24 0 1 38 0 0 4 8 21 0 0 8 14 0 2 11 11 15 5 2 0 18 0 0 0 0 0 11 28 35 0 0 
26 0 0 28 2 4 2 0 0 17 0 0 24 42 2 21 0 0 0 0 0 0 0 0 0 1 22 0 0 49 0 14 19 0 0 14 20 
0 0 0 7 0 25 0 0 0 7 36 25 21 0 0 0 0 5 0 16 0 0 23 0 0 14 0 7 0 7 0 0 27 24 7 0 1 
31 21 0 21 3 0 0 0 10 37 0 0 0 0 9 0 9 9 28 22 12 8 0 0 49 15 0 0 8 7 6 3 0 0 0 0 7 
3 14 10 15 26 21 24 3 0 5 0 23 27 13 49 14 0 12 0 6 2 0 0 0 25 13 14 23 20 15 13 7 12 0 23 0 0 
