37 21
5 0 0 12 0 5 0 7 0 0 0 20 13 0 7 12 0 19 0 2 11 0 0 4 6 13 5 0 0 6 6 36 0 14 0 0 2 
3 10 1 52 11 15 59 0 0 0 2 10 0 8 17 0 5 1 0 0 16 9 4 0 12 0 0 6 18 23 20 42 0 7 11 0 4 
14 31 0 12 15 9 0 0 6 3 0 0 0 0 18 3 0 0 3 0 8 0 4 1 27 0 0 0 0 4 0 0 76 0 9 10 8 
0 9 0 0 0 0 21 4 0 0 0 14 0 0 0 0 0 10 7 0 6 18 21 0 0 0 6 6 0 0 0 30 0 12 0 11 0 
37 4 0 15 42 7 0 7 0 2 0 20 11 3 22 9 7 4 1 5 0 6 0 27 8 0 22 22 6 13 19 0 8 0 5 22 1 
0 24 13 23 0 0 20 6 25 2 0 16 5 19 10 1 13 10 0 51 1 0 5 1 7 14 0 0 16 15 23 0 0 16 31 7 33 
22 23 0 9 0 0 0 4 0 33 26 0 0 0 0 8 0 8 0 0 0 0 18 0 16 12 12 9 6 0 0 0 0 0 29 0 10 
0 2 0 18 54 15 0 2 14 15 0 0 0 0 0 12 10 8 28 0 0 11 4 0 18 8 22 3 0 0 12 10 35 0 16 0 45 
0 2 3 15 0 0 0 0 7 0 8 5 0 0 0 0 28 4 0 0 0 0 0 0 5 0 0 11 0 5 1 0 0 0 0 0 0 
10 26 5 30 34 15 0 37 0 10 0 12 8 0 0 0 4 10 7 1 29 0 8 0 7 22 0 26 0 7 27 0 25 9 0 0 11 
0 0 19 3 12 10 3 31 0 27 0 3 3 0 14 18 11 9 6 0 8 20 0 15 9 5 0 8 6 10 0 12 0 1 0 0 27 
0 4 6 5 7 5 2 32 0 0 0 8 3 0 0 17 0 0 15 0 0 0 0 0 0 4 0 7 0 5 0 0 17 5 2 0 26 
0 0 34 7 8 4 14 0 0 27 7 6 9 9 20 0 0 2 0 0 14 0 9 1 6 0 0 29 5 15 0 4 7 0 31 11 44 
0 0 4 1 0 0 3 1 8 9 3 31 14 21 0 3 0 11 24 1 0 7 5 1 2 13 9 17 34 5 20 1 30 0 0 2 11 
0 0 1 12 0 2 6 0 0 2 8 5 0 0 5 4 6 0 18 0 0 0 4 0 0 0 0 7 0 2 0 0 0 0 9 0 0 
0 29 8 27 4 0 17 0 8 2 7 19 0 0 5 0 7 0 0 13 0 0 10 20 0 8 0 0 0 0 29 0 0 7 1 12 41 
10 0 3 0 21 14 0 15 35 2 18 11 0 0 14 4 11 2 1 11 0 0 23 0 16 35 0 32 0 2 0 0 0 0 0 0 28 
0 0 0 8 24 0 0 6 24 0 0 1 0 0 0 0 0 24 0 0 0 0 10 0 0 0 0 13 5 25 0 7 24 29 0 0 0 
0 0 0 11 25 0 0 0 8 10 0 7 0 5 0 3 0 19 0 0 0 4 0 14 0 16 13 18 0 29 0 22 0 17 0 0 10 
10 0 7 0 0 0 0 0 0 10 0 3 6 6 0 1 0 0 0 0 0 0 0 0 10 0 0 6 0 0 0 0 7 0 0 0 15 
19 23 0 0 26 0 6 27 25 0 0 0 0 0 1 0 13 23 6 10 0 17 0 0 19 11 6 0 13 0 0 0 6 41 27 0 6 
