37 21
22 0 0 28 17 18 8 1 16 5 10 3 2 6 29 0 0 39 2 3 3 2 13 19 4 0 10 9 27 10 10 27 0 2 0 4 0 
0 0 16 0 0 0 0 1 0 0 7 19 2 0 8 9 0 0 0 8 3 9 0 27 13 15 0 3 0 2 0 17 22 18 23 0 0 
0 18 0 0 0 17 0 15 5 39 7 1 12 3 9 13 5 16 9 2 15 0 8 10 23 0 2 8 6 10 0 0 23 9 16 0 0 
0 23 0 26 3 0 24 0 0 0 6 0 0 0 6 1 1 1 2 6 4 0 0 0 23 0 23 22 17 13 0 3 0 17 0 0 22 
0 4 5 0 19 26 4 23 0 0 0 9 11 19 10 0 0 0 9 0 5 0 0 19 0 0 4 15 0 3 13 30 19 0 0 0 35 
0 0 4 13 0 0 8 0 0 0 0 0 0 0 14 15 3 0 2 2 1 3 8 0 0 11 0 0 0 0 12 0 18 5 0 0 22 
0 0 22 6 0 0 0 12 0 0 9 0 22 0 0 0 0 6 15 19 5 0 0 8 37 5 0 15 0 0 0 0 0 0 0 0 8 
0 3 5 1 0 10 21 4 2 11 0 8 9 0 12 6 10 0 25 27 10 0 0 0 0 2 0 0 0 5 13 13 13 0 0 0 0 
29 4 0 0 19 52 23 0 0 0 6 0 0 0 0 0 0 19 0 0 14 16 4 22 0 0 3 0 29 29 3 0 0 3 2 0 49 
27 0 2 30 22 14 59 9 1 11 2 31 7 4 10 0 16 0 4 3 6 0 0 0 0 9 61 27 0 0 0 29 0 22 0 0 0 
15 0 0 1 0 3 0 0 45 0 23 5 17 24 9 1 3 0 1 11 0 0 0 0 3 0 0 5 0 2 6 23 19 25 0 16 0 
7 21 9 0 4 3 43 3 7 0 0 0 0 0 17 5 0 0 6 27 3 0 20 0 0 6 0 0 14 0 7 0 0 0 0 0 30 
0 8 9 11 0 4 20 0 0 6 2 0 8 12 6 4 0 3 0 38 3 19 0 10 4 7 0 0 22 1 0 0 34 0 0 16 0 
0 29 13 1 8 4 7 15 3 4 0 0 6 5 0 19 0 0 0 1 7 14 0 0 0 3 24 0 3 0 44 4 0 36 0 0 0 
4 67 28 34 9 0 11 18 14 5 4 2 5 0 6 16 0 13 11 49 1 10 0 19 2 2 0 25 25 10 4 14 4 46 0 0 52 
0 0 1 1 8 0 7 0 0 9 9 0 8 5 17 8 0 5 5 12 4 0 0 0 0 0 0 0 14 0 5 12 0 0 19 0 0 
0 0 0 24 0 0 0 0 0 0 0 0 0 7 16 9 0 0 0 4 0 0 6 0 0 0 0 32 6 0 0 0 0 16 0 0 0 
17 0 10 11 12 9 0 15 22 0 0 0 0 0 48 0 7 14 5 7 32 2 0 3 0 0 12 0 0 12 22 0 0 19 0 19 0 
0 0 11 13 3 13 0 12 0 6 4 19 10 6 0 6 0 0 9 0 3 18 13 23 0 0 11 14 0 14 26 0 0 21 16 0 15 
0 0 0 0 0 0 7 10 0 0 9 0 0 0 29 5 16 0 12 7 10 0 0 19 0 0 0 0 0 0 0 0 0 0 0 0 0 
0 0 38 14 32 9 13 27 19 15 7 21 10 18 0 0 17 39 9 25 3 0 0 0 15 11 0 23 9 27 13 20 28 13 42 0 23 
