37 21
0 0 7 7 0 0 33 26 0 13 0 0 0 0 0 8 16 0 2 0 2 0 0 0 27 0 0 0 0 17 0 0 0 26 15 30 0 
11 10 2 16 0 12 29 9 0 0 20 9 12 2 0 0 8 12 0 16 12 20 0 0 17 0 0 0 0 0 17 0 5 0 0 17 33 
1 0 9 14 21 0 12 0 30 13 1 7 0 0 31 0 8 0 6 0 17 0 15 0 4 0 8 0 0 6 22 13 29 0 0 17 0 
1 24 18 2 29 11 6 24 0 0 0 3 11 18 19 19 1 29 11 10 11 0 0 10 0 24 13 0 0 7 4 4 15 29 0 0 7 
16 0 0 4 0 54 0 16 45 1 0 3 2 1 6 0 27 0 0 0 3 0 18 17 0 0 0 8 0 0 22 0 24 28 2 4 0 
28 0 9 3 0 0 2 0 0 5 0 0 0 0 14 0 0 0 0 0 0 12 0 0 12 0 0 0 0 0 0 8 32 0 12 4 4 
0 23 31 0 0 0 0 0 0 11 0 0 11 0 6 0 0 18 1 18 28 0 10 0 26 0 2 0 0 10 5 0 12 0 1 19 0 
0 6 24 7 20 0 0 12 40 6 0 21 0 0 5 1 7 1 0 12 9 5 0 0 29 7 18 0 0 6 22 6 14 9 0 6 34 
15 10 57 24 4 12 15 0 0 0 11 2 6 4 13 3 0 5 40 0 7 2 0 0 11 23 2 1 10 8 1 0 7 1 0 26 34 
0 0 2 0 0 0 23 0 6 0 1 0 0 10 16 17 0 19 0 9 8 10 3 0 4 0 0 3 0 23 8 2 47 11 0 0 15 
10 0 0 5 29 0 28 6 0 0 33 33 47 9 5 0 5 3 0 0 0 5 0 12 8 0 0 9 0 1 0 0 0 44 28 47 24 
0 10 18 0 16 0 23 29 0 0 0 0 0 0 0 0 0 1 8 0 16 8 7 1 0 0 3 0 0 51 0 0 0 12 0 9 29 
21 23 0 0 7 7 0 2 0 0 0 0 4 9 1 9 8 0 0 7 1 28 0 18 20 6 0 24 0 3 0 9 3 10 30 7 0 
0 17 68 0 0 4 30 0 0 20 17 8 12 0 27 1 5 7 0 10 3 5 7 2 52 0 5 40 0 4 28 8 18 4 15 4 0 
13 0 3 0 5 1 0 39 0 6 0 0 17 13 30 0 9 15 23 5 7 13 0 0 5 0 12 4 1 6 0 0 19 26 0 26 27 
0 15 0 18 0 1 24 14 0 0 0 0 1 1 11 10 7 12 7 3 6 14 0 12 15 13 0 11 1 20 25 13 9 1 0 0 20 
15 0 25 8 64 0 0 0 0 13 0 0 33 3 10 0 20 0 0 4 0 0 16 3 0 10 22 31 0 10 0 9 9 2 0 11 32 
0 35 37 0 0 1 0 0 5 3 11 0 0 8 15 0 27 0 0 0 0 4 16 1 17 0 0 3 0 8 0 5 0 0 12 32 6 
0 47 0 0 0 0 0 0 0 11 4 0 0 9 0 0 29 0 1 9 19 11 7 12 9 6 0 0 6 0 0 0 22 8 0 12 0 
65 12 13 11 17 0 6 12 25 20 0 0 11 13 30 13 0 0 1 12 0 7 0 5 0 17 31 27 11 20 0 0 0 33 0 7 0 
87 31 54 0 0 16 0 7 0 0 14 3 26 0 14 5 8 17 13 0 0 0 15 20 14 23 0 27 28 2 0 0 20 30 0 9 7 
