37 21
1 15 32 11 25 0 18 4 12 14 0 4 1 6 0 2 0 9 6 0 12 0 18 2 6 0 0 0 11 0 0 0 17 0 48 12 0 
26 29 2 46 5 0 0 6 7 14 0 7 35 12 46 0 20 15 17 5 12 7 0 8 0 24 26 0 0 0 0 0 0 19 0 32 44 
18 0 0 0 66 0 0 0 0 7 0 19 4 14 0 2 16 2 0 0 8 0 11 14 0 21 7 0 0 0 0 27 0 7 34 0 13 
2 12 8 26 0 33 4 13 0 3 0 4 7 34 0 0 9 0 2 13 5 11 19 24 4 18 0 0 0 24 14 7 12 1 20 0 0 
0 10 1 0 2 15 23 0 7 0 0 0 4 0 0 0 0 0 10 6 0 5 0 18 0 5 0 2 3 23 0 12 0 13 9 15 0 
0 5 2 0 0 2 0 0 0 0 0 0 10 18 0 0 0 0 2 0 0 3 0 0 0 7 11 0 0 9 0 0 5 1 0 0 0 
36 0 1 40 12 13 0 2 1 2 16 4 22 7 18 0 0 18 3 19 0 1 4 1 2 0 16 0 0 0 0 9 1 0 31 8 14 
0 15 3 10 7 29 11 14 0 6 7 0 5 6 6 0 7 12 2 0 6 11 29 0 8 0 0 0 0 0 0 0 8 0 29 0 13 
0 0 27 8 50 9 27 0 7 0 0 21 0 0 2 0 0 0 14 0 0 0 0 7 8 0 0 0 0 42 0 0 36 27 5 0 5 
10 27 18 0 4 18 0 4 0 7 0 16 4 0 0 0 1 0 0 0 11 5 0 18 3 0 1 17 0 0 12 0 12 0 0 34 35 
12 8 0 19 8 0 8 4 2 6 10 6 1 6 10 23 5 6 1 1 25 0 0 22 3 0 6 0 9 14 17 2 13 3 6 0 2 
0 0 0 0 8 20 0 5 0 20 0 3 10 8 8 5 0 0 0 5 0 0 0 0 0 20 6 14 0 17 0 0 0 0 0 0 0 
13 31 0 0 3 30 10 10 27 16 0 0 0 11 0 6 10 8 4 16 13 0 0 0 0 8 0 4 0 0 23 24 0 0 0 19 2 
33 22 18 41 34 21 22 22 18 0 0 6 15 32 8 0 0 2 20 2 28 2 23 30 3 0 0 0 0 26 0 32 6 99 3 0 2 
0 8 29 35 0 15 15 0 7 8 0 0 3 0 0 0 10 15 6 10 16 0 2 3 33 22 0 0 0 2 5 9 4 0 16 8 0 
0 6 1 1 0 15 18 14 0 28 12 10 5 10 0 7 7 4 28 14 0 21 2 0 31 0 19 7 0 24 21 0 0 44 7 11 0 
0 0 0 0 8 0 49 39 0 0 5 27 0 20 14 4 0 15 13 13 3 0 11 16 0 0 11 25 14 0 7 10 11 11 10 0 3 
0 0 0 0 11 4 4 19 0 20 4 23 7 6 0 17 15 0 2 0 0 11 0 10 0 0 6 8 21 33 0 5 20 4 37 27 5 
0 0 0 13 0 0 18 6 0 15 14 16 21 1 13 15 15 0 14 0 6 0 0 0 29 0 8 0 0 0 15 0 0 21 15 0 1 
0 0 0 26 8 2 20 14 0 0 0 0 5 1 0 0 0 5 9 0 0 14 0 0 4 0 20 0 0 0 0 0 0 0 0 15 34 
14 0 0 28 18 0 41 13 14 5 4 0 0 32 0 12 5 11 9 14 0 5 1 6 1 26 0 0 0 0 0 10 0 0 0 0 43 
