37 21
0 0 4 0 19 7 13 35 3 27 3 19 13 13 22 0 22 4 0 3 0 5 27 10 2 9 15 0 0 7 0 0 0 10 27 0 63 
0 0 0 7 19 0 0 16 0 0 0 0 0 0 0 0 0 0 0 0 18 0 0 6 0 0 0 0 0 0 0 0 0 0 0 0 0 
0 25 19 23 0 0 0 0 0 0 9 10 0 12 19 0 0 18 0 0 0 0 2 0 0 31 0 12 0 0 2 0 2 19 29 0 0 
9 29 0 31 0 17 0 27 3 9 0 0 9 1 9 5 6 0 0 1 0 8 2 9 9 21 8 0 0 0 33 15 13 3 20 0 0 
33 0 6 0 2 0 5 0 10 4 15 22 6 27 1 11 0 0 16 7 0 0 22 0 2 2 13 0 15 0 0 18 0 0 0 0 3 
60 0 0 4 18 1 21 0 18 9 0 10 0 20 1 21 0 0 3 0 15 9 32 5 9 1 18 18 8 34 0 4 5 0 5 20 6 
4 0 4 14 30 1 0 2 0 22 0 0 14 15 20 6 0 0 13 6 0 0 12 0 4 3 22 12 0 0 38 0 0 24 34 3 0 
29 7 13 66 0 19 30 27 15 0 2 18 12 1 14 6 7 21 21 0 12 5 11 0 19 1 14 8 26 0 40 5 0 3 20 25 21 
20 0 3 10 0 0 0 22 0 21 0 8 18 0 0 3 8 2 0 6 14 0 0 4 2 5 6 2 7 0 40 0 0 0 6 0 0 
0 2 6 17 0 4 6 1 0 10 2 26 17 1 0 9 10 9 6 6 0 0 19 0 21 6 9 0 0 0 2 20 3 9 0 3 4 
83 0 0 8 0 0 1 11 21 0 6 21 3 0 0 37 16 0 0 4 8 14 0 5 18 0 0 0 21 23 2 31 25 1 20 0 12 
19 0 31 6 19 0 28 0 7 25 0 16 6 1 19 0 0 17 0 22 0 0 0 26 7 0 0 8 0 2 0 0 18 0 53 0 19 
7 0 0 0 0 0 0 0 0 3 0 5 20 2 0 0 9 0 0 4 10 15 1 0 3 13 2 0 2 0 10 5 8 0 0 0 5 
0 18 0 0 0 11 9 0 0 0 9 14 3 1 52 10 0 0 0 0 3 15 0 0 0 24 6 0 27 0 5 0 0 0 0 21 4 
4 7 5 21 4 19 1 19 18 0 7 0 12 37 15 4 0 11 3 8 0 21 0 4 10 22 0 20 0 6 1 5 19 0 0 10 13 
0 0 4 3 0 2 7 0 0 0 0 6 5 0 0 0 8 2 0 2 0 0 0 0 0 0 11 0 0 4 1 0 0 0 0 0 0 
7 1 1 0 15 0 0 26 2 0 6 0 0 0 7 0 8 0 0 17 3 12 11 2 0 7 0 1 9 0 0 12 9 1 0 10 4 
0 0 19 9 0 15 0 0 0 4 0 5 0 0 3 0 6 0 25 2 0 17 0 16 0 0 0 7 0 26 0 17 7 0 28 32 3 
0 0 0 11 0 26 20 8 24 0 0 0 0 13 0 6 0 0 13 2 0 6 15 2 0 0 0 0 0 8 11 1 30 0 0 0 5 
33 29 0 33 50 2 26 5 39 8 9 18 12 10 0 8 9 0 0 11 37 0 0 18 12 26 20 18 1 9 17 0 2 33 7 31 47 
10 0 41 14 19 17 0 0 0 0 4 14 14 0 0 0 14 26 16 0 0 3 0 0 26 4 13 20 13 20 0 0 5 0 0 0 7 
