37 21
12 20 14 6 0 0 0 13 2 51 14 0 31 3 4 5 5 14 16 0 11 13 4 0 7 13 12 0 3 17 0 4 0 0 11 0 0 
2 0 9 12 17 0 0 14 18 0 0 0 0 0 0 0 3 0 1 9 7 39 0 0 12 0 0 0 14 8 0 0 0 14 0 14 8 
0 13 0 6 12 21 17 0 2 3 0 0 0 0 0 38 0 0 13 0 2 0 0 3 0 0 0 4 0 8 0 2 0 2 0 0 22 
24 16 0 0 28 10 9 2 17 1 5 0 8 3 8 0 0 0 0 12 0 28 22 0 0 0 0 0 3 0 24 8 0 0 30 9 0 
43 15 1 0 2 9 2 0 2 37 0 0 9 0 9 28 14 9 9 0 22 0 6 27 2 0 18 0 19 29 29 0 0 7 23 0 27 
0 0 0 0 4 22 16 22 0 3 0 20 6 6 0 0 0 0 0 14 14 1 7 0 4 0 15 19 0 14 0 5 0 0 7 14 0 
0 0 0 6 14 0 6 3 2 0 0 0 8 4 0 3 0 6 1 1 9 0 7 10 12 0 0 15 0 12 0 0 17 0 0 0 0 
0 0 0 22 5 5 0 0 0 0 17 2 0 1 0 0 0 0 0 0 17 0 7 0 0 0 6 17 0 0 0 0 29 0 0 0 0 
0 29 0 19 0 30 0 18 0 11 9 0 3 6 0 4 0 19 0 11 18 0 4 0 20 0 0 4 0 0 39 0 0 6 0 30 26 
25 22 0 4 31 30 0 4 15 0 0 0 24 9 6 18 9 0 0 0 6 0 2 7 8 15 0 4 0 0 6 0 17 0 0 1 18 
21 21 17 16 0 0 9 0 6 4 0 0 5 15 4 0 11 4 0 6 0 17 2 21 5 12 0 29 8 8 12 17 0 0 0 5 0 
0 2 17 58 8 0 19 27 20 31 39 0 20 17 10 9 0 0 0 7 0 6 0 0 15 8 26 15 22 9 0 1 29 17 54 24 24 
0 29 8 0 9 0 6 10 5 0 26 0 6 0 0 4 1 17 0 0 0 0 5 0 7 0 12 0 0 7 30 0 0 0 0 1 33 
0 0 5 12 0 10 17 5 4 0 0 5 17 0 0 0 10 20 0 12 0 13 0 17 0 5 14 0 0 0 11 1 0 8 0 0 0 
14 27 24 26 9 0 19 0 0 0 21 10 4 0 8 36 0 17 17 0 10 0 9 0 6 0 35 0 0 0 0 16 0 16 17 0 0 
0 36 10 0 0 0 5 10 0 8 8 0 1 25 0 2 12 2 18 0 28 0 14 0 5 7 0 7 16 0 0 0 0 16 0 20 37 
0 0 7 0 0 0 0 2 6 8 22 9 5 16 1 13 14 5 1 0 29 0 0 0 0 0 12 3 14 14 21 5 12 15 18 0 3 
0 0 2 19 0 29 19 5 17 4 0 15 17 5 10 0 11 2 11 6 15 6 0 0 8 0 4 22 22 0 21 0 37 0 20 27 0 
0 0 12 0 45 0 4 29 15 18 0 27 0 28 0 0 12 0 0 0 0 9 13 15 0 7 0 7 4 7 3 0 4 15 0 12 2 
0 5 0 0 14 0 5 0 18 0 0 0 19 0 2 0 8 2 12 12 11 16 9 0 7 0 0 0 0 13 0 0 0 0 0 0 4 
52 11 8 0 0 19 31 12 39 11 9 0 17 12 16 0 4 0 22 36 33 0 16 11 20 25 0 6 0 15 33 10 12 5 16 37 0 
