37 21
28 58 46 0 14 28 40 0 18 4 27 0 0 3 16 0 0 0 0 24 14 23 5 0 0 19 29 0 26 0 0 9 0 27 89 0 34 
18 43 0 12 0 0 5 36 1 0 58 0 23 27 1 0 9 0 30 0 7 0 0 20 0 3 16 0 0 19 0 3 0 28 15 64 1 
26 6 0 20 22 0 7 15 0 0 0 8 0 7 14 0 18 14 17 1 4 4 15 14 8 2 50 19 1 0 0 8 8 0 0 0 12 
0 5 1 1 19 0 0 17 14 0 0 14 17 0 5 0 0 1 0 0 0 17 0 1 0 18 0 0 1 0 0 0 0 13 0 0 0 
0 0 0 0 0 17 37 29 10 0 23 0 0 7 8 17 0 12 18 0 29 18 32 1 2 3 0 0 11 0 0 12 33 18 2 26 40 
4 2 0 19 18 21 1 19 0 5 0 16 14 0 15 2 0 2 0 15 0 16 13 19 21 0 26 16 0 6 0 0 0 0 0 0 13 
19 6 11 0 0 0 1 0 0 0 0 0 0 2 0 0 3 0 12 13 19 0 1 0 0 3 0 2 5 0 12 9 5 0 7 0 0 
4 0 0 11 2 0 0 26 10 14 18 0 0 8 5 0 0 19 0 5 0 15 0 14 0 0 0 5 18 0 0 3 0 38 0 0 19 
2 51 13 0 9 5 0 0 62 17 23 7 0 6 3 7 11 15 0 16 0 12 0 0 5 0 0 27 20 0 0 30 13 0 33 8 0 
36 24 25 16 9 26 11 8 10 25 9 10 0 0 0 0 0 0 23 0 0 17 14 0 0 22 0 36 9 24 0 22 3 0 58 11 17 
0 10 10 5 10 7 0 19 14 8 4 1 0 0 0 0 9 0 2 0 11 5 12 0 0 0 0 0 3 0 0 28 4 0 31 0 0 
16 0 0 7 27 0 14 0 3 3 0 3 1 0 0 0 0 0 6 5 20 0 5 0 0 0 0 0 4 0 0 46 0 0 0 0 0 
0 25 0 0 10 28 5 0 0 8 0 5 13 0 22 0 0 0 13 0 49 0 3 6 0 8 0 7 8 20 34 0 9 0 0 0 11 
0 19 17 29 0 13 0 0 0 8 0 0 0 0 0 5 0 0 12 35 21 0 14 12 0 0 0 8 0 3 0 0 29 0 12 12 0 
15 8 0 2 0 7 0 15 3 0 0 6 5 9 0 6 3 20 0 0 4 10 15 0 0 0 0 5 15 5 0 11 10 1 0 13 12 
0 43 0 26 1 1 0 14 6 0 2 21 0 0 0 32 0 5 6 0 2 20 5 8 17 18 0 0 0 0 27 23 38 1 14 11 0 
0 19 20 0 85 31 24 22 28 0 0 0 0 16 15 2 16 16 14 16 1 9 12 11 0 0 0 2 12 15 3 28 28 13 0 16 49 
0 40 0 0 76 23 1 0 4 0 3 9 16 10 0 0 7 1 2 17 5 5 21 3 0 0 9 3 18 5 23 10 28 16 8 0 0 
0 0 0 4 10 0 0 3 0 8 0 0 4 0 6 5 2 0 8 0 8 0 0 0 0 0 8 0 10 0 0 16 0 0 0 0 0 
0 0 0 23 12 7 17 10 8 0 4 0 7 5 0 6 18 0 0 5 0 29 0 0 7 0 28 0 0 11 0 5 0 12 5 6 0 
0 48 0 23 3 26 11 37 26 0 0 3 32 9 25 7 0 0 17 1 0 14 0 0 7 0 0 0 2 21 20 33 0 14 22 4 33 
