37 21
9 0 7 16 0 6 0 0 28 28 0 6 3 0 15 2 18 16 0 10 5 11 0 0 0 3 7 0 0 1 9 0 23 16 31 10 37 
0 6 17 32 24 0 15 0 0 0 12 0 2 0 5 26 3 6 0 14 28 32 30 16 0 4 11 8 0 0 0 0 17 0 0 22 34 
11 9 0 0 32 6 0 15 25 22 1 0 0 0 9 30 12 9 0 0 7 8 15 0 11 0 0 5 13 7 0 22 9 16 4 18 15 
0 13 0 4 0 0 24 0 0 0 0 0 13 0 0 0 19 11 6 0 0 16 0 0 18 16 0 0 0 19 0 6 0 0 5 0 0 
32 14 8 0 0 0 4 17 8 0 8 0 0 0 14 1 63 3 2 0 0 0 0 0 24 0 12 13 0 0 0 6 32 0 10 13 20 
6 0 21 0 0 0 2 10 0 0 0 0 0 7 16 18 9 0 0 13 5 0 0 4 1 10 0 0 21 6 1 0 0 3 0 0 3 
12 0 0 0 19 0 11 0 0 0 7 5 6 0 13 11 5 19 2 6 0 7 2 31 0 0 15 2 0 5 7 0 0 14 33 8 0 
25 24 10 4 6 0 0 0 0 0 13 0 5 0 3 0 3 0 6 0 0 0 0 11 18 14 7 0 3 6 0 1 1 2 0 6 0 
6 0 6 0 0 9 6 14 5 0 0 37 6 3 9 0 1 16 0 0 0 21 5 3 0 19 0 5 0 9 0 0 9 0 12 10 33 
0 0 30 0 2 10 0 10 0 20 0 0 0 0 14 16 1 0 11 0 0 0 0 0 0 20 0 7 14 22 0 6 30 0 7 0 0 
0 9 0 0 0 0 0 0 23 3 14 17 10 0 3 0 26 1 0 16 3 1 6 15 8 3 0 0 11 19 4 39 14 1 1 10 1 
8 23 0 0 29 20 6 0 24 11 2 21 8 0 12 3 22 37 10 3 0 9 13 3 0 23 0 10 0 1 0 1 29 0 7 36 0 
13 0 7 22 20 1 4 0 0 0 2 17 5 8 8 0 11 29 24 1 5 6 8 6 0 27 0 11 17 0 5 2 0 16 16 7 16 
36 0 0 0 28 0 0 0 17 0 0 0 5 19 0 0 4 0 6 20 1 19 22 7 2 17 7 0 0 0 7 10 44 0 0 3 3 
26 13 1 12 0 24 0 14 0 29 38 0 12 13 13 4 32 0 0 0 34 10 13 18 19 14 7 16 0 0 4 4 0 23 3 8 0 
3 0 17 0 0 2 27 0 0 0 24 0 12 0 0 10 0 0 0 17 1 7 0 3 15 1 0 0 0 14 0 26 26 1 4 0 0 
10 0 28 0 0 0 8 11 2 11 19 20 0 0 8 12 0 0 0 4 0 0 0 21 0 0 12 14 6 18 20 0 21 0 0 0 39 
11 0 26 26 0 31 0 19 0 17 3 19 0 14 0 8 14 9 5 8 0 0 0 29 0 0 18 48 26 31 0 0 0 0 0 13 0 
13 36 2 0 26 0 14 2 12 5 2 0 17 0 0 4 32 2 3 0 33 3 0 8 11 32 0 10 0 17 0 0 10 0 0 25 16 
13 35 5 23 1 12 0 10 13 50 3 25 8 0 0 33 0 11 0 2 3 16 7 36 1 0 0 12 0 0 30 0 23 0 0 1 13 
0 0 0 0 0 0 20 2 0 4 3 0 0 0 0 0 16 0 0 4 13 0 0 0 1 0 20 0 0 9 0 2 0 15 0 1 0 
