37 21
22 0 4 20 0 17 0 7 14 6 0 12 0 11 21 0 19 1 0 14 0 9 42 32 13 0 0 0 14 0 12 0 0 3 11 0 0 
10 0 0 0 0 0 0 7 12 5 4 5 1 1 7 9 4 1 7 17 3 0 0 4 7 0 10 0 4 9 0 4 0 22 0 10 32 
0 27 4 0 0 0 3 6 13 0 0 5 0 18 0 29 5 0 1 0 0 5 8 0 9 0 0 0 5 6 15 0 0 19 0 0 0 
11 0 0 0 17 0 9 34 26 0 0 16 7 24 1 0 26 0 0 11 0 0 9 3 0 0 0 13 24 22 3 0 5 25 17 0 0 
10 5 36 0 43 2 0 20 1 0 0 0 0 9 11 8 0 13 7 0 19 8 17 22 0 0 0 0 2 0 17 11 4 0 32 13 24 
23 0 0 0 32 31 0 9 3 0 4 0 6 15 0 16 8 0 11 0 0 6 0 29 8 0 0 11 5 1 1 26 0 0 0 0 32 
15 26 2 22 0 2 0 12 5 17 8 0 14 3 2 0 9 0 1 0 0 0 0 4 0 37 0 2 0 3 5 0 23 28 0 0 0 
27 0 15 0 0 30 9 2 12 27 0 0 34 0 0 33 0 38 1 6 13 7 13 0 12 2 0 14 5 20 13 16 3 28 0 30 0 
1 25 0 0 8 0 5 0 12 3 0 20 8 0 3 0 3 2 3 17 7 10 6 6 6 0 0 16 0 3 10 0 0 21 20 0 0 
15 17 0 0 0 0 0 0 0 13 0 0 22 6 4 0 16 8 18 0 0 0 5 7 3 3 1 0 6 0 0 31 0 4 8 0 2 
25 0 0 0 3 0 2 0 17 0 4 0 5 20 0 0 0 19 1 0 0 9 0 4 0 13 0 0 6 0 0 5 2 0 2 3 14 
0 34 0 6 0 6 0 25 17 5 0 5 9 16 11 0 2 0 2 14 15 0 11 0 23 0 8 3 4 5 15 9 7 0 14 42 9 
29 6 12 7 22 0 19 0 24 0 4 0 0 11 12 0 0 0 0 7 1 0 11 0 8 5 38 4 0 29 0 0 24 1 0 0 0 
0 0 9 27 25 9 0 0 15 10 1 14 3 10 9 0 0 0 0 9 0 7 0 15 0 16 0 5 7 25 34 5 0 10 5 3 12 
0 0 0 31 0 0 12 5 27 19 0 0 0 0 0 0 5 0 0 9 0 5 17 0 12 0 0 0 0 0 0 0 10 0 9 27 22 
0 51 12 0 15 26 0 6 14 4 0 6 8 2 1 0 0 0 14 18 14 4 0 0 5 0 0 0 3 0 0 39 22 0 19 0 0 
6 0 7 0 10 11 32 14 0 7 12 20 3 20 2 0 10 0 11 8 0 2 0 7 0 9 3 15 0 0 0 19 0 22 27 10 0 
0 29 0 0 13 4 0 23 0 9 0 24 0 0 5 7 0 13 12 6 0 0 17 0 17 2 0 0 4 9 18 1 0 9 0 24 0 
0 34 0 0 3 0 0 5 0 15 0 0 13 0 0 6 25 2 0 3 0 4 0 16 15 9 0 0 0 17 0 0 0 0 0 34 0 
32 15 23 11 13 17 6 5 12 6 0 4 4 0 0 0 8 0 13 0 0 5 16 2 6 31 2 0 6 0 0 13 11 0 9 8 11 
16 34 0 0 0 0 18 24 17 0 0 7 47 17 3 0 2 2 0 6 15 0 8 0 13 0 0 0 13 22 16 32 20 0 9 22 0 
