37 21
0 0 0 38 8 0 0 0 0 0 16 16 8 0 19 7 0 3 18 9 0 0 7 0 0 6 2 16 12 0 10 0 0 5 0 51 18 
2 12 12 3 0 19 0 10 0 9 0 0 1 15 0 0 19 0 9 6 0 10 0 0 22 0 19 0 0 0 0 12 0 5 0 0 0 
11 0 23 0 0 29 0 16 0 14 0 18 1 0 3 0 0 3 7 0 1 7 0 4 11 23 1 0 0 0 0 0 27 10 0 0 0 
0 0 27 0 0 12 0 18 11 19 10 0 7 4 0 17 1 4 0 0 7 0 15 2 0 2 1 27 34 32 17 0 0 0 0 0 0 
1 0 22 5 28 0 0 2 17 0 8 25 3 19 0 0 1 0 8 1 8 0 12 0 0 23 8 0 9 3 14 0 10 0 4 0 25 
19 15 1 9 22 13 13 0 25 0 11 2 3 0 4 10 19 3 1 30 20 11 0 0 9 0 14 0 0 0 13 5 1 5 0 35 40 
15 0 8 6 6 0 0 0 8 0 21 0 0 22 14 0 8 0 0 9 0 8 0 0 37 0 0 11 0 0 2 4 0 19 0 30 17 
4 21 13 0 6 13 37 0 10 11 0 1 0 0 8 14 0 0 0 1 0 1 0 0 0 7 0 6 0 4 0 3 0 6 0 0 23 
0 33 0 33 8 0 24 0 0 2 12 0 3 3 0 0 0 0 4 0 0 15 0 4 4 19 0 0 0 28 26 0 0 0 34 14 33 
0 4 0 0 17 0 16 0 21 8 0 0 22 3 0 4 15 9 0 3 0 24 16 0 0 7 0 0 0 4 2 10 5 29 11 23 0 
16 14 9 0 5 15 0 0 0 12 17 1 7 1 0 14 0 15 0 23 1 1 7 0 8 5 16 0 2 0 10 4 17 0 3 1 0 
1 43 0 9 1 0 0 4 4 0 9 0 4 9 0 0 0 16 5 3 0 7 0 0 0 0 7 0 7 28 9 0 0 23 0 0 0 
21 2 26 7 15 6 0 7 3 17 3 7 15 0 6 0 16 14 0 0 8 5 0 10 3 6 9 48 63 24 0 3 22 28 5 8 0 
0 5 0 0 6 32 39 13 15 22 17 0 0 4 0 7 6 20 0 13 17 0 7 18 17 0 0 11 0 0 21 0 1 0 0 8 30 
18 6 0 31 41 0 2 12 39 0 8 0 0 27 10 7 0 15 0 18 0 16 19 8 15 0 14 1 0 0 0 26 15 7 0 1 6 
0 36 0 2 19 2 0 6 10 13 9 0 0 0 8 1 0 14 0 16 0 0 19 0 0 0 3 7 24 10 8 14 0 0 7 34 14 
35 3 26 0 46 0 21 0 9 15 18 16 0 6 0 2 9 9 18 7 0 0 0 10 8 9 2 37 26 4 12 9 22 19 10 4 0 
37 19 0 17 0 0 4 0 22 8 0 0 0 8 0 28 16 0 0 0 36 0 29 15 0 0 0 0 14 14 0 0 0 3 0 0 15 
0 31 12 0 4 32 0 16 0 6 10 16 0 0 22 0 0 0 0 4 11 0 28 3 4 0 8 0 0 15 0 5 32 27 0 0 1 
22 0 9 16 0 0 0 5 8 46 0 7 4 0 33 0 10 0 0 17 0 0 0 0 14 12 10 0 19 0 0 0 5 0 0 19 38 
52 33 13 49 17 32 7 0 4 7 3 0 15 0 0 10 48 2 3 8 16 9 26 7 0 0 77 0 27 21 9 19 0 21 57 0 0 
