37 21
0 15 28 0 17 0 8 0 0 0 0 19 0 0 0 0 11 0 5 0 0 0 0 11 0 0 0 6 0 0 26 0 0 0 0 0 0 
0 4 11 20 21 5 0 21 8 10 5 22 12 20 0 3 16 2 8 1 16 13 0 6 0 28 37 13 5 3 0 5 37 16 27 0 11 
5 7 0 28 0 29 0 0 7 0 0 36 24 0 0 14 5 37 0 2 0 18 17 11 5 0 10 17 0 29 2 0 0 0 0 0 19 
0 0 0 0 0 3 0 0 7 0 6 0 7 0 0 5 0 0 0 0 19 0 5 0 0 0 0 0 15 0 0 0 0 15 0 0 0 
4 11 0 63 0 0 34 7 3 19 2 14 14 9 3 2 13 3 0 0 7 1 11 9 9 3 9 0 44 3 8 4 0 28 31 4 0 
5 0 11 6 29 26 7 55 12 0 10 10 0 21 21 4 0 6 0 1 17 0 5 0 0 10 21 5 0 8 0 1 0 35 27 87 0 
9 0 0 0 13 8 0 0 12 9 0 7 4 0 0 0 11 4 2 0 0 2 17 8 0 0 0 6 5 8 0 0 0 0 0 13 0 
0 0 0 22 24 7 1 7 0 15 1 0 25 8 0 10 12 11 0 0 0 7 3 26 0 12 0 0 24 15 13 0 20 0 29 0 0 
4 0 0 0 10 0 29 0 2 0 0 0 0 9 10 3 13 29 0 0 1 3 21 9 0 0 7 0 0 34 13 0 0 16 0 0 0 
0 0 21 2 0 7 5 0 4 1 17 0 4 0 0 0 2 0 0 0 0 0 0 12 0 0 0 0 0 9 0 0 9 23 8 15 0 
29 0 25 0 8 6 17 13 7 15 2 6 9 0 0 5 0 0 11 0 18 9 4 6 0 18 0 25 0 12 0 0 0 3 16 6 2 
9 32 24 0 2 12 23 0 0 0 6 22 22 9 17 3 21 21 0 0 0 0 3 0 0 0 0 0 0 16 11 21 2 10 13 11 0 
3 13 22 14 27 0 0 11 20 2 7 0 0 8 7 8 0 8 0 1 0 16 8 5 3 0 32 0 6 5 20 0 15 29 12 1 0 
0 0 23 7 5 0 0 0 21 0 0 0 6 14 6 0 0 0 13 0 7 0 19 0 21 0 24 12 0 23 0 0 2 3 14 0 0 
5 0 0 0 0 0 0 25 0 2 0 0 0 6 0 0 0 0 0 4 5 19 9 0 0 0 2 13 4 0 0 37 0 5 4 26 0 
0 0 3 10 0 3 0 0 16 0 0 19 16 1 8 0 0 7 9 3 10 0 6 3 22 10 2 3 27 0 11 0 0 14 0 0 0 
0 11 4 0 25 8 29 23 0 0 0 14 27 4 0 0 0 0 6 0 1 0 17 0 6 0 19 0 16 27 0 0 4 0 4 46 0 
15 0 0 57 0 12 0 0 25 20 3 3 15 7 0 0 16 4 8 0 15 0 0 14 3 4 2 14 0 52 0 2 0 25 0 3 10 
0 0 7 31 5 23 0 0 1 7 40 0 23 0 3 0 31 19 0 2 3 0 0 0 0 8 3 8 40 38 1 18 10 22 15 32 0 
28 0 8 0 14 2 0 0 0 0 0 11 1 0 7 0 9 0 1 4 5 8 0 20 7 12 1 1 0 22 19 5 0 4 30 10 5 
10 1 23 0 10 5 0 0 0 19 16 3 36 24 0 15 0 0 0 0 13 0 7 16 18 0 16 0 2 10 18 0 19 0 10 25 0 
