37 21
12 47 0 31 30 0 46 8 0 15 0 0 19 0 0 19 7 17 0 42 19 0 0 0 10 9 0 0 0 53 2 18 1 1 44 4 3 
12 6 11 5 0 24 0 19 10 16 15 15 2 37 11 9 1 7 5 0 3 19 10 10 38 1 12 13 15 21 0 5 18 0 9 20 23 
16 7 18 18 0 0 30 0 42 5 0 0 0 0 0 0 2 7 16 0 0 18 0 11 16 0 0 19 26 0 0 4 0 0 9 0 33 
0 28 3 0 0 1 0 0 17 7 17 2 6 0 6 0 0 8 0 0 7 5 10 10 2 8 8 0 0 13 0 0 0 0 0 19 10 
6 1 27 7 3 57 7 3 0 2 25 0 2 15 17 0 5 33 0 3 1 26 0 8 5 16 5 14 7 46 3 69 29 16 25 4 8 
0 0 21 13 4 0 3 0 8 14 0 0 0 2 0 0 39 0 14 3 0 0 6 19 0 0 0 5 9 0 0 0 11 0 18 0 3 
33 0 14 0 5 2 0 0 1 0 0 0 14 0 20 0 0 0 31 17 0 0 0 11 26 19 0 0 0 1 1 15 4 5 55 30 12 
6 0 0 44 0 18 40 2 0 6 1 0 0 24 0 0 3 6 9 7 0 0 9 0 13 20 0 9 24 16 27 0 0 1 0 34 0 
49 11 0 4 29 0 48 3 0 0 0 0 0 0 0 11 4 10 7 0 9 0 0 9 4 19 0 21 10 0 0 19 19 24 28 6 0 
0 18 0 26 39 0 5 9 3 6 17 0 21 6 0 11 16 4 0 15 12 2 0 7 0 0 2 19 2 35 26 27 19 0 14 0 0 
4 0 8 38 1 0 0 3 0 4 0 0 0 10 0 5 8 0 8 3 5 0 19 0 0 10 7 0 0 16 5 0 4 0 0 15 0 
0 6 0 24 0 0 16 22 0 3 0 0 5 0 0 0 11 0 6 13 22 4 12 8 0 4 0 4 6 3 0 0 9 0 21 1 9 
0 7 8 0 31 0 7 0 26 0 19 0 23 1 0 0 0 8 6 6 9 0 0 0 0 6 7 8 0 19 0 3 0 7 13 47 8 
0 0 0 0 0 0 0 51 0 0 0 3 7 18 0 0 0 6 0 9 0 0 13 11 0 0 0 0 6 0 0 0 6 0 0 13 29 
0 14 0 23 0 0 14 19 0 13 0 0 0 0 16 0 0 0 7 2 0 10 0 0 0 0 23 0 9 7 12 0 25 0 0 0 0 
0 18 7 0 26 0 14 25 0 1 11 0 10 7 0 0 4 10 9 27 0 0 1 0 0 0 0 19 0 4 26 15 3 27 0 14 9 
0 24 0 0 23 7 9 8 0 2 10 27 11 23 0 8 0 6 0 0 12 0 17 18 11 8 1 19 5 0 16 6 0 0 10 13 0 
2 0 2 0 0 0 13 6 0 0 13 0 17 0 0 0 0 16 0 0 0 0 0 2 13 0 7 0 0 0 0 13 2 0 2 0 13 
53 0 0 30 0 0 11 17 18 0 23 19 18 18 0 0 1 24 24 0 8 0 0 6 24 14 0 0 7 0 22 10 1 23 26 10 0 
11 14 15 12 13 0 0 6 0 14 16 0 0 0 7 55 0 13 14 18 6 19 0 0 18 20 0 0 14 0 0 0 0 0 9 15 34 
2 1 0 0 0 30 0 0 0 0 0 0 16 0 12 0 25 0 19 20 9 27 4 0 13 0 12 0 0 8 0 13 0 0 0 20 0 
