37 21
10 10 0 27 34 0 4 15 0 0 14 0 8 6 22 39 0 0 0 15 27 0 14 18 0 2 8 0 45 14 0 11 0 18 0 0 21 
0 0 9 0 6 23 29 7 13 30 13 15 21 0 0 19 15 18 0 0 3 16 0 0 0 0 25 7 0 0 0 15 0 0 8 30 0 
17 0 25 34 18 0 14 7 0 0 0 0 0 0 10 3 3 11 3 1 14 0 0 7 8 0 10 0 1 0 0 0 0 14 0 0 33 
0 0 0 1 0 0 0 0 5 16 0 1 1 16 0 21 14 1 0 3 0 0 8 13 0 0 0 0 24 7 22 0 0 0 6 1 32 
28 1 15 0 0 11 2 0 27 39 0 0 0 0 2 1 14 15 6 9 7 12 13 1 6 0 0 7 0 29 0 0 0 19 3 25 28 
0 34 15 0 5 0 27 0 5 4 8 0 4 1 0 0 10 11 0 0 0 3 0 20 0 0 10 0 7 23 0 30 1 1 0 12 10 
3 0 1 19 0 7 6 0 2 4 0 0 2 5 22 19 3 0 12 19 0 0 10 13 6 0 0 0 1 17 6 0 18 0 44 26 13 
24 22 32 0 10 0 0 2 22 16 0 0 0 0 0 11 0 19 0 4 1 0 8 36 44 0 10 0 9 0 4 0 0 0 56 0 1 
17 62 19 45 29 12 24 8 7 4 35 8 12 0 15 10 8 6 10 2 5 42 9 21 13 2 6 7 0 55 17 20 28 24 23 6 14 
19 4 0 3 0 0 1 11 14 20 8 12 5 14 5 11 10 0 11 19 1 17 11 0 3 0 15 12 0 20 0 13 0 0 0 9 1 
53 8 4 0 8 0 26 19 0 17 0 13 0 0 8 22 0 0 1 0 13 2 0 8 17 0 32 0 0 0 0 0 0 42 8 0 35 
3 24 0 2 11 23 22 3 41 5 3 25 5 0 0 3 0 3 14 18 0 0 0 10 16 0 0 0 27 9 7 21 0 14 11 17 21 
0 1 17 17 0 8 0 0 9 20 0 13 1 5 0 13 0 6 1 5 17 7 0 1 0 0 3 0 19 9 0 20 0 0 0 12 1 
0 0 0 26 0 14 0 0 0 1 0 5 14 10 0 5 0 22 0 23 6 0 0 15 5 0 14 0 1 2 0 0 0 7 0 0 13 
0 4 8 0 9 11 27 0 15 22 22 2 21 8 8 11 0 0 26 1 0 1 15 0 24 0 20 1 1 8 1 22 0 27 0 0 24 
0 19 24 0 0 4 0 0 3 0 0 0 0 19 0 14 18 0 0 0 0 0 7 0 23 0 29 0 5 0 0 0 19 0 0 0 8 
14 47 0 0 0 25 1 0 0 26 23 15 8 3 3 9 8 7 28 18 3 0 0 11 0 0 0 0 0 0 59 0 2 36 9 28 0 
0 0 0 0 2 37 0 5 0 7 0 25 13 8 9 0 1 0 1 25 0 0 13 10 0 3 9 0 3 0 0 0 6 28 11 8 25 
0 0 27 12 0 0 0 0 0 0 0 0 0 0 0 20 0 0 12 1 0 0 0 6 11 7 0 0 0 31 0 3 0 0 12 28 0 
9 0 7 2 27 26 9 8 25 9 0 0 13 3 0 12 0 6 0 18 0 11 1 0 0 0 9 0 0 0 8 27 11 56 8 0 17 
9 25 0 2 0 18 0 0 5 13 0 0 6 0 12 10 0 2 6 17 0 0 13 20 0 0 0 0 36 1 0 0 0 7 0 0 0 
