37 21
0 0 5 17 0 15 34 12 7 21 21 0 14 0 3 17 15 0 10 0 5 0 0 0 0 0 14 20 15 15 21 6 0 5 0 13 4 
19 4 0 4 0 10 0 0 0 1 8 9 0 0 11 17 0 0 2 16 16 11 0 0 0 0 5 0 0 0 14 0 13 0 0 1 1 
32 13 8 5 0 1 0 24 20 15 0 0 4 0 13 1 0 0 14 0 0 13 47 0 37 14 29 4 9 0 4 13 4 5 2 13 2 
26 6 10 16 0 0 18 3 1 25 10 0 0 0 24 0 52 0 16 0 0 10 3 5 9 11 9 0 0 5 16 0 2 0 16 0 34 
0 0 42 16 3 2 4 5 25 1 3 3 0 6 24 1 0 1 10 11 0 6 0 0 6 38 19 6 8 0 2 0 0 14 21 35 11 
7 4 0 23 0 0 0 0 0 1 11 0 12 8 0 0 0 0 0 0 2 0 0 0 3 0 23 3 0 0 0 21 0 0 0 1 5 
36 0 8 0 0 0 10 28 0 19 13 2 12 0 11 3 10 0 0 0 0 12 1 0 0 7 4 4 26 15 1 0 0 18 0 51 57 
35 0 5 0 0 7 0 4 0 0 27 0 5 25 4 0 0 0 0 15 7 0 0 0 13 12 20 2 1 8 0 0 0 0 2 43 2 
0 0 6 0 27 10 35 1 9 12 18 2 14 2 0 4 0 0 0 13 7 12 0 10 0 4 0 0 5 5 2 0 19 0 0 31 1 
4 0 0 0 0 0 0 16 5 27 30 0 0 3 0 19 3 0 3 0 0 0 0 0 20 10 0 2 0 0 15 0 0 0 0 25 26 
0 0 0 0 0 0 0 0 8 0 0 0 0 8 0 0 0 0 0 15 9 8 0 0 3 0 0 5 0 0 0 0 0 0 8 6 8 
0 0 3 0 0 5 4 0 22 0 0 2 0 2 0 0 0 9 0 12 0 2 0 6 0 30 9 0 0 7 30 12 0 0 0 9 0 
10 0 0 0 3 0 17 0 21 0 18 0 5 18 22 11 13 0 0 0 12 4 6 8 9 0 0 7 1 34 6 18 0 27 13 0 22 
26 0 1 9 0 0 0 0 0 0 11 4 0 8 0 12 11 0 2 0 0 4 10 0 7 1 23 11 0 3 0 0 3 0 0 18 0 
6 5 16 3 22 3 1 2 15 0 17 11 6 0 6 4 0 15 0 6 1 0 18 0 0 3 37 10 0 3 18 12 3 0 7 2 5 
26 29 0 0 14 1 38 0 1 1 29 0 0 5 1 1 32 0 5 0 0 0 13 12 9 19 25 0 0 22 60 0 0 17 0 20 14 
47 0 0 0 12 0 0 0 29 13 10 7 8 0 0 0 0 0 20 0 0 14 0 15 0 2 0 0 2 0 3 4 0 33 0 14 7 
3 12 18 3 13 2 0 14 13 0 0 4 11 12 13 10 0 0 14 0 30 14 17 15 5 16 0 2 0 11 3 6 4 0 7 3 38 
0 0 0 0 0 10 13 13 0 17 0 0 0 0 0 5 0 9 15 12 24 0 0 10 0 7 23 8 2 0 0 0 0 10 0 7 0 
12 37 23 17 0 20 1 5 18 0 9 0 7 12 0 23 13 18 31 24 16 13 0 11 7 36 29 4 9 0 31 13 5 28 0 18 45 
66 1 33 0 0 18 12 16 24 0 0 0 4 22 46 9 0 1 11 0 19 6 18 18 5 13 1 25 19 0 0 4 43 0 0 11 17 
