37 21
29 30 0 21 0 0 0 0 0 0 29 3 0 12 1 12 5 18 0 6 10 3 0 0 47 0 0 12 0 21 0 27 0 0 10 0 12 
25 44 0 0 34 1 0 0 0 1 22 0 19 0 6 18 8 0 13 0 0 15 8 6 8 26 1 13 28 0 0 3 61 29 19 0 0 
22 0 0 0 24 1 0 0 8 1 14 0 0 0 21 0 0 0 9 0 4 0 7 0 14 0 0 5 0 11 5 4 0 2 0 21 0 
19 0 0 13 26 35 2 5 2 0 0 3 9 0 0 24 0 0 10 19 12 0 12 0 5 0 16 9 24 7 0 0 0 10 0 0 44 
2 0 13 0 0 0 0 0 0 0 0 24 3 0 0 4 0 0 0 3 0 0 0 2 11 3 1 0 17 9 0 12 0 0 0 24 0 
1 0 17 0 6 9 0 0 11 0 13 0 0 9 9 3 12 18 32 49 10 0 8 1 5 17 0 1 28 0 3 0 13 0 34 18 18 
1 0 24 9 18 54 1 1 20 0 15 6 3 0 8 7 18 0 0 15 44 0 2 19 10 0 7 0 0 0 0 35 32 28 0 0 28 
0 33 0 8 6 0 7 6 0 7 0 21 11 0 18 4 0 0 5 0 4 0 0 11 17 0 22 2 0 0 0 4 13 0 36 1 0 
17 11 13 10 18 0 0 0 0 37 0 0 29 10 36 20 0 28 3 15 0 0 18 17 5 9 0 0 17 3 14 17 1 10 4 4 2 
12 28 0 0 0 0 17 0 21 0 2 0 15 1 18 2 0 15 0 5 10 0 0 23 5 0 0 19 0 34 9 0 29 9 13 0 9 
0 5 21 31 0 0 5 0 18 25 5 0 4 0 2 8 0 0 17 5 3 12 14 23 0 6 4 0 31 0 25 0 6 11 44 9 0 
0 0 0 31 6 0 0 4 5 3 11 16 2 0 0 19 10 6 9 0 9 11 0 6 11 1 6 4 0 32 7 0 9 0 9 43 6 
0 65 0 1 0 0 5 7 0 0 0 8 29 7 7 0 0 2 0 10 11 8 0 18 6 3 6 5 13 0 0 0 29 37 0 12 23 
0 0 0 0 14 0 1 0 0 0 6 1 2 27 0 7 0 0 14 4 0 3 7 2 0 3 5 14 0 11 7 0 0 0 8 0 0 
0 12 19 0 22 3 44 14 23 3 0 2 3 14 0 0 3 8 9 9 0 0 0 16 0 5 22 7 0 6 29 0 0 11 0 27 0 
0 24 0 8 0 0 0 24 0 2 3 8 7 0 21 0 0 0 5 0 18 0 3 30 23 2 0 15 0 22 23 19 25 32 0 34 22 
2 57 0 13 21 0 24 0 0 24 0 0 9 3 8 0 13 0 0 11 0 12 0 0 11 19 13 0 15 0 49 1 7 14 4 34 0 
1 0 10 0 2 16 17 0 11 0 5 0 0 18 0 0 0 0 3 10 0 0 0 0 5 9 0 5 22 0 0 18 0 0 6 0 0 
1 10 96 0 20 4 0 0 4 0 6 6 8 0 0 19 6 7 0 18 8 6 12 0 27 9 0 8 17 2 5 15 1 25 44 1 25 
18 0 23 0 19 16 0 0 0 0 11 6 5 3 2 4 24 11 26 0 0 17 0 7 0 8 5 0 11 0 0 4 0 0 0 4 21 
0 8 18 0 0 0 39 13 2 20 0 0 0 0 0 0 0 0 18 0 19 0 0 12 9 0 2 0 0 0 7 11 11 18 8 12 0 
