37 21
8 0 30 0 0 0 0 0 18 10 0 0 4 6 18 0 0 13 0 5 3 0 0 0 21 0 7 0 0 0 32 0 30 13 0 0 0 
0 17 4 0 3 14 25 0 26 15 21 0 11 17 23 0 2 18 0 17 0 17 0 0 0 0 21 22 22 0 0 14 46 29 30 18 17 
10 0 61 19 0 6 24 4 4 23 10 0 0 10 9 0 0 13 2 17 2 9 3 9 8 0 16 0 0 0 21 19 58 31 0 4 14 
30 33 0 0 0 0 12 0 0 0 19 16 0 0 3 0 4 3 12 3 0 0 3 0 0 0 20 29 1 30 30 0 19 0 32 1 0 
35 26 0 14 13 5 0 0 27 17 26 0 4 0 22 8 2 41 2 0 4 0 21 15 0 0 0 16 0 1 26 0 23 0 33 0 45 
23 0 8 0 4 4 0 46 40 2 17 9 2 15 2 15 2 12 0 0 3 0 18 18 9 11 18 0 38 7 17 3 17 26 0 0 47 
0 0 0 2 0 27 3 10 27 11 0 0 0 17 1 0 0 9 0 0 8 7 1 0 11 0 6 7 2 8 6 23 27 0 7 0 0 
10 0 0 0 5 6 0 28 0 9 7 7 4 0 4 0 13 16 0 6 0 8 9 0 0 6 7 0 0 0 0 4 0 0 0 34 0 
0 0 0 5 36 28 2 0 2 0 12 18 7 3 0 0 15 0 5 0 6 0 5 0 6 0 0 7 3 15 1 4 3 29 18 2 8 
18 17 28 15 48 5 27 8 0 0 20 13 0 0 0 0 0 7 10 0 0 0 18 0 29 2 0 44 0 11 8 0 35 9 0 0 0 
0 0 17 0 0 0 0 15 0 16 25 14 11 22 3 0 9 0 7 30 0 0 15 0 0 8 0 0 0 7 5 0 13 9 5 66 6 
0 3 5 0 1 0 2 28 0 2 0 0 0 0 1 12 0 0 0 0 4 9 2 2 4 5 9 5 0 5 0 24 0 0 19 9 1 
0 0 0 0 5 0 18 0 0 0 7 12 2 0 0 13 0 2 0 3 0 1 7 14 18 10 3 0 8 4 0 0 0 1 0 0 9 
27 13 0 43 29 20 18 0 0 0 0 0 6 7 7 1 22 23 0 13 7 7 0 0 18 0 8 27 0 24 0 0 0 1 8 0 0 
7 0 0 0 5 22 8 7 14 0 7 1 4 6 7 0 0 9 5 0 0 0 0 5 0 0 27 27 0 6 3 12 2 0 12 0 10 
0 14 34 0 0 0 6 5 0 17 14 0 0 0 0 0 14 22 0 1 31 11 2 0 3 0 8 1 10 0 18 16 10 13 24 0 34 
12 28 5 7 42 14 12 7 11 26 0 3 0 0 15 0 9 0 6 3 0 0 3 0 3 4 1 37 0 49 0 11 13 0 0 22 2 
24 6 0 0 9 25 10 3 30 5 0 0 0 9 0 0 13 0 0 4 8 0 0 0 24 1 11 0 7 2 21 2 12 0 10 7 0 
14 31 14 1 0 0 0 17 9 12 3 3 18 11 7 4 10 0 12 10 0 0 1 0 0 7 6 0 0 0 18 0 17 0 0 21 10 
29 0 0 5 5 40 11 8 20 0 0 11 6 3 5 52 18 11 19 6 0 0 10 0 0 10 10 0 0 19 15 6 10 0 13 30 0 
0 25 0 0 3 25 0 0 0 21 0 6 0 0 20 0 19 0 0 0 16 5 0 9 0 0 20 16 0 25 2 0 19 0 20 13 16 
