37 21
0 0 0 33 5 0 3 20 0 27 0 0 21 23 5 19 0 2 0 5 1 20 14 3 0 19 5 7 5 11 0 0 0 0 0 0 35 
4 12 0 2 23 0 1 0 0 0 0 7 0 18 0 5 0 0 7 0 0 0 0 19 3 0 0 0 0 10 0 18 0 7 0 11 0 
26 0 3 0 23 34 16 0 3 0 4 18 0 8 15 1 0 0 0 0 2 15 11 20 0 0 29 8 6 0 0 35 0 13 0 0 0 
19 0 0 24 0 0 23 66 0 0 2 0 2 6 3 12 0 0 15 6 2 0 3 1 12 8 6 0 19 0 0 0 0 27 0 0 29 
14 0 15 32 34 0 25 18 19 0 9 0 0 0 16 5 0 0 0 0 0 0 15 20 3 15 0 0 0 64 0 1 2 12 0 7 32 
13 0 36 3 37 12 2 26 10 12 0 0 29 8 1 13 0 0 0 6 0 9 10 0 19 2 13 25 2 17 9 4 0 26 0 1 32 
17 0 0 8 0 9 8 29 2 26 0 8 0 0 6 0 0 26 0 0 5 0 0 27 1 0 17 0 9 14 0 9 2 0 2 6 33 
0 8 0 5 15 0 3 3 0 29 8 0 13 0 2 21 0 0 17 0 0 7 13 0 0 2 0 0 0 20 0 0 0 21 0 0 21 
0 4 0 0 0 9 12 14 0 8 0 20 0 0 7 0 0 0 9 0 7 10 7 7 3 6 12 2 1 7 7 28 0 1 16 0 0 
9 34 0 0 0 7 38 0 12 52 0 0 2 29 0 0 0 8 13 6 12 18 0 15 0 16 0 0 6 7 1 21 26 6 21 26 46 
0 0 0 26 8 1 0 4 0 0 0 24 21 0 0 25 0 0 6 15 0 9 3 4 2 6 0 0 1 31 13 16 0 5 15 20 0 
25 0 19 0 10 8 0 0 0 7 25 0 11 9 14 11 3 0 13 6 0 13 20 2 2 21 25 16 2 4 2 0 11 9 0 5 31 
0 4 28 17 5 11 15 2 0 24 0 8 0 12 0 0 4 10 8 0 26 15 4 8 0 0 1 18 2 1 32 0 0 24 4 0 5 
0 0 2 0 10 3 31 0 10 0 2 5 0 0 0 6 0 0 0 0 0 14 0 3 0 0 0 1 22 0 0 0 5 0 0 14 0 
7 23 96 1 1 6 8 21 0 0 0 11 9 3 0 24 27 2 5 0 15 11 7 49 33 10 3 20 7 2 17 40 0 10 10 32 0 
0 8 0 9 25 7 0 21 0 6 0 3 0 0 0 5 0 26 0 6 5 12 13 13 20 7 0 12 26 0 5 9 3 6 17 0 0 
32 0 0 18 22 7 0 20 3 36 0 9 0 0 13 0 0 6 0 0 0 2 1 7 2 0 22 7 0 7 30 22 0 8 0 0 0 
0 0 0 0 13 0 0 23 12 12 6 34 17 5 12 0 6 0 0 0 8 0 0 8 0 0 14 19 10 0 19 3 25 0 0 0 5 
36 0 0 15 0 0 6 4 0 29 10 5 2 0 20 7 4 0 29 0 12 9 7 1 4 16 13 27 0 4 0 4 0 0 5 0 0 
50 0 27 0 0 0 0 37 0 0 0 0 19 0 0 19 0 0 0 19 16 11 0 1 9 0 0 0 0 19 0 31 0 26 0 0 15 
0 8 0 7 112 0 57 17 0 15 40 0 8 0 0 6 8 11 8 0 5 5 8 1 10 5 13 1 5 24 5 11 0 0 12 13 1 
