37 21
21 21 19 3 26 14 32 0 0 0 30 6 2 21 0 19 7 6 1 4 17 21 2 6 5 19 24 0 0 13 11 0 0 10 21 0 10 
0 0 0 47 3 0 16 0 0 15 0 0 18 0 2 0 1 0 23 7 13 0 0 0 15 0 5 4 5 0 18 1 0 23 18 32 0 
5 21 27 27 0 5 0 0 27 4 4 0 0 6 7 0 13 13 1 18 29 15 14 0 4 0 8 0 0 46 13 16 0 0 8 11 35 
0 7 17 9 0 0 0 4 0 28 0 0 0 13 13 0 0 0 2 17 0 0 0 0 0 0 0 0 0 0 7 22 0 0 0 0 0 
0 8 1 7 6 6 0 2 0 3 0 10 17 5 14 0 6 0 8 0 9 9 7 0 4 14 4 0 8 4 4 27 0 1 0 0 5 
24 31 51 2 5 4 3 26 0 18 0 16 9 1 3 0 11 17 0 0 0 3 26 0 19 0 0 9 28 27 15 11 10 1 50 0 0 
5 17 18 0 0 17 4 0 6 20 0 16 12 5 0 0 0 0 14 12 6 2 4 2 2 12 2 6 9 0 21 0 0 12 0 0 0 
0 0 0 0 3 24 19 54 0 5 0 25 3 13 0 0 0 0 0 13 12 1 7 3 17 0 0 0 0 29 0 2 26 26 0 0 30 
36 0 36 0 0 0 13 0 5 0 6 0 0 8 0 0 2 0 0 3 14 0 0 10 0 5 9 17 0 12 0 0 0 8 16 0 36 
0 6 0 0 32 4 34 2 17 10 9 0 4 14 0 0 3 10 3 4 1 0 13 0 2 17 0 2 7 0 24 0 0 0 1 0 32 
50 11 22 1 20 21 26 0 20 0 10 14 3 14 0 7 38 0 0 0 10 0 1 3 0 26 31 7 28 0 13 20 0 10 12 0 10 
18 0 0 5 0 7 5 0 0 3 0 9 8 5 0 1 13 0 18 3 9 15 0 0 2 4 0 0 0 9 7 0 4 0 3 14 4 
0 17 0 0 0 0 14 11 2 4 5 6 0 5 0 0 6 7 4 0 19 0 7 0 4 0 25 18 6 8 0 0 0 23 0 0 0 
0 11 18 5 9 4 6 0 0 7 0 43 0 1 7 13 1 21 11 5 2 0 11 0 21 4 13 0 6 0 0 0 25 22 8 0 0 
0 0 19 26 23 24 8 0 5 29 0 7 14 0 20 0 18 18 0 0 0 19 8 12 0 0 12 26 0 2 34 0 20 17 0 44 0 
19 1 0 3 17 9 7 0 15 6 4 0 10 20 18 6 9 13 14 5 0 10 32 15 8 0 0 0 7 0 0 0 18 20 0 0 0 
9 7 27 0 0 5 15 0 6 13 13 0 0 29 24 9 0 0 0 0 0 0 17 13 9 0 0 5 11 54 0 0 5 0 0 0 0 
34 14 11 15 25 25 17 0 0 0 1 0 24 0 10 21 0 0 1 0 17 9 4 10 8 8 8 0 0 25 19 0 0 64 0 0 0 
1 9 33 26 6 0 16 22 0 0 2 0 2 0 14 0 0 14 8 29 10 0 14 0 0 22 12 0 0 2 36 5 0 0 0 29 0 
0 13 33 0 0 31 37 24 1 10 4 0 0 14 7 0 11 13 0 0 0 0 19 0 8 0 13 0 0 1 0 22 0 10 18 0 26 
4 18 0 0 0 65 45 0 0 7 8 0 3 23 0 2 0 0 0 14 8 0 4 21 0 3 3 6 2 28 41 0 4 6 0 0 0 
