37 21
19 4 2 0 16 20 6 0 14 0 38 25 18 13 6 15 0 0 0 6 0 26 0 7 0 26 0 0 3 27 6 6 20 5 0 0 27 
0 0 26 13 4 15 0 0 10 0 6 2 0 0 0 0 8 0 14 15 3 11 11 9 0 23 18 7 3 25 17 10 3 30 7 0 28 
24 0 13 13 0 12 11 6 0 11 1 1 0 13 0 0 0 0 1 0 27 3 19 20 3 0 2 0 0 2 21 2 0 10 0 5 0 
10 0 8 0 18 49 19 21 7 13 11 0 0 8 0 18 0 15 8 0 16 8 9 0 22 4 11 0 33 12 6 5 1 74 0 0 30 
0 13 22 22 0 10 0 0 20 13 2 0 30 7 14 18 20 0 13 5 4 7 0 27 16 22 23 45 9 20 0 0 4 23 0 23 3 
0 8 42 0 24 0 16 8 3 0 0 4 0 0 0 4 0 0 0 4 0 0 24 13 26 0 0 0 0 0 26 29 24 0 0 0 13 
0 29 0 4 0 3 40 0 2 0 0 0 0 12 24 2 0 8 3 0 2 0 0 0 11 0 2 0 0 0 6 0 3 0 28 3 22 
0 13 18 21 7 10 0 28 13 25 0 8 0 0 10 0 0 0 0 14 9 15 4 0 0 0 23 18 0 0 0 0 0 0 0 34 0 
8 56 6 6 0 4 0 1 0 0 0 0 0 7 0 0 0 15 0 25 7 8 0 0 23 3 2 7 8 10 0 9 0 16 13 0 0 
13 0 0 0 8 19 17 0 0 22 15 32 25 0 15 5 27 8 0 1 0 6 0 0 24 25 10 1 0 0 6 5 21 19 22 0 0 
0 0 16 0 0 23 0 0 18 0 0 0 0 0 0 0 8 0 22 0 0 0 0 6 5 0 3 0 4 0 25 0 0 0 2 0 0 
35 0 1 21 0 41 14 13 30 24 0 21 0 0 0 7 0 0 0 6 10 4 0 11 12 22 20 2 0 29 0 13 2 35 0 0 31 
0 9 0 23 20 1 12 34 17 0 20 0 0 5 8 8 0 9 0 0 17 11 9 0 9 5 23 0 0 0 0 11 0 28 26 0 11 
7 21 11 16 0 27 2 28 3 0 0 17 0 0 1 0 9 3 0 11 5 4 46 14 16 1 23 6 7 1 1 11 27 10 1 7 10 
0 0 1 10 23 14 2 7 0 4 11 8 0 0 21 0 9 0 0 4 0 0 0 20 9 4 9 0 0 1 27 2 2 33 1 3 0 
0 0 10 10 44 16 1 3 0 0 0 21 31 19 0 23 14 10 13 0 0 16 17 3 2 6 0 5 3 1 7 0 1 0 29 0 0 
18 0 0 12 6 0 25 7 16 0 8 0 11 0 21 0 0 1 63 0 21 0 3 10 14 5 13 0 10 0 75 0 9 0 0 0 28 
0 3 0 0 3 0 0 6 22 14 18 0 17 0 15 19 0 12 0 2 0 0 12 0 0 0 0 0 27 5 11 4 0 2 12 0 21 
17 0 36 2 0 0 16 2 0 9 7 0 18 0 0 0 0 7 0 0 28 17 3 21 0 8 0 2 3 0 54 0 0 0 11 0 0 
0 0 0 27 19 6 0 0 14 0 0 0 0 0 15 0 13 0 0 0 0 12 9 0 23 12 0 0 0 29 30 17 1 8 1 0 0 
0 49 0 0 0 10 1 0 0 0 0 9 0 0 0 0 0 0 17 0 0 0 0 0 6 0 0 3 0 0 0 3 1 9 33 18 1 
