37 21
8 0 13 0 11 0 37 1 7 22 32 16 0 19 7 6 0 0 0 13 6 12 4 0 4 7 4 0 0 0 25 0 0 0 3 21 0 
3 0 10 3 0 0 3 0 6 22 31 0 6 0 4 16 12 18 4 0 0 0 0 13 4 0 1 12 0 0 21 0 0 0 0 42 9 
0 0 10 0 22 27 21 19 6 8 2 36 0 0 5 7 4 3 0 9 16 0 0 3 1 0 41 10 0 18 0 4 0 7 0 24 0 
20 7 27 0 22 12 16 6 0 4 0 10 0 2 0 0 0 14 0 4 12 0 8 7 0 0 19 0 7 16 0 2 0 10 7 4 0 
0 41 0 0 31 0 5 0 0 0 4 0 0 25 7 3 1 0 0 0 0 0 6 3 0 4 4 1 7 28 16 0 0 0 0 40 2 
0 0 8 8 6 0 0 7 1 4 0 0 3 0 11 0 9 5 8 0 0 2 5 6 12 22 0 12 0 0 0 5 22 0 0 8 6 
9 2 0 30 0 0 5 13 0 8 0 0 5 14 0 0 3 7 16 13 13 0 0 0 4 5 0 0 0 4 9 1 1 30 0 5 2 
0 34 0 0 5 29 32 0 7 5 10 13 17 0 7 3 13 0 0 0 0 0 21 0 0 1 0 3 0 13 3 34 9 0 30 6 0 
3 53 15 3 10 11 5 5 18 0 0 4 4 5 29 10 34 15 13 7 1 3 0 2 1 19 16 6 8 13 0 0 0 32 2 0 4 
0 29 0 1 10 0 17 21 24 0 0 29 2 22 0 2 0 0 0 0 0 0 5 4 10 24 0 28 0 0 11 0 17 29 10 10 1 
0 28 0 5 3 4 24 0 6 8 22 5 2 6 2 0 0 0 0 6 19 0 0 5 10 7 2 0 0 3 0 0 19 0 9 29 7 
11 4 0 0 1 13 0 22 0 0 11 4 4 7 4 0 0 8 0 4 1 16 11 20 0 12 7 4 0 28 6 0 17 0 0 15 9 
0 0 9 0 0 0 0 2 2 0 3 16 2 0 2 13 0 0 0 4 1 0 10 24 0 0 6 0 5 32 4 27 4 0 5 6 0 
0 12 29 0 10 0 0 15 4 8 20 0 10 0 0 26 20 13 8 0 19 0 15 48 0 13 3 0 0 0 62 0 0 17 0 0 7 
6 19 12 37 0 15 13 5 19 0 0 3 0 0 36 0 0 13 14 18 0 7 0 3 0 19 10 14 0 5 0 11 19 0 31 0 10 
9 47 0 0 0 0 0 3 2 0 8 0 8 15 0 1 0 4 8 0 16 0 0 7 0 8 0 4 17 5 35 2 0 13 0 0 0 
0 1 0 24 7 1 11 0 0 0 0 41 16 1 9 1 4 0 0 7 0 0 0 6 0 0 3 24 29 2 4 9 15 0 0 16 25 
0 0 0 0 0 0 0 8 2 20 10 0 9 22 19 20 1 5 10 5 0 0 1 1 0 0 16 0 12 17 4 0 3 19 9 51 7 
0 8 0 0 17 25 1 0 19 0 2 12 3 8 11 16 17 0 0 12 3 16 0 12 0 11 7 6 0 21 0 54 0 0 0 22 0 
0 0 7 0 25 0 19 5 0 0 27 0 1 34 14 5 6 8 0 0 0 0 1 5 0 7 27 1 2 6 0 5 29 0 2 31 0 
12 7 0 15 0 0 8 0 0 0 20 12 1 14 28 1 4 0 15 0 15 0 0 0 0 0 0 1 14 0 11 6 0 0 3 8 7 
