37 21
13 4 33 14 0 6 3 0 17 0 0 1 1 17 19 0 0 15 0 0 0 0 9 18 22 7 0 0 0 0 33 0 0 0 0 0 30 
11 13 31 0 19 0 9 11 4 3 0 18 0 4 13 0 1 6 0 0 0 2 1 0 15 0 0 0 0 0 5 0 0 4 3 0 30 
0 11 5 0 18 2 0 0 3 7 0 0 11 10 0 13 13 47 16 0 11 4 17 0 0 0 0 0 0 12 17 0 0 27 0 0 19 
24 21 0 3 26 6 44 0 21 24 0 7 18 2 3 2 29 25 0 13 12 0 21 13 18 21 6 0 7 23 32 0 37 24 6 4 25 
0 0 0 0 17 0 21 42 3 1 10 10 0 2 1 22 6 8 3 16 3 20 0 0 10 0 20 0 22 1 7 0 19 0 16 1 2 
26 3 0 20 23 0 0 23 0 0 15 0 2 14 21 0 0 1 10 0 3 0 0 4 14 9 26 0 0 0 43 0 0 14 41 0 0 
0 0 15 24 0 0 0 0 0 7 0 0 13 7 0 0 18 15 0 0 5 0 0 4 0 13 0 4 2 10 0 0 0 0 0 0 0 
0 0 0 0 0 2 22 0 15 0 13 0 24 0 0 0 0 1 0 0 2 0 1 15 0 7 0 0 0 0 6 5 11 0 40 4 11 
3 47 0 3 17 45 2 0 2 0 0 0 0 0 8 11 10 8 0 24 1 0 13 10 19 2 0 35 0 7 25 26 28 0 15 0 8 
6 19 0 18 0 2 17 0 15 7 10 6 2 10 8 17 6 3 0 9 31 18 5 32 0 0 14 0 0 11 6 9 17 0 14 0 0 
0 60 7 0 0 0 11 0 24 7 7 27 24 0 0 0 23 0 0 8 1 0 0 0 8 0 0 26 0 0 16 0 24 0 0 15 28 
0 20 20 5 0 1 1 0 9 0 5 23 12 0 0 5 0 0 2 7 0 20 0 0 21 7 0 0 1 8 0 0 8 31 23 0 9 
0 0 0 0 0 4 21 11 0 22 0 11 0 0 0 0 4 0 0 4 6 0 0 5 16 4 1 19 0 0 0 27 0 0 14 0 0 
43 0 0 26 8 20 25 0 32 0 0 4 7 0 0 10 11 0 2 8 4 11 4 15 3 3 0 11 22 26 0 0 20 72 26 0 0 
36 15 32 8 13 1 32 26 32 3 18 17 0 7 0 30 18 10 2 0 13 12 14 0 24 28 46 12 14 49 0 1 0 19 10 0 16 
0 5 62 18 26 27 1 6 19 0 0 12 0 4 6 13 0 15 0 0 0 6 0 0 4 3 0 27 2 1 24 29 16 14 0 42 1 
26 24 2 58 17 20 32 15 18 9 0 12 16 9 3 21 13 2 6 13 2 13 7 8 4 33 5 4 9 13 9 28 0 30 29 13 0 
14 2 11 24 0 28 3 10 17 19 5 4 5 12 7 40 0 5 14 0 13 1 0 11 0 45 0 0 5 0 2 29 12 9 3 5 21 
27 0 18 0 28 0 16 14 5 0 0 0 8 0 0 18 0 0 0 0 23 0 14 4 1 4 0 27 2 7 1 5 17 31 11 0 7 
0 15 0 0 0 11 0 0 0 8 0 0 3 6 13 0 1 9 0 5 0 0 0 0 5 0 15 0 0 0 0 0 0 14 0 0 0 
35 9 0 7 0 0 6 15 0 0 15 7 0 13 0 14 14 0 0 0 0 0 13 0 0 0 14 1 4 25 18 0 0 0 6 35 7 
