37 21
0 32 36 0 0 13 0 0 3 1 0 5 0 8 0 7 10 0 35 0 17 8 10 13 15 0 0 0 15 0 0 0 12 32 5 22 19 
0 0 1 0 41 2 0 26 7 2 0 0 1 7 0 3 0 0 0 0 0 16 1 12 5 0 0 0 0 17 0 0 28 2 7 30 0 
10 0 10 12 3 0 0 0 0 0 0 5 13 10 0 8 17 0 0 6 0 21 0 1 0 0 0 0 26 29 0 0 0 27 0 12 0 
18 0 3 26 1 4 0 19 14 13 22 0 6 12 0 10 2 25 60 0 4 17 4 3 11 8 41 1 6 30 0 9 22 0 15 9 4 
23 19 4 6 0 3 0 35 0 0 19 4 0 13 0 12 0 0 1 0 7 11 12 20 0 0 11 0 29 0 0 0 38 26 0 0 6 
27 1 27 7 2 52 1 15 2 9 25 5 14 9 16 13 0 13 10 0 6 7 13 16 12 1 21 0 13 2 25 0 3 0 5 15 31 
0 3 0 12 30 4 0 0 16 0 8 8 0 3 6 0 13 1 1 0 2 0 0 0 21 0 0 0 8 0 4 5 2 4 0 0 41 
0 0 17 0 2 0 9 5 0 0 0 0 2 10 0 2 10 0 1 0 1 12 0 3 0 4 13 0 11 10 2 0 0 0 0 0 0 
11 24 33 4 0 34 3 2 4 9 0 14 11 7 6 0 0 0 6 26 5 2 0 6 2 12 12 0 0 30 0 0 0 6 16 20 0 
2 27 28 30 3 4 0 0 5 33 0 0 0 17 17 4 7 0 10 0 0 10 0 0 4 0 0 0 2 14 0 3 30 10 0 25 0 
0 0 33 0 9 0 0 0 0 0 0 4 21 8 0 21 13 0 0 0 2 5 8 11 2 24 1 0 0 0 4 7 30 7 21 1 18 
0 6 1 23 13 6 0 5 0 0 8 0 5 6 0 0 9 11 4 0 0 5 0 5 0 6 25 0 5 0 26 0 0 0 0 0 0 
23 4 2 0 0 4 30 0 21 0 0 18 10 11 17 0 14 13 12 6 19 4 3 23 14 19 9 2 0 18 3 17 20 0 0 4 30 
27 0 10 0 0 27 0 34 21 8 44 0 10 0 0 0 3 0 10 0 11 25 1 13 0 0 8 27 0 13 0 10 38 23 0 14 29 
5 0 1 1 13 0 30 13 0 0 14 8 7 4 0 9 6 0 13 5 28 0 0 6 1 4 11 3 6 0 0 0 17 0 10 15 30 
0 0 2 0 14 0 0 8 13 0 0 0 0 0 0 9 0 0 6 0 12 15 1 0 1 5 0 0 1 9 0 0 0 0 1 0 5 
7 0 0 0 17 26 11 14 3 4 0 9 6 2 24 1 4 11 19 0 14 21 1 9 12 0 18 0 0 15 19 7 0 12 0 0 16 
0 6 2 13 0 28 17 3 0 12 3 0 16 0 24 3 0 14 0 0 17 19 7 36 12 9 3 18 8 25 0 7 13 3 0 0 0 
134 25 17 25 0 6 0 5 20 0 19 0 0 14 21 15 9 38 0 6 12 28 0 2 6 20 0 5 50 36 22 31 0 32 15 1 32 
11 0 20 27 9 0 27 12 1 0 15 7 12 0 0 0 13 11 12 5 0 17 0 1 1 1 13 4 32 16 44 4 0 27 0 0 19 
26 0 10 40 0 17 0 0 0 0 0 23 10 0 0 0 0 4 8 0 12 13 0 0 0 0 0 0 25 0 0 31 12 0 23 0 0 
