37 21
0 0 0 17 13 2 0 0 2 2 12 13 8 0 0 0 35 0 0 0 0 0 5 17 30 0 5 6 0 4 0 0 0 10 0 19 14 
24 16 0 17 0 17 0 0 0 0 0 0 0 2 20 0 13 7 0 21 14 19 9 0 17 0 0 0 17 10 0 19 8 0 6 11 31 
0 31 32 29 0 17 0 5 3 0 0 3 16 5 0 18 0 0 0 0 13 9 13 0 0 0 7 0 0 28 0 0 60 18 32 0 0 
0 0 0 29 4 0 41 0 37 0 0 13 0 17 0 1 11 12 5 0 0 8 0 0 23 5 0 11 0 0 0 23 29 0 0 0 30 
1 33 13 3 0 0 0 11 0 0 11 13 0 0 3 22 10 1 5 4 0 4 0 0 16 1 0 4 12 6 0 4 17 32 10 0 0 
26 7 1 0 0 20 0 0 9 17 3 0 24 0 0 12 15 7 0 0 23 0 0 0 0 0 22 0 23 2 0 20 0 0 0 0 24 
1 2 22 11 0 0 28 2 9 25 2 0 0 0 0 0 0 6 10 0 4 0 26 0 24 9 0 10 5 0 0 0 0 5 2 19 30 
25 0 0 3 25 15 24 5 22 1 1 5 21 5 13 15 0 13 3 4 22 2 5 0 8 19 4 15 0 1 64 0 8 12 17 0 6 
28 9 0 0 13 0 8 11 16 1 70 11 3 0 0 0 1 2 13 0 20 0 1 19 5 3 0 0 20 0 0 21 0 1 24 2 14 
8 45 5 0 12 14 10 16 15 0 7 3 22 8 0 0 6 10 11 0 3 2 0 51 29 2 17 0 0 13 0 7 8 0 0 0 24 
5 0 0 0 10 0 2 0 0 0 21 0 23 0 0 0 11 0 8 1 4 0 0 0 8 0 0 2 0 8 0 21 0 0 4 17 0 
6 6 23 17 0 0 5 0 5 1 17 0 14 0 0 0 0 0 0 15 0 1 0 0 0 10 30 0 0 0 0 29 0 5 6 4 0 
31 3 5 11 18 4 6 6 3 6 0 3 9 8 0 7 0 17 0 0 6 5 0 0 0 45 9 23 0 15 5 8 1 26 14 11 28 
4 0 0 0 25 0 3 0 0 0 0 0 11 8 0 18 22 1 18 0 0 5 11 19 9 5 2 0 0 0 0 16 0 12 0 12 0 
0 8 0 0 4 0 10 0 29 0 17 0 0 0 0 0 6 10 3 0 0 0 0 0 2 6 0 23 0 12 0 7 0 0 0 0 0 
20 65 0 11 0 12 8 4 16 55 0 0 0 21 29 5 1 1 18 5 30 6 4 0 4 8 6 0 27 0 25 2 39 2 54 31 18 
13 12 0 2 15 0 12 0 0 0 0 4 0 0 23 0 4 2 3 3 9 10 0 0 21 0 26 3 0 7 0 7 0 14 0 0 7 
47 0 26 40 5 5 2 3 6 2 0 13 1 32 14 19 8 0 3 0 12 2 7 17 8 0 0 0 11 13 16 0 41 0 6 29 0 
12 33 27 0 4 0 3 26 0 25 0 0 35 0 0 0 15 0 4 15 1 12 8 9 17 0 2 1 14 39 3 3 0 30 58 0 0 
22 50 0 0 0 16 0 2 7 2 11 11 9 2 19 5 0 4 13 0 16 0 4 16 0 0 62 15 0 0 4 0 1 51 0 0 29 
0 0 27 0 14 19 0 3 23 0 17 0 0 0 12 0 15 20 0 15 18 19 0 9 19 0 2 0 2 27 10 0 0 23 45 0 0 
