37 21
16 0 23 9 8 0 0 3 11 30 23 18 0 6 47 44 0 0 0 11 13 1 9 7 0 15 12 20 11 14 3 31 2 31 20 22 23 
18 14 3 0 30 0 0 16 0 6 2 0 10 13 0 25 0 15 19 9 1 14 0 6 5 0 2 0 18 28 0 10 4 10 30 10 13 
0 34 1 26 1 0 4 1 0 0 32 0 2 10 0 5 3 0 3 0 0 13 0 0 0 7 13 17 0 0 0 0 0 0 5 48 0 
10 34 0 12 1 31 0 17 0 0 10 0 0 14 0 0 0 0 0 0 0 31 11 0 17 0 0 14 0 0 0 15 0 0 0 34 16 
3 0 3 0 0 0 24 2 3 22 13 0 30 17 0 9 0 24 7 8 0 11 13 20 3 2 4 7 16 17 0 47 15 45 3 13 36 
15 0 7 2 1 0 1 0 0 22 0 0 0 7 5 22 3 30 0 0 0 0 0 0 1 0 0 0 0 0 0 9 0 16 13 4 0 
12 0 0 11 19 19 0 2 0 0 0 0 14 2 5 11 11 16 9 5 0 0 0 9 17 0 0 2 0 0 0 0 0 9 17 12 12 
0 38 24 23 12 0 0 0 0 12 6 0 0 3 0 8 12 0 0 2 0 6 0 1 0 7 47 2 0 0 4 0 0 32 3 0 0 
22 0 0 0 7 9 0 0 0 7 0 1 9 4 9 0 6 7 0 4 19 0 22 0 7 0 12 2 8 2 0 2 0 0 0 4 10 
0 0 0 2 1 10 0 0 0 0 0 5 0 0 0 9 10 0 3 6 0 3 7 2 4 19 11 4 9 0 6 24 6 0 0 0 27 
2 35 0 0 10 0 0 3 0 0 9 0 0 0 0 5 0 4 0 0 5 0 7 0 0 7 9 6 0 0 0 5 0 0 0 0 35 
0 0 23 26 13 12 0 15 2 7 1 25 3 0 8 0 3 6 7 11 0 0 23 3 3 12 1 3 0 26 9 5 0 13 0 0 30 
16 0 8 25 0 0 19 14 26 22 6 5 9 6 25 33 20 14 3 5 13 0 10 0 1 21 4 18 0 0 0 39 0 13 20 4 9 
0 12 0 5 0 0 6 4 32 0 7 0 26 1 0 13 0 16 3 0 1 3 0 0 4 0 0 9 0 0 0 5 20 0 0 34 31 
35 6 22 39 0 1 6 0 0 0 7 0 7 13 20 20 1 5 1 15 1 14 13 12 2 17 9 0 17 5 29 23 0 21 6 46 44 
31 27 8 12 7 12 16 0 0 2 15 2 5 0 0 15 12 8 3 0 2 15 11 9 25 4 7 31 27 5 0 37 22 0 0 8 0 
8 0 19 0 7 0 1 0 0 0 16 0 0 16 14 1 33 15 16 0 13 0 22 0 8 0 16 11 0 13 0 0 1 12 0 31 3 
30 0 0 3 8 1 13 4 0 21 5 7 6 3 3 17 7 3 0 0 3 0 7 0 0 0 0 35 0 7 34 2 0 5 2 16 5 
0 33 0 16 0 4 1 0 0 0 10 3 0 0 3 0 0 11 0 1 13 4 0 0 0 6 10 8 16 0 0 12 3 0 20 7 0 
5 0 6 0 0 54 28 5 1 4 17 0 20 5 6 13 0 0 0 4 0 17 4 0 8 7 24 0 23 0 11 5 35 8 15 0 10 
0 0 7 8 1 0 0 0 2 7 20 11 34 0 0 0 6 0 0 11 4 0 0 0 4 2 22 49 51 0 19 0 0 0 13 23 0 
