37 21
0 12 0 2 0 0 0 21 0 0 0 0 15 0 0 0 0 8 0 0 20 0 0 5 0 16 14 0 16 0 0 11 0 0 26 0 0 
14 13 39 12 0 0 0 8 11 10 0 16 6 0 0 0 0 0 11 11 9 11 5 0 0 0 8 0 7 6 0 2 11 0 0 7 34 
14 15 3 31 1 11 0 0 15 15 14 0 1 10 0 3 0 15 3 7 11 2 0 5 0 12 0 0 8 0 7 14 3 13 6 23 5 
0 35 8 3 1 22 53 17 2 10 6 0 10 0 0 14 15 12 1 19 0 0 8 1 31 7 0 13 0 11 0 11 7 0 0 0 56 
2 35 34 9 13 4 0 14 0 26 0 0 5 0 0 0 0 24 13 13 15 8 0 0 0 0 0 0 11 0 0 0 0 0 25 9 69 
2 10 4 1 0 9 0 0 10 0 19 18 7 5 0 3 1 37 25 5 22 11 0 3 13 0 4 2 0 8 3 0 17 0 0 0 23 
8 0 1 24 0 0 0 1 22 2 13 0 12 2 3 24 1 0 0 6 10 0 0 0 11 16 5 15 0 0 77 20 0 4 6 12 8 
27 0 1 0 7 0 30 27 0 0 7 7 4 0 0 0 0 0 0 0 0 15 22 0 1 0 19 0 1 7 0 0 0 3 0 0 20 
12 11 10 1 22 0 30 17 8 8 3 6 5 1 0 8 0 7 11 0 0 0 0 0 0 5 9 10 0 0 26 0 15 0 19 37 21 
23 35 0 27 0 4 0 8 0 6 10 20 12 3 3 1 0 0 0 0 5 4 0 1 7 5 0 3 6 0 3 21 2 22 6 0 24 
31 0 0 0 0 9 23 10 23 0 5 0 3 3 1 0 4 15 5 5 9 0 0 1 11 0 0 0 2 21 0 56 6 27 0 12 7 
0 0 0 0 27 27 0 0 16 10 0 0 3 0 0 3 0 18 3 0 4 0 5 6 2 0 3 19 0 12 24 26 2 0 12 0 0 
6 4 11 0 0 7 30 0 0 0 0 0 8 0 0 0 0 0 8 0 10 0 11 0 0 0 2 0 0 0 3 0 0 0 0 29 5 
1 9 0 42 26 2 1 12 30 0 0 0 1 0 0 0 0 0 0 23 6 0 15 0 0 5 0 2 3 0 0 3 0 47 1 0 11 
0 37 0 6 0 43 50 0 0 5 9 18 4 1 0 3 0 0 1 1 1 0 0 6 5 1 16 3 0 0 24 26 26 0 0 0 8 
5 90 0 32 3 0 41 0 0 0 10 2 24 0 0 5 0 0 0 4 9 3 0 0 12 0 10 2 0 0 9 9 0 27 33 38 36 
17 19 4 24 2 0 36 19 9 15 17 20 1 0 0 6 0 24 3 10 11 9 13 0 19 8 26 24 13 2 29 56 11 0 0 7 40 
25 15 42 0 0 0 18 0 21 0 0 10 10 8 0 21 0 0 0 4 0 13 23 6 6 25 0 4 34 21 0 17 0 0 0 33 2 
1 0 35 0 0 1 4 14 32 8 38 9 12 5 0 0 28 5 12 0 2 12 0 0 4 0 1 37 0 0 0 0 23 1 1 13 31 
1 0 0 7 0 8 27 1 16 17 7 5 8 7 19 42 18 14 1 2 5 35 0 9 3 11 11 0 9 12 0 4 8 19 11 63 12 
0 7 32 6 29 7 16 10 16 0 0 0 19 10 0 13 2 0 9 0 14 0 16 10 16 0 6 1 12 0 0 18 0 29 51 4 15 
