37 21
59 0 54 0 5 0 0 0 41 0 31 17 14 8 1 6 0 14 1 6 15 13 13 11 19 0 0 0 0 29 2 0 16 32 32 0 28 
18 3 0 21 3 0 1 0 44 10 10 0 0 23 0 13 0 0 0 10 4 9 18 3 9 0 0 19 13 0 0 3 1 15 24 0 13 
4 0 33 0 19 0 2 12 1 26 8 22 0 41 0 9 0 18 20 12 52 1 3 0 6 1 15 16 0 6 2 0 3 32 15 99 16 
3 17 13 0 7 0 18 0 0 0 14 7 0 0 0 13 0 0 0 16 0 2 0 0 11 11 0 14 0 8 0 1 0 0 0 0 0 
13 7 27 0 0 24 0 8 15 0 0 4 11 0 0 8 0 0 0 0 0 8 30 0 0 0 0 0 0 49 0 13 6 0 0 0 32 
20 8 0 0 20 0 2 0 0 0 4 8 2 0 22 14 0 12 0 8 24 0 13 11 10 0 3 0 14 14 0 0 0 4 0 0 1 
2 0 47 29 0 6 3 1 25 0 2 30 2 0 0 4 0 0 0 4 16 4 19 4 19 3 6 5 0 0 15 5 0 20 0 7 0 
7 11 0 0 10 0 2 1 0 22 11 0 2 6 10 5 7 0 0 6 9 6 0 2 13 14 5 14 0 9 15 32 0 0 0 0 12 
8 0 0 0 0 0 0 0 0 10 8 4 2 0 0 0 0 0 0 10 0 11 1 0 29 4 0 0 0 0 30 0 0 3 0 0 13 
8 0 0 0 8 7 0 10 1 0 0 0 38 2 2 0 16 1 4 6 17 10 1 0 3 0 5 20 0 0 0 6 5 0 11 23 0 
24 23 0 21 0 0 27 20 2 0 6 10 0 0 0 1 0 4 0 0 0 1 0 0 28 1 0 0 0 0 0 25 0 0 0 0 29 
9 9 5 0 30 1 3 12 0 7 15 0 0 0 2 0 0 22 0 31 6 4 5 2 0 0 6 0 7 0 0 0 0 0 11 0 0 
30 10 0 0 37 26 3 0 0 6 3 10 0 5 0 20 0 0 5 13 0 9 7 0 4 9 0 3 10 7 5 1 1 25 34 5 2 
1 41 5 8 0 15 35 11 7 0 6 20 0 10 0 0 0 12 19 15 1 1 0 3 1 6 3 3 0 23 5 30 29 7 33 1 0 
8 0 8 0 0 30 21 23 18 0 2 1 7 0 9 6 13 27 8 5 19 7 7 3 16 7 9 1 11 16 28 0 0 13 11 46 5 
0 0 0 0 0 15 0 0 5 0 36 0 6 0 7 1 0 9 0 8 19 11 0 0 0 12 0 1 1 0 9 21 5 0 14 0 0 
57 9 9 0 25 0 27 0 0 23 18 3 1 18 0 22 0 6 0 0 14 3 8 23 3 9 0 0 0 1 25 0 11 6 0 0 0 
31 29 0 18 46 0 29 9 10 0 14 17 4 10 7 23 19 0 0 3 0 21 0 34 16 5 2 1 6 12 23 5 0 0 16 2 3 
0 0 0 28 0 0 11 14 25 52 2 2 0 24 16 20 2 5 0 0 0 0 4 0 0 0 20 1 8 1 8 27 16 5 1 0 8 
0 0 0 29 3 0 13 0 0 12 6 0 8 7 5 12 10 4 17 0 11 21 18 8 19 0 2 6 14 23 0 0 11 12 0 0 0 
22 32 0 0 11 9 0 55 0 0 0 0 0 15 0 0 27 2 0 15 3 0 6 12 17 0 0 13 0 0 10 0 19 19 49 12 0 
