37 21
0 13 46 26 0 19 10 7 36 0 0 5 9 4 3 0 10 11 24 0 0 11 9 12 0 0 8 0 0 26 3 7 55 0 17 0 0 
35 3 22 43 2 5 21 6 6 28 19 17 18 12 10 7 4 1 16 17 13 14 7 0 32 0 2 1 16 44 4 11 23 11 2 47 0 
0 0 0 1 5 25 0 10 0 5 0 0 1 16 0 0 0 0 0 10 0 0 0 10 0 0 7 8 23 0 0 0 0 11 11 10 0 
0 0 0 1 0 0 0 0 11 9 0 4 0 2 4 0 7 0 15 11 0 0 16 1 0 11 0 0 30 0 16 0 0 0 0 2 11 
6 0 14 0 0 0 18 9 0 0 0 0 0 0 0 6 8 0 29 6 0 0 2 0 11 0 0 0 7 0 0 0 4 0 0 0 0 
2 8 13 15 0 4 15 0 2 20 15 27 0 14 0 10 0 17 15 0 0 14 1 6 3 29 0 0 0 0 19 8 0 0 17 0 0 
6 0 15 4 21 5 0 11 0 3 13 0 3 18 10 7 1 0 0 0 0 5 2 0 0 0 25 0 0 3 6 18 0 18 0 14 0 
9 0 12 8 0 2 0 1 0 12 0 35 0 0 0 0 1 0 0 12 0 3 42 9 17 4 0 0 0 9 15 13 0 2 59 0 0 
16 5 11 6 0 4 7 23 19 2 2 5 17 26 0 17 21 0 0 13 16 3 9 6 5 13 0 0 11 0 32 29 10 12 0 25 44 
0 1 0 0 0 25 0 11 0 0 0 3 27 0 1 11 28 2 0 15 0 0 26 9 5 0 0 0 16 0 18 8 13 2 9 0 20 
0 25 4 35 22 0 0 0 0 0 11 2 4 3 16 0 21 0 0 5 0 2 4 0 0 0 1 0 0 2 30 7 0 1 33 7 0 
14 0 0 0 0 4 0 9 27 0 20 1 2 23 22 7 8 0 0 0 0 0 14 3 0 1 4 0 7 15 0 0 0 9 0 26 37 
77 25 3 42 32 22 4 24 12 4 4 8 18 0 12 2 2 39 0 13 12 2 22 19 0 21 22 40 11 18 13 49 0 37 2 15 0 
6 3 10 7 0 0 0 0 8 0 3 8 9 14 21 0 5 35 0 0 0 13 0 0 0 3 0 1 3 0 13 4 18 0 0 0 19 
21 32 34 0 22 0 3 16 3 11 0 0 0 0 3 12 10 3 0 2 0 19 4 9 1 8 20 11 0 22 6 9 0 24 1 11 43 
0 0 18 19 0 6 17 2 26 10 4 5 0 14 0 7 15 0 11 0 30 0 9 0 0 9 4 0 0 0 0 18 0 13 17 0 26 
0 0 16 0 49 0 0 24 3 14 0 11 18 0 14 0 0 4 0 0 0 4 12 12 0 0 2 4 0 0 14 28 0 0 30 6 0 
19 2 0 2 22 2 9 18 5 0 4 0 6 17 0 0 0 0 0 0 10 0 7 9 0 7 4 0 14 10 3 12 19 2 0 10 1 
22 0 13 20 0 9 0 3 19 0 9 2 0 15 9 9 14 6 45 20 0 11 41 0 9 0 0 22 0 0 31 0 14 17 16 0 0 
6 13 0 5 0 4 0 5 7 8 4 0 30 3 0 21 8 1 19 6 12 14 1 0 12 6 0 0 3 35 0 0 12 18 0 1 1 
13 47 16 0 3 0 7 35 5 19 19 14 0 5 7 17 0 19 27 18 14 6 0 15 13 8 0 0 15 0 49 0 0 11 24 18 19 
