39 22
18 25 11 0 10 1 0 16 0 0 22 0 27 9 11 17 4 0 11 0 0 0 0 0 0 0 25 0 12 16 0 0 1 0 8 23 0 6 0 
0 1 2 48 5 1 0 0 0 25 0 4 0 0 0 17 0 0 0 0 12 0 0 20 0 0 0 1 0 0 3 28 17 1 0 0 0 0 0 
0 1 0 3 0 20 13 0 2 0 13 17 4 7 7 1 10 0 0 18 0 21 0 0 0 19 0 0 20 0 0 4 27 4 0 0 0 22 5 
0 2 0 0 0 10 0 0 15 23 0 8 0 0 0 0 17 0 1 0 12 0 0 0 10 11 0 2 0 0 14 0 23 0 18 22 11 0 0 
2 32 32 0 0 0 0 0 0 0 0 0 12 15 0 6 17 2 6 0 0 0 0 13 12 0 0 0 22 0 0 17 0 12 32 17 0 36 0 
5 9 0 27 0 12 0 15 1 21 0 2 7 29 0 0 0 0 0 16 0 0 26 10 15 0 0 14 3 21 4 0 0 24 0 0 0 0 0 
2 50 0 0 38 5 31 21 13 4 0 5 0 0 9 30 8 21 13 0 5 8 14 2 1 20 3 0 10 15 0 28 0 23 38 0 18 24 3 
0 43 0 0 2 0 11 0 27 30 0 2 0 33 0 0 30 0 6 0 6 0 0 0 5 0 19 7 15 0 17 0 7 0 8 26 4 43 0 
0 6 7 28 0 6 2 0 0 20 8 0 0 13 9 9 2 0 17 0 7 20 0 0 8 0 1 0 0 23 0 6 6 0 25 16 0 6 26 
0 10 0 14 2 8 27 8 5 11 0 5 8 6 0 2 4 0 11 0 19 18 7 0 0 11 6 0 0 0 0 0 0 0 22 10 0 0 0 
0 31 0 26 11 6 0 7 0 4 0 6 10 24 0 2 0 20 9 0 24 8 0 0 8 0 0 3 0 0 0 4 18 0 3 0 7 20 0 
34 3 0 0 25 5 1 28 8 17 7 13 48 17 14 2 2 0 19 19 0 10 0 5 3 12 28 0 9 27 17 13 11 25 10 0 32 75 0 
0 11 8 0 1 21 2 0 0 0 9 0 11 8 1 8 16 19 0 12 1 1 1 0 5 2 21 6 13 7 9 0 0 0 0 0 26 0 2 
0 3 0 0 32 22 0 0 2 18 12 0 0 0 0 0 3 0 13 0 14 0 15 0 6 8 22 23 0 2 0 27 6 8 10 0 0 15 40 
13 4 3 1 18 22 11 0 7 5 26 13 0 2 2 23 0 0 15 13 0 24 0 9 0 12 22 0 15 6 25 2 37 0 30 0 26 0 8 
0 39 0 0 0 6 0 2 0 10 28 2 6 0 12 6 0 5 6 0 11 0 5 0 4 0 1 0 31 0 0 0 8 23 12 0 0 11 0 
0 0 0 0 0 3 0 16 0 1 6 0 25 0 14 0 8 0 0 5 8 14 4 7 0 15 9 0 1 0 0 0 6 12 22 21 0 14 25 
0 0 0 0 33 6 7 26 29 4 0 0 17 19 0 14 0 0 0 0 0 15 0 13 0 0 4 0 20 3 0 0 17 0 0 0 30 4 0 
0 32 0 20 0 0 3 0 0 0 0 4 0 0 11 10 12 0 4 0 5 0 16 11 12 0 10 21 0 0 0 0 5 32 33 0 0 2 12 
1 1 0 13 0 3 11 24 2 16 0 0 3 5 0 16 10 0 13 11 7 0 3 0 9 0 0 0 15 0 6 9 9 22 26 10 0 0 0 
34 0 0 0 0 0 0 6 9 0 0 0 0 4 7 0 17 0 7 34 15 0 1 11 15 0 2 0 0 0 0 0 0 0 45 16 0 0 0 
0 3 0 0 30 28 28 0 15 14 9 0 0 13 0 2 0 0 0 0 0 0 9 0 0 0 4 0 0 3 0 26 3 32 58 0 0 6 0 
