39 22
0 11 85 0 10 5 3 19 24 3 5 5 11 0 7 0 0 0 0 20 0 1 0 4 10 0 24 13 9 0 20 6 34 0 31 24 0 7 36 
53 1 1 18 4 8 11 17 0 0 0 0 3 9 8 0 0 0 0 0 0 8 0 15 10 9 0 0 0 16 0 0 0 1 10 9 36 0 40 
0 9 10 0 44 18 0 0 21 12 0 10 14 0 0 6 15 1 1 13 7 12 0 0 0 0 17 6 0 0 0 0 0 30 14 0 6 1 1 
0 9 0 0 0 0 0 19 0 0 0 6 0 0 18 0 0 6 0 11 0 0 5 4 7 6 16 0 0 0 0 0 50 0 0 8 0 11 0 
3 6 6 18 8 0 7 0 11 15 0 2 11 7 0 0 17 11 10 8 19 7 0 10 5 6 10 8 4 5 18 6 12 13 5 8 10 4 0 
0 25 0 0 0 0 0 0 0 0 21 25 0 1 0 0 3 0 0 0 16 11 0 0 0 15 25 0 0 8 0 0 0 0 0 0 2 7 0 
0 31 0 0 31 0 13 0 0 0 0 0 20 0 15 3 0 0 9 15 2 14 5 0 18 0 0 8 4 6 30 11 44 0 15 2 13 0 0 
3 0 35 0 33 3 2 0 1 3 2 5 0 0 10 0 5 0 4 3 0 10 0 0 13 0 8 0 7 0 0 5 7 4 0 0 5 12 8 
48 4 9 2 21 22 3 8 0 1 18 13 0 8 15 2 0 0 21 0 8 4 18 18 0 21 22 31 0 0 5 0 23 19 6 1 13 0 0 
20 0 17 31 37 38 4 0 30 23 2 0 0 0 10 8 18 0 0 4 20 13 0 8 0 16 0 3 32 0 0 8 33 28 26 0 4 17 29 
35 38 3 18 5 8 0 11 0 17 46 0 8 6 3 2 0 12 28 4 2 9 0 0 0 1 9 7 0 9 8 0 6 32 0 53 0 27 1 
36 0 0 0 0 0 7 0 0 0 0 7 0 0 0 0 0 0 0 5 7 0 0 0 14 0 0 0 8 0 30 11 0 1 1 8 1 0 10 
11 42 0 18 0 15 11 13 0 0 0 0 0 3 0 15 14 0 3 0 11 18 0 0 0 12 0 2 9 0 15 0 6 0 2 10 13 51 1 
0 0 19 0 0 18 4 0 0 26 0 0 0 17 0 17 0 11 0 0 0 12 0 18 5 0 9 0 0 15 23 4 0 12 0 33 17 15 7 
0 53 18 16 0 0 0 0 0 0 0 21 0 0 0 0 30 4 17 6 28 11 0 0 11 0 0 6 0 2 9 3 10 14 2 0 0 6 2 
60 0 7 0 15 0 0 14 0 20 26 19 31 0 0 0 12 13 20 2 0 9 0 0 0 2 27 2 0 0 39 1 16 4 7 9 35 4 4 
65 25 0 3 0 0 36 16 0 6 0 23 12 15 12 0 16 0 1 19 8 11 0 13 1 19 38 0 5 2 30 3 0 5 10 35 0 0 9 
32 4 26 0 0 0 0 26 0 0 0 0 0 0 0 19 0 0 0 0 0 0 0 0 1 0 0 3 0 27 15 26 42 27 0 4 0 0 4 
24 6 9 40 9 23 29 0 24 10 10 17 0 0 4 17 1 48 5 0 0 0 8 2 0 0 0 10 0 26 3 0 70 11 1 53 0 0 21 
17 0 10 18 0 0 0 43 17 22 21 0 3 0 1 0 0 31 0 0 0 0 13 3 18 4 0 0 0 0 0 61 0 0 24 13 12 1 0 
13 0 0 20 0 18 30 0 0 2 0 0 0 13 0 0 0 15 0 20 2 14 8 20 14 0 0 0 0 10 0 0 42 0 0 0 22 8 0 
0 0 26 0 19 23 10 0 22 26 10 9 0 0 0 0 10 0 0 19 31 0 0 0 0 0 0 0 23 0 0 4 0 0 6 30 0 8 49 
