39 22
16 0 0 0 19 0 20 0 0 0 0 0 13 0 22 11 1 0 0 0 20 0 6 20 0 0 10 14 0 16 8 0 0 14 0 16 40 16 0 
0 5 0 0 12 41 0 15 16 26 0 17 0 0 5 0 0 0 0 0 8 0 8 11 24 24 21 0 0 0 0 0 0 10 5 45 0 0 0 
7 0 1 3 4 0 21 10 0 0 5 0 0 0 0 14 0 11 15 4 24 0 19 0 0 0 0 0 0 12 0 9 4 0 3 3 0 19 3 
0 30 0 18 0 0 0 0 26 2 0 0 0 0 19 0 0 0 1 0 13 0 0 4 6 5 0 8 0 0 27 17 0 16 42 6 0 0 0 
4 0 0 33 3 12 9 0 0 19 15 0 9 24 13 7 0 7 18 23 11 0 19 0 0 11 0 13 3 1 0 8 0 0 0 16 16 27 0 
11 7 8 43 0 0 10 7 7 0 12 0 0 0 20 12 0 14 9 8 2 12 2 0 0 1 0 5 0 26 20 13 0 16 24 17 7 0 0 
20 0 2 0 11 32 6 15 0 0 0 0 0 0 0 0 0 0 0 0 3 0 15 0 0 0 21 6 0 2 0 2 4 6 0 0 10 32 0 
28 0 0 28 0 0 0 0 1 0 10 14 0 0 7 5 9 21 0 0 0 10 0 23 0 23 4 0 0 9 0 38 0 14 1 1 0 3 12 
57 0 4 18 4 1 17 0 8 0 0 0 0 21 0 11 0 0 32 13 6 1 0 5 24 1 0 26 0 0 13 33 0 0 21 35 8 0 5 
0 0 0 25 7 12 0 0 22 0 5 6 7 0 0 0 0 0 4 1 8 1 0 9 0 0 3 0 0 21 0 0 29 0 4 0 0 0 0 
0 26 10 15 0 0 0 0 0 1 25 20 0 0 3 10 8 0 26 5 0 0 0 14 3 23 0 2 0 5 8 22 23 0 8 11 0 0 0 
19 15 0 0 0 0 0 0 26 0 21 0 17 0 9 0 14 0 4 24 10 7 0 0 0 0 9 4 0 17 0 0 5 14 0 0 0 29 0 
38 0 11 58 0 4 29 2 24 4 26 33 1 32 27 7 1 2 6 0 9 5 12 3 7 13 0 1 45 35 9 4 26 22 9 60 17 0 71 
0 33 0 14 0 4 0 0 2 25 0 0 32 0 3 12 0 14 0 0 13 0 0 6 0 0 0 0 2 0 7 19 0 0 12 0 21 0 9 
0 30 12 24 55 0 17 26 0 0 9 0 0 0 49 15 0 10 10 13 19 0 0 17 13 21 0 24 0 12 3 18 31 48 19 0 1 0 52 
0 0 28 5 5 0 7 7 15 0 27 17 0 0 7 1 2 11 2 0 4 1 13 0 0 0 10 13 0 0 40 0 0 0 35 0 18 27 0 
27 0 0 0 0 22 0 14 19 2 0 26 2 0 8 21 0 10 0 0 13 4 0 0 8 0 32 35 5 25 0 0 0 0 0 0 6 40 9 
0 0 0 0 10 12 30 0 16 25 40 0 0 0 2 15 3 0 0 0 0 6 23 0 0 0 0 17 18 9 0 0 4 0 23 0 30 0 9 
39 33 7 5 0 0 27 7 5 36 26 28 2 0 0 8 4 0 0 0 14 2 0 20 17 25 0 0 0 2 22 0 1 28 39 6 26 14 23 
0 0 34 0 47 0 3 0 17 3 0 0 0 19 2 12 0 13 0 0 6 12 19 5 0 13 0 4 3 15 0 0 12 0 11 18 49 0 57 
0 70 0 0 5 0 17 25 4 0 9 5 6 16 0 3 3 0 9 0 0 0 0 24 18 0 0 0 0 14 29 0 25 0 19 0 16 0 0 
28 0 2 13 2 11 3 24 39 27 18 27 17 16 6 0 0 0 16 0 19 11 14 8 0 0 0 0 10 17 0 45 40 2 21 18 69 19 27 
