39 22
0 0 19 0 6 0 4 0 0 6 0 0 13 19 17 9 34 0 16 0 1 19 18 0 5 0 0 0 0 15 0 0 1 0 0 0 0 0 0 
20 0 2 21 2 0 10 0 9 5 10 23 11 0 5 16 19 14 12 0 28 4 0 0 21 21 20 12 3 0 12 19 15 0 0 21 0 0 0 
12 9 0 0 30 0 0 0 3 0 3 10 6 0 22 1 1 0 0 0 1 9 8 2 0 18 6 11 0 31 5 0 0 13 0 18 0 0 15 
3 18 18 28 0 15 23 0 6 0 15 31 0 14 12 9 3 0 0 22 17 16 0 0 0 0 0 0 35 11 0 3 0 22 0 2 0 0 0 
14 29 26 0 11 0 11 9 0 18 6 0 33 22 0 0 14 1 0 0 26 0 30 17 16 0 0 32 8 0 48 14 11 4 0 0 0 0 7 
9 11 0 16 3 0 0 0 4 9 0 17 4 0 1 0 0 0 8 16 0 9 0 0 0 0 0 0 0 0 6 0 1 0 4 0 18 0 5 
15 0 0 8 19 9 7 7 0 6 3 12 26 6 8 12 0 18 0 16 3 5 0 30 16 16 13 34 9 29 18 6 20 0 10 16 0 9 12 
0 0 26 9 0 21 0 0 6 0 30 15 36 10 0 0 12 0 0 0 0 1 20 13 5 0 39 7 4 11 4 0 0 0 0 0 24 0 9 
17 14 0 25 0 1 1 0 0 0 24 0 22 0 0 10 0 9 10 0 2 3 1 0 0 0 9 0 38 0 0 0 6 0 7 0 0 0 0 
31 0 0 0 7 6 0 5 31 0 19 28 7 6 0 7 15 0 24 4 8 16 0 3 0 0 0 0 0 25 2 15 29 0 0 8 8 12 0 
13 26 27 0 27 17 0 23 3 0 8 25 2 5 0 0 12 0 0 5 9 8 0 11 0 10 0 57 0 17 24 0 0 21 3 10 0 0 37 
0 63 0 33 0 19 30 0 0 0 0 0 4 2 0 28 3 6 0 9 5 12 0 3 33 10 10 6 0 1 21 7 0 9 0 34 20 31 6 
12 24 0 0 17 0 0 0 0 0 0 9 12 0 0 4 8 0 0 3 12 25 0 0 12 17 0 1 4 2 0 12 4 1 0 0 0 0 0 
10 14 7 3 16 0 0 0 2 32 12 2 10 4 5 20 0 7 18 18 16 16 0 0 0 0 0 21 0 26 0 0 0 0 22 0 18 18 29 
8 29 0 11 0 27 10 0 0 0 12 0 0 0 11 0 0 17 0 0 20 0 3 0 0 3 0 12 28 0 29 0 21 0 13 0 0 0 7 
27 37 0 24 0 0 10 0 24 0 26 22 1 23 0 0 10 0 19 12 9 0 0 0 0 12 0 42 0 0 0 12 3 0 0 27 26 0 35 
0 6 0 0 12 24 0 0 0 0 0 15 0 12 0 0 9 5 36 0 5 0 12 0 0 0 4 0 13 21 5 21 0 0 0 17 0 27 20 
0 37 0 0 0 28 0 19 0 0 0 0 0 2 29 0 15 12 17 0 0 0 0 0 13 0 7 10 0 0 1 15 16 0 3 14 0 48 23 
25 0 4 0 0 3 15 2 49 0 8 13 0 8 5 1 3 0 2 0 0 10 16 0 0 25 0 19 0 16 0 6 5 31 0 0 9 41 2 
37 0 0 31 33 16 0 0 56 0 0 5 18 13 0 0 2 0 2 0 10 16 0 0 10 9 16 0 0 0 0 0 12 4 79 0 0 5 30 
0 6 0 0 22 0 0 26 0 19 27 27 5 16 12 0 9 0 11 10 0 8 0 0 2 6 3 0 10 3 5 5 0 4 0 23 5 42 46 
49 0 18 8 0 0 0 1 30 35 0 2 0 0 0 0 5 5 13 0 0 5 0 3 21 4 29 11 0 3 0 13 0 17 0 32 0 12 40 
