39 22
17 43 32 31 0 33 5 9 30 6 0 0 21 13 0 0 13 11 18 0 22 20 0 15 24 0 13 0 10 27 0 0 0 19 49 0 18 0 56 
0 0 0 17 0 61 12 22 0 0 0 0 0 0 0 0 0 11 6 0 17 11 0 0 5 0 5 2 5 13 14 0 8 0 29 14 0 0 0 
0 0 0 0 39 0 0 0 16 0 4 0 21 0 24 18 12 0 0 19 19 10 0 0 1 0 11 17 5 4 15 0 0 6 20 0 0 0 0 
15 0 33 0 14 14 0 7 30 0 0 0 16 17 0 9 7 0 0 21 27 1 22 10 27 0 7 7 0 0 0 11 0 7 0 28 16 0 39 
0 0 41 27 13 0 5 10 6 0 0 0 30 0 6 12 0 7 0 12 12 1 4 1 6 0 0 3 2 12 6 29 25 33 0 0 0 25 0 
0 27 0 3 0 0 0 13 51 0 0 0 7 0 0 0 16 12 0 7 18 14 0 7 0 14 0 7 21 34 22 12 1 0 13 0 0 20 0 
32 0 0 0 29 0 4 0 0 0 4 14 0 4 0 0 0 4 0 9 0 1 0 10 5 5 10 0 9 4 0 10 31 39 0 0 0 6 0 
4 25 0 3 0 8 11 0 8 0 0 0 20 14 13 10 10 0 0 0 0 4 8 0 0 0 0 0 9 0 0 15 0 15 0 4 0 22 0 
0 1 8 6 2 52 14 14 0 0 10 0 15 0 0 15 0 0 5 8 27 1 14 0 0 3 8 0 1 0 0 4 4 4 37 14 0 25 0 
49 1 25 0 18 6 8 6 9 7 28 0 0 4 24 7 17 0 17 0 20 0 25 0 6 9 0 16 38 0 20 7 0 0 0 22 0 12 24 
0 0 34 0 9 9 0 4 0 0 0 4 6 0 2 11 11 0 8 0 16 0 7 0 18 4 0 0 0 8 0 11 0 10 18 2 27 2 0 
26 0 0 14 0 0 0 0 20 0 0 5 10 0 0 5 8 0 9 0 6 3 19 0 7 3 25 0 10 0 12 0 0 17 31 0 0 17 0 
0 0 32 4 2 27 26 0 26 17 0 0 0 0 2 9 0 0 6 5 2 2 0 0 5 3 16 7 0 11 0 0 46 1 24 0 18 9 41 
6 0 2 0 0 6 23 0 3 0 0 13 0 4 4 0 0 0 7 11 0 0 14 26 8 0 14 4 0 3 0 0 0 0 0 0 0 0 0 
26 2 18 46 16 0 0 3 0 36 4 0 11 0 5 5 0 14 1 1 24 7 0 0 0 0 18 0 19 2 0 2 0 0 0 0 0 34 0 
0 10 2 0 22 13 0 11 33 1 6 28 2 0 19 0 10 16 0 0 0 4 8 0 13 14 23 14 31 0 13 13 0 21 1 6 9 13 0 
0 0 18 10 1 0 0 0 0 1 18 3 0 18 22 10 6 0 0 8 18 13 0 0 1 0 19 3 38 1 10 25 29 0 7 0 0 1 0 
11 0 0 1 14 7 0 3 0 12 0 0 3 0 3 14 0 0 0 0 3 9 0 6 15 9 12 3 0 6 15 0 6 15 14 0 12 37 0 
0 0 0 0 16 0 0 0 0 18 0 0 3 0 12 0 0 0 0 0 0 0 0 0 18 1 0 0 0 0 0 3 0 11 3 0 0 0 0 
0 35 14 6 0 0 0 0 0 1 0 20 0 0 21 40 11 10 15 0 16 21 0 0 7 0 0 0 27 0 27 4 17 22 3 0 19 23 0 
2 10 2 4 17 0 16 1 7 0 4 4 6 19 1 2 5 0 0 6 0 2 16 16 0 0 0 15 0 0 19 2 24 0 2 0 30 13 32 
0 34 0 0 1 0 0 30 0 25 9 0 3 34 2 0 0 0 0 37 19 33 0 17 19 28 14 0 16 0 0 33 11 0 0 41 0 46 0 
