39 22
20 0 46 2 5 2 18 8 0 16 10 9 24 0 20 0 4 0 0 18 18 0 20 1 10 0 0 0 0 0 0 22 0 0 0 16 24 33 0 
0 20 24 0 11 0 0 0 0 0 6 0 12 0 0 0 38 2 0 0 18 10 19 0 12 2 0 4 0 10 19 0 30 31 0 0 15 0 54 
0 0 0 0 0 15 6 16 0 0 0 0 13 0 2 9 27 0 18 2 45 2 0 0 12 0 10 0 0 17 4 14 0 13 0 0 30 2 0 
58 0 0 0 17 8 0 18 0 0 4 0 7 8 0 0 2 17 3 21 3 28 0 7 0 18 9 27 4 0 9 0 29 10 2 7 17 0 10 
0 0 29 0 43 0 13 7 8 36 0 6 29 0 0 0 13 5 1 0 0 23 0 0 0 6 0 11 0 2 5 23 11 0 28 30 14 2 20 
15 0 0 1 29 0 0 0 8 11 13 0 6 30 12 0 7 4 26 9 0 14 0 0 5 12 3 16 2 25 4 0 0 0 0 2 0 19 38 
38 45 0 34 0 4 0 28 0 9 9 11 2 28 0 0 6 0 0 2 8 8 18 0 15 24 8 18 2 14 23 0 0 20 0 15 0 36 60 
4 0 0 25 0 0 38 21 30 0 7 0 0 0 2 0 14 0 3 0 13 0 1 10 6 0 0 0 42 0 0 13 0 10 0 3 17 0 13 
5 0 18 0 0 31 13 0 0 11 0 0 4 0 8 8 15 0 9 13 18 2 10 1 0 1 0 6 2 0 21 15 0 0 0 32 31 0 4 
29 0 27 0 17 1 0 0 8 0 0 0 0 44 0 0 22 0 16 0 0 17 14 2 3 0 0 5 6 0 0 0 0 8 12 8 23 37 7 
0 0 32 0 13 4 22 0 0 0 0 0 0 0 8 0 8 13 17 0 0 0 0 0 5 19 0 4 5 5 9 7 8 8 37 10 3 0 2 
18 0 17 0 22 0 0 6 0 0 0 0 0 39 0 15 9 13 0 23 4 10 2 3 0 0 20 0 0 9 0 5 0 4 39 11 0 0 0 
0 0 3 0 0 15 0 29 18 0 18 24 16 28 20 0 8 6 0 0 31 1 0 7 22 0 6 8 7 8 8 24 1 2 0 19 5 0 2 
0 0 0 0 29 0 0 2 0 0 0 0 0 4 0 0 8 0 0 0 0 0 0 0 0 0 1 0 0 0 0 1 0 29 5 0 0 0 4 
31 0 0 17 0 0 0 0 0 16 14 23 13 24 0 0 21 3 0 0 13 3 1 10 0 3 24 0 4 9 0 49 0 7 12 6 0 21 0 
15 0 0 0 33 0 0 21 3 0 22 0 0 0 0 0 0 35 0 0 10 14 0 4 0 25 9 0 9 0 0 10 6 0 0 0 8 24 0 
0 0 31 27 3 0 0 0 0 32 0 0 0 14 7 14 0 18 14 20 5 8 8 0 0 7 2 12 0 2 51 9 33 15 6 4 5 0 13 
0 0 3 14 0 8 6 0 10 0 0 0 3 0 0 0 0 13 9 0 0 16 0 5 1 12 0 12 13 0 11 0 1 17 0 6 0 0 15 
0 0 0 14 17 9 24 33 3 0 6 12 6 0 2 0 0 27 12 0 0 0 0 1 0 0 15 20 0 0 12 0 0 0 5 0 0 0 0 
8 2 4 10 14 0 28 5 0 0 5 30 5 13 0 32 18 3 19 0 0 5 0 2 2 16 11 27 0 18 12 0 0 0 0 23 21 0 0 
13 0 29 0 9 24 0 4 0 0 48 11 16 71 16 0 25 8 0 0 0 15 32 0 0 0 4 0 0 33 31 1 16 13 11 14 0 5 9 
0 18 0 0 0 0 0 18 0 17 0 0 24 10 0 0 11 0 2 5 14 0 0 0 2 10 17 0 0 10 8 30 6 0 0 41 38 0 4 
