39 22
32 0 4 15 0 0 29 2 0 0 0 21 0 0 8 3 9 0 12 2 9 0 2 21 0 9 3 4 0 16 0 0 14 0 21 11 11 0 22 
0 0 32 47 34 61 17 0 0 14 0 0 0 0 0 0 15 15 4 0 0 0 4 25 7 0 0 0 6 0 0 22 11 16 32 23 0 5 51 
0 0 0 0 3 0 7 1 0 0 23 29 0 14 0 0 15 7 0 0 16 5 7 0 2 8 4 0 10 18 8 24 4 23 19 0 0 0 22 
0 35 12 0 27 0 3 0 31 3 0 0 8 18 0 15 15 0 12 2 3 4 0 22 3 0 0 19 0 0 3 2 0 0 0 0 25 0 30 
0 0 73 91 27 0 0 35 26 0 7 13 24 0 7 12 0 0 0 0 0 18 0 0 0 2 0 1 10 15 28 27 0 30 35 28 24 0 0 
17 2 0 35 12 0 0 0 65 0 0 9 0 0 15 0 26 28 0 0 0 13 12 0 0 12 21 0 8 2 5 7 21 0 0 1 21 11 5 
2 15 0 35 0 0 3 0 0 0 0 11 0 0 26 0 15 19 0 0 9 0 0 0 0 2 4 11 7 0 4 17 0 0 0 0 11 0 35 
0 0 0 8 39 0 29 13 29 4 27 0 0 4 7 1 6 5 10 16 10 1 6 5 0 0 0 23 10 0 26 17 0 0 15 26 13 28 0 
12 33 0 7 3 25 43 50 12 10 15 1 11 8 17 0 2 0 0 4 12 0 2 27 0 0 20 2 21 39 29 17 0 0 6 25 0 1 0 
17 20 0 0 0 18 37 0 4 29 3 24 13 10 0 10 1 35 0 0 19 0 0 0 0 12 27 6 0 0 0 0 0 5 0 24 10 3 0 
24 8 0 26 0 9 1 0 7 38 2 13 3 0 0 0 0 12 0 2 44 2 0 0 5 0 6 19 11 12 24 11 0 24 8 0 5 11 0 
42 0 35 0 0 0 0 0 0 0 7 9 0 0 18 0 0 0 0 0 9 0 0 8 0 0 0 2 0 0 0 8 18 10 0 19 8 12 0 
0 0 0 17 0 9 41 0 7 3 5 0 12 11 0 0 0 5 0 0 15 0 0 0 23 19 0 0 22 0 0 0 11 0 0 5 8 1 0 
7 0 32 12 19 0 0 0 0 0 0 11 0 8 6 22 12 20 0 13 0 8 0 19 10 0 10 0 4 0 3 0 13 0 32 0 10 43 0 
2 18 6 0 24 18 23 5 4 0 8 62 0 0 11 20 0 17 0 27 0 0 0 27 13 11 5 10 37 22 0 18 11 0 53 0 0 30 0 
5 8 32 15 14 14 5 0 0 5 0 0 0 4 9 7 7 5 14 15 20 0 0 21 7 5 10 0 0 0 0 7 0 30 1 0 0 0 0 
0 0 0 0 0 0 0 0 0 0 25 0 0 14 0 0 0 0 0 8 0 9 4 0 13 0 5 8 9 1 5 0 0 1 9 41 0 0 4 
2 0 72 0 7 14 0 0 9 0 0 10 1 7 1 0 10 1 0 7 18 3 12 6 3 11 9 0 18 1 2 10 18 0 29 0 0 0 0 
5 28 3 21 0 6 0 0 27 3 13 4 8 25 6 17 1 6 0 18 20 8 10 41 1 21 21 0 8 14 0 0 17 12 26 0 0 52 42 
0 0 14 43 41 0 0 0 0 0 0 5 0 32 0 0 17 0 0 0 0 0 0 7 0 0 0 13 0 0 7 14 0 29 0 4 33 0 0 
12 0 0 0 15 0 5 30 2 0 6 0 0 0 0 0 12 0 0 15 10 0 13 0 0 20 0 0 0 0 10 9 0 11 19 0 0 30 0 
24 30 10 11 8 9 4 6 6 18 0 0 13 1 0 6 22 5 0 0 13 11 0 20 24 0 61 38 28 5 6 29 7 3 47 0 1 11 22 
