28 16
18 19 7 0 0 0 3 3 0 0 4 0 8 25 0 13 0 0 15 0 19 22 0 11 14 0 0 0 
3 23 0 10 0 0 0 1 0 0 2 0 0 1 0 14 0 0 0 0 2 0 0 0 25 0 0 14 
0 47 9 16 0 0 5 1 0 0 0 12 18 1 0 25 3 0 0 16 24 0 6 13 0 27 0 0 
5 0 2 23 0 17 1 23 0 2 0 8 13 8 0 2 0 14 9 0 7 2 28 0 0 18 0 6 
5 0 4 21 0 0 0 9 3 23 3 0 0 3 1 8 13 0 29 11 0 7 8 21 0 0 5 25 
0 0 0 0 0 0 0 0 0 0 0 10 4 9 0 0 1 3 9 0 9 2 12 3 9 0 0 26 
5 5 0 0 7 13 5 3 15 0 0 7 0 6 0 2 0 1 0 9 0 4 4 33 0 3 1 1 
7 23 0 0 0 0 0 7 3 0 0 0 3 0 2 0 6 5 0 0 0 2 0 1 29 5 6 0 
1 28 11 5 0 0 1 6 7 5 10 0 12 3 0 12 6 4 7 17 19 7 2 8 6 0 5 7 
0 9 6 2 0 10 0 5 21 16 0 16 1 0 0 4 0 0 10 8 1 3 14 11 0 11 5 0 
0 0 2 20 0 0 20 10 2 0 13 3 0 1 0 0 3 0 0 0 8 0 0 20 18 8 0 0 
11 7 29 1 31 0 3 0 7 0 8 21 7 2 0 7 0 0 0 0 0 0 17 0 22 0 0 23 
0 20 14 12 0 0 0 9 0 0 0 11 0 12 0 1 0 0 3 8 0 20 4 1 0 7 23 8 
0 0 11 0 25 0 9 10 0 0 0 7 20 0 8 9 9 5 0 13 0 0 10 0 30 6 11 2 
0 0 20 14 23 0 19 0 0 10 0 4 0 14 0 0 0 20 4 0 9 6 7 6 3 19 0 29 
2 7 25 18 14 10 0 18 6 0 14 0 0 7 0 10 0 0 3 15 0 18 0 0 11 19 2 16 
