28 16
5 14 0 9 13 2 57 0 0 19 28 0 2 0 12 0 5 0 9 13 19 12 0 13 0 19 11 9 
0 0 15 12 29 0 20 0 24 11 0 5 12 0 0 7 5 9 0 0 16 0 9 21 16 21 23 0 
9 0 0 0 0 0 13 4 9 11 1 0 12 0 2 6 6 0 5 0 0 0 10 5 8 3 0 0 
0 11 8 2 2 15 0 0 4 0 0 0 7 11 22 0 12 5 0 0 18 0 0 0 11 0 5 0 
0 0 9 2 0 10 0 14 0 0 8 9 10 3 0 0 0 0 2 0 0 7 0 0 0 0 1 0 
5 0 9 8 0 0 0 0 18 8 0 12 0 0 0 0 0 0 6 0 0 0 3 15 0 3 6 0 
0 0 19 39 0 2 8 2 0 2 6 2 5 3 0 11 0 2 13 4 7 34 2 0 4 0 34 0 
0 0 25 0 0 9 8 0 0 11 9 11 0 0 0 0 11 0 2 9 11 0 11 0 20 1 0 25 
0 0 0 0 16 10 4 5 0 2 0 1 0 4 0 6 6 3 0 0 11 5 5 0 0 0 1 0 
4 0 14 15 8 4 9 5 19 7 13 1 0 0 11 2 12 0 13 0 7 1 0 3 1 0 0 35 
0 0 22 0 13 6 0 0 0 0 12 0 2 0 0 0 0 15 0 2 4 0 15 2 37 0 7 0 
0 0 0 0 0 8 30 0 0 11 0 0 4 0 0 2 5 0 8 0 0 0 1 0 0 3 28 11 
0 0 0 0 2 0 3 0 4 3 3 1 10 16 12 2 0 6 0 6 0 4 9 10 0 19 13 0 
22 5 0 55 21 0 14 7 0 21 5 0 35 0 7 8 5 10 5 16 16 4 38 2 26 0 14 0 
0 39 0 2 0 6 3 5 0 3 14 0 7 0 1 4 0 2 0 0 19 0 0 8 0 3 0 0 
0 0 4 0 5 0 22 7 11 5 20 19 8 0 7 0 0 10 12 11 20 3 3 5 7 14 10 0 
