28 16
23 3 0 0 5 2 0 5 0 0 0 0 3 12 0 0 0 0 0 0 0 0 9 23 0 10 0 2 
0 4 0 14 0 0 0 0 0 0 0 5 1 0 0 3 30 14 3 0 0 0 0 0 0 0 30 9 
11 4 7 17 3 1 3 0 1 6 18 11 1 8 0 10 0 5 0 7 10 0 19 13 0 0 17 4 
6 0 3 0 6 5 0 18 27 0 0 0 0 1 1 20 0 0 0 0 0 0 8 0 24 22 26 19 
0 40 0 0 0 18 0 0 0 0 2 0 8 4 16 12 0 8 0 0 12 0 1 44 0 6 10 9 
10 0 0 0 0 0 0 15 26 10 17 0 12 6 1 0 0 0 0 3 12 0 23 0 11 15 5 0 
8 20 0 12 0 0 0 0 8 0 7 4 8 12 5 1 0 1 18 2 8 0 16 2 1 1 0 4 
19 6 15 23 0 38 4 11 2 4 5 0 3 17 4 8 9 10 4 7 5 16 4 18 0 22 0 3 
13 0 0 1 7 0 0 0 0 0 8 0 12 8 0 0 4 6 11 18 0 7 5 6 0 0 0 2 
0 21 22 20 2 3 4 14 12 1 8 7 4 1 0 9 2 0 0 0 17 22 8 0 11 0 0 0 
16 0 20 0 9 0 0 1 19 13 0 13 5 7 1 0 30 0 0 0 4 2 40 4 0 1 17 14 
12 16 0 15 0 22 11 8 0 0 1 1 2 6 0 8 10 18 2 20 0 18 0 11 0 0 21 0 
0 8 0 1 0 0 0 0 5 17 0 0 4 0 0 0 0 0 0 0 0 2 1 0 0 0 27 5 
0 0 4 24 0 0 4 0 4 0 8 0 0 0 9 0 0 0 0 0 9 0 0 0 0 0 0 24 
0 25 0 0 0 6 0 0 11 0 0 0 0 12 9 7 0 0 0 10 19 0 4 22 0 4 19 0 
0 0 19 6 13 17 9 15 0 6 4 0 14 1 19 1 1 5 1 12 0 17 17 0 0 0 26 0 
