28 16
2 39 3 23 0 17 25 0 0 2 9 6 0 0 8 14 7 11 4 16 16 6 1 0 3 0 23 5 
9 13 0 0 24 3 6 0 18 30 0 13 14 0 0 4 4 0 14 7 4 6 17 19 0 0 15 9 
21 0 18 0 0 0 0 0 5 24 8 0 0 4 0 5 0 0 1 0 0 21 1 6 0 0 24 18 
0 20 26 18 0 0 6 0 0 8 10 0 5 0 0 0 0 0 0 0 3 7 0 0 22 0 5 7 
3 4 1 17 22 6 34 0 9 0 0 3 7 0 0 5 0 9 0 0 33 0 0 0 0 3 42 0 
0 18 1 0 7 1 2 0 0 5 5 8 8 11 10 2 8 0 0 10 22 16 2 0 3 18 0 5 
0 0 8 0 0 1 0 0 0 15 0 8 0 13 6 0 2 0 0 0 0 0 0 0 0 2 17 14 
3 1 18 3 21 1 4 16 2 0 0 0 0 8 0 0 0 5 9 17 3 0 5 37 7 3 7 9 
0 8 26 6 3 0 4 0 0 24 4 0 15 0 12 12 8 6 16 3 0 0 0 0 0 9 8 12 
0 0 0 1 17 0 22 1 2 0 14 8 0 11 0 0 3 1 1 5 0 9 12 3 0 0 3 21 
0 20 10 10 0 5 3 0 0 2 1 5 0 0 0 0 13 1 0 0 18 17 0 0 3 0 0 9 
0 0 23 0 0 25 8 7 4 11 3 0 23 1 2 0 15 1 3 17 9 0 2 19 19 6 0 0 
0 13 7 0 3 1 13 8 16 0 14 0 0 0 6 0 0 0 12 0 0 14 1 1 30 0 0 0 
24 0 6 0 0 0 0 0 0 0 14 5 6 0 0 0 2 0 0 0 3 4 21 3 46 3 2 15 
14 13 0 0 8 0 0 0 7 0 8 0 9 6 10 0 0 2 0 13 0 11 0 0 9 0 18 0 
15 6 2 19 8 0 2 0 5 4 0 0 7 16 10 0 0 7 0 1 0 0 26 10 0 3 2 0 
