28 16
18 3 12 13 13 5 5 6 0 5 10 7 4 0 2 6 13 3 23 13 0 6 16 0 0 2 0 18 
0 0 0 34 0 21 0 0 4 12 4 10 0 0 0 0 34 2 0 0 12 22 1 3 21 0 0 0 
78 22 9 0 7 19 5 3 0 14 3 16 12 12 21 0 16 0 13 0 0 0 0 8 37 1 0 24 
6 0 0 8 0 0 23 0 6 0 5 0 0 0 6 26 2 0 2 0 0 6 3 17 3 0 16 5 
24 1 0 0 0 7 20 3 0 26 4 4 7 4 9 6 0 7 0 0 9 0 0 21 0 0 37 9 
0 18 0 0 19 5 2 0 19 0 17 2 5 5 0 1 0 5 3 32 0 7 4 9 25 28 0 3 
0 0 0 0 0 17 0 0 0 0 0 0 0 9 2 0 9 0 0 0 0 0 4 10 14 2 0 22 
0 0 0 17 7 0 0 3 5 12 10 2 7 1 7 8 0 5 0 0 35 0 3 0 15 0 0 0 
14 13 0 19 3 37 0 14 14 7 0 8 10 0 33 0 2 0 3 12 4 0 40 0 25 3 0 0 
0 9 0 0 26 0 0 5 6 0 0 0 0 0 6 0 0 0 0 0 7 0 2 19 0 0 0 1 
0 0 0 0 23 0 0 2 0 18 0 1 0 0 0 0 11 10 0 0 0 0 7 0 0 3 0 30 
7 17 16 8 0 7 5 2 0 0 0 8 10 0 0 0 0 0 21 3 13 0 2 21 0 0 0 33 
0 19 0 12 0 6 0 0 2 0 0 7 0 0 10 9 3 0 9 0 24 6 0 0 6 5 0 0 
27 10 0 18 1 6 14 7 0 16 8 5 7 0 10 0 5 0 3 1 5 22 2 0 11 23 4 36 
0 10 37 0 12 1 0 11 0 0 25 1 0 13 7 11 14 0 30 4 4 3 11 21 4 0 22 14 
0 10 1 41 0 7 0 10 12 7 0 4 11 0 0 0 53 1 5 10 37 16 1 2 0 0 3 29 
