28 16
0 0 0 1 0 0 0 18 0 0 0 0 3 15 2 12 0 0 0 0 4 6 23 1 0 2 0 16 
12 0 4 15 0 0 9 11 6 0 9 1 11 5 2 0 0 15 11 0 1 5 11 0 0 5 0 0 
11 0 0 17 7 0 16 0 10 0 0 1 10 0 9 0 0 0 0 6 13 0 1 0 7 14 5 1 
24 23 1 3 9 8 9 0 6 0 6 5 0 10 8 0 8 0 12 22 4 0 11 9 1 0 24 12 
9 18 17 2 0 8 0 6 9 19 8 0 11 6 1 0 0 7 7 17 8 4 1 0 8 19 7 7 
0 9 0 7 0 0 0 0 6 0 2 5 1 0 0 0 5 4 7 0 0 18 6 2 7 7 0 8 
18 0 0 40 23 12 5 0 7 9 0 0 0 1 0 0 0 21 18 5 17 0 0 0 0 0 32 23 
7 0 30 0 9 0 14 0 0 0 0 3 10 2 8 3 0 0 12 0 1 14 0 0 0 30 0 1 
0 0 10 0 0 0 14 15 4 17 0 0 3 2 22 0 5 0 3 11 14 4 15 14 15 0 0 0 
0 0 0 19 0 2 14 19 0 5 3 3 2 0 5 0 0 4 0 0 14 0 19 0 17 0 0 0 
0 0 14 17 0 0 2 6 2 2 12 22 0 2 1 4 8 3 1 21 22 8 0 0 3 2 0 5 
21 0 0 0 2 0 0 0 17 0 9 8 7 2 1 1 8 7 0 7 3 8 1 0 0 0 0 8 
0 0 2 11 0 0 8 0 3 0 0 7 18 9 0 1 10 0 0 0 11 1 4 0 15 3 0 0 
0 15 25 0 17 16 7 0 2 0 0 16 1 16 0 5 15 12 0 0 6 10 0 0 11 8 0 49 
7 17 11 0 0 5 0 0 0 0 5 9 10 0 0 0 0 8 17 0 12 2 14 0 3 8 0 0 
0 3 18 21 2 0 0 0 1 9 0 8 14 0 3 0 0 0 3 0 13 3 0 22 21 0 39 0 
