28 16
0 24 0 13 0 0 12 0 17 0 0 4 12 3 5 1 11 0 6 4 11 0 0 0 6 31 3 11 
6 12 7 35 3 0 0 3 11 2 0 2 0 2 1 11 0 12 7 0 20 0 3 10 0 4 8 0 
11 0 0 0 0 0 8 2 13 2 0 6 0 0 14 0 9 0 12 1 1 22 0 1 0 7 0 9 
0 0 0 10 0 0 0 6 0 6 0 0 5 5 0 0 0 13 0 0 0 1 6 0 3 0 3 0 
13 0 21 4 0 0 11 0 17 0 0 4 0 0 3 0 11 1 7 4 0 0 0 21 0 0 26 6 
0 8 14 0 0 0 0 0 0 3 0 6 0 0 2 18 21 4 11 0 13 0 8 1 0 1 0 1 
30 22 22 12 8 3 2 1 7 0 14 0 6 0 10 26 10 18 10 0 0 0 5 18 17 0 16 11 
0 13 5 10 0 3 0 0 3 11 2 1 2 18 11 9 0 3 8 1 2 20 0 0 9 7 0 3 
14 0 7 0 0 10 0 6 10 3 0 1 0 0 9 0 0 2 18 0 0 0 0 15 0 0 0 6 
3 0 4 8 0 0 11 0 3 11 0 4 6 4 11 4 0 0 10 8 6 6 6 0 3 8 0 3 
0 12 32 0 7 0 5 4 18 16 4 15 13 6 1 21 12 8 3 13 5 7 0 14 0 11 23 3 
25 0 0 7 0 0 0 0 0 21 8 0 0 3 0 4 28 4 6 7 0 2 2 0 2 0 16 0 
10 0 0 0 0 17 0 0 15 4 35 0 6 5 0 3 6 6 0 0 0 0 17 24 14 0 1 0 
1 28 7 15 0 0 0 11 5 1 23 0 5 10 28 8 1 16 4 0 0 4 29 0 0 8 6 3 
0 17 0 2 0 2 0 0 0 14 0 0 0 0 0 0 0 8 5 0 0 0 4 10 0 24 0 2 
10 0 0 0 0 0 0 0 13 17 7 5 10 8 13 4 11 1 0 0 0 0 10 0 0 16 0 13 
