28 16
0 0 3 9 0 0 0 0 28 0 14 0 0 0 8 1 0 0 0 2 12 20 10 2 0 17 0 0 
0 0 0 1 14 6 0 4 29 0 1 14 19 0 4 0 0 0 5 0 0 6 14 0 16 1 14 0 
0 12 0 0 5 0 0 25 2 7 0 1 0 0 9 0 0 0 0 0 0 12 8 0 7 4 15 0 
0 0 27 23 0 33 0 0 7 0 0 1 4 0 12 16 1 0 0 8 2 0 2 9 5 0 20 11 
0 3 12 13 2 0 6 0 0 7 0 0 0 9 7 0 11 0 2 5 0 0 0 4 0 0 2 4 
0 0 0 6 8 3 0 6 3 13 0 0 7 17 2 3 1 0 3 0 2 18 0 16 11 0 2 15 
10 0 19 18 0 2 2 0 0 0 10 0 13 0 4 3 0 0 8 17 9 19 0 0 4 14 0 0 
8 3 6 0 15 5 3 5 2 0 1 9 5 6 0 7 0 15 0 0 1 15 23 3 13 0 0 0 
5 0 0 0 0 4 8 6 0 4 6 0 0 8 12 15 4 0 8 11 3 0 0 3 0 12 29 1 
0 0 27 12 1 19 0 0 0 7 5 0 8 0 0 13 0 0 0 3 7 6 20 0 19 1 0 6 
17 13 0 23 7 0 2 0 0 0 0 0 3 0 19 0 13 30 0 10 2 3 18 0 0 0 0 0 
4 3 17 4 12 2 0 20 1 6 0 0 0 6 2 3 11 0 0 21 1 0 9 1 30 18 0 0 
8 0 27 22 32 0 0 5 8 7 4 13 13 1 2 9 2 3 8 23 0 0 3 1 1 16 22 1 
38 6 10 19 4 5 1 31 1 14 5 0 8 11 14 3 0 3 16 5 5 5 12 8 41 5 1 11 
2 10 2 0 0 0 18 0 0 0 0 0 0 0 0 4 0 0 0 0 0 0 0 0 0 19 0 0 
27 1 20 0 9 12 0 10 0 0 10 0 4 9 7 0 4 11 0 0 3 7 12 0 0 0 0 2 
