28 16
0 0 0 32 0 0 19 0 16 15 0 9 3 0 0 15 7 0 0 0 5 3 9 30 2 17 0 2 
0 9 13 0 0 0 0 0 23 0 2 14 0 14 6 5 0 14 0 0 13 0 10 0 3 0 11 0 
3 17 41 1 0 0 5 11 12 0 16 5 0 7 0 0 0 0 23 0 12 1 29 10 0 11 5 25 
4 0 0 8 14 2 21 2 4 0 0 0 9 3 7 0 5 3 14 13 0 16 10 0 0 0 10 0 
16 0 8 13 0 0 0 34 6 13 1 3 0 8 1 9 20 6 7 9 3 14 13 8 11 3 6 20 
3 0 41 0 12 0 5 19 0 0 0 4 14 0 7 0 11 1 2 17 0 3 7 0 4 0 5 1 
19 0 22 20 8 0 0 9 0 0 0 0 3 0 11 15 2 11 3 20 0 0 2 0 17 10 0 0 
0 13 11 0 32 0 0 3 0 0 0 8 0 15 6 4 19 0 0 8 6 20 0 0 0 3 7 0 
0 0 0 2 0 6 0 0 0 1 10 5 1 0 0 6 0 7 14 0 6 5 0 0 7 13 16 0 
0 15 22 3 12 0 3 11 16 6 5 34 15 1 11 8 0 9 10 0 3 5 11 19 31 1 0 1 
24 0 24 0 0 0 12 0 0 14 0 7 13 5 8 0 0 0 0 0 0 0 10 6 24 16 10 0 
10 0 1 1 0 0 1 18 0 0 0 0 0 0 4 1 0 0 7 0 9 7 5 0 9 12 1 3 
14 0 0 14 0 14 17 0 19 0 10 0 9 5 6 0 0 0 6 0 0 0 34 29 0 0 8 22 
23 0 0 7 0 0 7 0 0 0 0 10 0 19 0 0 0 0 7 0 0 16 4 0 7 26 0 0 
23 9 32 0 0 6 11 0 20 0 0 14 12 8 0 6 0 3 9 8 0 33 12 21 15 6 0 16 
0 0 0 0 14 6 0 0 14 0 14 14 0 2 0 9 0 14 1 0 0 0 6 0 25 1 16 9 
