28 16
51 0 0 22 2 0 1 0 7 0 0 11 15 0 4 24 0 17 6 0 14 0 22 0 13 22 16 7 
10 0 0 0 0 4 1 6 0 0 13 18 0 0 1 22 12 2 0 0 0 0 0 13 0 0 0 0 
21 1 4 1 4 0 4 0 37 1 1 0 0 0 0 0 16 0 16 12 1 2 20 0 2 0 18 19 
22 21 1 4 0 3 13 12 7 13 0 0 2 0 6 4 0 0 0 9 1 0 9 0 0 13 25 0 
0 0 0 4 66 0 0 6 0 0 7 0 9 0 0 5 0 0 14 0 7 0 0 0 0 0 13 30 
4 17 20 0 4 4 0 0 0 10 0 0 4 0 0 0 0 4 14 0 0 22 0 0 0 8 0 8 
43 14 3 1 17 9 2 4 19 0 0 20 0 0 16 14 14 20 13 2 20 2 22 0 7 14 18 2 
41 0 17 34 6 0 0 6 8 0 10 12 0 5 3 5 20 4 0 3 0 0 15 21 5 9 26 21 
0 0 0 0 0 0 0 0 0 0 7 5 0 0 0 5 0 0 0 0 5 0 0 0 0 0 0 0 
3 0 9 20 17 32 1 12 0 7 10 11 4 3 25 28 10 0 12 18 1 3 0 7 0 10 21 24 
1 0 5 3 7 16 0 6 1 6 0 2 0 0 0 6 14 0 0 0 0 0 0 1 0 16 10 0 
10 0 15 1 46 24 0 0 2 0 7 0 5 0 8 11 2 2 2 2 0 4 0 4 0 15 21 0 
18 8 14 21 1 1 17 0 2 7 4 33 0 11 12 8 8 2 3 10 0 4 11 15 30 2 0 16 
4 0 10 28 36 0 10 0 2 0 7 14 1 1 13 13 15 1 0 15 0 0 6 3 1 8 10 29 
8 1 0 0 0 0 5 0 2 0 0 17 11 5 7 0 0 4 7 0 0 0 6 4 12 11 0 0 
6 3 10 0 0 0 17 12 4 19 8 9 32 0 6 14 0 2 0 2 0 0 0 17 15 0 0 10 
