28 16
0 8 0 1 12 14 1 0 5 24 13 0 7 0 0 4 20 0 0 13 4 15 0 0 8 16 0 14 
0 0 13 20 0 0 14 4 11 0 0 13 0 5 16 13 7 14 9 2 0 18 0 0 0 0 0 0 
0 11 20 14 7 0 13 0 6 7 2 11 2 20 0 24 8 9 0 0 0 0 8 0 3 0 13 3 
0 0 4 7 0 0 0 9 0 7 0 0 7 0 0 12 0 9 0 27 18 0 4 0 17 0 13 8 
20 2 0 12 9 11 1 9 12 19 5 4 6 0 8 11 26 9 0 9 47 11 13 9 0 5 0 0 
0 0 25 19 0 19 1 4 4 8 17 4 6 0 0 4 0 8 0 5 0 14 19 0 19 8 0 42 
0 0 0 0 17 0 18 3 0 0 3 0 0 3 0 0 4 2 0 0 5 26 0 17 0 4 0 0 
0 7 0 0 3 0 7 6 0 0 7 0 4 14 5 0 8 6 1 6 1 0 4 0 0 2 4 12 
17 3 2 1 4 2 5 3 5 11 2 0 7 0 14 0 7 3 0 1 16 0 14 0 5 0 0 0 
3 8 0 18 0 1 1 2 7 0 9 0 0 12 0 6 0 0 0 15 0 5 0 0 0 15 0 0 
5 0 3 10 9 3 12 3 0 18 3 9 9 19 19 13 8 0 19 7 8 5 4 8 10 0 13 0 
0 0 1 0 0 0 0 0 0 18 2 0 8 0 12 0 0 0 0 0 3 5 4 0 0 0 16 18 
0 0 0 11 2 12 2 9 0 0 0 0 0 0 4 0 4 19 3 0 10 2 2 14 12 0 6 0 
32 11 0 2 0 18 0 5 12 8 13 11 0 0 22 11 0 0 18 5 3 0 19 17 0 0 17 0 
24 7 0 21 26 4 13 1 0 1 0 11 22 12 11 0 4 0 14 29 2 7 14 7 1 13 7 7 
7 0 0 0 0 0 21 23 0 2 10 0 19 11 4 18 19 3 8 10 6 20 15 2 13 4 17 0 
