28 16
3 0 20 6 9 0 0 11 0 0 0 4 0 0 7 0 0 0 4 0 0 0 2 0 6 1 1 2 
0 14 19 0 3 0 8 0 8 8 0 14 12 29 8 19 9 1 1 9 0 10 0 5 17 2 0 11 
0 13 0 3 28 7 8 17 2 7 6 12 16 5 12 11 9 4 8 0 0 0 2 12 24 11 20 23 
13 19 0 7 5 0 0 0 0 11 3 0 0 21 5 8 10 12 0 10 8 12 10 8 13 12 16 0 
4 1 29 0 3 0 0 2 15 0 0 4 0 0 4 0 8 2 0 3 3 0 0 5 0 23 0 0 
7 7 0 0 0 0 14 26 25 2 0 12 0 16 0 6 3 0 7 4 21 8 6 12 5 7 36 1 
38 27 19 9 6 0 0 14 2 12 2 10 8 12 12 4 7 20 5 0 20 12 0 2 6 0 21 6 
0 0 10 2 0 0 0 0 0 0 0 0 9 0 0 8 0 5 1 3 5 0 5 0 4 0 0 0 
4 6 2 0 0 0 3 8 6 0 6 6 6 0 9 9 1 11 0 0 2 0 2 0 2 0 0 0 
15 0 23 23 9 7 0 0 8 8 3 5 0 2 0 1 0 1 0 8 0 11 1 10 21 23 0 0 
2 17 30 0 0 6 2 0 8 0 0 6 4 9 3 0 11 0 11 0 0 3 9 14 8 4 4 0 
1 37 15 40 0 0 1 0 9 3 15 1 10 0 10 5 9 2 15 8 19 7 24 9 2 17 0 5 
2 0 0 0 0 0 0 0 2 8 2 3 7 9 0 0 3 14 1 14 7 3 0 0 0 13 0 0 
0 0 3 11 0 8 0 0 0 0 0 0 0 20 10 2 10 2 0 2 0 12 8 0 0 11 0 7 
11 6 23 0 0 0 0 0 0 12 0 0 15 0 1 6 0 2 0 0 0 0 0 0 0 19 0 23 
0 30 0 0 0 0 0 9 6 0 0 0 3 0 6 13 0 10 6 0 0 12 0 0 0 8 25 0 
