28 16
0 0 10 20 0 0 0 0 0 5 0 14 0 1 12 0 0 3 12 0 0 14 10 0 0 14 0 4 
8 12 35 0 3 0 0 21 2 6 0 12 0 1 10 7 14 0 0 0 0 1 0 0 10 0 0 8 
9 41 0 0 27 10 0 42 0 4 14 0 0 19 13 11 1 0 21 0 0 0 5 1 3 24 26 14 
5 0 4 16 0 10 26 0 14 0 0 12 0 0 21 10 0 11 0 16 7 0 5 14 0 2 0 22 
45 0 0 0 0 0 10 0 2 6 4 0 0 0 5 3 0 0 2 1 14 21 3 0 26 10 0 7 
8 0 0 0 17 0 0 0 8 16 0 0 4 0 9 0 13 4 10 0 0 34 1 0 1 0 0 0 
27 2 0 6 0 3 8 0 2 2 0 13 0 7 2 2 7 0 0 0 7 5 15 0 0 15 4 0 
0 0 0 19 0 6 0 0 8 0 0 3 7 9 6 3 0 16 0 0 0 4 6 4 21 0 0 0 
2 16 6 0 13 18 0 0 0 0 0 5 4 0 11 6 4 13 4 0 0 6 0 18 0 0 0 0 
29 1 25 22 0 14 0 5 12 0 10 0 10 0 6 4 6 15 1 4 18 3 1 18 12 3 31 9 
0 0 0 17 5 0 0 17 4 0 17 0 6 0 3 0 0 0 6 3 18 0 7 0 17 0 18 17 
5 4 0 0 14 14 8 10 0 1 1 8 2 0 9 0 3 0 26 6 10 4 0 3 0 2 0 13 
18 10 0 0 0 0 7 0 0 0 0 10 0 7 0 0 16 1 13 0 19 2 9 4 0 1 0 5 
2 12 0 0 0 7 11 0 2 0 4 0 0 0 0 0 6 11 1 1 1 0 2 0 1 13 4 0 
21 11 13 1 12 19 11 5 0 9 3 0 32 0 12 0 5 1 6 6 0 10 5 12 17 29 0 2 
15 21 27 0 9 7 0 13 0 5 2 0 10 3 25 10 16 15 10 0 2 3 22 0 0 4 1 11 
