28 16
0 8 0 0 25 24 0 14 3 24 0 0 0 14 24 0 0 8 0 8 19 0 17 4 23 14 0 14 
0 8 7 13 3 0 0 5 12 0 0 3 0 9 12 3 1 1 5 0 0 0 0 15 0 0 8 0 
33 0 2 0 14 0 5 2 0 1 16 0 0 4 0 9 0 0 0 0 2 0 2 13 0 0 0 27 
11 1 33 0 0 17 6 19 0 4 14 11 0 13 0 4 0 0 8 0 0 16 7 0 14 21 32 0 
3 0 4 6 40 0 8 7 0 5 3 5 0 13 3 1 6 2 0 23 22 0 18 0 3 10 24 21 
0 20 0 0 0 0 5 9 0 1 3 9 0 3 4 0 10 7 0 3 11 20 16 0 0 2 0 3 
0 18 27 23 14 0 6 10 0 7 0 0 6 4 0 2 15 18 0 0 8 4 44 1 10 8 23 20 
1 1 21 3 20 18 0 0 13 19 3 0 4 0 2 16 0 0 4 6 0 19 0 3 7 6 0 3 
8 0 6 10 2 7 0 1 12 10 6 0 0 25 6 0 0 0 0 1 0 0 3 15 3 0 0 24 
39 9 0 0 8 0 0 7 0 0 0 0 1 16 7 3 26 20 2 0 19 4 0 23 0 0 0 3 
0 0 0 0 0 0 11 9 0 0 0 0 3 7 0 1 11 2 0 11 0 1 9 0 3 18 0 0 
0 0 9 0 0 0 0 1 3 6 0 16 0 0 0 0 0 3 8 11 3 9 0 0 10 0 0 7 
0 14 4 17 1 0 6 0 3 0 18 9 0 6 0 21 4 9 0 0 18 6 2 0 0 10 0 11 
0 0 1 0 2 0 1 0 2 0 12 8 13 1 15 0 0 0 1 0 14 11 0 0 13 0 0 0 
13 12 6 28 0 0 0 16 5 0 7 0 0 25 14 0 0 0 12 6 13 0 0 19 0 16 0 14 
0 13 21 0 30 3 4 0 12 19 18 10 8 5 9 0 0 0 0 10 18 4 10 28 5 0 0 11 
