28 16
0 0 7 0 0 15 18 0 2 0 0 11 12 0 0 0 0 0 15 0 14 0 17 0 9 0 0 0 
11 7 1 0 20 0 6 26 6 0 0 14 6 10 11 5 2 0 11 0 5 0 15 0 21 1 0 0 
32 12 21 15 0 10 0 7 0 7 10 4 15 8 4 2 7 9 11 2 2 8 10 17 28 34 0 3 
0 0 7 1 20 20 0 0 0 7 4 0 0 2 0 10 6 6 34 16 0 0 7 28 32 0 0 4 
7 0 15 4 23 17 0 0 0 4 1 21 8 0 3 9 0 15 7 22 0 0 12 1 6 14 11 0 
1 0 0 24 0 0 0 0 4 0 9 15 19 0 0 2 0 0 0 0 0 0 4 0 1 10 0 51 
13 10 5 1 3 0 0 0 0 0 0 7 0 2 3 0 0 5 1 0 0 0 0 17 17 0 0 0 
0 4 7 0 0 0 1 0 9 4 0 0 0 26 0 0 0 4 5 1 0 7 0 0 0 8 0 7 
0 7 1 5 0 0 1 0 0 0 5 8 9 0 0 28 0 1 0 8 0 0 0 6 0 0 0 0 
0 0 4 0 0 6 0 0 10 2 14 7 0 0 0 0 0 2 11 11 0 0 4 0 22 0 0 0 
11 0 0 0 4 4 0 0 0 15 2 3 10 3 0 2 1 0 4 7 20 4 11 5 2 8 7 0 
25 1 13 20 0 17 0 14 13 6 2 16 2 14 18 0 4 9 15 11 10 7 1 5 19 19 1 0 
64 1 7 13 11 19 5 0 8 2 21 6 34 5 1 15 6 12 15 0 0 0 30 0 14 11 0 27 
13 0 0 0 7 0 0 0 0 0 0 15 28 16 1 3 0 0 0 0 0 0 24 1 7 13 4 15 
15 33 5 5 29 0 13 0 3 4 4 0 11 23 10 20 10 11 1 0 26 3 21 29 5 22 0 7 
0 8 28 0 13 30 0 0 3 0 0 18 0 8 0 9 0 13 16 8 5 0 11 0 13 33 11 25 
