28 16
18 0 1 8 6 13 19 0 15 0 10 8 8 7 19 11 14 0 7 13 31 24 0 15 0 7 0 0 
0 5 0 8 0 5 13 13 5 0 1 8 7 8 6 0 0 0 0 0 0 12 0 0 0 0 20 11 
7 16 0 17 1 1 9 0 5 0 1 10 0 12 5 3 0 16 3 12 23 4 0 0 0 6 12 0 
12 26 14 13 1 1 8 16 0 0 7 6 23 0 0 0 4 0 11 5 3 3 0 25 23 2 3 0 
0 5 3 17 5 35 5 9 1 0 4 0 4 3 3 0 6 0 2 1 0 10 6 13 11 5 0 22 
0 31 0 2 0 0 6 0 0 0 0 16 11 0 0 0 0 0 5 0 0 0 4 22 0 0 0 16 
0 3 16 10 3 0 5 0 33 0 4 3 7 10 0 0 0 6 3 2 2 6 1 9 0 26 18 0 
0 0 67 3 0 7 8 7 11 12 0 0 0 8 0 10 0 2 6 4 5 20 4 0 8 30 0 25 
20 17 22 24 4 0 1 17 0 15 0 13 0 0 10 0 16 0 17 3 0 9 3 0 45 0 6 25 
20 0 6 8 8 0 3 0 2 0 0 18 0 17 7 4 0 4 4 0 9 7 22 0 6 5 4 0 
5 40 17 0 15 0 0 0 16 0 7 0 0 2 10 0 11 5 6 4 19 0 35 1 15 4 1 11 
0 17 9 3 0 0 8 21 2 0 0 4 10 4 9 13 1 17 42 4 0 12 0 25 17 16 1 0 
0 10 0 23 0 0 0 5 0 0 0 0 15 0 0 0 0 0 14 0 13 0 0 0 0 12 8 26 
0 11 0 1 0 0 4 0 18 0 5 0 21 9 0 2 0 6 0 0 7 12 0 6 0 2 19 0 
0 0 0 23 12 6 0 20 0 10 11 13 0 18 0 5 1 0 1 6 5 16 0 20 13 0 0 0 
2 2 3 2 0 0 5 0 10 9 2 15 0 14 0 7 17 1 26 5 0 0 0 7 19 0 5 0 
