28 16
21 0 0 38 2 0 3 0 0 0 17 5 9 0 0 1 2 8 18 10 5 15 0 11 0 3 0 17 
9 0 9 0 10 26 0 4 0 0 6 2 6 0 10 12 2 0 1 0 0 0 0 0 22 0 0 12 
15 0 0 5 0 6 8 10 0 7 3 27 0 0 8 7 0 0 0 0 16 10 11 16 8 18 0 13 
0 2 19 12 3 0 4 3 0 0 3 0 13 0 10 0 0 7 0 0 11 19 0 9 7 29 1 10 
20 16 0 5 1 0 1 26 0 14 0 3 1 0 0 0 8 16 0 0 20 3 15 2 9 0 0 0 
5 10 24 4 16 0 21 7 16 3 6 0 6 0 0 8 5 17 0 8 3 0 1 41 16 8 23 24 
0 2 9 6 9 4 12 2 30 0 0 0 6 0 0 6 0 0 0 6 1 13 0 0 25 17 7 1 
0 13 0 15 0 14 0 10 6 0 6 0 0 13 6 2 2 2 20 18 0 19 4 7 0 0 10 9 
7 0 0 0 0 0 0 12 0 0 0 4 0 0 0 9 0 0 0 10 0 0 1 12 0 0 12 0 
12 0 1 0 0 0 16 5 6 0 0 0 16 11 0 1 1 4 0 2 0 0 0 0 18 6 0 11 
20 24 16 21 5 16 7 9 1 23 5 0 11 6 0 3 10 10 16 7 0 0 0 1 9 9 0 26 
0 1 1 5 1 2 0 17 0 0 2 0 0 0 4 3 0 9 19 2 0 0 5 15 17 5 17 16 
0 0 23 2 0 0 0 0 0 0 0 0 9 5 12 6 0 0 0 0 12 0 0 9 0 23 3 0 
0 2 0 26 0 0 0 0 0 0 0 0 0 6 10 0 0 0 6 0 0 2 0 0 27 0 0 26 
0 11 0 11 16 15 4 13 9 0 3 5 10 3 0 3 1 0 0 0 43 0 0 0 0 0 0 3 
17 19 23 12 6 19 6 21 1 1 0 1 14 0 9 4 15 12 9 18 0 14 22 4 17 2 7 15 
