28 16
0 2 19 0 0 14 12 21 4 19 3 26 0 2 5 25 4 7 20 1 5 0 23 0 8 7 21 0 
14 3 23 15 21 21 13 0 0 9 0 14 17 5 0 3 9 4 7 23 15 6 13 1 0 30 8 0 
11 0 0 0 12 6 0 0 0 2 16 8 0 0 4 0 0 0 3 0 0 15 10 1 0 14 2 2 
0 10 0 0 0 12 0 26 19 2 3 12 6 11 0 27 0 12 6 0 12 9 0 7 20 0 11 19 
7 1 9 17 10 0 0 0 22 10 0 11 14 0 10 20 4 0 3 0 20 0 3 8 24 4 32 53 
19 5 0 0 0 6 0 15 10 3 0 13 5 0 0 8 9 0 0 24 0 0 0 0 19 18 0 0 
7 1 5 0 0 1 5 14 0 0 17 8 0 0 14 9 0 0 0 0 7 9 6 9 8 0 2 6 
11 0 0 0 0 0 0 4 0 17 1 3 11 1 0 12 0 6 4 0 0 0 3 7 0 0 1 15 
0 0 0 0 0 20 24 19 0 0 0 0 3 0 0 3 4 4 8 0 0 4 0 0 4 20 20 0 
3 2 0 37 0 10 4 6 4 2 0 0 11 6 11 12 5 5 5 4 0 5 0 0 0 0 23 0 
0 0 0 0 0 0 0 0 0 0 0 0 9 0 0 8 0 0 0 0 0 0 0 7 6 0 8 0 
0 0 0 7 0 9 10 20 11 15 10 16 0 0 0 12 0 12 0 11 0 0 0 0 0 16 8 17 
0 0 10 14 6 1 3 0 0 0 6 7 0 0 0 0 0 14 5 0 0 9 6 0 0 0 19 6 
4 8 28 17 16 12 4 0 0 26 0 1 10 7 0 22 0 0 14 0 9 11 14 0 0 23 0 23 
7 35 7 15 36 3 15 31 31 34 12 6 22 14 3 11 7 11 29 13 12 1 46 2 6 11 4 5 
14 6 0 1 6 4 3 0 49 8 2 0 9 9 4 21 15 16 5 0 12 13 0 9 0 0 0 28 
