28 16
2 6 41 35 0 12 0 0 3 0 9 1 6 0 0 0 0 18 0 7 0 19 1 1 0 7 6 0 
0 12 13 0 2 25 0 0 16 0 16 0 0 0 0 13 4 0 8 0 0 0 0 8 16 12 5 0 
8 33 16 24 0 0 0 13 0 10 0 14 0 2 11 0 0 0 7 8 2 0 2 5 0 31 2 23 
1 0 35 14 9 16 3 12 4 10 10 5 6 11 0 21 13 11 7 5 11 0 22 21 0 33 6 0 
0 9 31 0 7 0 0 0 0 5 5 9 0 11 0 0 8 4 7 0 0 0 0 0 28 0 0 0 
11 3 0 16 0 30 5 0 9 3 0 18 1 3 10 3 4 10 0 24 0 2 0 0 2 0 23 13 
0 6 0 19 0 1 7 11 0 4 31 0 4 5 4 0 6 2 11 6 10 0 34 3 0 3 7 17 
6 29 24 2 0 15 1 7 1 23 10 7 10 1 0 0 1 0 9 12 15 0 31 24 0 8 23 0 
3 1 0 19 0 0 7 0 0 5 2 0 6 0 1 10 21 10 0 19 4 4 15 1 3 4 0 0 
24 9 14 0 0 0 0 0 8 15 5 1 0 7 0 2 0 0 6 10 0 0 1 12 24 0 3 4 
6 15 2 0 0 0 2 8 3 0 3 0 0 0 0 15 23 0 0 5 0 2 7 0 2 0 1 0 
17 0 0 0 14 5 0 0 5 13 6 6 0 12 0 0 1 0 10 0 0 3 17 7 0 0 43 0 
0 5 1 47 0 2 0 3 10 2 9 3 0 6 3 7 26 0 11 5 0 3 16 0 1 0 8 0 
0 9 4 0 0 14 7 0 2 0 2 0 0 0 0 0 1 0 0 35 0 8 5 0 0 12 7 5 
0 12 10 0 0 14 0 0 9 2 0 10 0 14 12 14 8 0 9 0 0 0 4 0 7 1 0 14 
0 0 21 1 14 11 20 0 0 0 14 18 0 11 3 10 4 10 8 0 4 18 19 21 20 9 35 0 
