30 17
7 11 0 36 0 16 7 0 0 0 5 10 10 7 4 11 0 0 0 7 6 0 0 13 2 10 6 0 25 14 
0 10 2 0 0 0 14 6 1 0 37 9 0 11 0 0 10 0 0 0 0 7 26 12 0 15 26 7 10 5 
25 23 0 0 3 0 43 6 0 15 0 7 0 2 13 0 0 8 7 13 6 0 13 0 15 17 0 26 0 13 
0 4 5 3 2 0 19 0 0 0 9 3 0 0 0 0 9 1 0 0 6 0 0 11 4 2 10 0 22 0 
5 0 0 19 9 0 0 4 0 5 0 6 0 2 5 0 3 4 1 3 0 10 0 4 0 27 2 5 14 0 
1 0 0 0 14 10 0 17 0 0 6 4 0 3 0 3 2 2 1 0 16 0 18 0 0 11 0 2 0 0 
51 0 0 0 20 15 0 0 0 1 16 12 0 0 10 0 0 0 0 0 0 8 0 31 24 0 0 9 1 0 
25 7 0 7 0 3 21 0 3 17 0 0 0 7 13 10 8 0 0 10 7 20 13 0 4 14 17 34 4 0 
0 0 5 0 0 1 10 4 0 10 0 4 0 0 0 10 10 0 4 0 6 10 0 0 0 5 0 7 0 4 
18 19 7 0 30 27 0 7 0 11 0 1 3 27 19 0 0 5 13 0 25 0 0 1 1 7 22 5 26 0 
0 0 0 0 1 0 0 11 0 6 0 0 17 0 2 2 0 0 11 0 6 0 0 2 0 2 14 0 0 8 
0 0 0 11 21 20 0 0 0 9 0 3 5 0 0 0 0 0 0 5 0 0 0 0 19 0 25 0 19 10 
3 0 0 0 2 0 10 0 15 22 0 9 0 4 0 7 10 14 0 4 0 4 0 12 0 0 0 8 0 0 
22 0 0 0 36 0 0 0 14 0 2 12 2 0 0 0 12 0 10 0 0 0 14 0 0 0 0 0 14 0 
20 11 22 0 14 7 16 2 17 0 8 0 11 0 0 10 21 0 0 0 27 2 9 0 22 0 3 7 20 11 
0 0 63 20 7 1 1 15 0 0 10 8 0 0 0 15 14 0 15 0 10 0 12 23 0 17 12 2 26 4 
34 19 0 20 0 15 0 2 34 3 14 4 12 0 4 12 10 0 0 9 13 0 0 5 15 2 0 19 7 13 
