30 17
6 3 27 0 7 1 10 0 4 0 2 0 19 0 0 0 10 0 0 0 0 0 0 0 0 0 4 0 0 44 
0 0 0 0 0 1 2 16 0 0 14 0 11 0 0 0 0 8 6 15 0 0 5 16 9 0 0 0 0 10 
0 0 0 0 0 0 0 0 12 17 0 0 0 0 0 0 0 8 0 0 0 0 0 1 2 17 12 4 0 0 
0 27 0 10 13 21 3 0 11 8 2 4 7 5 0 3 9 22 11 0 0 9 0 11 22 10 21 0 8 0 
0 2 11 2 0 2 8 16 0 1 10 6 3 4 19 22 9 20 1 5 0 4 11 16 9 4 12 12 14 22 
20 14 0 0 0 0 11 0 0 16 5 0 0 0 0 14 0 5 1 9 20 1 1 0 0 0 0 0 19 0 
1 16 0 0 20 0 9 0 0 0 0 11 14 5 0 23 8 16 4 8 4 3 17 0 23 0 6 0 2 14 
0 27 3 0 21 24 0 0 3 0 0 12 0 0 0 0 0 0 0 0 0 17 0 0 0 0 15 0 27 24 
0 24 0 2 9 0 0 0 0 2 0 13 0 2 0 0 0 16 8 4 0 3 0 0 13 5 0 0 7 0 
1 7 0 0 16 3 0 0 3 18 10 3 0 6 3 6 13 24 0 0 16 0 9 14 0 0 0 0 0 32 
4 35 8 0 0 16 49 0 0 0 18 5 6 12 6 20 2 0 12 4 9 4 0 12 18 21 5 12 13 0 
23 4 9 24 22 14 0 0 17 0 1 15 0 0 10 13 0 6 5 14 5 0 0 5 32 15 24 24 23 0 
0 28 11 0 0 0 0 0 0 3 0 3 0 0 13 0 4 0 0 3 3 21 0 2 0 0 0 0 9 10 
7 0 0 0 0 21 0 0 0 9 0 6 0 0 0 0 9 8 8 9 0 0 0 0 0 5 4 9 0 12 
3 45 1 23 25 0 9 0 14 0 0 3 5 0 0 0 8 14 17 0 4 0 0 5 0 0 34 26 0 6 
0 26 22 0 0 4 1 5 0 15 0 24 0 0 0 0 0 6 0 22 22 7 11 0 15 2 20 2 0 0 
0 17 0 12 0 0 17 5 0 5 0 0 1 10 2 0 2 0 22 0 6 0 0 3 6 0 3 0 0 0 
