30 17
7 0 0 0 13 23 8 0 0 1 0 0 0 13 10 0 2 12 1 0 8 0 10 4 0 0 0 4 3 0 
0 4 0 20 18 32 4 49 14 2 10 0 6 15 13 6 0 0 6 8 1 22 37 18 24 6 0 39 10 8 
0 0 11 0 0 0 5 13 0 17 0 40 0 14 0 14 1 7 14 0 0 0 0 22 13 0 32 0 4 0 
0 0 0 5 1 0 3 0 12 6 0 2 0 8 0 5 0 0 4 16 0 0 18 0 0 0 0 0 0 0 
0 0 0 0 0 0 1 10 0 3 0 0 0 0 0 3 0 0 0 0 0 0 0 0 0 10 0 0 0 0 
0 0 39 11 0 10 4 10 0 0 0 6 0 3 0 13 0 10 0 0 0 0 0 11 0 23 1 21 6 0 
6 22 0 0 0 0 48 8 0 0 0 5 0 0 0 6 3 0 0 3 0 1 0 37 9 19 5 0 3 0 
20 0 0 0 22 26 5 3 5 0 0 0 13 0 0 4 0 0 0 2 19 4 11 0 0 0 4 0 0 0 
0 0 0 31 0 2 24 0 0 6 8 0 0 14 8 12 0 0 8 8 1 7 0 2 0 4 7 2 52 0 
7 8 0 0 0 3 8 7 0 33 0 0 0 0 18 1 0 3 0 2 9 8 9 0 0 0 0 9 14 12 
0 0 12 12 0 25 0 2 22 2 0 0 0 0 1 12 1 0 0 0 3 7 0 0 3 20 2 6 14 21 
11 1 0 3 11 0 24 4 9 0 0 0 8 0 0 18 0 19 9 5 0 0 0 3 0 0 1 23 15 0 
0 0 15 11 21 0 16 1 2 8 0 12 13 2 3 10 5 13 4 0 0 2 6 6 0 17 0 2 9 0 
0 0 22 0 0 5 22 11 0 17 0 0 0 0 0 0 0 10 0 10 8 0 5 0 22 0 0 0 44 20 
0 0 36 0 19 27 2 0 0 0 0 4 0 0 0 6 0 0 0 17 0 17 20 0 0 20 0 0 0 0 
6 0 13 11 0 9 7 14 8 0 0 0 0 7 7 12 14 11 0 17 7 25 8 0 0 0 0 14 6 0 
0 0 26 13 0 0 0 15 0 6 3 0 9 3 1 5 0 0 15 0 4 3 1 11 7 0 0 5 29 0 
