30 17
7 16 0 10 0 0 8 11 10 30 0 0 4 0 8 14 0 25 13 6 0 0 0 5 0 2 0 2 0 14 
15 0 0 0 2 0 0 7 10 12 5 0 0 5 4 0 12 23 12 8 2 0 8 0 0 0 0 5 12 10 
14 0 13 0 1 0 0 8 9 18 2 0 2 0 20 1 0 0 0 0 3 0 13 5 0 14 13 11 0 0 
9 4 2 2 2 0 14 6 0 4 0 17 0 0 1 1 0 11 0 0 2 0 2 5 10 14 2 4 0 0 
20 0 2 14 12 22 20 7 1 4 1 2 15 1 1 3 2 1 6 0 0 0 6 0 21 24 0 0 23 0 
0 0 29 1 3 21 0 20 2 12 28 7 0 0 0 0 0 0 8 15 0 20 10 0 0 0 21 0 31 27 
3 2 0 26 0 11 0 0 4 6 14 0 0 33 5 8 13 0 0 9 0 7 0 6 13 2 7 4 6 0 
0 0 0 3 0 0 0 0 0 0 0 0 12 0 0 0 2 0 2 0 0 4 0 0 11 4 4 0 0 0 
0 13 0 25 0 0 7 0 2 0 7 0 6 0 4 6 1 13 3 0 0 0 0 0 0 0 0 0 0 28 
6 0 13 0 2 0 4 0 12 7 0 0 0 0 0 13 1 16 10 2 20 5 8 0 12 0 0 0 22 5 
0 9 11 13 22 0 5 2 16 10 20 0 0 5 0 0 0 9 0 17 0 8 0 0 30 21 4 0 28 7 
5 0 0 25 8 0 15 21 9 11 0 4 0 0 8 0 0 0 12 9 18 2 5 2 1 21 0 17 2 0 
0 0 0 0 0 2 0 5 0 12 9 5 0 0 0 0 14 0 0 9 0 5 0 13 9 8 6 0 12 12 
0 0 2 6 7 0 17 8 6 8 28 6 3 0 2 0 23 28 3 0 8 4 0 16 0 0 18 0 4 19 
5 0 0 0 0 0 19 0 11 2 0 0 0 0 0 23 0 0 0 11 0 0 0 0 0 31 8 0 0 0 
12 0 11 0 36 0 2 0 0 0 0 0 12 0 0 1 0 0 0 1 8 17 10 19 0 6 32 0 12 0 
14 0 12 0 4 1 0 2 4 2 12 0 0 0 14 0 9 12 0 19 5 0 12 0 0 0 0 5 0 0 
