30 17
25 0 9 0 0 12 21 10 1 0 0 0 7 0 0 1 9 1 3 0 0 0 0 0 2 38 37 26 0 2 
0 13 0 13 35 4 0 4 5 7 0 0 0 0 6 1 3 0 0 0 12 12 0 3 0 0 18 0 24 0 
7 32 13 0 21 0 18 15 0 0 13 5 0 6 12 24 21 17 2 0 13 3 0 0 3 20 1 20 0 23 
0 20 9 29 17 0 22 9 24 0 8 17 0 11 0 8 14 3 20 0 0 32 1 0 9 0 0 19 0 18 
24 19 4 1 0 20 0 3 0 6 16 10 10 19 13 1 7 0 6 4 0 11 0 14 3 20 11 0 0 17 
1 24 15 2 1 5 0 0 0 0 7 21 0 0 0 0 0 9 10 2 0 0 20 22 7 0 9 5 0 0 
3 2 0 0 17 7 28 0 0 0 4 0 7 0 4 0 13 0 0 0 0 17 0 17 18 0 2 0 0 12 
5 4 14 0 25 20 0 18 0 25 17 13 2 0 5 6 11 10 7 2 6 3 4 37 8 15 17 15 12 24 
18 0 0 5 0 0 3 0 0 18 7 2 0 0 1 21 5 0 9 0 7 23 0 7 0 0 2 0 0 0 
34 20 2 1 10 9 3 12 19 13 12 1 1 3 2 0 9 0 11 6 8 3 11 21 14 0 18 0 28 15 
20 0 5 0 0 0 7 5 13 0 0 0 1 0 0 0 0 0 0 0 19 13 6 0 0 8 8 0 0 0 
3 16 0 0 19 0 4 0 1 0 6 0 0 0 0 6 18 26 1 1 0 3 0 15 6 0 1 10 12 0 
0 0 0 0 11 0 4 0 1 11 4 0 0 0 9 0 0 3 11 0 0 0 4 0 0 0 13 5 5 0 
18 26 0 0 0 0 17 21 0 0 4 0 1 5 0 0 0 0 21 8 0 3 0 17 0 13 0 28 21 0 
5 19 0 0 0 23 0 0 0 10 0 10 12 0 9 0 12 0 0 0 17 3 0 19 12 0 14 0 23 14 
0 3 0 21 13 0 15 0 2 0 0 10 15 0 0 0 4 0 2 0 5 0 0 14 21 0 0 17 0 0 
0 25 0 0 3 9 4 3 2 0 0 0 0 0 6 0 8 0 0 0 2 15 1 0 0 0 25 0 0 0 
