30 17
25 22 0 12 20 9 0 0 0 0 0 8 20 0 0 0 0 0 0 8 0 0 0 22 20 0 0 1 15 0 
23 19 0 0 11 1 0 0 22 13 10 21 0 7 28 0 22 0 7 0 1 0 27 0 0 0 0 0 0 1 
9 2 0 9 0 0 0 0 11 0 12 0 9 13 17 13 6 12 0 0 6 10 6 23 15 2 1 11 9 19 
0 10 0 0 0 12 0 12 2 0 2 32 12 13 10 0 18 3 29 0 0 6 0 0 8 7 13 3 16 13 
21 6 0 10 12 0 7 0 6 0 0 0 9 7 11 0 12 0 0 0 8 25 0 0 21 0 0 0 0 0 
4 0 0 29 4 4 0 12 0 0 0 0 0 0 0 0 0 0 0 33 0 3 19 0 0 0 0 5 0 10 
0 0 0 0 0 0 0 0 14 0 0 0 0 0 0 0 0 13 0 10 3 0 21 3 9 0 0 0 0 17 
0 6 0 17 0 21 15 0 3 0 0 7 12 6 8 7 0 21 16 0 32 2 19 0 18 0 9 9 8 0 
11 1 7 0 0 0 0 0 14 8 0 0 16 5 0 0 8 32 23 0 2 7 22 0 7 1 13 2 0 13 
13 42 0 0 17 4 0 0 4 6 0 0 4 2 0 0 0 0 1 9 3 49 4 8 11 2 5 9 5 0 
10 21 0 10 41 8 22 14 17 0 23 17 4 8 0 8 7 6 11 19 0 18 0 8 0 30 22 11 22 11 
0 0 14 1 0 0 11 0 0 0 0 4 13 0 0 0 17 11 0 0 0 0 10 0 0 0 0 0 0 0 
6 3 15 14 27 3 6 0 0 8 0 1 3 5 3 3 1 18 0 7 3 0 6 0 0 3 0 0 38 0 
13 0 0 0 0 0 3 0 1 0 2 9 0 0 0 0 5 14 0 8 0 0 0 0 10 17 9 14 0 0 
0 12 0 19 0 5 0 0 0 0 1 0 3 18 14 0 0 0 0 8 2 0 0 20 0 0 5 1 21 6 
29 16 15 27 14 17 10 2 16 3 2 6 4 8 4 12 14 24 26 10 8 6 6 4 3 6 0 3 14 2 
14 0 0 0 0 0 0 0 0 0 0 0 0 0 15 0 0 10 0 0 0 0 0 7 0 0 0 0 0 14 
