30 17
0 9 0 26 7 6 6 0 0 0 5 5 0 3 11 0 11 3 5 5 3 0 0 0 5 0 12 0 0 18 
3 0 8 0 0 0 1 0 16 0 8 15 13 9 1 8 9 2 15 0 16 7 0 26 15 15 2 0 31 4 
1 11 0 11 30 0 3 0 14 0 19 20 40 18 12 1 2 5 9 0 10 20 0 10 12 0 30 15 24 17 
0 0 0 8 0 0 7 0 0 0 0 9 0 0 11 0 10 0 0 0 0 0 0 17 0 2 16 0 0 0 
0 0 0 0 0 3 15 0 2 9 13 7 2 0 1 0 2 11 0 19 0 0 0 6 3 0 10 13 0 10 
14 2 0 6 1 21 10 0 17 9 11 0 1 0 0 18 10 0 0 0 0 16 0 22 3 24 18 0 0 29 
0 11 0 0 13 7 19 0 0 0 0 8 19 0 0 0 0 15 0 0 0 0 0 25 0 0 10 7 0 2 
0 10 12 22 7 0 0 0 16 0 2 23 0 0 0 0 0 0 6 7 0 2 0 14 21 18 0 16 0 0 
33 0 13 0 7 28 0 21 20 0 6 18 0 7 0 3 0 0 8 0 2 6 16 0 23 0 0 0 31 10 
0 43 0 0 0 0 7 0 37 9 3 17 15 7 1 0 8 0 1 0 8 0 0 7 5 1 5 46 1 0 
9 0 27 0 0 0 0 2 16 5 0 2 4 8 1 3 5 0 0 0 0 0 3 0 0 3 5 19 0 27 
4 0 0 6 27 3 17 8 0 0 0 5 0 4 3 14 5 4 14 0 0 17 0 7 7 4 0 0 0 0 
0 28 13 24 18 0 0 8 20 9 0 0 0 8 4 0 0 6 15 11 3 10 18 13 0 24 9 5 0 6 
27 8 0 0 8 10 0 0 10 17 0 9 8 0 0 14 0 12 0 19 1 0 0 0 0 0 11 7 0 0 
0 19 7 0 0 11 8 4 34 0 8 9 11 11 13 3 0 9 17 12 1 0 0 0 46 11 48 5 13 31 
0 8 1 0 0 0 11 1 19 0 0 10 0 0 12 0 0 0 0 0 0 10 0 0 0 0 17 1 1 21 
0 0 18 14 0 0 0 0 0 0 3 7 0 0 0 0 0 14 18 0 0 19 0 9 2 0 24 0 0 13 
