30 17
28 15 6 24 0 0 0 8 14 12 1 14 0 0 0 8 0 0 0 16 0 6 0 0 0 0 0 9 52 0 
1 21 4 2 6 0 1 0 21 1 9 11 0 0 13 0 0 0 9 7 0 3 0 3 3 0 0 9 0 45 
4 1 8 7 0 0 9 3 0 34 18 6 0 0 0 8 0 0 0 0 0 0 0 3 0 0 0 12 0 20 
0 24 7 0 35 0 10 0 4 8 8 15 0 0 0 0 11 6 0 0 16 4 0 0 0 2 0 62 1 0 
3 11 0 24 12 0 18 8 0 0 1 26 0 0 3 0 7 0 0 6 0 5 0 6 32 14 4 2 4 8 
15 0 0 28 30 10 0 9 0 0 8 0 9 14 0 17 28 0 4 0 16 0 33 21 12 0 8 0 0 4 
0 0 5 0 3 3 0 7 25 0 0 0 16 5 0 0 0 0 0 0 0 16 0 0 0 3 0 3 43 0 
0 0 0 7 19 2 7 5 0 4 5 6 15 0 0 0 0 0 0 0 11 4 12 19 7 0 0 15 0 0 
21 0 0 0 0 0 16 5 0 10 0 16 0 0 8 3 0 0 3 6 6 21 16 2 2 22 1 0 0 0 
0 37 25 0 5 18 5 5 0 0 0 0 0 0 0 4 7 0 0 7 0 1 20 0 0 24 5 0 0 0 
5 0 6 13 0 16 0 19 0 9 6 0 9 0 0 5 0 0 0 0 0 15 11 0 4 2 4 0 0 0 
6 16 0 3 7 22 6 12 0 13 5 5 15 0 5 5 0 16 0 22 0 0 0 0 7 0 19 37 0 0 
56 17 14 0 0 3 0 18 0 0 0 3 0 0 0 0 20 0 17 0 0 0 1 12 24 7 0 0 0 0 
0 6 0 0 14 0 9 22 7 0 17 0 15 3 4 16 0 0 6 0 0 0 0 0 0 7 0 2 0 0 
28 19 0 0 8 28 18 18 0 7 16 0 7 22 0 1 9 8 3 9 35 20 0 2 1 4 48 2 0 25 
0 43 0 4 0 10 3 7 19 3 8 4 0 0 0 1 3 0 25 3 0 11 0 10 0 0 0 22 0 0 
18 0 43 4 0 19 21 1 15 16 17 5 10 13 3 2 8 13 0 26 1 9 1 26 23 0 0 77 7 7 
