30 17
15 0 23 23 8 15 10 0 0 0 25 0 0 0 0 4 0 0 7 22 5 0 0 18 12 51 22 22 0 0 
8 13 0 0 0 0 11 19 2 12 15 0 33 24 0 0 0 0 10 0 0 0 5 5 12 7 0 19 0 10 
1 12 7 1 19 0 8 9 17 12 5 0 28 10 7 6 10 0 0 1 0 8 0 0 0 17 10 15 12 3 
2 19 0 11 0 7 3 1 0 0 0 0 19 2 0 0 0 0 0 4 19 0 0 5 0 1 1 0 0 0 
26 0 0 6 37 22 0 0 4 0 9 2 21 0 10 0 11 6 11 22 0 17 6 6 20 0 26 42 0 0 
2 26 11 0 0 0 6 0 0 14 4 11 2 2 17 0 0 0 17 8 0 9 0 0 0 0 0 8 0 5 
4 3 0 0 7 10 8 0 0 8 0 12 0 11 0 0 0 0 13 0 0 0 4 5 13 6 0 0 0 5 
0 0 8 22 0 0 20 0 14 0 8 0 0 21 0 0 10 0 0 0 7 0 19 0 0 3 18 0 15 0 
21 17 0 23 19 0 14 0 4 5 0 2 8 8 0 2 12 9 12 2 5 26 0 24 8 5 31 0 12 0 
0 4 0 0 0 0 16 22 0 0 6 0 2 0 0 8 0 12 14 0 5 0 5 0 6 15 0 10 6 53 
6 0 0 8 21 0 8 7 8 14 10 0 0 0 5 6 0 39 0 6 0 5 13 0 8 27 0 0 0 5 
17 22 5 0 0 54 8 4 10 4 5 0 6 0 0 0 0 7 17 7 0 0 1 15 24 0 0 22 23 21 
0 0 0 3 4 8 57 10 6 4 18 0 0 11 0 11 9 0 0 0 3 16 1 0 0 11 11 0 40 0 
2 4 0 10 12 0 0 1 21 12 0 9 3 1 0 0 9 0 0 3 0 0 0 13 7 10 0 9 20 8 
0 4 9 11 25 19 3 8 28 10 0 11 10 9 23 8 3 0 4 0 9 6 0 15 40 0 0 23 2 0 
13 0 0 0 0 0 0 0 0 3 12 0 28 0 0 0 0 5 2 0 0 0 16 0 0 0 0 0 6 0 
5 15 0 0 16 1 7 0 0 0 0 6 11 0 0 0 39 11 0 0 0 0 1 2 0 2 0 0 6 0 
