30 17
8 0 10 23 0 0 0 0 1 0 12 0 3 15 0 0 9 0 0 3 20 0 11 0 0 9 19 1 15 0 
0 10 0 0 25 3 14 0 13 0 8 19 13 0 0 0 12 0 4 13 14 0 0 0 0 10 1 0 8 25 
7 15 1 0 10 0 0 26 1 7 3 17 0 0 8 12 10 7 0 0 1 8 0 0 4 4 0 20 19 9 
12 69 0 0 25 0 0 9 0 0 0 0 15 0 0 8 6 0 0 1 6 0 0 8 9 0 0 0 27 3 
0 13 43 6 2 19 2 11 0 5 0 26 5 0 6 0 0 8 0 0 0 0 3 1 21 2 24 0 0 0 
9 8 1 11 0 8 0 0 0 7 0 0 1 1 27 0 0 0 0 2 6 7 0 0 0 0 0 0 13 0 
8 4 0 0 0 4 0 4 0 17 1 27 0 0 0 7 0 1 8 10 6 0 25 0 13 19 4 0 1 0 
0 0 3 0 0 0 0 3 0 0 0 0 0 0 0 6 0 1 0 3 0 0 1 0 3 0 0 0 0 0 
0 0 0 0 7 26 12 0 3 2 0 0 0 0 0 0 0 0 0 3 4 15 0 0 0 0 20 0 19 24 
0 13 5 0 0 4 7 0 14 14 4 15 11 0 3 0 0 7 0 0 8 17 25 0 0 0 24 23 8 20 
9 29 6 2 21 16 0 3 2 2 9 7 1 4 19 0 0 16 0 0 0 0 0 0 17 20 0 1 5 12 
0 28 0 0 3 0 23 9 10 2 0 7 6 0 21 6 10 10 6 0 0 6 11 9 0 7 18 0 5 35 
0 0 0 14 0 1 6 0 5 0 2 0 0 5 4 7 0 31 5 9 20 0 2 6 2 0 4 0 0 0 
0 4 10 0 1 13 0 0 0 0 0 9 10 0 14 6 0 0 12 0 0 0 0 0 0 0 4 0 14 0 
34 21 14 0 3 2 6 0 0 7 8 24 0 2 9 26 29 1 7 28 2 16 0 0 20 14 12 0 0 14 
5 69 25 0 6 0 2 0 1 5 4 12 4 9 5 0 7 5 0 0 0 8 0 22 0 24 3 19 5 22 
0 7 0 2 39 26 2 0 3 0 0 0 8 6 0 0 9 19 5 0 2 8 20 1 0 9 4 0 0 24 
