30 17
0 34 17 2 25 0 0 0 3 15 10 0 4 0 0 6 6 4 0 7 18 6 0 0 20 0 0 0 0 13 
0 20 10 0 24 0 0 3 13 0 2 0 12 3 9 0 4 4 0 0 5 20 12 0 13 8 0 0 0 25 
0 27 22 13 4 0 0 6 0 6 10 0 18 10 0 0 0 5 24 0 0 0 3 0 20 0 0 0 27 0 
0 0 20 0 11 0 0 1 3 2 9 9 2 0 0 0 0 0 6 1 10 2 9 0 0 0 0 0 0 0 
2 0 17 7 0 0 7 0 0 0 28 0 0 0 0 11 0 3 1 8 0 22 0 13 0 0 0 0 0 0 
17 48 0 0 15 5 0 0 15 0 0 7 2 3 0 0 8 0 1 15 4 13 6 15 0 0 6 0 15 22 
0 0 17 10 4 0 0 19 0 0 3 0 0 9 14 0 19 0 12 13 5 0 10 0 22 0 0 0 14 22 
0 33 13 5 0 0 6 26 1 1 3 0 0 0 14 13 0 0 0 0 0 3 0 2 0 18 0 0 2 28 
0 14 0 0 0 0 0 7 10 0 12 0 5 8 0 14 6 0 3 9 8 0 6 4 0 0 1 3 0 2 
9 2 12 11 3 0 9 3 0 12 20 5 4 0 23 7 2 0 2 25 11 1 11 32 0 4 3 0 9 25 
14 15 0 16 0 9 0 0 27 3 0 0 0 0 47 1 0 0 0 4 0 6 0 9 0 0 0 8 20 2 
12 1 4 13 2 1 15 7 0 16 0 0 4 0 4 9 13 0 0 0 3 0 17 19 0 16 0 0 0 6 
7 0 13 7 5 0 0 7 11 5 28 4 0 0 0 8 1 0 0 8 0 3 0 0 3 3 16 0 0 0 
19 17 1 3 41 0 0 0 0 0 0 15 13 0 0 0 0 19 20 16 9 11 18 0 0 0 0 0 7 17 
0 25 4 44 24 0 19 0 5 3 0 14 3 2 11 0 14 1 8 5 18 0 1 3 14 18 26 0 0 0 
11 5 0 18 0 16 14 0 0 0 0 9 28 10 8 15 0 0 13 0 18 8 0 0 5 1 0 16 0 18 
19 0 21 24 2 2 9 2 0 7 8 0 0 2 19 14 4 0 27 25 4 1 0 0 1 22 2 15 14 0 
