30 17
27 12 13 0 18 0 4 15 6 0 6 0 2 16 6 7 0 0 7 6 1 9 46 1 5 13 8 6 0 0 
0 0 8 26 4 0 5 11 0 9 8 11 0 0 0 0 0 1 15 0 1 0 0 0 6 0 0 1 0 21 
10 28 0 2 14 4 0 19 6 4 0 0 5 4 6 0 0 21 0 18 20 0 0 0 17 5 0 1 0 1 
0 13 33 0 4 0 0 0 7 12 0 0 11 12 19 0 13 0 0 13 1 6 22 20 0 7 0 0 0 0 
1 0 19 2 2 0 0 9 0 14 0 9 0 0 3 0 9 8 0 0 0 19 0 14 0 10 0 0 7 0 
1 31 0 22 0 2 0 5 11 0 0 2 16 14 7 3 0 0 0 0 0 7 0 0 0 20 2 0 0 0 
32 6 0 19 0 0 23 22 0 3 8 0 12 0 0 0 0 5 8 19 0 18 0 0 23 25 3 0 22 20 
26 0 0 7 17 40 24 12 21 17 0 0 0 13 16 2 17 15 10 28 16 0 8 0 0 51 40 8 11 18 
0 6 0 9 0 6 0 0 1 0 0 14 0 3 0 0 0 0 0 5 17 0 0 0 0 0 2 0 1 0 
0 4 0 0 18 0 36 0 0 10 0 5 8 0 15 13 7 24 0 0 0 9 1 0 7 0 20 0 19 15 
4 5 5 0 0 0 8 2 0 19 5 0 9 7 0 5 0 0 0 0 3 0 4 0 0 11 19 0 0 4 
3 0 0 6 1 24 13 0 0 2 0 9 0 0 4 0 2 0 0 0 7 0 0 0 18 0 0 25 11 5 
19 18 13 30 20 10 4 5 7 0 0 1 12 19 1 28 10 36 3 0 8 4 0 0 19 9 0 0 8 26 
0 26 6 15 0 0 10 15 0 11 0 11 0 7 2 3 14 0 0 1 13 37 4 0 0 1 1 26 0 0 
7 2 3 22 0 12 0 3 0 0 14 0 0 8 3 2 9 2 0 4 0 18 17 12 14 10 7 0 1 0 
7 31 17 10 13 0 14 6 2 0 0 0 0 13 14 12 2 0 2 0 2 7 0 0 4 0 1 16 47 0 
0 0 8 11 0 0 0 0 10 0 8 0 0 16 9 5 13 7 0 0 0 0 0 0 0 0 0 16 0 0 
