30 17
42 0 0 2 22 0 10 6 9 10 0 8 0 7 7 7 0 9 0 15 7 0 7 15 4 35 18 27 4 10 
0 12 0 0 3 0 10 0 0 0 0 0 0 0 0 17 11 0 0 0 5 7 0 0 0 0 0 11 0 0 
0 9 0 0 0 0 0 2 13 0 0 5 0 1 40 0 0 7 0 0 0 5 7 0 15 0 2 0 0 16 
0 0 9 0 3 19 24 0 18 12 0 0 0 0 11 10 9 23 0 0 0 8 16 0 16 4 0 0 0 4 
15 0 0 0 22 0 0 0 0 0 0 0 3 0 8 15 2 0 2 0 0 0 20 1 3 0 0 0 0 15 
0 0 0 0 5 9 13 0 11 0 0 0 0 3 5 0 0 10 0 2 0 0 0 0 0 8 0 0 0 1 
14 0 7 0 6 0 0 0 8 46 0 2 0 2 3 0 0 0 7 8 0 0 0 6 4 7 2 0 17 14 
16 0 6 9 3 7 28 0 0 5 8 0 0 7 13 7 8 23 12 0 7 0 2 1 10 22 2 1 22 3 
0 44 0 13 47 0 1 1 17 0 0 2 0 1 4 0 16 1 4 3 0 13 5 4 0 7 2 20 31 0 
28 0 0 0 7 0 6 1 0 0 0 9 0 1 8 0 0 6 0 6 0 0 0 0 13 0 0 0 28 0 
0 13 22 10 0 24 3 0 1 10 0 5 0 3 12 0 0 7 10 0 0 0 4 3 22 2 10 0 2 2 
0 22 21 0 0 0 4 17 3 0 0 9 0 0 0 7 15 0 16 2 0 8 0 0 12 0 0 0 0 0 
24 0 10 22 13 0 11 0 0 11 0 0 15 7 0 0 12 21 18 0 0 0 5 0 0 38 0 15 0 12 
8 3 13 6 0 0 10 17 21 13 0 10 3 2 5 15 0 4 0 0 0 3 7 0 17 3 15 0 0 0 
0 7 21 0 20 4 0 4 3 0 9 5 10 0 2 1 15 3 0 1 2 0 0 0 43 14 0 13 14 0 
64 0 32 21 0 1 27 18 9 13 3 5 0 13 24 0 10 15 12 11 0 14 10 4 14 0 7 1 21 23 
22 0 0 0 0 16 0 12 0 0 2 0 2 0 11 1 0 8 0 4 0 0 8 0 0 0 9 9 13 0 
