30 17
0 7 6 0 3 0 3 3 13 7 0 0 7 0 0 4 16 4 0 0 0 1 0 12 8 8 11 11 0 0 
16 0 18 0 16 0 1 18 14 0 0 0 0 2 1 11 13 0 30 4 16 3 0 4 0 18 0 8 13 0 
0 4 0 0 17 27 22 0 0 0 0 0 0 0 1 18 0 14 0 0 15 20 0 0 0 3 0 17 9 2 
2 6 0 9 30 0 3 3 5 0 17 10 0 16 0 0 8 8 9 8 0 0 6 0 1 0 0 14 14 25 
0 0 4 0 0 0 13 12 11 9 0 1 0 0 0 13 2 0 18 1 3 0 14 4 5 1 3 13 2 14 
9 10 9 1 1 5 0 3 0 10 0 0 0 0 0 12 5 0 11 11 0 0 22 0 0 5 0 13 0 0 
6 25 5 0 0 0 2 0 0 3 5 9 7 0 14 4 4 0 1 1 15 0 21 0 0 0 21 5 0 9 
0 37 3 6 0 0 0 12 0 11 13 0 7 0 0 5 0 0 0 9 0 0 0 31 0 0 15 1 4 0 
0 0 22 1 2 11 4 0 3 0 17 1 13 0 8 7 6 4 0 9 2 2 19 0 0 0 15 10 18 18 
0 0 8 10 0 1 3 0 11 0 0 2 0 1 0 0 3 1 0 11 5 0 0 0 0 4 0 2 0 4 
0 0 26 0 0 5 3 0 0 3 0 0 0 0 0 4 9 3 7 0 0 0 3 3 1 8 0 32 0 0 
6 8 15 6 31 0 2 0 0 5 0 0 14 3 0 0 0 4 0 18 9 3 0 1 0 21 30 8 18 3 
7 0 12 12 0 18 4 0 0 0 0 0 0 0 0 12 0 14 0 0 0 11 0 27 0 0 0 0 5 0 
12 16 0 0 0 15 40 0 9 9 3 13 13 3 5 10 16 12 22 6 9 2 1 5 31 16 0 32 16 7 
2 21 3 0 16 0 26 9 10 0 0 0 6 0 0 14 18 13 9 0 16 6 20 4 0 3 3 0 3 14 
0 2 0 0 0 0 0 0 14 10 0 8 0 0 0 0 0 0 5 8 1 0 0 8 2 0 5 0 0 6 
0 0 13 0 29 0 0 0 9 0 0 0 5 11 0 0 10 24 14 19 4 2 0 0 0 0 17 0 7 12 
