30 17
0 10 8 8 0 0 21 9 0 0 7 10 11 1 8 9 0 0 4 0 0 20 18 2 0 7 0 21 3 14 
0 18 0 29 8 0 3 4 25 6 0 17 8 15 0 0 13 0 7 33 4 0 0 0 7 0 0 24 32 0 
29 0 8 0 0 0 0 0 3 1 17 0 0 7 8 14 0 0 0 0 0 0 0 3 11 11 0 0 0 29 
27 18 1 0 4 0 2 0 0 1 6 2 0 0 7 0 0 0 0 18 0 0 0 0 0 0 0 15 3 0 
15 0 13 8 0 0 20 4 2 3 8 10 0 10 3 20 0 2 13 0 0 8 0 10 3 1 21 1 19 0 
0 0 0 22 0 10 0 15 13 4 0 2 0 0 3 5 0 0 0 2 0 32 0 0 0 14 23 6 1 3 
0 6 7 18 0 6 15 1 20 16 0 0 0 4 2 6 0 0 0 0 0 35 7 2 9 18 0 0 21 0 
9 0 0 0 0 0 3 0 0 14 0 7 6 0 4 1 0 4 0 0 0 13 0 5 0 11 0 0 4 0 
32 1 0 1 6 0 22 0 0 0 6 7 5 0 14 8 15 2 7 0 10 3 7 0 0 0 0 0 32 27 
0 21 10 13 11 0 17 4 0 12 1 0 8 0 0 7 5 0 12 38 3 3 2 14 0 18 7 4 6 0 
0 0 0 5 2 0 0 1 0 0 0 0 6 0 0 0 0 2 6 0 0 0 0 0 0 0 0 0 2 0 
0 0 1 0 0 0 2 0 5 1 4 11 2 0 0 0 1 0 0 10 4 0 19 0 0 4 0 17 2 11 
0 6 1 0 0 1 19 0 32 15 9 8 7 0 9 3 0 0 0 0 9 0 3 14 21 24 0 2 0 4 
0 0 20 0 0 7 15 3 0 3 0 0 7 0 10 13 0 0 11 8 0 19 3 0 0 7 0 8 0 2 
43 0 0 25 2 0 2 16 0 9 0 0 4 0 0 5 17 2 16 0 0 6 22 14 0 0 0 3 1 11 
26 21 17 8 1 10 14 0 14 1 9 0 16 1 15 13 0 0 1 17 13 2 16 0 9 10 0 6 12 15 
56 9 12 2 20 13 2 0 0 25 8 4 12 0 8 18 17 0 4 18 1 30 49 23 28 9 20 5 22 0 
