30 17
0 0 0 5 26 0 0 0 5 10 12 0 2 0 0 11 10 9 0 15 17 8 23 1 2 0 1 0 0 32 
32 24 18 37 10 6 19 24 0 0 12 6 14 0 0 0 0 5 0 0 32 1 0 22 0 40 7 24 28 0 
0 3 8 2 17 8 0 13 0 0 9 0 29 8 13 3 0 0 3 9 13 22 10 10 4 0 8 13 2 0 
0 0 24 2 2 11 0 3 5 9 16 0 16 3 0 0 0 0 0 13 15 8 5 18 1 0 12 0 0 70 
12 0 23 21 0 0 0 7 11 10 9 0 1 4 5 0 0 10 0 15 9 4 0 10 21 25 14 4 13 0 
17 18 18 0 8 22 8 7 5 15 0 0 29 0 19 2 0 2 3 19 20 18 8 7 0 4 7 6 0 5 
4 4 0 0 1 0 0 5 0 7 0 0 5 0 0 0 7 4 0 0 0 0 5 0 0 2 10 0 1 1 
11 5 12 11 0 20 19 12 0 0 7 6 9 11 20 14 0 0 0 12 0 16 10 0 11 0 0 0 9 0 
9 2 0 0 0 5 0 0 0 0 0 0 1 0 14 1 0 0 0 0 4 0 5 0 4 0 0 0 0 0 
21 11 1 5 0 16 0 21 0 0 9 1 7 0 0 9 0 4 4 0 6 5 15 0 0 1 31 0 0 1 
10 1 8 0 0 0 0 0 0 10 7 1 4 0 4 1 4 0 0 10 3 9 6 0 10 25 11 17 0 14 
1 0 20 3 0 6 0 0 0 1 0 0 6 0 0 7 7 0 0 0 0 0 3 11 22 0 0 0 0 0 
0 54 0 21 0 0 0 6 0 25 0 0 2 0 0 0 15 0 0 0 0 9 5 16 0 8 0 5 0 10 
20 3 2 22 11 1 0 19 17 18 22 0 16 23 0 0 0 0 8 0 23 13 0 10 0 13 59 16 0 11 
27 0 0 8 18 0 0 0 0 0 7 0 0 0 13 0 1 17 8 0 0 12 14 9 1 1 9 11 1 38 
0 25 6 9 23 4 0 0 12 0 0 15 2 0 0 0 1 0 0 23 8 2 15 20 12 0 33 8 11 0 
2 0 0 15 14 0 0 21 0 0 0 0 24 0 0 0 0 0 0 0 0 0 0 0 0 0 0 0 30 0 
