30 17
9 12 23 8 0 13 5 0 0 12 1 8 0 12 0 13 7 0 0 0 0 4 0 3 0 38 12 16 17 0 
31 0 0 3 25 4 10 1 18 0 14 24 1 27 5 0 1 0 15 8 4 0 10 23 0 3 0 7 14 10 
87 0 18 23 12 0 0 0 10 15 8 11 16 13 18 15 7 0 8 19 17 0 1 8 7 39 13 18 0 36 
3 10 20 26 0 0 5 4 0 18 3 21 1 0 0 0 0 0 0 0 0 0 20 0 0 0 0 13 0 8 
0 6 0 1 0 2 11 0 0 6 0 11 10 14 0 2 0 17 5 6 0 12 0 28 1 0 0 9 12 0 
0 0 0 17 0 1 0 0 15 2 4 12 11 0 11 0 0 4 2 0 17 0 0 43 6 0 7 0 21 0 
0 1 0 0 16 1 0 20 0 8 0 10 2 10 2 8 4 7 10 0 4 0 0 0 3 0 0 46 0 0 
12 0 0 0 0 0 0 5 0 0 0 7 17 0 1 0 0 4 0 0 0 4 0 1 0 0 0 13 14 0 
8 38 0 0 0 3 0 0 1 0 2 10 9 0 3 0 4 1 6 0 14 5 1 4 6 0 8 8 0 28 
9 3 5 0 5 11 5 11 0 0 0 11 10 11 0 0 21 4 0 8 7 0 5 0 11 0 7 8 1 0 
0 11 0 0 5 5 0 9 8 12 0 5 0 0 0 4 0 0 17 0 9 0 2 0 5 0 10 0 0 8 
11 0 0 23 21 6 0 2 0 0 0 0 0 1 13 15 18 0 0 0 5 5 0 0 15 1 7 14 26 4 
0 2 0 0 3 37 16 0 2 12 16 0 0 0 0 3 1 0 0 0 14 14 2 2 10 0 34 0 0 0 
0 22 16 22 0 13 0 0 0 0 0 0 0 12 8 0 0 3 14 0 4 0 0 22 4 22 0 9 10 0 
0 2 0 0 12 0 0 17 0 0 0 14 10 3 0 10 3 0 0 4 0 0 0 4 17 0 1 13 0 0 
0 11 34 1 1 17 0 0 33 43 0 3 5 9 2 6 10 8 10 0 7 19 6 14 20 0 0 22 20 0 
0 11 12 25 11 0 0 6 0 0 0 17 16 35 11 7 12 13 23 0 13 0 9 7 0 14 33 38 34 0 
