30 17
1 14 9 1 0 0 12 7 2 0 0 10 14 4 12 0 2 4 0 0 0 10 0 1 1 0 0 0 14 0 
15 0 0 13 8 13 8 0 0 0 0 0 17 3 14 0 12 0 12 12 13 2 0 0 4 25 21 9 11 13 
29 0 0 0 0 15 19 0 6 0 0 0 0 0 6 0 0 17 0 0 29 0 0 0 4 0 0 9 0 0 
0 21 1 0 6 22 3 18 12 0 1 23 24 2 7 13 17 7 10 7 10 0 14 0 8 24 1 12 18 1 
0 11 0 23 0 1 13 0 0 0 19 0 15 3 0 0 13 1 1 2 0 0 0 0 0 19 23 6 0 10 
0 23 10 0 0 9 0 0 7 0 0 0 5 33 13 0 0 0 0 8 0 0 9 8 15 24 18 0 3 0 
0 16 0 0 0 0 0 21 0 0 0 2 2 13 0 8 7 16 6 6 8 0 4 9 4 5 6 0 21 0 
0 0 28 0 11 0 8 0 0 0 0 0 4 2 0 10 1 1 12 0 4 0 13 0 0 5 24 0 8 3 
0 0 0 0 4 14 15 9 11 0 0 0 0 0 0 0 0 0 0 14 11 15 0 0 0 0 0 0 3 9 
0 2 7 1 24 1 21 2 1 3 8 19 0 15 0 18 0 12 2 0 0 0 5 0 0 12 39 3 11 14 
17 0 0 0 4 0 0 0 0 0 18 0 21 10 10 0 0 16 0 7 8 8 5 0 0 0 6 6 21 0 
0 2 26 25 0 2 0 30 1 0 1 0 0 1 0 0 4 0 2 0 10 12 0 2 0 0 25 1 1 0 
11 0 0 6 0 0 0 0 20 6 1 0 0 17 0 0 0 0 6 5 0 0 0 0 2 2 16 8 24 0 
12 44 2 28 15 32 0 6 1 10 9 11 0 0 13 6 6 0 14 26 19 0 1 12 0 0 0 24 0 24 
55 11 0 3 4 9 7 37 6 0 6 0 12 5 24 3 16 3 7 13 3 0 15 10 10 4 2 20 26 17 
0 0 15 0 20 0 0 0 0 8 0 17 0 10 6 9 2 15 4 3 9 2 18 2 10 14 0 12 0 0 
0 14 0 17 8 0 9 8 12 5 13 3 15 6 19 8 0 0 13 0 20 0 14 15 0 7 0 0 0 0 
