30 17
0 0 29 5 2 18 20 0 11 25 38 2 23 0 0 0 14 8 16 14 6 3 0 16 12 10 50 3 26 4 
0 12 0 0 0 2 5 15 0 3 0 3 9 0 3 0 13 0 0 1 6 14 0 0 18 13 15 0 20 13 
0 3 0 8 0 0 0 10 8 6 0 15 0 0 3 0 0 0 0 8 25 13 0 23 0 0 1 0 8 0 
3 0 3 0 6 2 0 3 22 0 7 0 11 8 8 0 8 9 0 0 0 7 0 0 0 0 0 28 1 13 
1 0 2 0 0 13 12 0 6 0 0 0 19 0 0 0 0 0 13 6 4 4 0 0 12 4 0 9 0 0 
1 3 11 1 0 5 0 15 20 0 16 8 26 4 0 7 0 0 20 0 0 1 14 0 23 10 2 0 0 11 
3 0 0 0 10 1 10 0 0 0 0 0 0 0 11 0 15 0 0 1 0 0 0 0 5 0 0 0 0 0 
0 3 0 8 23 9 0 18 2 0 0 1 0 0 1 0 9 0 2 1 5 0 0 0 0 4 0 22 0 8 
17 0 28 7 0 0 3 0 7 20 7 0 0 0 6 6 5 0 0 0 2 24 0 3 0 16 19 0 26 0 
0 9 6 10 4 1 0 1 12 0 6 3 0 13 2 7 8 0 7 0 0 6 6 0 0 7 7 1 0 0 
0 3 0 0 0 1 5 0 17 0 10 11 14 10 12 0 0 3 0 5 7 8 9 0 0 3 6 16 0 0 
0 6 18 11 31 20 8 22 5 0 0 18 3 5 29 0 3 0 0 10 19 0 6 22 5 16 19 11 10 3 
7 3 35 19 2 5 0 1 0 1 12 3 0 0 0 0 0 4 0 0 18 0 24 0 0 2 0 2 27 0 
0 23 10 24 9 13 19 13 11 14 15 6 8 9 9 3 8 0 2 0 11 6 0 11 0 19 16 27 12 0 
0 15 9 1 17 0 0 0 7 0 0 0 0 0 0 11 15 0 6 7 12 17 4 0 14 0 18 4 0 11 
0 0 0 0 0 12 0 0 6 3 15 15 0 1 9 0 0 12 0 9 0 1 0 0 0 22 6 8 9 26 
22 0 8 11 7 0 34 41 20 0 0 7 11 1 0 0 1 5 29 3 0 0 22 16 17 0 0 20 22 13 
