30 17
5 22 0 8 0 6 0 17 0 0 8 0 0 0 0 10 2 13 8 0 8 0 2 22 0 4 0 7 21 4 
1 28 0 4 0 12 23 6 0 11 0 17 1 7 0 0 0 0 0 0 0 0 0 0 0 0 20 0 0 37 
10 7 0 0 0 0 19 0 0 0 10 0 1 11 6 0 0 0 0 6 0 0 22 1 0 19 7 0 0 7 
0 15 0 30 3 9 8 6 0 0 0 13 1 4 0 9 0 4 0 3 0 8 0 0 4 22 6 0 0 0 
4 2 0 9 0 4 12 18 0 1 5 0 17 12 0 4 0 0 2 0 0 0 2 7 0 23 0 9 0 3 
13 11 0 6 24 6 11 0 0 10 5 9 8 0 0 1 0 11 15 2 6 0 22 3 0 20 0 0 47 7 
0 21 12 0 8 0 4 4 9 5 0 1 0 4 7 0 0 0 10 12 0 14 2 0 0 24 25 0 9 3 
0 12 4 0 15 13 0 6 1 1 0 1 10 6 9 0 0 0 5 0 8 20 0 19 0 0 6 6 0 4 
0 0 0 7 9 1 3 0 6 0 0 0 6 0 14 0 8 0 0 3 0 0 0 0 5 0 0 2 0 1 
24 1 15 12 5 0 1 15 2 0 18 0 17 27 3 5 6 8 0 0 8 9 0 5 24 0 10 14 0 55 
20 26 27 5 2 8 38 15 4 20 17 8 0 10 9 5 0 10 12 8 20 4 7 16 0 0 20 41 23 11 
0 4 3 8 0 5 3 6 0 5 2 0 0 0 0 0 0 0 1 0 14 0 0 0 0 0 0 0 0 0 
0 0 3 50 2 27 7 6 13 6 0 2 8 1 11 0 0 8 14 0 8 9 0 2 4 17 20 24 0 12 
5 0 24 11 23 25 1 0 2 0 14 12 3 0 0 0 0 13 8 8 0 0 0 13 0 13 10 29 0 24 
0 24 0 9 2 3 5 5 14 7 15 0 3 0 0 6 0 0 0 9 3 13 7 0 0 0 0 21 0 2 
0 19 40 9 6 0 0 0 0 23 0 9 6 0 1 0 15 12 0 1 29 12 13 21 12 0 0 0 0 29 
0 4 43 1 8 11 12 1 3 14 0 10 3 21 2 0 8 3 17 9 0 0 0 7 0 23 0 8 15 6 
