30 17
0 53 11 1 15 17 5 0 17 16 10 13 0 16 1 27 0 17 11 20 12 0 5 0 4 3 25 10 0 48 
0 0 0 5 0 0 0 9 0 0 0 32 8 11 7 11 2 9 11 0 2 1 0 15 0 4 3 0 9 14 
7 12 0 10 12 0 20 7 16 8 0 3 0 18 1 2 0 4 0 18 2 0 22 0 19 0 20 0 0 29 
0 0 4 20 0 46 4 0 20 21 0 5 0 0 22 0 14 5 8 6 11 16 5 24 1 11 13 24 20 25 
0 12 0 0 22 0 0 1 0 7 0 0 0 0 0 0 0 2 0 22 16 7 1 0 0 0 0 18 0 26 
0 25 9 12 4 2 0 1 5 5 0 3 0 12 0 0 0 5 2 0 4 20 2 0 13 8 0 9 0 5 
0 0 0 5 12 0 0 3 21 0 6 0 0 0 15 5 2 0 0 4 0 0 6 0 10 21 0 10 6 23 
0 14 7 0 0 0 0 6 2 0 2 0 8 6 0 14 0 0 0 7 9 0 0 0 0 1 6 0 0 9 
0 0 16 6 16 2 0 5 14 0 9 0 1 14 0 0 0 0 16 9 0 17 6 0 0 5 1 14 0 4 
9 5 0 0 28 0 22 3 0 0 0 0 0 14 0 15 3 0 14 0 20 0 16 2 0 16 26 7 3 25 
0 0 32 0 17 6 53 21 22 7 4 11 0 8 7 10 0 7 0 12 8 0 0 6 4 0 4 17 19 11 
0 0 27 0 16 0 0 0 11 0 0 6 0 2 4 0 1 3 8 7 11 1 4 9 1 0 0 0 8 32 
2 0 2 1 0 10 4 6 0 0 0 10 0 17 2 1 6 14 0 16 0 1 0 0 0 4 4 0 0 0 
11 0 0 0 0 13 0 21 0 9 0 13 0 15 4 13 0 4 11 0 0 0 7 0 24 9 2 0 27 0 
0 14 9 23 7 0 3 0 4 5 0 0 4 4 5 14 4 5 1 1 0 0 26 0 3 3 0 35 0 22 
10 19 0 0 0 0 0 1 1 0 10 7 0 7 2 0 2 2 0 0 26 0 11 0 10 14 2 0 2 12 
0 12 0 14 6 9 11 10 0 0 0 9 0 0 3 0 0 10 13 0 20 0 0 0 7 0 9 25 0 0 
