30 17
0 18 27 14 20 6 10 0 3 2 11 0 0 9 30 0 10 0 0 19 14 11 0 0 6 22 10 0 3 22 
15 16 1 12 0 6 17 0 2 9 14 9 10 12 0 0 9 10 12 22 3 8 11 13 35 0 0 14 12 0 
20 0 0 22 8 29 16 0 27 1 1 0 3 0 0 0 8 0 10 8 6 13 0 0 2 20 9 0 25 0 
0 31 0 0 0 0 4 0 0 0 0 11 0 12 0 13 4 0 0 0 18 0 0 0 0 0 6 0 13 0 
11 9 26 2 0 9 0 0 0 0 5 21 6 4 0 3 12 0 17 2 8 0 0 4 9 0 0 0 0 0 
0 13 0 15 17 1 1 19 0 0 3 1 5 0 25 12 4 7 0 0 0 10 0 0 4 0 0 4 2 0 
0 0 3 0 0 3 0 0 0 0 0 0 11 0 0 0 0 0 0 0 5 0 0 11 0 0 0 0 0 0 
18 9 5 0 16 0 7 0 0 0 1 4 0 0 0 5 10 3 18 3 1 11 0 8 5 0 0 0 2 9 
5 0 23 5 1 30 5 1 6 0 9 7 17 9 0 12 4 0 2 27 3 2 10 13 8 10 6 0 7 1 
0 0 0 4 19 13 11 3 0 9 5 12 7 0 3 0 3 2 11 15 4 16 0 7 19 5 3 4 0 8 
12 25 0 15 0 11 12 19 2 0 0 1 0 18 0 12 10 0 15 19 0 9 0 0 10 1 7 26 0 0 
0 22 7 0 0 0 0 0 0 0 7 5 0 0 5 0 0 6 0 1 11 0 0 19 0 0 3 0 11 0 
1 1 3 10 0 1 10 0 0 0 3 18 0 1 0 2 0 0 0 7 4 0 3 1 0 4 0 0 0 18 
21 29 16 17 20 12 1 1 15 1 1 9 3 12 0 0 0 5 17 1 14 1 9 5 29 0 12 17 12 0 
0 0 16 0 31 10 5 16 0 5 0 39 0 4 0 0 0 0 16 0 0 0 4 8 20 0 0 0 0 0 
10 0 11 14 0 6 0 0 3 19 0 0 0 0 9 15 0 0 1 0 0 13 3 3 0 0 0 14 26 6 
14 8 0 0 0 29 0 22 12 28 0 0 3 7 3 3 3 0 7 0 25 1 0 18 11 0 0 7 0 2 
