30 17
24 29 0 7 0 2 16 8 0 0 5 0 10 13 0 10 0 0 15 0 0 0 0 5 47 8 11 0 0 0 
0 26 0 20 39 24 1 0 14 0 3 0 0 15 11 1 13 0 7 1 2 1 9 0 0 18 0 12 13 9 
0 0 0 16 33 0 0 0 7 0 0 0 3 0 25 7 12 3 0 17 0 0 8 0 0 30 0 0 7 0 
2 19 2 6 7 29 0 0 3 0 19 0 0 9 0 12 0 7 8 0 29 0 0 13 9 8 6 10 0 6 
0 12 7 46 0 6 0 3 0 7 8 24 4 12 7 0 4 0 1 0 8 0 1 25 13 0 0 14 20 26 
0 14 0 0 0 1 9 7 0 0 0 0 12 0 2 14 8 3 0 0 0 7 7 3 0 9 0 15 0 0 
23 4 1 0 0 12 19 0 19 13 3 1 0 0 0 15 23 0 0 0 0 11 19 1 30 5 15 16 0 9 
0 7 0 48 0 21 5 27 7 3 9 15 0 14 5 13 6 2 0 9 1 0 0 0 0 22 4 6 15 35 
0 0 0 1 0 21 0 4 0 0 8 8 0 7 7 10 1 0 2 0 2 0 0 0 0 1 5 5 0 0 
0 0 22 13 10 0 0 0 0 3 5 5 10 0 17 5 0 8 0 17 0 1 3 5 17 0 0 21 2 7 
0 0 0 0 0 7 0 4 0 0 0 0 10 0 0 0 0 0 0 0 3 0 3 3 0 0 0 5 0 9 
4 17 0 8 7 2 5 5 0 5 0 6 0 0 0 0 0 0 17 0 12 0 14 0 19 15 1 0 0 0 
0 20 25 0 16 1 18 0 4 9 3 22 18 0 0 1 5 18 27 4 2 10 18 29 1 11 24 0 11 27 
0 22 11 0 23 0 0 0 0 4 10 6 0 9 10 2 12 1 0 5 0 0 5 30 11 4 5 16 12 4 
0 10 0 2 0 0 2 21 0 0 0 4 0 0 5 9 0 0 0 7 0 13 0 0 0 0 0 0 2 0 
26 3 0 17 0 3 23 0 20 0 7 24 0 14 13 5 0 12 15 0 2 6 22 3 5 9 0 13 11 10 
2 11 18 10 0 1 41 5 0 8 0 8 2 3 8 14 1 0 0 0 6 7 21 0 0 2 0 10 1 0 
