30 17
12 0 0 0 24 14 0 1 0 6 18 0 12 4 6 6 0 0 0 0 1 0 5 9 0 0 4 0 50 0 
25 2 15 6 24 0 2 4 14 0 0 12 0 3 0 0 3 0 11 0 27 0 0 15 5 30 7 15 0 0 
18 0 8 24 25 12 0 0 0 10 10 3 11 1 2 7 5 0 18 0 9 17 17 4 0 0 5 27 13 8 
21 23 7 17 0 0 2 30 17 4 0 7 11 11 7 0 7 0 0 0 11 37 0 44 17 3 2 6 2 0 
0 0 0 0 30 4 23 1 10 0 0 0 10 0 8 8 12 12 0 14 0 8 14 0 0 0 4 0 0 8 
36 0 0 15 8 0 0 15 18 9 12 3 3 0 2 0 0 5 15 8 0 5 3 5 0 8 13 25 0 0 
0 3 0 16 3 0 2 0 0 2 0 0 0 0 15 6 8 3 0 16 3 12 1 13 5 0 0 0 0 0 
0 0 0 0 9 0 7 19 0 0 15 0 0 11 9 11 3 5 3 0 4 6 17 0 0 11 2 7 0 0 
0 0 16 0 14 0 2 4 2 0 9 0 6 0 4 0 0 7 2 9 0 0 0 0 0 3 6 1 0 0 
0 2 6 6 2 12 0 6 2 2 0 5 0 2 0 0 6 12 0 9 6 0 0 16 0 0 0 0 9 0 
0 32 7 0 29 15 6 3 11 21 17 10 6 0 19 2 0 2 3 0 14 9 3 2 20 13 0 31 18 0 
12 6 8 9 2 4 0 4 2 13 8 3 17 1 0 11 0 2 10 0 0 4 6 0 0 23 11 0 1 0 
0 11 16 0 0 8 5 20 0 2 0 0 0 13 8 0 0 16 27 4 0 9 8 10 0 0 0 3 10 22 
0 1 1 41 44 3 0 0 29 5 0 4 9 0 3 8 0 13 0 1 0 7 0 8 0 0 0 0 29 0 
21 5 15 28 0 8 4 16 0 0 4 31 16 14 0 8 5 5 13 17 0 0 22 38 5 0 25 0 6 0 
1 9 0 0 6 0 0 0 13 12 15 16 4 0 0 0 16 2 0 1 0 0 0 0 0 0 10 19 0 0 
0 0 5 16 2 2 9 5 6 5 6 0 5 0 5 0 0 2 4 16 9 0 7 0 0 13 0 15 0 7 
