30 17
0 8 0 17 0 0 2 0 44 10 0 0 1 8 4 5 7 10 1 7 0 3 9 0 17 0 11 31 0 7 
2 0 0 0 0 0 0 0 0 0 10 0 0 0 0 2 0 0 0 0 0 2 0 6 1 0 6 0 1 0 
0 1 0 25 0 0 8 22 12 27 0 12 2 0 0 9 0 0 8 4 4 0 5 8 7 0 9 8 7 11 
14 5 3 13 10 0 0 34 13 0 18 0 15 2 6 1 13 0 4 0 3 35 15 18 22 2 0 64 25 13 
0 0 1 9 4 15 8 22 7 20 2 4 2 0 0 0 10 9 10 9 9 7 0 1 0 20 10 0 19 25 
0 0 0 0 41 8 0 0 3 0 0 3 0 7 15 0 0 0 0 0 0 1 1 20 7 4 22 0 0 4 
17 0 3 0 0 3 0 0 0 0 3 18 0 3 7 6 0 0 0 4 0 21 0 5 0 0 8 0 0 10 
0 0 20 0 16 0 0 0 4 5 10 2 2 0 7 0 0 0 0 13 17 0 15 0 4 0 3 0 4 3 
8 2 8 24 0 24 0 0 15 1 7 5 8 8 0 0 0 9 0 7 0 26 0 0 5 0 2 6 0 19 
8 2 0 6 0 6 0 0 18 22 13 4 2 0 2 6 11 0 0 0 0 0 0 0 7 9 0 2 0 21 
5 0 11 0 0 0 10 0 23 8 3 0 0 32 15 0 0 10 0 0 1 0 8 23 0 5 3 14 6 1 
0 22 0 1 0 46 1 4 2 0 0 0 5 0 12 0 5 0 0 7 15 14 1 2 12 0 21 15 0 31 
0 11 10 0 0 4 7 1 5 15 10 3 5 0 1 1 3 10 4 0 10 0 7 0 24 0 6 17 4 8 
11 12 0 9 49 0 27 11 19 0 9 39 4 12 5 11 0 0 12 22 14 1 20 4 0 21 19 17 1 32 
42 0 0 29 0 0 0 2 5 17 17 16 2 0 6 6 7 0 10 4 0 0 0 4 0 0 26 33 0 10 
0 6 0 0 0 4 12 8 0 11 0 0 0 7 10 0 7 10 0 0 8 0 0 0 0 0 0 0 0 0 
3 0 4 8 0 12 18 0 29 2 5 0 3 13 7 14 0 5 0 5 0 0 0 0 5 0 13 0 22 0 
