30 17
39 13 0 0 17 0 0 6 18 11 0 3 17 10 1 0 12 0 26 4 16 39 23 14 12 0 8 0 0 37 
0 19 8 0 3 6 2 0 0 0 2 6 0 0 0 14 0 4 0 8 16 0 2 3 0 0 0 24 9 47 
0 29 14 22 14 0 18 0 16 12 9 4 13 2 8 7 6 3 0 0 13 20 8 15 13 50 0 14 0 0 
10 0 0 17 0 0 9 0 4 7 0 11 4 16 7 0 16 0 0 0 8 10 0 0 9 7 0 0 0 9 
0 3 8 9 0 10 6 2 0 2 3 0 0 5 9 10 0 0 0 1 7 2 3 8 11 0 0 1 0 23 
0 0 0 0 0 0 0 0 0 1 2 1 3 0 2 0 0 4 0 0 21 12 0 0 0 0 0 0 0 0 
14 0 27 0 60 0 15 0 4 23 1 14 1 2 7 0 2 5 7 10 0 12 15 1 6 0 2 5 19 61 
0 16 10 0 20 0 22 0 6 11 3 6 13 11 2 0 5 11 1 0 5 10 5 21 20 0 2 0 26 35 
8 0 5 5 4 24 0 20 10 0 0 2 6 13 14 0 0 0 15 19 0 9 0 0 0 5 0 0 14 29 
9 7 6 0 0 0 0 0 2 7 6 0 0 3 0 6 1 0 0 5 6 8 6 0 0 0 0 0 0 8 
0 5 10 25 0 3 3 2 2 2 0 0 7 0 0 13 9 0 0 11 0 0 0 8 10 9 0 2 34 2 
0 1 23 0 0 2 5 0 0 7 5 9 4 0 0 5 1 1 0 0 6 7 0 0 0 0 5 0 12 3 
5 17 28 10 17 12 18 0 0 13 12 1 5 1 3 0 0 11 0 12 15 11 10 4 11 0 0 39 26 2 
22 27 0 25 0 13 3 10 6 0 0 1 0 2 3 2 0 10 12 26 15 0 19 9 16 0 0 8 8 13 
17 0 0 36 14 0 30 0 14 12 9 10 26 10 9 0 0 30 0 5 0 10 0 10 0 8 10 1 22 24 
0 5 3 0 0 0 0 0 0 0 13 0 0 7 3 5 0 11 0 0 10 7 0 0 0 0 0 13 20 14 
0 4 13 18 6 0 0 21 0 0 0 9 3 0 4 3 0 0 4 0 13 18 7 2 20 0 5 0 0 0 
