30 17
35 3 2 0 15 0 0 0 0 7 13 0 1 0 14 0 20 0 2 23 8 11 0 23 8 0 0 0 0 0 
0 0 13 26 18 17 15 5 17 0 0 0 11 0 0 0 6 5 0 0 0 9 1 1 3 17 1 15 0 26 
0 31 23 21 21 0 8 0 10 9 13 0 1 0 0 0 0 0 21 0 0 0 19 28 0 23 26 7 0 25 
17 16 10 3 0 10 8 4 0 0 4 0 9 12 2 3 0 32 0 0 11 8 10 5 17 0 11 0 5 0 
0 11 26 0 25 0 2 0 4 0 2 5 0 0 0 0 0 5 0 2 4 0 29 0 13 0 15 0 8 32 
1 2 23 3 0 12 1 2 17 2 12 0 0 8 0 0 5 0 0 0 10 0 17 13 0 11 0 0 5 0 
36 2 2 13 9 23 2 2 20 0 7 0 0 0 0 15 10 13 0 7 3 5 0 3 24 0 10 0 3 0 
5 7 18 41 4 0 0 4 34 2 3 0 0 15 10 0 15 7 3 0 0 23 19 14 0 2 3 5 14 22 
0 9 19 6 2 42 0 20 2 0 0 16 0 11 5 0 0 15 17 8 0 7 0 21 5 0 0 23 1 8 
4 0 9 33 3 5 0 3 0 1 9 8 0 3 14 6 3 0 0 0 0 0 7 0 4 0 0 7 11 1 
3 0 6 1 43 0 8 3 0 9 2 0 2 3 0 0 3 0 5 0 0 14 37 0 3 5 2 15 35 1 
0 0 6 5 0 16 9 19 2 0 0 0 3 0 14 16 0 0 3 10 0 9 0 3 0 0 0 22 0 3 
0 0 25 0 9 3 0 0 17 9 0 0 7 4 0 0 27 9 20 0 3 19 9 21 0 6 9 0 11 2 
18 0 0 0 0 0 0 18 16 0 13 3 2 5 2 0 19 7 6 0 0 3 4 0 29 12 0 0 0 13 
8 0 14 31 0 8 3 19 10 0 5 10 4 12 7 15 2 0 0 0 0 12 0 21 3 14 42 2 0 30 
20 19 10 25 0 0 0 21 0 0 0 0 9 2 0 0 0 0 5 24 15 0 0 0 0 0 0 0 7 0 
0 0 1 0 0 4 15 0 0 0 0 0 2 7 0 4 6 0 9 15 7 19 27 14 0 0 0 15 0 0 
