30 17
11 13 15 9 0 0 5 0 0 0 0 13 1 0 0 0 0 5 0 0 7 1 2 0 4 35 0 0 12 11 
8 15 9 15 0 0 0 6 0 23 10 10 2 1 3 3 2 0 3 0 8 17 0 20 0 8 0 18 10 0 
0 17 30 21 4 0 8 17 2 0 7 18 25 19 18 0 0 0 9 0 2 1 7 8 18 25 1 1 0 50 
1 2 0 20 0 18 12 13 0 14 0 23 0 0 8 0 0 0 6 0 1 6 0 13 3 0 3 0 4 18 
22 0 17 0 20 23 23 0 0 9 4 0 0 0 0 0 0 0 0 30 0 2 0 5 23 0 0 3 9 29 
26 3 0 0 0 13 0 8 9 7 19 0 19 0 0 0 1 21 13 0 0 0 22 9 8 13 0 0 0 24 
5 8 18 0 0 8 8 5 0 9 4 3 8 1 22 3 0 1 0 6 18 6 0 5 0 4 12 0 0 0 
4 2 0 9 16 11 5 0 0 1 2 21 7 3 6 23 11 4 0 12 0 0 3 0 1 24 0 7 9 0 
21 0 18 0 0 0 0 1 5 0 4 0 0 4 11 0 6 0 6 0 0 23 0 0 0 2 0 0 34 0 
42 3 7 0 0 0 21 13 0 8 16 0 12 13 0 15 0 0 9 11 20 6 7 3 17 9 16 0 5 0 
27 0 0 0 11 0 0 0 0 1 0 0 11 0 2 5 4 2 0 0 0 6 7 0 12 0 26 0 5 2 
24 14 0 0 24 16 0 3 2 4 2 3 3 2 5 16 5 2 11 4 10 27 0 5 0 31 7 11 2 25 
22 11 12 0 8 12 0 0 0 0 10 5 14 0 14 3 1 10 0 0 8 0 0 0 0 0 0 3 0 0 
17 31 0 14 0 21 12 25 11 0 0 1 0 15 0 0 3 6 1 29 20 0 22 0 0 12 2 0 0 10 
6 0 0 3 30 0 1 0 0 0 0 0 0 13 7 11 2 0 1 1 0 0 0 10 5 0 13 2 0 3 
23 6 33 0 19 0 22 2 0 0 0 4 0 0 5 0 8 4 0 8 6 9 0 4 8 0 2 8 19 1 
0 16 8 4 10 0 6 1 0 0 0 0 14 3 34 10 0 16 15 0 0 0 0 0 14 2 0 13 12 0 
