30 17
2 17 0 12 0 5 0 0 14 0 21 9 2 0 0 0 0 0 17 16 9 0 14 11 0 42 0 0 0 10 
8 16 16 2 0 0 5 15 3 4 8 38 4 4 8 13 1 24 4 1 9 1 17 16 4 22 24 24 10 7 
13 0 12 14 24 0 16 18 6 1 11 0 24 10 6 3 10 0 17 0 11 16 3 11 0 18 34 0 19 0 
6 7 0 2 0 20 0 0 0 0 0 0 0 8 0 0 0 1 0 0 0 8 6 18 0 25 0 2 0 19 
18 0 6 27 18 0 24 32 19 0 0 0 0 7 0 6 3 1 21 15 0 20 0 21 10 19 0 25 0 27 
0 14 8 15 1 15 5 1 0 0 8 3 0 9 15 0 0 3 0 0 12 0 2 1 17 0 12 28 11 0 
2 19 22 0 5 0 6 4 0 5 0 13 0 0 0 5 0 2 0 14 14 5 0 1 2 0 24 7 10 0 
9 6 5 0 0 6 0 15 13 9 3 0 0 0 7 10 0 4 0 1 10 10 8 8 0 0 0 0 0 0 
0 0 26 12 7 0 0 16 4 0 1 0 0 0 0 12 0 2 0 4 13 0 6 0 5 0 0 8 32 0 
5 27 0 0 5 9 8 18 0 17 8 0 7 9 0 6 13 8 1 8 20 15 22 8 18 25 11 0 0 23 
21 7 0 36 7 9 1 4 19 0 0 14 0 0 23 20 0 5 8 0 0 4 1 0 0 14 9 27 0 26 
17 6 5 9 4 2 0 2 8 0 0 15 0 7 0 0 0 8 0 3 2 4 17 12 0 11 0 29 11 8 
6 0 0 19 0 14 6 26 7 7 1 0 4 1 0 0 3 0 0 9 0 0 8 17 1 2 0 1 1 22 
12 6 0 0 11 0 0 18 0 0 0 0 15 11 0 14 0 5 0 0 0 0 11 2 20 18 0 3 6 4 
0 17 0 16 10 0 37 0 2 12 25 8 8 7 8 9 13 11 38 3 0 13 5 13 14 2 0 21 7 24 
32 0 0 11 20 0 0 11 3 0 0 4 13 0 0 4 0 0 0 0 20 9 13 6 0 4 0 0 0 4 
4 0 0 27 2 0 0 9 2 2 0 17 0 0 0 4 13 1 5 0 5 0 0 0 6 5 0 8 21 0 
