30 17
24 31 8 11 0 0 0 5 11 6 0 11 15 13 11 13 0 8 0 2 0 1 0 0 0 12 0 26 0 15 
0 15 14 12 0 0 0 0 0 0 12 7 0 0 7 6 11 0 19 1 6 6 12 0 0 0 5 6 0 0 
14 2 14 10 0 3 14 42 0 0 12 10 0 6 0 0 4 0 0 25 31 10 15 0 0 15 0 2 0 22 
0 14 0 4 0 0 5 4 0 0 5 0 13 0 12 18 0 0 0 0 0 3 10 0 0 0 9 0 0 4 
11 0 0 0 0 0 0 0 8 7 0 5 11 0 7 0 24 0 0 1 0 7 0 0 0 0 0 2 0 0 
0 0 4 9 8 1 0 15 10 0 0 0 5 0 7 0 0 7 8 1 0 3 1 7 11 0 0 1 2 0 
0 6 5 0 19 16 6 12 7 19 0 6 7 0 0 13 0 2 1 0 5 10 8 35 0 0 11 8 9 21 
1 6 10 0 23 7 8 43 0 1 19 4 3 0 2 19 3 0 0 0 0 0 0 0 2 0 0 9 0 16 
0 2 0 0 3 13 5 14 10 0 22 1 0 7 0 0 12 0 4 0 12 3 0 0 11 0 0 17 20 0 
29 0 2 0 12 0 7 0 0 0 0 17 0 7 1 1 5 0 0 0 3 6 0 0 0 0 0 40 0 0 
0 9 0 0 0 0 12 4 0 6 4 0 0 14 0 3 6 0 11 3 0 0 2 2 0 0 2 34 0 0 
0 4 6 9 8 24 0 0 11 15 0 0 11 0 0 5 0 0 0 9 2 0 17 0 15 11 1 8 0 17 
24 12 12 10 0 16 0 21 0 12 10 0 6 31 0 10 20 9 0 9 15 12 15 19 6 10 11 25 7 13 
14 12 26 13 17 2 9 30 16 0 11 1 6 7 14 5 32 0 3 3 1 19 11 4 7 19 0 4 24 1 
0 13 0 9 0 23 7 0 0 15 10 14 1 0 9 0 1 19 13 9 0 0 3 0 14 15 0 18 31 1 
0 7 22 0 14 0 0 0 0 39 12 0 12 0 12 8 0 0 17 5 13 6 1 0 5 0 0 0 27 35 
10 0 5 0 11 14 4 8 13 0 2 0 18 6 0 0 7 18 16 4 18 9 0 15 34 7 22 15 26 4 
