30 17
0 0 0 0 13 0 0 0 17 16 0 0 7 11 17 0 13 25 0 0 2 9 5 0 1 13 12 0 8 0 
0 18 12 0 0 20 7 27 15 5 9 0 13 9 9 3 7 10 1 0 3 19 10 40 5 11 21 16 26 18 
90 20 0 2 4 10 3 0 21 7 10 14 2 6 21 19 0 35 0 0 10 0 8 0 0 14 0 0 27 8 
4 6 11 0 2 0 0 1 20 0 0 0 1 12 3 13 0 4 11 12 0 0 14 19 10 0 13 0 0 3 
0 7 24 0 0 19 0 0 3 3 4 0 0 6 0 0 8 0 0 0 0 1 0 4 19 2 37 4 0 8 
0 4 2 0 0 33 2 8 0 12 0 27 8 2 8 19 2 0 2 2 17 11 6 4 9 0 0 4 23 18 
4 0 31 13 8 1 0 9 0 2 0 9 0 1 0 4 17 12 1 16 8 0 0 5 5 1 0 0 13 1 
22 2 2 24 3 2 4 2 0 5 0 0 18 1 0 3 6 0 3 0 15 0 17 27 0 1 4 24 0 13 
0 0 12 0 0 3 23 0 1 0 0 10 0 10 18 12 0 8 0 15 9 12 6 4 1 0 0 3 0 28 
3 7 0 6 9 24 0 1 6 13 0 0 0 7 4 8 0 0 1 0 2 27 1 4 2 3 0 1 0 24 
0 0 0 0 11 1 10 0 0 0 0 0 0 0 0 8 0 8 0 0 0 0 0 13 0 4 0 0 0 0 
9 22 7 0 0 30 16 0 7 7 0 0 0 6 0 3 15 0 10 6 6 2 0 0 2 20 4 0 8 1 
0 0 23 6 22 9 5 0 0 3 0 9 0 9 9 11 0 11 0 0 22 0 0 0 0 26 43 0 0 7 
7 1 14 28 0 39 7 7 5 11 10 8 9 7 17 5 1 0 7 13 16 3 17 1 2 20 0 0 2 0 
0 18 0 9 8 13 29 0 21 0 0 0 38 0 0 14 8 0 21 0 0 9 22 11 0 14 14 0 0 21 
11 0 0 23 5 3 24 0 0 9 9 11 0 9 13 0 0 0 0 1 16 2 0 4 14 20 0 0 2 0 
5 0 21 14 1 16 0 0 4 0 0 0 4 0 20 6 0 6 0 0 0 20 0 28 0 0 13 0 0 8 
