30 17
4 12 0 1 3 13 12 23 6 0 0 0 0 0 0 14 0 0 15 0 0 5 5 3 12 0 16 14 0 0 
0 0 0 12 6 6 0 9 1 10 0 6 0 5 0 12 2 0 16 0 2 0 0 30 21 20 9 9 3 0 
0 24 3 12 16 3 0 18 14 6 0 2 0 1 7 15 13 0 2 0 31 6 14 0 19 14 21 0 0 0 
25 26 13 0 10 0 13 13 0 0 0 0 11 0 10 14 0 0 0 13 0 0 0 0 2 17 0 0 0 0 
32 17 4 26 0 0 16 3 12 10 0 7 0 12 9 10 7 3 7 10 14 40 6 10 9 0 24 4 23 8 
6 0 19 0 8 23 21 14 0 3 11 0 19 4 0 0 1 0 6 17 12 18 21 11 2 16 17 0 0 29 
0 4 0 6 7 7 0 0 10 0 0 0 0 0 0 2 0 12 0 0 0 8 4 0 2 3 21 9 0 0 
7 0 7 4 24 0 2 2 21 12 0 6 0 3 0 7 0 13 0 6 0 12 25 0 2 6 4 0 0 21 
15 5 26 6 5 2 20 4 0 7 5 2 2 0 4 21 0 0 7 0 0 8 16 0 0 0 1 1 26 0 
0 12 3 7 14 0 14 5 6 15 43 0 10 10 6 0 0 10 19 0 16 0 0 6 33 9 0 17 3 5 
6 52 29 6 12 21 10 1 1 1 0 11 4 6 5 10 20 3 5 22 0 6 29 0 0 1 33 0 27 4 
21 5 24 0 5 0 13 0 8 11 6 0 0 4 0 7 0 2 5 2 11 6 0 4 0 20 26 1 3 0 
0 6 20 5 1 7 0 4 0 9 7 9 2 12 4 0 2 3 4 0 26 0 11 0 18 10 0 12 1 28 
0 18 0 0 15 0 11 17 0 3 0 0 0 0 0 0 0 0 0 0 0 0 3 12 0 0 22 0 0 0 
5 0 0 15 0 4 0 0 0 15 0 0 0 5 0 14 10 0 15 0 0 8 0 0 15 0 10 14 0 9 
17 0 0 0 0 11 17 0 27 0 0 0 0 0 2 4 3 0 0 0 0 5 0 22 0 20 10 1 0 0 
0 3 13 14 0 0 10 13 20 0 0 14 1 4 3 0 10 0 13 8 2 0 11 1 0 0 0 12 20 0 
