30 17
0 0 2 37 14 15 0 0 11 0 0 2 8 5 3 11 4 0 15 9 0 9 3 0 0 23 0 0 0 13 
30 0 0 7 16 2 7 7 0 0 15 0 0 3 0 0 13 0 0 0 9 12 9 19 0 6 0 0 11 8 
0 0 9 0 0 24 0 19 0 0 25 4 0 0 0 12 1 12 16 14 0 0 1 24 0 12 0 0 0 19 
17 10 0 1 4 18 0 0 4 0 0 0 5 2 0 0 0 22 0 0 0 0 3 18 9 1 0 0 0 0 
19 0 1 18 11 0 14 2 5 7 4 12 2 4 1 5 20 7 5 26 26 23 11 2 1 0 12 0 0 9 
6 3 0 0 35 0 0 5 4 20 6 0 0 4 4 1 12 10 24 3 4 1 14 4 16 0 0 9 0 5 
0 0 0 18 0 0 0 0 45 0 0 0 0 0 0 0 0 0 0 0 0 37 0 15 1 13 0 6 0 21 
0 3 17 11 8 0 10 1 18 5 0 0 0 8 5 0 9 0 5 0 3 3 0 8 0 2 0 6 20 1 
0 7 5 23 7 13 8 8 6 0 14 0 0 7 0 0 0 0 16 2 6 0 0 6 14 8 30 0 0 1 
0 0 8 1 7 0 20 0 5 0 1 0 22 4 9 1 4 16 0 8 1 12 20 12 0 15 25 4 0 3 
8 0 0 24 23 20 26 0 6 3 2 0 0 2 5 2 0 1 0 8 0 3 0 0 21 24 0 15 0 28 
14 52 5 0 5 0 27 11 40 4 0 10 1 11 15 14 23 5 8 8 20 8 0 6 8 9 31 13 27 2 
11 15 0 2 6 10 0 9 3 0 8 23 14 0 0 4 0 13 17 18 0 2 11 0 0 4 16 0 12 12 
1 8 1 3 13 9 0 0 0 3 0 11 0 13 3 0 2 2 3 0 0 12 0 1 13 0 12 6 15 11 
0 0 0 22 3 0 0 0 0 0 1 3 5 5 1 0 2 0 9 6 0 0 0 1 0 34 0 0 0 0 
22 0 10 1 6 29 13 0 18 5 15 0 0 0 2 3 19 10 4 8 20 0 14 7 16 0 25 0 0 5 
28 0 9 18 3 0 0 7 9 9 0 3 0 0 2 0 7 0 0 0 1 18 0 5 0 28 0 18 28 0 
