32 18
0 18 0 4 3 9 0 4 6 8 0 0 8 0 38 11 15 7 0 0 0 7 16 25 0 0 9 0 14 0 0 0 
15 0 15 10 28 8 13 22 0 0 19 8 0 11 0 0 1 12 0 0 0 10 25 29 0 2 0 0 18 46 10 33 
2 1 17 0 4 16 9 0 12 22 0 0 31 0 0 10 27 11 18 0 3 15 10 21 0 3 14 15 6 0 0 43 
0 16 0 22 0 19 15 6 0 0 0 2 16 15 0 2 8 1 0 0 19 5 16 0 19 9 0 24 0 2 0 59 
21 21 15 11 0 4 0 2 0 38 2 0 2 6 13 0 0 0 5 0 0 2 4 27 3 11 0 5 8 0 21 15 
25 3 3 1 7 5 0 0 0 19 1 8 0 5 0 2 7 0 3 6 16 0 0 2 0 20 15 12 0 0 30 0 
0 3 9 0 0 0 0 0 11 9 3 2 3 0 0 0 5 6 0 0 0 12 3 1 0 0 0 0 0 3 9 0 
7 7 29 14 17 0 0 15 16 53 17 0 4 0 7 0 8 10 14 0 0 13 0 0 15 0 21 18 0 0 34 22 
2 27 7 0 11 2 0 0 0 0 9 0 0 0 0 5 0 9 4 17 0 5 2 6 0 0 0 0 6 0 0 48 
0 0 7 0 0 8 1 0 10 8 0 0 1 15 0 15 0 0 12 5 0 0 0 0 0 4 9 15 39 1 12 0 
3 7 13 2 0 16 7 20 0 7 13 0 0 6 0 2 7 5 6 0 0 31 9 0 0 0 3 20 2 0 15 0 
23 18 10 20 2 6 14 0 0 0 0 0 10 0 0 0 0 3 2 4 0 20 0 25 0 0 4 26 0 0 0 9 
11 0 3 0 24 10 0 2 0 7 0 7 6 0 0 0 0 11 0 4 0 0 2 12 0 0 0 8 3 0 11 24 
0 0 2 10 0 11 12 0 25 0 0 8 0 0 0 0 0 0 0 5 0 0 0 0 0 0 18 0 0 0 12 0 
25 28 0 0 0 16 6 0 0 4 39 6 0 3 14 6 0 0 17 14 0 0 0 0 3 0 0 0 18 0 0 21 
0 16 28 0 0 2 15 0 10 0 0 0 0 0 0 0 1 21 10 0 12 0 0 11 0 19 0 0 0 0 1 13 
0 0 0 12 0 8 7 0 11 0 0 0 0 0 0 0 0 0 0 7 0 0 23 15 0 0 14 0 0 7 0 12 
8 0 0 0 0 4 0 0 13 14 0 0 15 1 13 0 7 8 0 8 0 16 3 21 3 25 0 19 0 0 0 27 
