32 18
14 38 8 5 0 0 0 0 0 0 0 0 9 0 3 0 0 0 0 0 0 0 7 15 2 0 0 0 0 0 0 0 
18 23 0 38 13 19 8 7 0 2 14 17 0 1 4 0 8 9 6 0 0 0 0 11 42 0 0 10 43 0 0 13 
0 43 23 0 1 25 0 0 14 0 0 0 0 4 7 0 2 0 9 0 9 0 7 10 13 23 0 0 0 4 25 0 
0 0 0 21 26 6 15 0 12 4 12 4 19 0 4 0 0 8 27 0 22 0 8 0 36 0 0 8 19 54 0 1 
5 18 0 14 22 0 1 0 4 10 13 14 13 0 5 2 8 4 7 26 10 0 3 0 0 17 3 2 10 3 47 0 
0 0 0 1 2 0 3 0 0 0 2 0 3 1 6 3 0 4 0 0 6 0 3 0 0 0 0 0 0 0 0 0 
0 12 17 24 0 8 0 7 0 10 8 15 7 16 10 11 12 24 0 7 6 12 19 0 0 0 1 19 18 0 16 22 
0 0 0 4 0 0 25 0 0 7 10 0 15 0 13 7 5 0 1 0 0 0 9 4 0 3 5 5 9 0 0 5 
8 0 27 0 0 9 0 7 11 12 15 0 0 0 0 6 21 3 0 5 7 0 13 6 14 0 0 7 12 0 0 0 
3 29 0 0 0 0 0 0 0 0 0 0 0 0 6 0 0 13 4 0 6 2 0 0 0 0 7 10 0 0 23 13 
13 4 25 0 0 0 12 0 0 0 5 10 1 0 0 12 0 0 8 0 10 0 5 0 24 0 6 35 4 0 3 0 
2 0 0 24 0 11 0 9 9 0 15 10 0 0 19 0 3 14 4 9 11 1 7 0 8 1 0 38 0 0 0 11 
0 0 0 3 0 0 12 20 0 0 0 0 0 0 5 0 8 10 5 4 0 0 15 3 0 0 5 11 6 0 0 5 
14 20 0 5 6 0 0 0 0 3 7 4 6 0 16 14 9 7 0 14 10 16 8 19 0 10 0 6 0 25 12 0 
0 21 6 13 0 0 0 0 0 0 0 0 18 0 0 6 0 0 0 0 0 0 14 1 0 24 0 0 2 6 18 3 
13 2 0 19 0 9 0 0 17 0 36 8 2 9 0 0 4 0 0 0 0 0 0 8 0 17 0 0 0 0 2 21 
0 0 0 3 24 0 54 0 0 3 0 0 10 16 11 2 8 0 1 3 10 0 13 2 8 1 15 9 53 23 0 0 
0 34 0 30 0 7 0 5 19 0 3 0 2 8 11 21 2 0 17 4 0 8 19 0 23 0 0 10 13 0 7 13 
