32 18
8 20 23 0 0 11 40 0 7 0 0 0 4 10 6 0 6 23 0 6 0 11 16 14 5 22 0 26 0 27 11 0 
14 1 4 0 22 1 12 0 9 0 0 0 0 0 14 0 0 10 12 0 0 5 12 0 0 8 0 21 0 1 0 0 
13 0 0 3 38 0 0 2 13 1 2 17 5 0 0 11 16 0 0 0 0 13 0 0 1 1 8 8 17 22 26 15 
35 25 2 0 2 7 19 0 0 17 5 15 0 0 0 16 29 0 0 1 14 0 0 0 0 14 6 0 0 20 25 15 
0 20 22 0 0 0 0 17 9 17 0 0 0 0 22 0 0 0 0 0 0 0 25 3 39 8 22 0 0 2 1 34 
0 0 30 0 1 0 0 0 12 1 0 0 0 0 5 11 2 0 3 0 11 0 4 4 5 5 18 3 0 0 0 9 
11 23 0 4 21 4 2 0 8 4 0 1 0 2 0 0 3 21 0 0 3 15 5 0 11 1 22 0 24 0 0 2 
18 0 10 0 25 29 7 0 0 0 10 6 10 20 0 10 2 7 0 0 10 0 0 7 0 10 3 6 17 18 0 31 
41 8 0 0 3 12 0 8 0 0 0 0 0 0 11 0 15 19 10 0 0 0 4 4 0 11 0 0 28 37 0 18 
1 1 10 0 19 1 5 4 0 12 2 9 0 11 0 0 8 0 0 0 0 12 0 19 0 3 0 18 2 0 0 0 
0 29 4 36 10 3 2 2 2 15 15 0 6 20 1 12 6 0 0 0 10 11 0 13 15 11 8 9 3 0 17 0 
0 0 4 0 0 21 23 0 0 0 2 2 0 0 16 0 0 6 2 8 3 0 3 1 0 19 4 0 0 9 23 6 
0 19 0 0 14 12 0 0 0 18 0 7 0 0 3 0 0 34 9 0 30 8 0 22 7 1 0 0 0 8 25 47 
0 0 16 0 39 29 0 7 9 0 0 2 13 24 21 0 0 3 2 6 19 0 18 0 0 6 1 0 6 2 0 17 
0 6 5 0 0 0 0 0 15 0 0 9 0 9 1 0 0 0 0 0 0 0 9 29 0 0 0 0 4 7 0 1 
0 7 25 0 0 0 25 5 0 0 12 0 5 9 17 5 0 7 0 17 1 22 1 21 7 0 4 17 27 0 5 70 
0 6 0 18 0 0 0 3 13 13 0 1 12 10 0 0 0 0 4 6 0 14 0 8 0 0 29 24 19 21 1 0 
0 0 0 15 0 7 0 0 0 20 14 7 6 16 13 0 14 16 22 0 6 0 7 17 0 1 5 0 0 27 1 43 
