32 18
14 0 0 0 0 11 0 0 1 15 17 0 0 1 0 13 2 0 0 12 5 0 0 26 0 3 1 13 4 0 13 21 
21 0 0 18 4 0 8 0 3 0 0 0 0 2 0 0 13 0 0 10 0 35 0 0 0 0 12 0 0 0 0 0 
41 30 14 0 0 5 5 5 0 6 1 9 3 14 0 1 2 0 3 0 14 15 8 2 24 0 1 13 0 30 7 42 
20 0 58 0 0 0 0 0 21 4 7 4 10 17 0 0 0 0 0 0 12 0 10 17 0 2 4 0 31 6 3 0 
4 0 7 3 0 1 0 7 0 0 0 11 0 18 14 0 10 0 16 0 0 0 3 8 2 1 0 9 12 0 0 4 
8 0 0 0 9 1 19 0 11 16 0 12 0 2 6 7 0 0 2 13 2 0 2 3 20 17 21 7 0 6 11 0 
5 0 0 3 0 12 21 0 0 1 17 0 0 13 18 0 2 12 2 11 4 0 0 0 0 0 19 17 0 0 14 4 
25 16 0 0 0 0 0 5 1 0 10 6 0 2 0 3 0 16 0 1 17 21 4 2 0 0 2 7 6 9 1 0 
14 14 15 19 1 6 3 5 9 6 4 1 0 9 0 14 1 0 0 5 4 0 0 0 26 9 13 0 0 0 1 6 
0 0 1 2 8 0 23 0 0 0 10 5 17 0 0 11 0 18 0 0 0 23 0 3 0 0 24 4 9 10 13 13 
0 0 29 0 0 18 0 6 3 0 11 9 0 0 0 0 0 0 0 0 0 0 5 5 16 5 1 4 1 0 0 29 
0 0 3 7 0 0 6 0 0 0 0 7 0 0 11 0 14 0 0 10 3 11 0 0 0 6 6 5 8 14 14 0 
0 0 2 1 24 0 3 16 0 7 13 0 4 0 6 0 3 0 5 0 0 0 0 14 0 1 5 12 0 0 0 5 
27 26 0 0 3 0 25 0 0 11 0 17 12 0 0 0 13 0 0 0 11 10 6 7 20 0 12 0 8 0 13 49 
12 0 25 2 13 5 6 0 13 13 6 11 0 0 0 0 0 5 0 0 0 3 0 21 20 0 2 0 26 0 0 3 
21 0 12 4 25 13 0 0 14 0 0 6 2 7 3 8 34 0 0 0 0 21 9 5 1 11 0 0 7 38 0 0 
2 0 0 0 0 5 0 0 9 2 7 1 0 12 0 5 0 9 2 0 8 0 0 2 2 16 4 7 0 0 11 0 
0 40 23 0 20 0 66 18 16 0 0 0 0 9 13 0 12 0 0 1 21 8 7 14 18 17 0 0 13 23 11 11 
