32 18
5 0 0 0 0 0 7 0 0 0 12 16 0 17 0 0 0 15 0 0 0 10 0 0 0 0 0 16 0 12 0 3 
0 2 0 15 0 0 0 0 0 2 0 0 0 3 8 0 8 0 3 17 1 0 15 10 0 11 0 3 0 13 15 2 
0 21 0 0 0 6 14 0 22 7 0 12 1 0 0 4 0 6 0 0 0 0 5 7 0 0 25 0 0 0 22 0 
39 13 0 0 16 0 0 22 0 35 10 1 18 4 5 0 11 42 5 1 27 7 21 0 11 14 26 4 10 22 0 22 
14 21 0 0 0 0 0 4 0 0 0 2 0 0 13 0 8 1 7 0 9 0 19 0 13 0 0 0 0 0 0 10 
11 12 0 0 5 0 0 8 16 3 8 0 0 0 1 12 0 0 0 0 0 0 7 0 0 2 0 19 12 0 0 0 
17 5 0 3 0 0 2 10 0 0 0 6 0 0 0 5 0 38 0 0 3 0 0 8 0 0 0 10 1 0 7 8 
12 28 0 2 0 12 19 20 0 0 7 3 0 0 3 0 0 13 0 0 0 21 22 0 6 2 0 28 8 0 3 30 
1 11 27 0 15 14 2 26 3 0 0 7 0 8 22 0 7 0 4 27 0 0 6 0 0 4 2 26 2 3 29 0 
31 18 5 1 0 2 8 4 0 12 7 0 0 8 6 0 0 4 0 18 11 0 3 7 0 0 0 0 0 0 0 31 
3 0 0 0 24 11 6 0 8 4 0 0 8 30 17 0 0 3 2 0 22 0 0 0 0 0 13 0 4 0 0 17 
29 0 0 3 4 0 4 0 4 5 14 11 30 1 15 0 4 0 7 10 8 0 0 0 14 0 0 4 3 13 0 0 
0 0 3 18 0 0 0 20 0 6 13 0 8 10 0 5 0 16 0 0 8 0 2 30 0 6 0 20 0 1 0 0 
0 0 0 0 0 8 0 0 0 14 1 5 0 8 0 9 9 11 3 4 10 3 6 0 8 0 0 0 2 12 11 0 
0 0 0 27 0 0 22 21 0 19 0 7 0 17 11 3 18 0 0 3 10 0 9 2 0 13 0 24 17 13 28 10 
0 0 3 10 9 12 19 0 15 2 3 6 0 10 0 14 0 17 0 0 0 0 13 2 0 16 0 22 8 14 13 2 
11 80 0 16 22 0 15 0 4 57 11 5 18 27 3 14 13 13 6 10 5 0 15 0 6 25 60 6 9 28 3 0 
0 23 14 2 0 0 29 20 0 0 0 6 0 29 0 7 15 7 11 6 0 0 3 0 2 23 0 0 3 0 17 0 
