32 18
31 0 2 0 14 10 26 0 21 3 0 0 13 0 0 0 25 13 8 2 9 15 14 14 0 0 11 0 0 31 0 40 
0 0 10 0 0 0 29 0 0 5 0 3 14 0 5 0 0 5 0 0 9 0 10 0 0 0 23 0 0 9 0 0 
9 7 0 16 0 0 27 7 0 9 13 0 19 0 4 0 11 2 17 5 0 15 0 11 10 1 1 0 15 6 0 33 
0 0 13 0 0 9 0 0 0 0 0 14 7 11 10 2 14 6 0 0 0 0 5 3 0 14 11 0 0 0 0 16 
0 0 1 0 0 0 0 0 0 0 0 0 0 8 6 0 0 2 0 0 0 0 6 0 0 1 3 4 17 28 0 13 
0 0 6 0 0 1 8 0 0 0 2 5 3 0 0 10 0 27 0 1 1 0 0 5 0 0 1 12 0 0 0 0 
1 0 0 0 0 0 17 0 1 7 21 14 6 8 0 0 2 7 2 5 9 0 4 4 13 0 0 0 2 6 0 29 
1 0 0 6 21 0 0 2 6 2 0 0 0 0 6 1 0 10 4 0 4 0 0 1 0 21 0 7 0 0 0 0 
9 0 5 0 5 8 2 3 21 8 0 10 0 10 0 0 0 21 0 10 0 0 0 3 9 0 0 4 0 5 0 7 
25 29 1 8 14 25 6 11 0 3 0 22 12 8 5 0 1 11 17 0 9 0 0 15 0 13 5 33 21 0 4 14 
0 0 0 0 12 2 0 1 35 0 0 1 7 0 3 4 2 12 0 2 12 0 0 0 16 0 0 0 0 21 0 16 
4 0 10 24 21 25 14 2 6 0 0 0 13 2 2 3 0 3 0 2 0 0 0 4 0 34 2 24 2 0 1 0 
0 10 0 0 0 0 0 0 0 3 0 0 1 12 2 0 4 0 12 14 4 0 0 4 17 0 0 3 5 0 0 20 
0 0 19 13 2 6 8 0 6 27 0 9 17 11 2 0 25 0 7 17 9 15 19 4 0 16 0 18 9 0 4 15 
25 28 0 0 2 0 4 5 0 2 0 0 0 29 0 14 0 6 0 3 0 0 20 16 9 37 2 1 0 28 16 4 
10 0 0 0 7 0 5 0 0 0 0 6 0 6 16 0 10 15 0 0 2 0 0 0 4 0 0 0 0 0 16 12 
0 0 7 26 0 17 1 2 23 25 2 0 4 34 12 0 0 5 15 3 13 5 15 14 19 0 17 2 0 3 7 27 
13 0 0 8 0 0 0 0 0 11 0 0 0 14 0 13 7 9 6 0 11 0 8 12 9 0 0 0 23 11 0 6 
