32 18
1 0 7 0 0 0 16 0 0 2 0 18 0 0 0 0 0 11 0 0 14 0 0 0 0 11 5 16 0 0 3 0 
4 0 14 20 0 13 0 10 11 15 19 16 0 34 0 0 1 10 0 3 16 0 1 13 10 0 0 23 12 12 0 39 
0 0 11 8 9 0 45 1 17 5 3 8 0 0 3 0 0 11 0 0 0 0 0 0 15 19 0 2 0 5 32 0 
21 0 0 12 10 7 0 13 0 9 2 0 35 7 0 18 0 0 14 0 15 1 3 13 4 3 7 0 0 0 3 0 
0 11 0 0 0 0 7 0 0 0 0 0 0 6 0 0 0 0 10 0 0 0 0 0 0 0 0 0 0 0 0 0 
39 38 0 0 0 4 8 18 0 9 0 23 2 0 0 14 8 14 7 0 4 0 11 0 0 49 5 0 0 0 30 0 
0 34 0 0 2 7 0 19 0 0 10 1 0 12 0 0 9 0 2 0 11 7 2 0 5 4 0 0 21 0 29 0 
9 36 3 0 3 13 13 1 1 17 0 1 1 18 0 0 0 3 7 26 1 6 0 3 23 0 2 20 0 3 0 14 
6 18 12 42 3 0 5 4 3 0 5 0 7 0 12 1 0 4 0 6 26 21 0 2 0 19 0 0 25 0 0 10 
16 38 17 6 1 1 0 1 23 0 7 1 0 14 11 9 13 0 0 10 3 6 27 8 0 25 11 2 3 14 0 23 
3 0 0 36 2 2 4 0 5 9 15 16 0 15 0 22 17 9 0 0 1 0 21 0 0 10 34 3 2 3 6 0 
3 1 4 29 11 1 37 0 9 4 2 2 0 2 0 10 0 11 0 0 44 27 0 2 3 9 0 0 0 26 1 41 
1 45 4 0 2 1 1 11 12 34 0 2 0 0 7 5 3 0 0 5 0 5 21 0 0 24 5 0 0 1 21 0 
0 0 0 20 4 2 8 28 3 11 10 0 1 0 0 0 8 0 0 5 11 5 0 15 0 2 0 0 5 2 23 0 
0 17 0 0 0 0 0 0 0 0 0 0 0 0 0 0 0 0 7 0 0 0 0 0 0 0 0 0 0 0 0 0 
0 15 2 2 22 1 3 0 0 16 24 0 19 9 13 9 9 0 3 0 12 6 5 0 9 4 23 6 0 0 20 0 
6 0 0 0 0 1 11 12 1 5 9 1 1 7 0 10 0 0 1 12 3 0 7 11 4 0 0 11 0 14 0 0 
9 0 17 2 0 0 0 0 0 9 8 23 11 0 0 0 0 12 14 16 14 0 0 15 7 5 7 4 2 0 2 23 
