32 18
0 9 2 0 2 0 32 0 11 28 3 11 0 12 10 14 0 0 0 5 2 12 0 17 13 0 0 18 0 7 4 0 
23 0 0 7 20 0 14 0 39 12 7 0 15 2 6 2 0 1 13 1 11 13 0 5 12 1 22 6 10 14 10 0 
7 0 0 0 0 0 0 3 4 1 8 15 16 11 0 0 7 5 9 1 10 0 0 0 17 9 15 12 6 0 0 0 
43 0 0 39 0 0 8 1 36 0 4 0 16 13 5 0 2 10 0 16 15 9 11 7 14 9 23 4 16 0 43 4 
25 21 8 0 0 19 27 7 0 0 3 7 3 7 27 1 8 24 0 0 0 0 0 8 10 0 6 10 27 0 4 14 
27 1 13 0 10 26 0 3 0 0 0 11 0 4 16 0 8 0 0 4 0 0 8 23 0 0 5 0 3 0 8 26 
4 30 0 0 37 2 6 24 0 0 7 0 2 0 7 11 2 11 1 0 0 10 1 0 1 0 30 0 0 2 0 30 
0 6 23 0 19 0 10 9 12 0 0 8 0 0 3 13 11 13 6 0 7 0 1 9 0 23 0 6 0 8 13 0 
0 5 0 3 0 0 7 0 0 9 0 16 1 0 0 12 1 0 0 5 9 0 1 0 5 0 0 0 13 0 19 0 
8 4 9 0 26 7 1 0 0 0 0 0 7 11 17 7 35 12 0 7 0 21 6 5 0 0 2 11 13 0 0 0 
0 15 8 0 0 5 5 1 8 0 8 0 0 0 10 0 0 0 0 0 0 0 21 0 0 0 1 0 0 0 0 0 
6 0 0 0 0 3 6 6 4 0 14 7 0 0 0 0 8 4 0 0 0 0 0 0 2 0 2 11 4 0 20 0 
2 11 2 0 7 0 0 5 11 0 17 4 6 0 0 0 0 8 0 9 5 0 0 0 0 1 0 17 19 0 0 0 
26 6 0 1 0 12 6 0 0 0 7 0 0 0 0 12 13 12 0 13 0 0 0 0 2 6 26 0 0 0 0 12 
50 5 5 4 19 0 18 4 19 15 0 0 0 0 5 12 3 0 2 19 1 0 13 1 22 14 4 15 31 0 9 0 
4 0 0 8 0 5 35 11 14 0 0 4 12 28 2 4 1 6 0 9 0 0 0 1 18 19 13 0 14 14 0 0 
0 25 0 0 0 12 1 0 0 22 0 0 20 8 0 0 6 2 0 9 0 9 2 0 3 0 25 14 0 0 26 22 
25 0 0 0 5 0 30 3 14 9 6 0 0 0 7 0 0 15 12 5 4 0 0 13 11 16 8 18 12 9 0 0 
