32 18
10 0 17 2 6 0 0 4 31 18 13 0 0 0 0 0 0 13 0 4 0 0 2 2 10 2 16 3 0 0 35 10 
0 0 0 25 0 0 10 0 14 0 0 15 2 0 8 0 8 16 0 3 18 4 4 3 0 0 12 11 25 0 0 0 
0 5 0 2 29 0 21 0 9 6 1 2 0 0 0 35 10 10 4 1 0 0 0 9 0 0 10 31 2 0 0 0 
0 10 20 36 0 0 0 0 17 11 1 0 2 10 0 7 0 10 0 0 0 0 19 0 0 0 0 15 20 1 0 0 
4 9 18 2 0 0 0 0 21 0 0 18 4 0 0 13 12 6 10 17 24 21 1 1 0 25 6 0 22 13 0 0 
0 3 0 8 0 0 0 14 5 0 1 26 0 0 4 8 0 0 8 0 0 4 0 0 1 4 0 2 0 0 18 0 
21 27 8 4 15 26 0 0 0 21 4 18 10 0 0 1 1 0 12 11 8 11 9 1 21 7 10 0 15 0 1 42 
0 5 0 0 20 0 0 5 43 0 0 10 0 0 2 0 0 0 6 0 7 0 7 0 6 0 0 18 7 28 0 27 
0 4 0 24 19 0 2 13 7 0 0 0 2 0 0 0 1 0 0 0 14 27 0 0 0 19 0 24 0 0 9 0 
0 2 0 0 19 21 0 0 9 0 4 3 0 3 2 7 6 0 0 0 10 0 0 34 0 0 23 0 0 0 0 0 
10 0 3 8 17 0 25 16 5 22 6 13 2 6 0 26 0 5 0 0 9 0 29 0 19 27 9 0 25 2 0 12 
0 11 5 0 17 21 1 4 26 8 2 7 7 0 0 0 0 4 0 13 0 13 2 7 2 0 33 0 0 0 7 0 
24 0 23 36 0 0 1 20 0 0 0 0 19 10 0 0 11 0 0 1 0 19 0 16 0 0 0 3 0 17 0 0 
0 11 7 20 4 0 0 12 7 0 0 0 0 0 1 23 4 0 0 18 25 13 0 0 23 5 0 6 0 1 29 7 
47 51 11 11 0 0 0 9 13 0 0 0 11 0 7 0 21 14 0 0 2 7 21 11 3 0 2 0 30 7 2 31 
0 0 1 0 9 10 19 4 14 10 23 0 0 0 0 12 0 4 4 13 10 11 28 8 0 0 0 0 19 1 0 16 
0 8 1 15 25 0 0 30 53 0 27 5 4 6 0 0 9 0 23 14 2 11 5 8 16 9 18 11 0 25 1 24 
5 3 5 10 28 0 0 21 1 0 0 11 0 0 0 15 4 16 0 2 0 0 0 8 3 0 6 0 0 47 0 0 
