32 18
0 0 24 2 17 0 3 0 0 0 8 0 0 0 17 0 0 0 11 6 0 39 0 0 0 1 0 0 0 0 5 0 
0 22 9 6 0 7 11 0 4 7 12 5 0 31 0 13 0 1 0 29 6 13 0 7 23 0 2 19 14 0 17 12 
0 27 26 13 0 23 0 40 0 1 21 4 0 4 0 19 0 30 2 0 9 0 15 11 0 6 25 0 20 35 10 3 
14 13 29 11 4 21 1 11 0 0 0 0 12 9 34 16 1 4 0 13 5 12 11 0 19 11 20 8 0 2 0 13 
0 0 0 0 28 6 9 9 6 9 0 0 0 0 12 5 0 7 0 0 16 0 12 0 1 1 0 0 0 0 16 0 
3 0 0 11 0 11 9 0 0 2 0 17 0 0 8 0 0 2 0 16 0 0 0 11 0 0 10 0 17 0 27 0 
0 0 0 0 0 13 9 7 0 0 0 3 15 9 17 0 0 12 4 19 0 6 5 0 0 0 5 12 0 0 0 17 
0 3 7 25 7 19 4 5 2 2 0 13 2 6 0 0 0 0 0 0 6 20 0 22 1 0 3 0 23 0 7 0 
17 0 7 16 54 7 0 21 16 0 0 3 15 0 3 4 0 13 0 25 4 2 3 11 19 0 26 0 12 0 22 0 
13 0 0 0 0 0 0 0 0 0 0 4 0 13 6 0 0 0 0 0 0 0 9 0 5 0 0 0 0 12 0 5 
16 0 0 7 6 19 0 16 6 0 4 0 0 0 3 9 25 28 9 2 8 8 6 0 0 25 0 0 11 0 0 0 
0 0 0 24 0 0 11 0 10 0 3 22 0 5 0 6 0 3 3 0 0 4 24 0 0 0 0 0 0 18 0 0 
0 0 1 2 11 18 8 0 0 0 0 4 5 27 14 4 0 13 0 7 7 2 17 17 5 0 0 0 14 0 10 0 
21 6 10 0 0 1 15 16 0 16 12 3 1 10 10 4 0 11 18 15 0 3 0 3 0 9 0 0 0 10 4 4 
14 0 22 12 0 2 16 1 2 0 0 8 12 0 16 17 0 0 0 0 11 0 0 6 20 0 12 0 5 14 10 58 
0 13 15 31 0 0 26 6 9 2 0 0 21 27 23 1 2 1 9 8 8 6 0 0 2 0 10 12 50 0 17 0 
0 0 0 0 0 13 0 0 0 0 5 0 0 0 10 0 2 0 2 0 0 9 31 0 1 0 0 22 0 0 0 0 
8 0 0 2 9 3 16 0 0 0 0 0 12 13 17 11 7 0 0 0 0 0 16 0 0 7 11 0 0 0 0 0 
