32 18
0 0 0 0 0 0 0 13 13 0 4 16 0 10 0 0 0 0 7 10 0 10 0 16 0 0 0 0 0 6 0 0 
0 1 52 18 15 59 7 0 0 0 0 10 10 0 0 11 0 2 16 8 0 0 8 8 0 0 20 25 24 0 0 26 
0 4 0 6 0 0 0 0 19 6 0 8 0 11 1 1 0 16 0 16 0 0 11 14 9 0 1 42 1 0 0 0 
0 28 7 0 0 13 0 0 0 10 3 4 0 0 0 0 10 2 0 15 0 8 3 13 5 5 4 0 12 22 5 0 
0 2 23 13 26 3 2 0 1 30 23 6 1 0 0 2 0 0 1 1 4 7 0 0 19 0 0 0 24 21 21 2 
0 38 1 0 31 0 0 8 1 0 19 6 0 15 0 2 9 3 7 6 0 9 0 2 0 23 7 0 8 8 26 0 
17 11 19 0 12 0 3 0 5 36 1 1 36 7 11 3 20 1 0 8 0 12 11 0 0 16 5 0 19 23 18 10 
0 0 0 0 19 8 0 9 2 5 36 9 0 8 0 0 0 0 15 1 21 2 0 11 0 0 6 17 5 0 0 0 
5 10 0 0 5 0 22 0 5 11 24 34 7 0 6 0 1 0 0 11 5 0 9 7 0 14 0 1 22 28 0 0 
10 21 21 24 0 0 21 16 0 0 0 4 5 0 0 0 0 22 0 19 0 4 9 13 0 0 7 46 0 28 0 0 
6 6 7 0 17 2 0 9 0 0 0 4 0 1 17 0 11 1 3 7 6 12 0 3 3 0 18 0 0 6 17 0 
0 0 0 0 24 0 0 0 0 0 0 23 0 0 0 0 0 0 2 0 2 3 0 0 7 0 0 16 24 0 0 0 
0 9 4 0 11 2 0 0 7 0 26 13 4 18 0 16 0 0 0 9 3 4 0 12 0 11 0 4 14 0 0 34 
2 0 0 7 1 0 0 13 13 10 5 0 5 0 0 1 9 0 0 0 0 0 0 0 0 1 0 0 8 0 0 0 
0 0 2 0 51 0 15 0 7 20 6 12 0 0 0 8 0 0 7 13 0 29 0 0 0 18 0 0 0 16 26 0 
0 10 0 39 8 0 0 17 5 0 0 1 10 10 0 0 0 4 9 0 0 3 7 9 3 1 0 9 22 12 6 19 
34 13 22 10 21 5 13 12 21 2 4 19 0 10 0 15 0 6 12 12 5 13 21 40 1 1 0 3 3 21 3 16 
0 0 0 0 0 16 0 0 4 0 10 0 4 0 4 0 4 0 0 16 0 0 0 0 4 2 0 0 4 14 0 0 
