32 18
0 30 0 13 2 3 0 0 3 0 0 6 0 0 0 0 22 5 1 0 7 0 0 2 0 7 0 7 0 16 17 17 
0 36 0 0 23 0 0 2 0 2 0 8 0 0 3 2 10 4 13 1 15 15 0 6 11 10 17 3 0 0 14 0 
26 0 0 0 15 0 16 9 0 9 0 1 9 0 5 5 24 6 1 2 5 8 15 0 0 0 26 0 0 0 0 11 
0 69 26 27 7 0 2 0 0 0 15 0 0 0 9 5 0 0 1 18 0 0 31 0 13 15 0 0 35 0 27 33 
0 0 1 12 15 29 6 0 0 0 1 5 0 10 0 0 11 8 1 15 0 0 0 0 0 7 11 0 0 0 0 4 
37 5 1 7 20 24 15 0 0 2 16 3 0 0 16 14 0 0 0 0 0 0 0 6 6 25 18 3 37 30 17 8 
30 0 1 19 17 0 15 0 22 16 8 0 0 0 4 7 13 0 8 0 0 2 0 0 0 2 0 0 3 14 34 0 
0 6 7 0 0 0 10 11 0 6 7 5 19 0 0 0 1 8 11 5 0 0 0 0 9 0 7 0 0 17 1 0 
28 7 1 0 0 15 8 19 6 12 0 3 0 0 16 0 0 1 0 0 12 1 0 9 15 1 25 22 0 12 8 8 
1 0 0 0 0 2 0 6 3 0 0 16 3 0 2 3 0 0 0 0 0 14 6 0 0 5 0 36 0 5 4 0 
0 8 4 0 16 15 4 17 7 3 10 0 16 0 5 5 7 0 13 0 10 0 15 7 0 13 0 5 0 0 9 0 
0 0 28 3 0 7 0 0 0 3 0 1 3 19 6 12 0 4 0 0 7 0 9 11 7 22 0 12 0 5 29 6 
0 8 0 7 3 0 19 17 20 5 6 0 0 0 1 8 8 0 0 10 0 4 9 1 40 17 5 3 11 0 0 12 
0 43 0 17 10 10 0 0 0 5 5 0 0 18 0 4 0 0 12 0 17 29 0 3 23 0 0 0 0 0 0 13 
0 4 37 27 19 0 0 0 0 4 6 0 9 6 0 0 0 0 7 2 1 0 7 19 2 2 8 0 26 1 2 0 
0 8 0 8 14 0 0 11 1 0 0 8 5 0 0 6 0 13 14 0 0 0 0 0 0 0 4 5 0 0 1 0 
0 2 35 12 13 0 0 0 16 9 4 0 0 0 0 16 6 22 16 0 6 34 13 7 20 30 9 0 0 16 8 1 
30 0 13 0 34 13 5 11 16 5 11 31 0 11 3 0 15 9 7 0 16 5 8 45 11 0 16 0 5 22 18 17 
