32 18
39 1 20 16 0 5 0 7 3 0 0 20 0 33 17 9 11 20 0 0 9 0 18 0 16 0 4 0 0 0 29 14 
0 7 0 0 1 9 0 5 10 0 1 15 12 1 0 3 0 2 12 2 0 0 0 15 17 0 16 26 0 12 1 0 
1 0 12 25 10 3 25 5 12 17 13 16 0 11 8 10 0 19 10 0 21 10 8 0 7 41 2 17 36 14 29 18 
23 10 0 13 0 0 0 0 2 0 23 14 8 22 0 10 0 4 0 0 17 4 0 6 23 13 0 0 0 10 0 0 
2 0 1 1 0 0 0 0 6 8 11 0 6 0 0 3 0 12 23 0 0 21 0 0 0 7 0 3 0 8 0 0 
46 0 10 23 5 22 0 0 4 15 0 13 10 9 0 2 0 0 0 0 0 0 0 0 19 23 53 0 28 0 0 0 
14 13 9 0 2 0 11 0 2 8 18 19 0 4 14 13 0 7 0 13 0 1 0 0 12 0 13 0 18 3 19 0 
4 0 0 0 0 0 0 11 2 0 20 2 0 3 0 7 0 5 0 6 0 11 0 0 3 0 0 0 10 0 20 3 
14 0 0 28 5 3 0 0 3 0 8 18 0 0 14 0 0 0 0 0 11 2 0 7 0 3 0 0 0 18 8 23 
0 7 0 0 0 0 0 32 2 12 0 5 2 17 9 4 1 0 4 0 9 5 7 6 17 3 4 0 18 6 5 1 
28 0 21 0 0 9 0 7 11 0 0 5 0 5 28 0 16 1 0 0 0 0 0 21 0 0 0 0 0 0 30 2 
36 4 7 0 0 0 0 2 5 14 9 3 13 2 0 14 14 16 7 6 0 0 0 23 5 9 1 4 0 0 1 4 
35 0 6 41 0 0 0 0 0 2 27 5 9 0 5 15 14 7 0 2 11 0 7 0 0 3 26 0 25 10 30 11 
0 0 2 24 3 0 0 28 13 0 0 11 0 0 0 10 1 0 7 1 0 7 0 5 0 0 0 24 1 12 0 0 
0 1 1 0 0 0 0 0 0 0 0 0 0 0 0 0 2 7 0 0 5 0 0 3 0 0 0 10 0 0 5 3 
0 26 0 1 0 17 0 21 5 10 21 3 0 12 0 0 6 0 0 10 18 13 32 0 9 10 0 26 8 0 0 1 
17 35 8 11 0 9 0 0 11 4 9 0 44 17 20 13 0 13 0 0 15 9 2 14 8 0 28 7 0 15 1 19 
0 0 0 0 0 9 0 0 12 0 0 3 12 14 16 0 6 18 0 0 3 0 0 3 12 0 0 1 0 0 0 2 
