32 18
0 0 28 0 0 4 0 0 6 0 0 0 4 9 6 0 4 0 0 0 0 2 9 1 0 0 0 0 0 0 51 0 
15 8 5 0 0 17 2 0 29 10 0 0 10 9 18 15 3 2 10 2 0 16 7 1 1 12 16 19 0 0 31 0 
0 15 6 0 0 11 0 0 8 0 0 0 0 0 0 14 0 0 0 0 11 0 0 9 3 2 0 0 2 0 0 0 
19 0 0 0 0 2 3 0 0 26 21 0 0 0 8 0 10 13 0 0 9 0 13 0 9 0 0 0 4 0 0 21 
25 12 0 9 11 4 11 11 18 0 24 4 12 0 4 5 0 2 2 15 5 0 0 13 0 35 22 0 2 0 30 15 
9 10 0 0 0 0 0 9 3 7 15 8 0 5 7 0 0 8 1 0 0 0 7 0 3 9 11 2 0 0 0 8 
15 24 0 0 0 5 0 14 11 0 14 0 4 0 2 0 17 9 0 0 0 0 14 5 14 7 0 7 5 0 23 0 
35 26 6 0 3 0 0 2 16 4 29 5 0 20 25 13 10 0 0 0 13 0 18 9 13 15 10 0 10 0 3 0 
8 15 0 0 0 0 0 0 15 0 0 11 17 8 13 0 9 0 0 19 0 0 0 9 5 25 2 27 4 11 6 6 
31 31 26 24 5 30 0 3 4 5 0 4 7 2 0 5 0 11 13 8 14 0 4 24 0 10 26 29 0 0 28 13 
16 0 16 0 0 17 0 0 25 0 15 29 0 2 1 0 25 0 16 1 0 0 17 13 0 6 13 0 0 0 14 0 
2 15 0 0 0 3 0 4 0 0 0 0 4 2 0 7 12 0 4 0 2 6 3 9 0 0 0 5 4 0 3 0 
0 4 0 0 19 4 0 0 0 0 0 0 10 0 11 0 0 3 0 10 7 1 17 26 0 5 3 0 0 10 7 8 
25 23 0 17 0 2 0 0 2 0 9 1 21 12 1 1 10 0 20 5 50 0 13 7 32 23 0 9 0 17 0 8 
0 0 0 0 25 26 17 2 7 11 14 0 9 0 0 0 8 0 5 4 2 9 0 18 6 14 17 0 0 0 3 32 
0 10 25 21 11 1 0 0 18 0 5 2 0 8 8 21 15 3 0 2 0 0 19 8 0 2 20 25 0 14 0 15 
45 5 16 38 28 0 0 25 4 33 0 11 9 13 0 26 16 8 6 19 0 5 18 19 3 8 33 0 5 6 7 0 
24 15 23 13 0 20 0 0 23 1 7 1 4 0 0 0 0 0 15 11 5 3 0 8 21 15 16 0 20 0 10 1 
