32 18
7 3 20 0 10 0 0 22 19 7 0 3 27 0 0 0 13 2 7 0 5 10 20 0 7 4 0 6 11 11 0 0 
20 10 0 0 0 19 8 0 1 2 0 0 32 0 0 0 0 0 6 0 0 6 5 0 1 8 16 5 10 0 12 32 
0 2 34 0 0 11 0 0 0 0 7 0 0 0 0 7 15 7 16 11 16 3 0 3 13 0 3 0 1 5 0 0 
6 34 0 26 3 0 41 0 2 2 0 1 9 13 0 0 0 0 17 11 0 6 0 17 12 12 11 0 9 54 0 23 
0 10 0 42 0 0 0 0 0 0 0 1 2 0 8 5 0 0 5 9 23 0 0 0 4 0 0 0 25 0 0 9 
4 29 18 0 24 0 11 0 8 7 0 7 0 9 1 1 4 2 7 0 15 7 23 0 5 11 23 0 0 0 29 3 
41 0 0 6 0 5 18 6 0 0 0 0 2 8 0 0 0 0 3 10 0 0 0 0 18 7 3 6 28 0 0 2 
10 0 27 11 0 0 0 17 1 2 0 6 0 6 13 2 1 7 4 4 2 20 4 7 0 0 17 0 0 22 7 0 
5 0 0 3 27 41 0 0 3 0 18 3 11 0 0 6 11 0 11 5 2 16 0 8 7 0 0 11 18 0 25 50 
11 0 8 13 20 0 14 11 4 19 0 20 13 0 8 2 18 17 2 0 14 5 0 1 5 2 1 16 19 12 24 5 
0 1 0 0 10 0 0 0 1 0 0 9 0 0 0 0 0 0 7 0 9 0 0 1 7 0 0 0 0 0 0 0 
0 32 53 0 10 26 1 0 38 0 31 3 0 1 0 1 14 0 0 0 16 0 21 6 30 1 14 20 39 17 3 22 
0 50 17 24 43 1 17 6 12 0 0 4 0 1 8 4 5 0 6 21 12 21 0 31 0 24 0 26 23 1 0 1 
0 1 1 0 3 0 0 1 2 0 0 0 13 0 0 0 0 0 0 2 11 0 0 5 12 12 2 0 0 0 0 20 
18 0 4 0 0 0 11 0 6 0 0 1 16 10 3 0 5 8 18 4 2 20 10 0 5 0 3 0 17 6 0 11 
25 2 12 0 0 0 25 8 8 0 0 12 14 1 14 0 25 0 0 8 0 12 0 14 18 11 0 9 1 5 9 14 
0 12 0 25 3 24 11 0 0 14 13 2 9 13 13 3 0 10 5 14 0 0 10 1 2 0 13 1 20 31 0 0 
28 13 2 2 7 15 0 22 6 3 0 8 6 4 0 0 0 0 31 0 13 0 0 6 0 0 29 0 0 20 21 8 
