32 18
0 0 0 0 21 20 0 24 0 0 8 25 0 10 0 12 8 0 0 3 0 0 27 9 28 1 3 20 0 0 0 24 
0 55 0 4 6 5 0 0 0 12 18 7 0 0 0 0 0 0 9 0 9 5 0 0 0 0 3 31 0 11 29 16 
8 0 2 0 15 1 19 1 9 0 10 0 13 0 16 9 10 9 0 15 0 0 0 2 9 0 0 0 9 0 16 0 
16 9 4 0 6 33 10 0 26 2 24 0 0 28 0 0 6 11 1 1 3 0 14 0 0 35 0 2 6 0 17 0 
0 18 0 0 0 0 20 7 0 0 13 4 20 0 0 10 10 0 10 0 19 9 15 20 0 3 17 7 10 14 2 4 
0 36 0 6 4 0 0 0 17 12 0 0 0 19 0 0 0 7 9 1 0 12 0 5 0 17 0 2 27 0 0 0 
14 0 6 0 6 0 0 0 10 16 0 0 0 0 5 6 0 0 0 1 1 27 0 15 0 16 5 0 7 0 0 2 
0 1 0 2 32 19 0 4 3 4 0 7 2 0 13 3 10 12 11 26 0 0 18 3 1 0 14 21 0 0 25 12 
31 0 9 9 0 2 15 18 0 10 3 0 3 7 0 15 7 5 7 0 0 2 16 0 0 4 8 12 5 15 0 64 
25 21 14 0 13 17 4 0 0 0 4 9 2 1 10 0 5 0 0 4 0 0 17 21 0 12 26 0 1 0 0 0 
20 0 29 25 4 0 20 6 22 9 0 0 0 24 0 11 16 2 3 13 0 4 9 0 7 0 11 0 31 0 0 29 
2 0 26 21 20 0 19 30 26 8 6 0 16 1 6 2 0 9 3 0 0 0 3 33 42 0 6 0 18 21 16 24 
3 0 30 0 30 0 1 4 1 0 17 14 7 1 0 0 17 7 6 0 9 17 0 5 0 17 21 17 0 4 0 4 
21 53 0 21 10 0 8 0 0 3 0 0 8 14 8 0 0 18 8 4 19 33 3 13 19 0 2 0 0 0 0 0 
0 9 17 0 5 0 2 16 0 14 0 9 0 2 10 0 14 0 19 0 0 4 0 18 0 0 2 6 10 0 0 0 
30 14 23 1 0 21 0 21 16 13 0 17 23 0 14 2 0 7 1 0 0 9 1 0 2 17 21 19 18 0 0 14 
0 0 1 0 3 0 2 3 7 0 0 7 12 0 0 0 0 8 0 6 0 8 0 12 0 8 0 0 0 0 0 0 
0 0 16 9 5 17 0 0 0 0 0 0 0 4 0 0 14 0 28 4 0 0 0 0 17 0 0 25 0 0 0 0 
