32 18
0 0 0 25 0 8 0 4 0 0 4 0 0 8 4 0 0 8 4 6 0 0 15 0 0 11 0 24 8 0 0 3 
0 0 0 0 9 0 0 0 0 1 10 0 0 9 0 16 0 2 7 3 21 25 8 6 3 5 0 4 0 8 11 38 
0 1 0 0 1 0 0 13 15 27 12 0 5 9 0 14 4 0 0 10 1 13 9 0 9 0 18 1 0 0 0 0 
6 10 15 0 1 0 0 0 16 0 7 0 0 8 0 0 9 21 0 10 0 0 7 0 16 0 3 0 0 6 0 0 
0 0 23 7 2 2 0 6 2 0 0 0 10 20 0 0 0 0 7 3 0 0 0 21 3 21 0 3 6 16 0 0 
26 6 0 20 8 0 0 19 19 0 3 0 7 14 0 0 0 9 0 0 0 4 0 0 7 0 45 5 4 6 27 0 
3 23 0 0 9 26 0 7 7 10 1 15 3 18 0 4 0 15 0 13 2 5 2 0 0 5 5 0 0 10 5 45 
14 0 22 11 6 2 2 0 20 0 9 0 8 0 10 0 0 21 7 0 8 2 4 4 11 0 0 3 0 5 0 5 
26 0 7 0 2 0 0 22 0 0 0 14 0 0 26 0 16 3 7 8 6 0 0 0 0 1 37 11 8 23 0 18 
13 6 0 2 6 3 0 25 0 3 0 0 16 8 5 0 13 13 6 1 0 10 23 6 12 12 0 0 11 16 1 9 
0 17 0 5 0 0 0 0 0 0 0 0 0 6 10 13 14 0 17 0 0 6 0 0 10 8 3 0 6 0 14 0 
12 3 0 11 33 24 21 12 8 0 9 13 1 2 15 7 12 3 3 10 4 8 0 36 0 0 7 25 19 17 25 1 
0 0 32 12 0 0 12 3 0 6 0 1 0 18 0 0 10 2 12 0 0 0 0 14 0 1 0 25 0 0 0 22 
0 47 0 5 2 0 2 0 0 0 0 8 7 0 0 0 1 0 0 0 0 16 0 15 3 2 22 0 2 0 18 12 
0 0 7 0 12 0 4 0 0 2 4 26 3 11 0 12 20 2 7 3 8 3 0 0 14 0 0 1 0 0 19 6 
0 17 8 31 19 1 0 6 11 1 15 0 13 18 0 2 0 10 4 9 4 6 0 6 9 24 19 24 0 0 2 18 
0 43 28 42 17 17 2 0 2 15 13 0 0 0 12 23 1 13 5 1 17 3 16 5 5 3 5 24 0 27 29 12 
0 31 0 32 0 0 1 6 6 8 0 12 5 20 9 7 0 11 0 0 0 0 1 12 0 22 1 0 27 0 2 0 
