32 18
0 9 17 0 20 24 37 1 0 17 0 18 0 0 0 5 0 13 9 38 3 0 12 12 3 1 24 1 10 5 0 0 
0 39 0 0 0 10 12 1 14 8 0 23 10 0 9 1 0 0 6 7 8 3 0 0 20 0 1 4 27 15 15 0 
12 0 0 23 11 23 1 11 0 0 0 13 5 7 1 24 1 0 42 12 5 0 4 10 13 14 15 0 13 2 0 12 
0 5 0 24 0 0 23 0 14 12 14 0 0 12 1 0 1 9 1 0 7 13 0 0 32 8 0 24 0 13 0 0 
5 7 0 2 0 8 4 43 21 31 4 0 5 8 14 12 3 0 2 11 0 12 5 13 0 16 0 16 27 22 11 0 
0 10 26 10 10 23 1 14 10 11 3 0 26 5 2 5 0 16 24 9 5 0 6 0 23 0 0 32 16 24 1 0 
0 0 23 0 27 9 0 0 19 3 0 0 0 0 9 0 0 0 0 6 0 0 0 0 0 25 21 2 0 9 1 27 
0 0 7 0 0 10 0 0 10 0 0 6 7 0 7 1 0 12 0 0 0 0 0 0 0 2 0 0 3 0 0 0 
0 0 26 0 0 0 0 0 3 2 0 0 0 0 0 0 4 0 0 10 0 0 0 0 0 6 0 0 26 0 0 8 
0 6 10 0 7 0 17 0 0 1 10 7 8 0 2 0 23 0 3 0 18 0 0 12 3 9 3 2 12 0 0 0 
15 21 0 0 24 9 13 8 1 19 2 10 29 13 5 5 12 5 7 6 0 0 0 5 0 22 2 0 17 12 0 0 
3 15 6 6 27 58 11 11 4 3 0 0 7 4 3 0 20 1 3 3 0 0 1 0 0 13 24 1 0 24 0 26 
35 21 5 0 33 5 0 3 0 6 2 11 9 0 0 0 4 0 2 0 0 0 15 15 2 0 5 0 24 0 30 27 
16 0 8 17 4 0 0 15 13 11 0 0 8 5 0 0 16 13 15 0 18 14 0 0 0 17 3 1 0 2 0 0 
13 7 0 20 0 0 13 0 13 2 9 3 7 0 2 0 4 0 0 0 0 13 0 43 1 0 0 0 0 19 29 0 
0 0 0 9 9 0 6 0 20 20 0 12 9 9 13 9 5 0 3 0 0 0 0 12 0 0 0 0 0 22 0 0 
0 8 22 0 0 14 0 13 10 23 21 0 0 12 10 0 5 0 1 6 13 9 0 0 18 4 12 0 6 2 0 13 
0 0 18 0 0 0 9 0 10 5 17 16 0 0 17 0 8 0 15 13 0 0 0 21 3 0 0 5 22 0 0 8 
