32 18
5 0 0 0 4 0 13 0 0 2 0 2 8 0 9 9 0 0 14 0 0 5 0 8 0 3 20 0 7 15 13 0 
4 3 4 20 21 22 15 5 0 7 15 1 0 4 0 9 0 10 0 17 0 0 0 11 0 19 0 6 2 14 4 12 
0 0 9 0 17 2 0 4 5 0 0 4 0 14 0 0 12 0 16 0 2 0 0 0 0 11 12 0 0 0 0 10 
3 0 19 35 17 11 0 13 0 9 21 16 0 8 3 7 11 4 0 0 12 31 9 6 21 3 12 10 21 0 20 21 
26 1 24 3 4 3 0 0 16 11 0 0 0 0 9 0 16 0 0 0 6 0 0 0 16 0 24 0 0 11 0 23 
11 12 0 4 0 13 30 0 0 0 8 8 0 17 8 8 0 0 13 4 0 4 0 7 1 4 0 21 0 43 24 0 
67 13 0 10 29 0 3 34 18 0 1 5 8 0 0 14 0 17 18 0 8 14 4 0 24 0 0 4 0 33 22 0 
0 9 0 0 25 0 0 1 0 0 6 8 0 0 11 5 0 4 0 3 0 0 9 13 9 0 0 0 14 25 0 0 
29 23 0 25 18 32 26 8 6 16 16 3 0 0 5 21 0 10 5 14 22 20 17 15 0 21 22 26 25 15 24 5 
0 0 0 26 0 0 0 4 0 0 0 15 0 18 0 0 0 0 0 0 0 9 0 4 0 0 15 9 0 28 9 15 
0 0 0 30 0 13 24 0 10 0 4 0 0 0 0 0 0 11 10 3 21 0 0 15 0 0 7 1 18 0 27 0 
5 0 29 3 0 0 0 5 0 0 0 20 6 2 0 23 0 0 6 4 8 2 13 14 0 0 0 12 8 2 0 0 
31 0 0 5 19 28 0 0 6 2 10 5 0 8 0 12 7 0 1 16 7 7 2 4 21 4 2 6 39 0 0 1 
7 6 4 3 7 22 7 2 30 21 15 0 0 29 11 0 19 13 1 15 10 0 2 7 0 12 0 12 0 33 43 26 
0 0 0 3 0 26 0 6 0 0 0 13 14 5 0 0 0 7 5 11 0 4 0 0 0 4 11 0 23 8 8 0 
2 28 0 25 14 0 0 0 0 25 0 0 1 0 5 0 0 0 14 0 0 0 0 0 0 0 1 15 8 12 0 12 
0 20 27 3 8 0 10 20 0 0 11 19 0 0 0 9 2 7 13 1 0 1 9 0 14 10 6 12 0 27 12 0 
0 0 35 0 15 3 22 23 13 0 11 0 2 0 0 16 12 0 0 17 18 15 0 0 1 1 0 0 22 12 3 43 
