32 18
0 8 0 0 5 22 0 0 0 14 0 0 0 0 17 5 0 0 9 0 5 0 17 3 0 2 0 0 0 0 0 8 
0 0 15 5 10 6 0 0 0 15 1 17 0 0 14 7 0 13 0 5 0 17 7 9 1 1 0 32 17 0 0 0 
0 0 38 16 5 15 0 18 4 4 14 0 0 8 0 7 0 6 0 11 1 2 0 13 1 20 0 25 5 0 20 0 
47 0 22 0 11 26 1 0 0 10 0 9 1 0 15 0 0 0 0 1 21 0 0 12 12 0 0 25 0 3 10 17 
20 30 11 7 19 13 0 0 0 10 0 18 10 3 0 0 2 0 0 18 20 2 3 6 1 5 0 3 0 18 4 30 
10 0 0 0 5 5 7 16 8 12 13 0 0 0 5 0 0 0 0 4 0 12 0 16 5 0 0 0 2 0 3 0 
0 10 0 40 0 0 0 0 19 22 9 3 0 9 7 13 0 6 17 5 15 13 5 24 0 22 7 32 13 3 0 50 
0 26 29 15 0 0 6 4 15 2 0 0 6 0 3 0 11 3 34 0 1 10 15 15 1 0 0 12 2 1 2 10 
0 8 0 6 0 0 0 0 0 22 3 12 2 0 2 0 0 0 0 0 6 0 0 0 1 16 15 0 0 0 0 20 
22 27 2 0 2 17 23 0 11 9 0 15 5 0 0 0 13 5 0 15 1 7 20 3 4 5 2 10 33 0 19 37 
14 4 6 0 0 3 0 0 3 0 0 16 15 0 12 2 14 2 0 0 14 7 0 0 5 0 0 7 8 0 17 0 
8 9 27 9 0 0 0 11 0 8 9 0 0 11 0 6 0 0 10 0 0 0 2 0 8 9 4 2 10 0 26 0 
15 0 9 0 0 36 16 0 7 3 0 2 13 16 2 24 0 12 0 0 5 16 0 9 0 8 5 7 0 8 0 19 
0 21 5 0 14 0 0 0 2 14 0 4 18 0 0 7 0 10 14 3 3 0 17 0 0 0 7 12 0 6 25 0 
0 31 0 0 18 27 7 24 0 6 12 9 6 3 3 10 0 25 17 18 0 0 5 12 0 0 0 8 8 0 0 17 
10 0 4 16 0 2 2 4 19 0 1 0 3 0 0 12 11 0 0 37 9 0 2 9 10 23 0 11 9 0 0 0 
0 0 4 0 0 26 16 0 12 20 10 6 0 0 22 0 0 8 25 0 22 7 9 10 14 0 0 0 7 0 3 24 
0 6 20 17 23 12 0 5 27 10 7 0 7 26 9 6 4 0 13 4 0 0 26 24 6 4 12 23 12 4 6 18 
