32 18
43 0 0 0 0 0 5 24 0 9 31 5 0 0 26 29 12 1 11 0 0 21 0 0 17 1 12 0 45 13 15 24 
20 16 19 8 0 15 0 2 0 3 11 8 0 0 0 0 4 3 4 3 21 14 1 0 0 1 0 0 9 0 4 0 
0 0 7 1 17 1 14 0 0 7 0 0 0 0 0 8 0 0 12 15 10 0 0 0 0 0 0 0 0 0 13 0 
0 17 21 21 0 25 0 15 29 0 3 0 11 0 31 11 7 1 25 3 7 0 8 0 0 0 12 20 9 3 0 3 
0 9 0 25 3 10 0 0 2 0 3 0 12 0 0 0 6 0 0 13 3 16 0 0 12 0 1 4 25 0 10 0 
4 2 0 18 0 21 7 0 0 11 0 0 0 14 7 13 6 12 0 0 10 24 2 0 0 0 22 18 7 0 4 15 
30 15 1 16 20 0 0 24 9 0 0 13 0 0 0 0 23 2 13 18 0 10 0 5 23 6 16 27 0 0 0 24 
5 7 26 5 3 14 2 0 13 15 0 0 0 20 19 14 0 4 0 11 3 2 0 22 21 0 4 0 41 14 1 0 
0 26 0 0 0 0 5 0 0 7 0 2 0 0 8 6 0 7 7 0 7 0 2 4 0 7 5 26 8 14 0 0 
3 7 28 0 18 0 10 0 0 7 14 2 0 0 0 12 4 7 0 0 6 2 12 2 3 0 0 8 9 0 22 21 
14 0 0 0 16 23 22 7 19 0 6 5 0 0 24 7 5 2 0 7 2 5 17 0 6 0 0 19 30 0 6 0 
4 2 0 0 22 0 0 0 30 10 0 12 0 0 17 4 15 0 4 13 4 10 3 15 0 4 20 0 9 10 0 23 
0 15 16 0 0 17 19 0 0 30 28 19 0 7 9 0 0 8 16 0 9 0 0 0 5 4 16 0 27 0 19 69 
13 0 23 10 20 6 10 23 0 0 13 8 0 0 0 10 10 8 0 0 7 6 0 0 20 0 2 24 1 0 24 0 
0 0 0 8 0 0 0 0 0 0 0 19 4 0 0 0 0 0 0 0 9 1 0 0 0 0 14 0 0 0 8 5 
14 3 2 0 0 6 38 0 0 0 9 13 1 0 2 0 2 0 18 3 5 9 0 3 5 0 5 11 2 23 13 0 
31 4 2 12 23 15 0 4 0 65 20 0 18 15 5 5 15 3 4 1 10 16 11 0 25 16 17 1 16 3 7 50 
16 36 1 0 1 2 5 10 0 11 0 0 0 0 11 14 8 0 0 6 11 6 0 0 22 0 19 1 0 0 0 10 
