32 18
18 30 6 0 51 13 5 43 13 13 0 6 14 0 0 9 1 11 45 0 0 13 10 0 0 24 46 5 0 12 17 0 
9 6 10 7 8 39 3 8 9 7 16 11 8 1 0 4 7 2 0 4 15 0 19 0 0 9 15 22 6 0 0 0 
0 19 0 0 22 0 11 0 0 0 12 0 8 1 0 0 0 0 14 11 0 0 41 22 0 9 14 0 8 1 11 0 
9 0 17 1 14 0 17 17 0 16 5 0 1 0 0 13 0 0 9 7 24 16 1 17 0 0 0 0 13 0 0 8 
0 0 24 0 0 9 0 9 0 11 2 0 0 0 9 0 13 0 0 11 8 0 0 0 0 0 21 0 0 3 2 0 
5 0 9 0 0 4 37 2 8 2 0 5 2 0 0 0 8 1 0 6 0 0 2 17 0 0 29 0 0 0 0 0 
0 0 0 5 0 0 2 8 7 9 7 6 0 0 0 0 0 0 9 0 0 3 0 13 0 2 6 6 1 3 14 0 
0 24 14 0 0 5 0 18 0 0 9 17 8 0 8 10 1 0 0 0 3 4 6 8 1 17 0 0 12 0 0 0 
0 12 0 0 6 0 1 13 0 7 5 6 10 12 8 0 13 6 3 1 0 0 7 0 17 0 4 0 11 0 14 0 
0 10 5 1 0 4 0 9 0 0 21 8 18 2 9 9 2 0 5 2 6 2 5 0 0 23 16 0 10 10 26 0 
22 5 0 22 33 20 31 2 9 9 0 9 2 1 0 11 0 2 12 15 0 1 1 17 0 36 18 2 9 7 0 25 
12 22 26 22 1 0 0 0 3 0 4 0 0 3 0 4 0 0 25 0 6 2 8 6 23 36 0 25 3 0 7 8 
0 0 9 0 1 1 23 1 10 0 3 4 0 16 0 4 0 0 16 0 0 0 0 1 0 0 4 0 0 16 0 25 
0 16 24 14 0 0 2 16 11 3 1 0 0 6 7 7 0 9 8 0 9 0 11 0 0 0 14 7 0 12 0 0 
0 0 9 0 14 12 14 21 7 0 0 6 18 0 20 8 0 20 5 0 10 7 17 9 6 8 9 13 5 11 1 0 
1 0 14 0 15 0 15 25 0 1 0 0 18 0 4 5 0 2 0 11 3 0 0 3 0 18 15 0 26 0 21 0 
4 0 7 0 0 17 0 10 0 1 13 0 0 8 10 0 2 14 0 0 13 0 0 22 0 0 0 0 0 0 0 14 
6 0 23 0 2 0 82 0 11 0 20 0 3 0 0 2 13 5 12 11 6 0 0 20 1 3 0 21 28 23 5 0 
