32 18
0 0 0 14 3 0 0 4 16 0 4 0 0 0 0 9 0 37 0 4 0 15 14 4 0 17 0 0 10 12 0 0 
9 23 17 7 0 9 16 6 5 10 2 0 12 6 24 9 4 0 0 10 16 39 0 0 0 0 0 0 0 0 0 0 
24 1 0 25 0 16 8 12 6 15 0 13 0 0 31 3 11 0 3 15 0 9 51 3 16 0 0 7 7 0 9 1 
0 2 0 6 0 0 0 5 0 0 0 18 14 12 0 0 0 0 5 12 14 0 0 0 0 0 6 0 8 23 0 0 
0 33 0 0 0 18 0 0 10 0 24 2 0 1 11 0 0 5 0 12 0 2 7 13 0 20 0 0 8 7 54 12 
23 28 0 0 5 7 0 0 0 9 8 0 0 0 11 1 9 10 0 0 0 5 17 9 0 0 0 0 0 57 0 0 
0 12 8 2 11 12 5 2 0 8 0 10 11 0 35 15 9 13 13 0 0 2 0 1 0 8 0 0 0 0 12 4 
0 10 0 2 0 0 0 9 0 0 3 3 0 0 8 10 5 13 0 0 12 4 8 8 2 15 0 5 0 0 13 8 
0 0 0 23 23 22 1 4 34 0 1 10 6 0 0 7 15 3 17 0 12 2 0 19 24 0 21 25 2 7 0 0 
30 4 32 13 0 27 0 6 6 0 6 19 0 0 0 8 19 5 0 8 1 0 0 3 19 0 5 7 3 0 30 2 
1 0 50 0 0 34 2 0 7 2 0 9 0 5 4 0 1 2 6 0 3 11 2 0 22 0 0 0 9 7 0 30 
27 0 4 24 13 0 0 13 0 10 10 0 0 18 0 0 27 11 7 10 1 11 9 5 2 3 24 27 5 0 0 33 
0 14 0 34 3 0 15 6 0 2 9 8 0 16 41 14 10 7 8 32 0 23 11 17 6 3 0 13 13 16 11 0 
0 4 0 4 0 2 0 26 1 0 8 0 17 0 4 2 0 2 0 1 5 1 14 0 0 0 0 0 13 0 23 0 
0 8 0 0 0 10 0 16 7 10 7 1 0 0 13 7 0 13 1 0 0 15 0 0 0 0 0 0 0 11 0 0 
14 11 14 24 1 1 0 3 0 4 16 5 0 4 1 4 7 6 13 16 0 10 8 2 17 0 16 54 0 7 8 0 
0 0 9 17 0 0 18 0 8 7 4 1 0 0 4 12 7 0 2 0 19 0 12 0 20 0 0 0 13 0 0 0 
0 10 6 20 7 11 22 0 0 0 0 0 31 0 4 13 0 22 0 3 15 22 8 41 0 6 0 10 5 0 0 0 
