32 18
22 0 17 5 2 0 9 13 0 0 12 0 0 0 0 25 14 0 9 18 11 7 7 0 0 9 0 5 34 0 0 16 
54 8 0 26 27 0 9 2 7 0 0 7 30 0 0 20 0 0 0 0 4 0 0 0 11 24 14 2 3 33 38 31 
1 9 23 0 12 7 8 38 16 16 13 10 0 18 0 9 2 0 0 12 13 0 0 0 20 19 16 1 0 22 1 33 
0 11 0 0 0 7 0 13 6 4 0 30 18 0 12 1 6 0 7 0 13 5 2 0 22 0 17 0 17 0 38 7 
1 47 0 8 2 19 15 1 0 3 2 0 20 0 0 0 0 12 4 0 6 0 4 17 5 24 0 4 12 18 0 0 
0 0 0 33 4 0 0 1 20 0 3 0 10 6 0 0 5 0 8 6 6 0 1 1 2 17 8 0 0 5 0 28 
29 2 0 2 12 10 0 0 0 0 0 3 0 0 0 13 12 0 0 6 0 0 4 14 8 4 0 4 8 23 25 0 
0 26 0 0 2 20 7 1 0 2 0 11 0 2 0 0 5 0 0 0 6 5 0 12 0 34 0 26 0 0 4 15 
11 0 15 50 0 0 9 3 16 15 9 4 0 0 14 0 23 15 0 7 1 5 0 0 2 6 0 1 11 2 0 0 
0 0 0 7 0 2 21 0 4 0 0 0 19 14 0 0 0 0 0 0 0 0 0 0 6 11 0 35 0 0 0 19 
17 0 0 24 9 0 0 0 0 0 0 0 0 0 0 0 0 0 0 0 4 6 7 23 5 0 0 30 0 5 9 7 
13 29 11 0 18 33 9 0 2 10 2 1 0 13 0 11 0 11 2 7 2 0 28 0 0 0 6 0 7 24 29 0 
25 0 0 30 11 7 28 4 14 5 12 1 9 18 0 0 8 11 0 12 9 1 25 0 16 27 1 0 0 39 6 58 
5 16 0 27 0 20 8 9 18 0 0 10 0 0 5 0 3 4 9 2 17 0 7 0 9 0 9 0 23 3 27 0 
13 0 0 9 7 30 16 0 12 7 10 8 38 0 0 0 16 0 1 8 9 9 19 0 10 14 0 14 0 5 25 0 
1 7 0 0 0 0 0 0 13 16 0 0 3 0 3 0 1 0 5 7 19 0 0 14 13 16 0 0 20 0 0 0 
6 2 23 21 39 25 20 0 0 1 0 11 7 16 0 14 4 12 3 0 1 14 0 10 4 23 17 17 24 16 19 1 
9 0 0 0 0 15 0 0 10 9 0 0 0 6 0 5 10 0 10 0 7 8 17 10 0 0 0 0 0 0 0 16 
