32 18
31 0 11 20 9 5 8 0 46 4 0 0 3 7 21 10 16 0 0 0 0 6 13 10 10 17 0 0 0 29 19 0 
0 0 0 0 0 25 3 0 0 0 0 0 0 2 0 0 15 23 0 11 8 10 0 8 0 0 0 0 0 12 22 26 
16 29 0 21 13 13 27 14 10 0 0 10 9 0 0 15 25 13 9 0 12 11 0 0 21 0 25 0 1 0 27 5 
9 0 22 13 0 0 1 10 20 0 0 17 0 4 0 0 18 0 18 3 0 2 0 0 14 12 0 0 17 0 3 0 
6 22 0 10 0 0 35 35 8 11 22 16 0 3 4 0 13 6 16 0 11 0 0 7 0 18 16 0 20 23 11 11 
20 0 0 0 7 0 19 0 3 9 8 15 10 0 3 0 0 6 0 2 10 2 10 1 0 19 0 0 16 1 0 0 
0 27 0 0 19 3 6 22 3 4 11 2 4 24 0 0 0 4 0 0 0 3 22 19 13 0 0 0 26 27 7 0 
26 29 23 2 14 1 7 4 5 0 0 20 28 9 18 4 0 19 17 9 4 3 11 0 8 23 26 13 6 11 11 34 
0 24 0 19 0 0 0 0 0 0 0 13 3 0 3 0 0 0 2 0 2 0 19 2 0 26 0 9 17 0 0 0 
0 0 0 0 0 0 21 0 0 35 8 6 0 0 13 0 6 0 5 8 2 0 8 0 0 0 20 2 0 0 7 0 
7 1 0 0 7 0 2 16 6 0 6 0 0 3 0 0 0 0 2 0 0 8 4 0 0 0 19 0 0 10 0 9 
30 3 32 13 26 25 0 0 25 0 0 0 14 5 13 0 9 9 20 5 2 7 0 7 0 0 26 11 18 0 5 23 
1 0 0 33 26 3 17 0 8 0 0 5 1 4 0 0 0 12 0 0 0 0 1 7 0 0 23 0 0 2 26 0 
10 0 7 21 11 6 0 0 0 7 21 0 0 13 0 11 15 0 5 0 4 3 6 0 18 2 0 2 0 13 0 0 
9 0 0 5 0 13 0 0 3 5 0 15 7 4 3 0 0 20 0 14 4 1 19 6 0 0 15 0 0 7 0 0 
30 0 0 11 11 3 0 0 25 7 0 14 7 0 13 7 0 12 13 7 0 0 8 5 14 5 9 0 31 2 70 0 
0 0 0 0 16 25 0 0 0 2 3 2 1 23 2 0 16 0 1 7 16 3 0 0 3 12 0 0 14 0 26 0 
0 13 16 0 0 20 0 1 9 20 12 14 24 13 8 0 4 0 15 0 0 8 0 11 0 20 0 10 0 36 1 0 
