32 18
5 0 0 26 0 20 0 0 10 0 37 0 7 0 0 17 27 16 2 1 0 0 35 0 14 0 0 3 0 0 0 28 
0 12 0 2 0 14 4 7 1 22 14 0 2 0 2 12 0 8 1 16 19 20 10 16 14 0 4 2 0 0 16 35 
6 32 0 15 7 13 16 12 2 20 2 10 0 0 21 9 0 5 1 42 0 5 8 6 13 0 7 0 2 20 9 30 
7 0 0 0 22 5 2 7 2 2 10 0 3 0 3 20 0 0 0 4 0 0 0 8 0 0 19 20 13 3 0 6 
17 6 0 0 15 1 45 1 13 12 0 0 12 4 12 10 4 11 0 3 16 4 17 0 8 23 67 3 27 0 9 25 
9 1 0 0 25 1 0 0 0 2 0 0 7 0 17 11 0 0 4 11 1 8 0 0 20 0 0 8 0 26 16 0 
26 5 5 0 14 0 7 24 10 0 8 0 4 0 3 0 0 0 22 0 6 0 0 0 0 2 49 4 0 0 0 4 
0 32 0 0 0 0 6 0 0 0 9 0 0 0 0 13 4 2 0 0 0 0 7 4 23 0 0 0 0 12 15 0 
4 0 0 0 8 0 0 0 0 19 11 5 2 0 0 0 0 0 0 0 0 0 17 0 7 0 0 0 19 0 0 6 
0 6 15 0 7 0 28 30 2 0 0 11 0 2 8 0 0 8 4 0 0 10 0 0 17 0 9 0 0 2 4 9 
28 0 15 22 28 0 0 5 30 0 19 2 16 13 0 5 4 17 0 1 17 0 0 0 24 17 0 23 7 40 0 0 
0 0 4 33 0 18 16 11 3 3 3 2 5 7 0 2 4 3 5 6 0 0 1 1 0 0 26 3 3 0 0 12 
0 2 3 0 2 0 11 0 0 22 0 22 3 13 5 0 14 6 0 18 9 4 20 18 0 12 4 3 0 0 0 33 
8 16 1 9 0 0 0 0 0 0 0 5 0 0 3 2 13 5 0 0 0 0 0 0 0 1 23 2 11 7 4 0 
20 4 0 23 1 58 0 6 0 25 11 0 3 0 1 16 0 6 7 0 11 0 24 0 1 3 23 20 0 1 25 0 
26 6 0 11 1 1 5 5 14 14 5 14 10 0 1 10 0 0 4 0 11 0 15 0 3 0 4 30 5 10 20 20 
5 5 6 13 8 5 0 0 6 0 1 1 20 0 5 12 6 1 1 5 0 10 21 0 12 0 15 1 29 17 0 9 
10 0 0 15 0 13 0 9 4 3 9 0 11 13 0 5 1 0 13 16 7 0 9 13 0 0 18 3 0 10 38 8 
