32 18
8 0 0 1 16 5 8 27 10 0 15 11 0 25 1 9 0 2 13 1 0 10 9 2 3 0 0 0 18 16 16 14 
0 0 0 5 18 0 0 32 0 22 28 0 2 28 2 5 15 0 4 0 0 11 7 8 17 15 0 11 0 6 0 9 
0 0 0 3 20 42 8 11 2 13 0 4 1 3 3 3 12 1 12 16 0 16 10 2 7 16 30 17 4 0 38 0 
0 12 0 4 12 10 3 13 0 0 0 0 0 17 0 0 0 0 0 11 0 0 0 0 37 0 0 0 1 0 28 2 
11 0 0 27 0 1 0 0 9 1 16 15 0 10 0 0 0 9 0 12 0 0 0 14 0 0 11 2 5 0 19 0 
0 0 0 19 7 2 2 15 0 0 0 7 4 11 1 3 0 3 0 7 0 9 36 0 18 0 0 7 0 0 9 0 
0 0 0 5 0 0 3 0 6 0 0 0 4 5 1 0 17 0 0 2 0 2 8 0 5 0 0 0 5 13 0 1 
3 0 1 6 1 6 18 12 0 8 0 2 0 0 6 3 2 0 11 16 0 0 4 12 22 0 14 0 0 6 0 1 
19 1 1 22 0 1 23 0 0 0 7 0 16 4 0 10 0 26 0 0 20 0 19 0 12 6 0 10 0 36 13 10 
0 0 0 3 0 25 0 0 21 17 0 9 0 0 0 5 2 0 0 7 0 8 3 15 4 0 5 0 0 23 26 0 
0 0 5 12 15 0 5 13 10 8 0 0 0 4 4 15 0 15 0 15 0 0 0 0 4 1 0 0 2 0 0 0 
0 2 0 5 6 47 9 0 12 0 8 11 9 10 0 7 3 0 6 6 0 25 0 5 0 2 2 0 3 24 7 3 
0 0 0 5 0 4 3 0 0 0 0 17 5 4 2 0 4 11 11 5 9 1 12 5 1 1 0 4 0 5 8 0 
4 46 17 38 7 5 0 0 3 1 5 13 1 12 11 0 0 16 2 24 0 10 3 35 23 30 2 23 11 26 0 0 
23 0 1 1 26 0 12 0 0 16 3 0 6 3 11 13 18 0 1 0 0 9 0 28 0 0 17 0 3 14 26 0 
0 22 18 0 37 0 5 15 0 8 0 2 0 0 15 15 3 0 4 18 18 0 27 2 0 0 10 0 0 0 28 0 
6 5 2 0 3 21 5 0 19 0 17 14 14 0 3 0 2 3 0 5 0 2 14 6 13 14 21 2 0 39 0 0 
2 10 17 9 23 20 16 0 3 7 0 27 5 7 8 3 7 22 13 11 0 18 3 0 0 20 18 8 3 8 0 0 
