32 18
0 10 9 1 22 8 0 0 0 9 9 0 17 0 9 0 15 0 9 0 19 0 0 0 0 21 0 4 0 0 0 25 
9 0 0 0 6 27 3 15 0 19 5 9 14 4 14 0 0 0 0 2 5 0 16 0 0 13 0 0 21 24 2 14 
19 52 27 11 17 0 0 23 0 0 29 0 7 8 0 0 0 0 23 6 19 18 0 0 22 12 25 8 0 0 23 0 
16 29 7 1 20 0 7 2 0 6 0 0 8 11 20 1 16 0 0 3 18 7 10 0 13 14 0 13 2 10 7 17 
0 0 0 3 0 32 11 0 0 13 10 7 0 0 2 8 9 0 9 0 14 2 0 0 0 0 0 11 0 0 25 0 
2 9 25 0 9 2 21 0 5 0 27 13 0 5 0 3 5 0 0 15 0 8 0 0 4 4 0 21 18 6 2 4 
3 0 0 3 10 0 5 0 3 0 6 3 4 0 10 0 2 0 13 1 5 0 2 10 2 9 0 0 22 0 4 6 
5 0 11 5 0 19 0 0 0 4 0 10 0 11 7 0 6 2 0 0 0 4 0 7 0 4 0 0 0 24 13 1 
0 0 19 0 3 22 9 23 0 23 9 6 18 0 0 0 4 0 0 4 0 0 0 7 0 23 0 3 0 20 1 27 
3 0 9 0 0 12 9 21 2 0 6 0 0 3 0 0 0 16 12 8 7 8 5 0 0 0 0 21 21 4 1 0 
31 24 21 5 2 0 42 3 5 0 18 0 1 5 6 6 12 0 8 2 11 0 2 0 10 9 3 0 12 25 5 47 
0 23 0 0 25 3 0 0 14 17 5 2 10 0 0 3 4 4 0 0 5 8 0 0 37 5 40 4 0 1 0 5 
3 31 13 19 2 0 3 0 8 19 39 0 0 4 6 2 2 17 0 11 6 0 22 9 10 19 0 18 26 17 29 2 
0 6 24 0 0 0 0 0 1 7 0 0 4 0 0 0 30 3 12 0 0 0 0 4 11 23 0 0 12 7 5 10 
24 1 13 8 0 0 0 0 4 1 4 24 5 0 0 9 13 17 0 0 0 0 10 0 9 0 15 0 0 0 0 2 
7 2 0 5 0 0 7 7 0 10 14 0 16 7 14 5 0 1 0 10 5 7 1 0 2 4 1 0 7 0 8 5 
0 0 26 0 27 0 0 4 0 0 0 0 0 10 20 0 10 10 0 2 4 15 0 11 0 4 9 14 0 0 10 0 
0 4 0 0 0 12 35 1 17 5 35 19 4 11 0 12 3 3 11 0 7 11 16 4 13 31 20 13 0 2 20 14 
