32 18
0 4 0 0 4 13 0 0 14 1 26 0 0 0 0 8 0 0 0 7 8 8 2 18 15 5 11 0 8 5 47 9 
28 30 0 13 4 0 11 1 5 17 9 3 13 18 22 1 34 6 18 24 4 5 10 2 0 9 8 0 1 29 13 79 
6 0 9 1 4 0 24 0 15 26 16 15 8 17 0 24 16 13 8 0 16 12 0 0 0 16 11 0 1 25 30 0 
0 0 1 24 11 0 18 0 0 20 4 0 5 3 12 21 11 11 2 6 0 11 0 9 8 4 0 0 20 0 23 0 
33 29 18 5 27 2 15 16 11 1 4 19 0 6 1 21 4 11 21 3 27 15 0 2 8 0 51 17 21 3 15 0 
0 51 0 2 15 8 10 0 5 0 30 10 0 5 0 16 2 7 9 18 19 10 0 0 14 24 2 0 2 19 0 0 
0 0 0 0 0 0 0 9 0 0 7 0 3 0 0 3 0 10 0 19 7 8 0 0 0 0 12 0 0 0 0 12 
17 0 9 16 22 24 0 0 0 11 0 0 6 0 13 0 0 17 6 0 9 7 0 20 10 5 10 4 0 24 0 0 
0 31 7 0 12 7 5 22 0 11 21 0 5 0 1 3 9 0 2 0 11 0 2 0 0 0 16 49 0 0 15 0 
31 0 0 0 0 19 0 0 0 0 0 0 8 0 0 0 0 6 22 7 8 3 0 0 0 0 0 0 28 5 0 0 
2 0 34 16 0 0 5 29 0 8 0 0 0 0 5 8 0 3 0 16 0 19 0 0 0 0 28 0 5 18 0 0 
0 0 17 6 0 2 1 3 24 2 7 7 0 8 0 21 5 16 0 0 0 7 3 2 0 26 5 4 0 0 15 4 
5 0 0 0 0 0 3 2 1 3 3 4 0 0 0 0 0 7 2 7 2 0 0 12 0 6 0 0 0 0 0 0 
0 0 11 0 0 14 0 0 18 0 1 19 6 0 0 0 0 0 0 14 6 0 2 0 15 5 0 19 0 9 19 0 
0 20 0 21 20 0 4 24 0 0 0 1 0 26 0 0 0 1 9 0 14 2 0 0 20 2 0 2 7 7 14 24 
0 12 9 26 46 15 11 2 6 10 5 13 9 29 45 13 0 20 3 22 16 4 31 0 2 3 12 3 31 16 23 16 
28 0 8 0 8 1 0 10 0 0 20 0 8 17 0 0 0 10 12 4 16 0 7 0 0 3 0 0 28 13 36 0 
0 0 5 0 12 14 0 13 13 22 0 15 0 0 0 8 0 0 0 12 4 0 0 0 0 0 0 0 2 16 1 38 
