32 18
24 1 28 1 17 15 42 11 0 4 0 31 10 0 0 0 1 0 18 0 30 0 16 0 11 2 0 13 12 14 2 20 
0 3 0 28 4 0 0 0 5 8 17 0 7 6 5 0 0 2 0 1 0 0 0 16 2 6 1 0 7 2 0 62 
0 11 0 5 17 5 2 0 14 0 6 0 3 20 0 0 0 10 0 27 8 31 0 4 0 8 0 10 0 0 20 0 
2 6 26 0 0 0 0 7 0 2 0 15 5 3 7 0 0 3 4 0 5 14 0 11 4 18 1 0 12 19 25 11 
9 9 0 5 27 0 21 0 12 0 2 5 6 9 3 0 7 0 0 15 21 6 12 0 0 7 0 15 0 9 0 0 
0 0 0 0 4 0 5 2 4 17 19 7 2 12 4 0 8 9 0 0 0 0 9 0 8 15 26 0 10 0 5 0 
0 18 0 0 2 0 25 0 10 0 0 6 0 9 0 0 0 15 0 0 0 11 12 0 0 0 6 0 2 28 0 25 
18 14 0 19 13 18 19 29 9 0 0 0 2 17 17 0 9 14 17 8 26 13 28 16 6 14 9 0 0 22 0 17 
0 21 0 0 30 0 8 0 0 0 0 1 2 3 10 3 0 0 0 0 0 0 21 0 16 4 0 0 6 0 0 0 
28 6 0 0 0 12 0 18 0 5 2 9 4 0 1 7 13 17 0 0 1 16 2 3 0 17 1 0 0 13 0 0 
9 15 10 22 0 0 4 18 6 19 0 0 16 0 5 13 8 10 23 2 0 7 6 10 2 10 0 3 17 6 0 24 
21 25 0 0 4 0 1 0 5 0 9 0 9 0 12 0 0 3 0 0 0 2 0 2 1 2 0 37 27 0 13 9 
0 5 0 8 0 0 8 0 0 19 0 2 0 4 3 13 4 0 0 0 0 12 0 0 1 9 20 0 32 0 0 9 
1 2 0 2 27 2 0 9 0 13 0 5 0 6 17 16 2 3 0 11 7 0 0 0 13 12 0 8 12 13 0 57 
0 22 39 2 0 5 0 0 17 4 12 0 0 0 7 0 0 3 0 0 8 2 5 5 0 41 24 1 15 1 0 2 
24 12 0 0 2 9 21 0 23 8 5 14 0 15 0 0 1 0 0 8 0 0 8 0 0 20 12 1 29 0 0 25 
1 38 0 21 16 0 8 14 15 13 8 16 0 3 5 17 4 2 17 24 15 37 30 12 0 14 0 9 8 7 0 3 
10 0 27 13 27 21 13 0 0 0 0 0 4 15 0 0 11 7 0 13 0 11 0 0 0 14 21 0 0 24 0 13 
