32 18
22 0 0 15 0 19 13 0 7 9 0 0 5 2 16 1 1 4 7 7 0 15 20 0 12 7 7 2 0 0 0 15 
0 7 0 11 0 25 0 14 7 0 15 0 0 12 14 0 1 31 0 0 0 0 0 0 0 15 0 0 23 14 0 1 
24 0 0 6 17 6 0 23 10 6 1 6 0 0 9 0 8 3 2 0 7 11 13 0 3 0 0 21 21 0 0 1 
5 5 0 2 0 5 5 3 5 0 4 0 1 2 13 11 2 0 7 0 2 7 0 3 3 0 5 3 21 0 13 24 
0 0 0 0 9 15 0 11 12 0 20 0 11 0 0 10 0 0 3 13 0 0 7 13 0 0 7 3 3 0 0 26 
27 14 0 7 0 15 9 1 17 4 24 0 4 13 7 9 7 14 0 5 31 15 16 7 19 12 4 4 0 19 0 0 
20 24 11 28 0 0 8 13 3 27 0 5 6 11 0 20 0 11 9 11 27 2 8 0 0 24 1 1 0 14 29 13 
4 3 0 0 51 0 0 0 11 14 3 0 1 3 0 0 12 7 0 0 12 17 0 12 20 8 0 3 0 0 36 1 
0 14 0 10 0 9 0 0 0 0 11 0 6 2 0 5 0 0 5 1 0 11 8 5 8 0 0 4 0 0 8 0 
0 11 0 6 0 0 0 20 0 9 20 8 28 4 2 6 5 4 0 1 9 1 3 2 17 0 0 0 3 5 0 20 
25 2 0 0 0 0 3 0 14 3 1 15 4 0 0 0 3 0 11 14 0 0 0 0 7 21 0 6 0 29 0 7 
13 0 4 0 4 0 0 0 13 1 2 3 0 0 14 7 6 0 0 0 0 0 5 0 0 0 17 28 20 0 0 4 
0 0 19 10 0 3 0 8 16 4 0 3 0 0 12 0 0 17 5 0 0 28 8 8 21 0 28 1 0 8 0 23 
0 5 17 3 0 0 3 4 6 17 3 13 0 12 4 26 0 0 9 0 18 1 11 0 0 0 0 12 4 0 0 0 
11 0 16 0 0 6 2 0 3 0 13 1 4 0 19 3 14 0 19 3 0 0 5 0 5 4 0 24 0 5 2 0 
0 12 5 6 2 4 23 0 11 0 6 11 29 0 1 25 0 15 6 0 0 5 0 0 6 10 0 0 0 37 26 19 
6 16 0 17 12 0 5 17 5 4 0 0 7 11 0 0 8 3 0 8 0 1 0 0 22 10 3 13 0 22 8 0 
0 29 0 15 0 9 13 16 0 13 4 2 0 0 9 3 8 15 13 21 12 0 13 9 0 12 20 12 0 0 39 0 
