32 18
4 6 25 5 31 14 0 0 11 13 2 11 2 9 1 3 0 20 0 22 4 1 8 6 29 0 2 30 12 0 8 10 
4 9 0 38 23 18 11 19 15 18 9 0 8 0 14 0 12 14 0 8 2 2 12 17 4 3 3 5 16 15 0 9 
0 17 0 0 21 0 17 23 5 11 1 4 1 5 10 0 0 0 6 0 0 0 0 22 7 3 0 0 0 0 0 9 
0 19 10 0 10 5 0 0 7 10 1 0 9 0 2 3 15 0 0 16 4 5 0 13 7 11 0 26 5 0 0 7 
39 0 0 0 0 0 17 0 0 13 8 0 1 0 0 0 0 11 0 2 11 5 13 17 0 0 2 0 28 0 0 0 
9 0 0 24 29 22 0 0 5 17 3 0 41 10 0 0 0 0 0 5 15 0 18 0 16 6 17 34 16 0 8 6 
19 15 44 2 5 7 0 0 3 0 0 0 0 0 0 0 0 12 0 4 23 0 0 0 5 0 9 27 27 11 11 0 
12 0 24 23 6 1 4 1 0 0 2 0 31 0 5 5 9 13 5 3 5 6 15 0 14 0 1 0 0 2 12 4 
0 16 18 21 39 3 5 8 5 7 6 11 15 4 5 0 0 11 9 13 19 9 10 18 0 5 25 0 0 0 50 11 
0 0 0 0 26 0 0 17 0 0 5 0 0 0 0 2 14 0 3 5 0 1 0 0 10 8 0 0 0 8 26 0 
40 0 0 1 2 21 7 0 6 5 0 17 0 12 13 0 0 0 5 4 0 12 5 2 3 0 27 8 24 24 9 7 
0 0 0 27 16 23 6 12 0 9 1 11 6 1 6 0 0 0 4 10 1 23 0 8 4 3 0 10 23 1 2 37 
5 14 16 1 15 12 0 0 5 4 9 21 0 0 0 0 11 0 17 32 0 2 14 15 16 24 0 0 0 0 14 3 
7 11 0 18 10 8 0 2 20 0 10 0 0 0 1 7 0 12 0 4 0 18 5 0 0 0 0 0 33 0 11 0 
0 6 0 0 0 10 0 12 0 0 0 5 1 14 1 0 5 14 0 12 5 2 0 0 0 16 0 0 0 24 0 0 
11 38 0 33 0 26 0 24 18 3 9 0 1 0 15 0 6 0 0 4 17 0 5 8 8 0 4 8 0 0 11 63 
0 8 0 0 17 7 7 8 0 0 0 14 0 18 23 20 1 16 0 5 0 17 0 4 5 24 0 4 6 20 16 0 
0 0 0 0 11 0 8 0 0 5 1 1 0 0 7 11 8 0 8 10 0 0 13 0 0 13 0 0 0 0 16 5 
