32 18
0 3 3 0 3 0 20 20 0 4 25 17 0 8 8 0 15 0 2 10 1 20 11 8 0 0 11 3 5 0 0 21 
13 0 27 24 20 0 17 0 14 0 0 0 0 3 0 0 0 0 0 0 2 4 9 19 23 0 0 3 0 15 0 0 
15 0 0 1 1 16 10 0 0 0 0 18 0 0 0 0 9 0 0 3 0 16 3 5 0 12 0 14 3 14 11 0 
10 3 4 14 11 0 0 0 8 7 13 0 4 10 5 9 9 0 0 0 0 2 2 20 1 0 3 0 13 19 0 4 
26 12 2 10 7 0 18 4 4 15 0 5 4 5 0 0 8 1 7 8 6 4 9 20 54 30 23 24 28 12 24 6 
0 5 0 0 0 5 5 0 0 0 4 0 14 9 0 0 6 0 8 1 10 0 0 4 0 2 0 0 7 0 0 0 
0 18 0 0 0 0 20 9 0 0 3 1 12 2 0 0 9 0 5 19 1 0 3 11 9 9 13 0 0 4 11 2 
7 0 34 1 27 0 14 13 8 6 12 16 19 0 0 0 16 10 8 0 13 7 12 11 0 8 10 25 3 1 14 2 
0 1 0 23 16 17 4 0 0 13 6 19 7 3 0 11 0 2 0 8 0 0 21 2 3 9 50 0 1 4 19 5 
0 1 4 6 18 7 4 0 0 0 0 0 13 0 0 0 0 4 1 3 0 0 23 7 0 15 13 1 4 0 0 5 
2 0 2 28 2 0 13 3 6 3 6 1 0 0 2 0 2 0 0 31 0 0 0 2 1 16 0 0 0 10 6 28 
0 11 0 4 0 1 0 19 20 0 0 10 10 0 0 0 0 0 0 5 0 12 3 1 0 20 40 4 27 0 0 0 
0 0 7 0 0 4 10 0 0 7 0 0 10 0 6 3 0 0 0 0 0 0 0 0 0 15 0 0 0 0 5 17 
4 14 0 12 0 0 0 12 16 0 0 10 22 7 0 2 0 11 0 0 9 10 0 22 17 5 0 0 0 5 0 25 
0 0 21 1 28 0 0 0 1 0 0 16 0 11 6 0 0 0 0 2 7 12 18 17 0 1 0 16 0 0 2 0 
8 0 16 14 7 0 0 1 13 15 17 16 1 7 0 0 0 5 13 0 29 8 6 26 24 7 0 0 32 8 10 29 
0 7 11 3 23 9 16 6 6 11 0 15 4 7 1 0 13 9 0 0 11 0 0 10 0 22 1 9 2 0 15 18 
30 0 2 3 0 0 5 0 0 3 0 5 22 0 14 1 11 0 0 0 0 0 0 11 11 0 17 11 28 0 16 0 
