32 18
14 0 1 0 5 3 0 4 1 29 33 0 1 1 12 15 3 0 5 4 11 33 0 0 0 3 0 9 0 0 0 28 
31 0 0 0 0 0 0 0 0 1 0 3 0 1 16 0 0 29 0 2 19 2 0 0 5 15 6 0 7 4 0 42 
9 0 12 0 5 0 21 2 4 0 0 0 14 3 2 3 1 0 0 2 0 2 0 21 0 11 0 0 22 0 0 0 
11 8 0 24 1 32 0 0 12 17 16 24 17 12 9 4 9 0 8 1 30 3 0 0 0 3 26 25 29 19 0 33 
0 6 9 0 15 3 1 4 3 21 0 3 0 0 0 0 0 8 0 5 10 11 0 1 1 1 0 20 11 0 15 1 
1 29 21 0 20 0 3 8 23 10 0 14 12 7 0 0 0 10 5 0 12 21 0 21 21 8 9 0 0 46 29 37 
7 0 5 1 20 9 0 12 10 0 0 0 0 0 0 0 0 0 0 5 6 4 0 0 20 2 1 0 0 0 0 0 
7 9 9 1 17 12 6 4 4 0 19 0 9 33 12 2 4 4 0 6 0 7 20 8 0 0 6 0 0 0 17 8 
0 0 1 0 9 3 0 3 3 5 0 8 3 1 10 6 0 10 11 2 9 2 6 0 0 4 5 3 4 9 3 0 
3 12 0 0 7 2 7 30 0 0 3 2 19 1 0 10 3 13 11 14 0 0 0 1 3 10 9 0 1 1 0 43 
3 6 0 0 3 25 0 1 23 0 1 2 8 2 0 0 0 11 8 0 2 0 0 0 19 0 12 0 11 0 0 23 
9 8 22 0 11 20 18 3 0 0 3 0 2 16 4 29 10 13 0 7 0 0 0 1 6 0 8 3 26 7 0 5 
9 0 8 0 29 3 0 0 6 9 20 0 0 0 7 1 1 0 1 1 2 2 0 0 0 21 0 6 0 1 0 0 
18 0 9 0 3 18 6 5 17 8 0 6 7 3 0 2 9 0 4 0 0 0 3 0 0 35 5 0 17 0 25 20 
20 0 26 30 0 3 0 4 0 13 0 10 0 0 0 0 13 0 8 2 0 14 13 5 0 0 9 6 26 39 0 11 
6 0 0 19 6 9 0 20 1 6 6 0 10 6 15 21 0 8 5 0 12 14 29 0 11 1 19 0 0 15 0 0 
0 19 23 0 2 5 0 0 10 15 0 8 16 20 9 10 0 13 7 0 22 0 3 5 10 8 0 25 16 16 13 5 
10 0 15 0 4 0 9 4 0 5 0 2 0 4 4 0 0 0 6 2 11 22 0 0 0 0 0 4 0 16 11 28 
