32 18
0 0 11 0 0 0 19 0 0 0 0 0 0 11 0 0 8 11 8 0 7 3 0 6 8 19 0 0 0 0 0 1 
29 30 22 0 0 0 17 8 0 0 11 2 5 2 1 16 6 1 0 3 6 11 10 17 8 0 6 3 0 18 14 29 
5 11 27 5 18 10 15 6 5 0 0 0 0 10 4 14 0 2 0 0 15 6 18 5 0 0 0 17 20 12 14 1 
32 0 6 0 2 26 8 4 4 11 11 24 0 0 0 6 15 14 8 0 20 24 0 4 6 6 25 4 0 0 25 31 
11 25 2 0 14 10 19 18 0 17 0 11 2 0 2 0 5 7 0 15 30 8 0 5 1 5 36 3 4 0 10 0 
35 4 2 12 6 21 15 0 0 0 14 11 0 0 0 5 0 0 7 0 0 3 0 17 14 25 1 0 23 0 0 10 
17 3 0 5 3 5 17 0 24 21 0 5 8 15 3 0 11 13 19 0 15 3 5 0 0 0 0 5 0 0 21 0 
5 0 15 17 1 10 8 0 4 9 0 0 3 8 0 9 0 41 0 2 22 6 0 0 6 1 1 6 3 12 0 10 
28 0 0 17 0 3 0 2 12 6 0 17 0 0 0 0 0 0 10 0 13 1 1 3 5 2 23 2 11 0 22 0 
8 5 0 6 0 0 0 12 0 0 12 0 4 7 2 0 20 6 0 13 0 1 16 0 1 3 0 8 8 0 0 0 
7 1 0 17 0 9 19 0 0 0 13 0 7 18 0 0 0 0 5 4 4 0 35 27 2 0 0 4 0 6 0 0 
0 0 0 24 13 16 31 0 9 0 0 0 8 0 2 0 9 8 18 0 7 0 0 3 8 0 0 24 0 0 0 14 
0 25 1 0 0 0 0 10 29 1 2 19 3 0 0 2 9 19 0 10 0 8 0 30 0 0 0 8 3 10 9 0 
22 11 0 0 0 5 24 5 2 0 5 3 17 0 15 0 0 0 3 0 0 0 18 8 17 0 4 14 2 0 25 8 
0 20 5 34 0 25 0 0 1 0 11 8 8 0 0 12 14 5 0 19 32 18 2 0 3 28 2 29 0 0 13 8 
47 34 1 6 9 11 16 8 25 5 0 0 20 30 0 10 3 21 1 2 13 0 0 0 16 15 0 15 11 1 24 65 
0 12 0 0 0 5 1 0 0 9 0 11 5 5 5 12 4 5 2 12 4 14 1 0 0 0 0 0 0 0 0 13 
25 13 14 32 12 5 5 1 0 14 0 1 6 21 11 0 32 12 0 16 4 0 6 0 11 13 0 10 15 0 0 14 
