33 19
50 0 8 0 16 0 0 21 8 0 6 14 0 9 16 0 0 13 0 0 0 21 14 0 0 10 0 0 0 29 0 24 17 
31 39 33 19 0 0 2 20 1 4 0 0 10 6 28 0 0 6 7 6 0 0 20 14 4 1 11 20 0 10 29 34 8 
2 31 12 0 0 3 0 0 0 0 0 13 0 10 18 0 15 11 0 0 0 0 0 10 15 19 0 0 0 0 0 0 0 
0 27 43 0 6 19 30 0 0 0 0 8 0 2 0 15 12 0 0 8 4 0 0 0 14 0 0 21 33 14 2 0 30 
0 0 23 0 12 0 3 0 16 0 0 0 0 1 8 0 0 0 0 3 0 0 7 0 16 5 0 0 0 7 0 3 0 
30 0 26 0 9 29 0 0 6 1 0 0 0 9 2 0 0 0 6 2 0 8 0 9 2 0 0 0 24 0 28 26 0 
41 21 37 0 8 7 10 0 17 4 0 11 13 0 12 39 21 8 27 19 8 10 26 0 22 0 3 18 20 5 0 22 17 
26 0 18 14 7 5 7 7 11 3 0 14 16 6 12 4 13 9 0 18 10 11 12 0 8 5 56 3 4 4 12 9 6 
25 0 3 0 10 0 0 3 10 5 15 0 0 0 2 0 4 0 0 0 12 0 36 0 2 18 0 0 6 0 0 29 0 
0 0 0 5 6 5 12 0 8 0 12 0 8 12 0 2 1 6 0 0 0 0 0 0 0 20 3 0 0 23 0 0 0 
0 0 0 0 0 0 0 0 0 2 6 16 0 0 0 0 0 0 0 0 0 0 0 0 5 8 0 14 0 0 0 0 0 
17 8 1 5 0 0 0 13 5 7 6 0 0 1 11 2 0 17 0 0 5 0 7 0 0 11 0 0 12 0 0 0 4 
15 5 6 0 6 0 14 0 17 17 9 13 0 5 0 15 0 0 0 4 0 8 0 0 12 0 11 0 5 0 21 6 8 
0 16 0 0 10 36 4 0 26 9 0 13 3 0 0 24 0 13 12 0 6 4 5 19 21 2 0 10 0 5 10 26 0 
2 27 8 13 8 7 7 0 2 0 0 33 0 9 10 0 2 7 13 0 0 0 14 0 0 0 9 0 28 19 0 15 0 
0 0 10 0 0 2 22 11 6 0 5 12 0 0 0 0 5 2 18 1 12 0 0 1 0 9 0 21 0 13 20 0 0 
20 0 32 0 9 0 26 16 0 6 21 0 0 2 24 13 0 5 3 6 2 3 7 16 5 4 2 0 0 0 9 0 0 
11 1 14 0 0 0 4 0 10 20 28 0 10 16 0 10 0 0 6 0 9 0 10 16 6 13 2 0 0 4 0 6 17 
0 20 4 0 8 0 4 0 6 18 12 0 0 5 0 0 0 18 0 13 5 16 1 0 7 4 4 4 5 19 2 4 0 
