33 19
0 48 42 5 16 20 2 0 0 6 0 10 0 0 14 3 0 0 0 0 17 33 0 22 9 10 7 0 7 14 0 29 0 
5 0 7 14 29 5 0 0 0 0 17 0 9 18 0 24 0 26 0 0 0 0 6 20 0 0 0 20 7 17 3 9 29 
0 0 21 0 0 19 0 0 20 8 0 0 14 0 7 9 0 8 0 0 0 0 12 0 18 0 4 0 13 0 4 0 0 
0 23 4 14 2 0 14 0 0 4 0 0 4 4 0 0 4 14 0 10 26 0 0 10 25 0 0 0 0 0 11 0 1 
26 0 5 0 0 1 1 13 13 0 0 0 3 12 0 4 0 21 0 10 4 21 0 0 27 30 14 0 20 29 2 0 0 
9 0 7 0 19 7 16 0 0 5 16 0 0 12 0 0 0 0 0 0 0 0 16 20 3 0 26 0 15 0 0 0 11 
14 11 7 0 6 22 24 4 17 11 3 16 11 18 2 0 0 5 10 21 0 4 12 0 3 6 0 51 9 0 22 0 3 
0 2 17 9 12 0 0 1 3 0 0 0 3 0 0 0 12 14 5 11 0 19 6 0 2 0 47 0 2 11 0 41 0 
15 2 6 0 3 0 14 0 6 0 0 0 0 3 0 15 21 0 10 4 0 1 6 0 2 16 2 3 24 13 0 10 4 
18 0 22 0 23 9 4 13 26 0 1 8 8 0 13 5 6 2 18 0 42 24 6 0 1 4 0 2 3 9 21 0 1 
4 0 19 0 10 0 0 12 22 0 0 0 4 0 0 15 0 8 9 2 0 6 4 5 13 17 26 5 6 0 9 0 1 
0 20 0 8 16 0 26 0 6 0 0 11 9 7 0 0 0 12 0 16 23 11 18 1 0 0 2 5 11 7 2 1 20 
0 0 47 1 1 3 21 0 22 0 0 22 0 19 0 10 2 11 0 6 0 3 6 1 13 18 19 26 20 0 4 0 3 
23 27 0 10 23 27 0 0 13 11 0 8 0 1 4 7 0 0 6 10 7 18 0 5 0 21 0 9 15 16 0 15 29 
6 25 4 23 1 3 0 0 0 17 0 11 1 12 1 0 2 8 0 9 0 0 12 0 0 6 23 1 0 14 11 6 4 
13 22 2 0 5 0 0 0 12 0 5 0 8 0 2 20 2 0 0 1 4 0 6 22 5 0 7 1 0 0 0 0 0 
0 44 9 0 7 0 6 18 0 0 0 9 6 0 10 11 7 0 0 1 1 0 0 0 0 8 0 0 0 28 7 0 2 
0 0 1 0 28 3 0 0 0 12 0 15 1 0 0 0 0 0 0 0 0 6 0 0 2 0 10 12 6 0 6 0 20 
0 10 15 26 18 9 0 0 0 0 0 0 2 26 0 9 0 20 0 0 0 10 7 10 4 0 14 0 7 15 0 11 4 
