33 19
21 11 0 10 27 10 0 0 0 0 17 0 5 0 24 0 0 0 0 5 0 21 5 0 0 11 0 0 2 0 0 17 0 
4 44 13 24 12 1 24 22 0 0 1 0 13 2 6 13 0 9 11 0 17 8 23 0 0 0 4 0 0 6 0 36 31 
16 0 16 0 12 0 1 0 3 8 3 5 0 0 0 0 4 5 0 0 0 6 0 0 3 4 0 0 0 0 9 0 0 
9 6 9 0 13 13 7 9 0 9 0 0 10 6 0 0 20 0 13 0 16 5 0 1 0 0 0 0 0 9 0 4 0 
8 21 10 36 9 13 0 3 15 2 11 4 0 10 14 5 2 22 0 0 17 0 37 1 2 13 0 25 21 22 0 27 29 
0 0 22 0 3 5 0 8 3 8 13 12 0 0 5 8 1 11 9 7 6 8 11 13 12 1 0 0 0 0 0 0 0 
0 7 14 5 0 13 0 0 53 2 0 0 16 0 12 20 6 9 9 0 0 0 0 22 23 4 21 11 36 0 6 0 22 
0 0 2 0 2 7 0 0 0 3 0 0 0 23 6 0 0 0 0 0 0 0 0 0 0 0 0 0 0 0 0 4 19 
22 4 44 18 5 9 0 12 22 9 20 20 0 0 0 0 0 6 0 12 17 0 22 21 0 23 0 0 10 0 42 28 0 
0 1 16 13 0 5 0 0 11 3 7 0 16 10 0 0 9 14 16 0 19 40 9 10 15 0 0 0 12 0 0 3 4 
21 36 4 10 16 5 21 0 0 1 4 0 11 0 20 0 16 15 4 0 18 0 7 1 8 0 27 60 2 7 4 12 23 
0 5 3 0 22 3 6 0 4 5 0 7 11 0 0 0 4 0 0 3 0 7 0 0 23 0 0 10 7 33 0 0 0 
0 3 0 0 7 8 0 0 10 0 0 0 0 6 4 6 3 0 16 6 21 20 0 0 0 0 0 1 0 0 0 12 5 
3 9 0 2 27 3 25 11 4 0 0 8 0 29 0 0 0 37 11 9 12 18 3 4 10 2 16 10 24 0 4 27 0 
20 17 0 16 27 6 0 11 0 0 4 4 4 4 0 0 0 17 24 0 0 9 19 1 1 0 0 0 0 11 0 27 0 
0 0 0 23 10 37 13 0 0 17 17 8 0 0 4 0 0 12 0 11 0 0 0 0 0 14 6 21 0 0 0 0 0 
3 12 10 0 47 0 0 0 18 13 5 0 0 0 0 5 1 0 0 0 0 0 11 0 0 2 35 2 8 31 0 3 0 
0 9 0 0 12 14 8 0 19 17 21 19 6 3 14 9 16 0 5 8 16 17 7 3 7 0 5 16 19 1 35 21 18 
0 0 16 0 27 0 3 0 0 0 0 27 24 4 6 4 0 11 0 0 20 17 10 19 8 12 44 3 0 0 0 20 0 
