33 19
0 0 0 29 0 0 19 0 0 0 0 0 8 4 11 0 3 7 0 0 2 0 0 1 1 12 0 0 0 13 27 0 0 
17 0 0 0 0 33 0 0 8 0 0 0 0 0 12 0 0 0 0 3 0 28 10 0 0 11 21 0 0 0 10 0 15 
0 0 0 20 0 0 0 0 0 15 0 0 0 0 0 0 0 0 11 0 0 0 0 20 15 1 0 0 3 11 0 0 3 
0 0 12 16 6 21 2 0 12 0 6 0 0 19 16 11 0 1 5 9 0 0 3 0 0 7 32 0 4 0 7 3 21 
5 0 0 7 0 5 0 0 0 15 7 0 10 0 11 6 0 10 19 3 0 0 13 0 0 0 0 0 11 0 5 0 0 
4 0 0 0 0 0 5 5 0 0 4 0 19 1 8 0 0 11 3 0 14 0 0 0 1 0 0 0 3 0 0 18 6 
14 21 27 4 0 0 0 21 10 10 1 0 17 1 0 0 9 10 0 28 3 8 8 0 1 14 0 6 0 23 15 0 2 
8 0 0 12 0 8 21 25 2 6 7 0 3 0 2 6 9 22 0 0 0 0 2 20 0 0 0 0 0 0 23 25 2 
0 0 0 0 0 0 0 6 23 9 6 33 8 2 1 1 5 1 3 0 0 7 2 0 0 0 15 0 0 8 0 43 6 
0 28 6 0 0 17 0 0 5 14 17 37 21 0 0 0 0 5 0 0 7 0 24 23 0 0 20 17 0 3 18 0 6 
25 27 29 11 0 18 0 29 10 0 25 6 2 2 14 20 13 0 33 12 4 2 8 8 8 6 13 0 27 21 13 13 17 
0 0 0 15 1 22 1 12 25 16 0 19 7 2 6 0 0 0 3 29 9 18 16 5 2 1 0 37 6 9 17 3 26 
14 0 2 0 0 20 0 0 0 0 0 28 0 0 16 0 0 5 1 0 15 3 0 0 13 0 0 0 0 18 0 0 4 
18 4 0 16 26 18 0 8 0 9 0 0 0 10 12 6 0 0 27 0 10 18 6 1 14 12 3 0 0 0 10 2 0 
18 0 23 16 0 0 3 2 21 2 0 3 10 0 3 0 4 8 19 12 0 1 20 1 9 32 0 0 0 1 0 4 3 
2 14 26 2 3 9 0 6 12 7 18 0 1 9 23 7 5 0 8 0 3 8 13 0 0 18 23 9 23 0 6 3 16 
23 2 25 26 0 1 6 0 8 2 14 0 0 0 0 0 2 2 0 18 8 0 10 30 0 0 0 35 0 6 7 2 0 
24 0 24 0 13 8 23 2 0 23 0 0 1 21 0 3 0 8 0 13 16 2 1 4 3 0 24 0 0 7 0 0 16 
0 5 0 5 3 11 0 3 0 0 20 3 2 0 14 0 0 6 0 0 0 4 2 8 0 0 25 0 11 28 20 17 0 
