33 19
24 0 14 21 0 10 17 0 16 0 17 17 0 0 0 7 1 14 0 8 16 0 17 4 45 0 15 0 0 13 7 0 0 
30 15 2 0 13 0 22 0 21 2 0 13 6 0 0 0 0 10 0 0 0 0 11 0 0 17 0 4 10 4 0 4 0 
17 0 10 11 1 0 0 1 13 0 9 0 11 0 8 0 9 8 0 0 0 0 0 0 0 24 6 0 0 0 0 14 0 
0 0 1 23 8 10 1 3 9 0 8 0 5 0 10 18 0 0 3 0 11 18 0 2 0 0 0 3 2 0 7 4 15 
29 5 26 0 0 0 4 22 0 0 0 0 0 3 12 13 6 1 12 0 5 0 0 4 0 0 10 0 0 29 0 0 9 
2 0 51 1 34 0 0 3 3 0 0 13 10 3 0 16 0 5 0 0 0 0 0 0 4 0 11 0 39 27 0 43 7 
14 0 0 0 0 0 0 7 4 11 19 7 3 0 0 1 2 0 9 2 35 0 6 0 4 0 0 9 8 4 0 0 0 
1 21 0 33 0 6 0 6 3 18 0 12 8 5 0 12 9 0 4 0 1 0 13 0 0 16 35 12 15 0 4 15 0 
0 0 22 4 14 27 0 0 0 8 0 0 5 1 22 0 0 0 13 19 1 0 8 0 22 0 6 15 0 0 0 0 40 
4 0 4 0 14 0 0 0 0 0 0 0 0 17 4 0 14 11 1 0 6 0 0 0 0 0 5 0 16 0 31 0 4 
0 28 0 0 23 29 15 0 2 3 0 2 0 3 8 7 4 0 3 0 15 3 0 14 1 0 35 2 0 30 1 23 0 
2 0 12 20 3 12 0 14 12 6 22 0 19 0 0 0 1 15 13 17 12 2 0 7 0 0 0 1 0 0 2 0 29 
0 0 66 4 2 0 0 0 10 0 0 14 0 0 0 7 11 0 8 0 6 4 24 0 0 4 0 10 3 27 0 2 7 
25 29 0 18 0 12 12 16 7 36 11 8 0 4 6 6 14 18 0 2 4 13 0 18 29 0 13 9 18 0 18 5 27 
0 8 0 0 13 4 13 6 8 7 1 0 11 6 0 0 20 12 5 0 9 0 0 9 6 0 0 4 1 21 0 9 0 
13 0 0 12 5 0 13 0 4 6 20 8 0 2 0 14 0 2 0 3 6 0 0 0 0 1 19 0 15 9 20 0 0 
0 15 17 21 0 0 16 18 0 3 0 9 11 0 0 0 14 0 2 5 22 0 4 2 29 0 8 3 4 0 3 0 0 
0 0 1 10 26 0 37 0 4 0 17 22 6 0 6 4 0 3 0 0 6 0 1 0 1 14 17 0 7 0 4 0 0 
24 8 14 3 0 2 0 0 25 0 12 0 16 0 27 0 0 5 11 0 0 10 20 0 46 17 0 0 1 17 22 47 15 
