33 19
0 11 13 0 23 1 0 0 0 13 12 0 0 14 14 1 6 0 4 3 10 0 13 5 19 24 11 28 0 0 14 6 0 
9 16 28 3 1 1 9 0 0 11 0 0 11 0 0 0 0 0 0 14 3 0 0 2 0 0 0 0 0 0 11 1 13 
7 0 0 36 10 21 0 10 15 1 5 13 0 6 0 3 0 0 0 6 0 0 0 0 0 0 21 24 24 14 7 0 0 
0 26 0 15 10 0 0 17 7 17 0 6 3 0 0 0 0 7 0 4 23 0 19 5 7 16 12 0 17 4 0 0 10 
3 30 0 1 12 1 0 2 6 13 1 4 7 0 5 1 10 0 0 4 1 0 0 6 0 0 10 0 0 0 0 42 0 
0 0 23 1 0 1 0 4 12 0 0 0 0 0 0 13 0 0 1 0 0 0 0 3 0 23 0 0 0 0 2 8 0 
0 6 1 23 13 44 13 25 5 0 13 0 10 19 0 10 28 13 13 0 4 15 8 21 0 15 38 0 1 43 6 0 16 
4 8 0 8 23 18 0 1 0 10 5 0 4 0 4 17 0 8 14 16 4 0 0 2 0 2 0 23 37 4 29 21 9 
0 0 0 0 8 0 0 0 0 20 0 1 0 0 10 0 4 0 3 0 0 0 5 3 13 0 15 5 14 20 0 0 5 
7 19 0 25 1 2 26 23 5 0 3 0 2 0 5 5 6 21 0 15 22 4 19 8 0 0 0 5 0 0 20 1 11 
9 22 6 21 4 3 8 0 0 4 0 1 0 12 0 1 5 0 0 0 6 0 0 16 21 12 0 0 0 0 0 0 2 
0 36 7 0 22 0 1 16 2 10 0 0 15 7 0 0 0 0 0 7 20 0 0 0 12 6 47 0 0 0 0 0 3 
1 15 5 26 25 0 0 0 8 0 4 5 0 0 28 13 13 0 0 15 19 0 9 0 0 0 16 24 2 0 0 3 6 
33 0 14 0 1 0 12 0 0 0 0 2 0 0 0 0 0 8 12 0 1 0 3 23 0 14 0 0 0 0 13 31 0 
0 0 13 2 24 12 5 25 6 1 0 4 4 0 20 8 9 4 1 28 0 15 0 16 0 0 0 15 1 56 7 8 10 
27 0 0 8 0 25 0 0 0 14 0 11 13 1 3 0 6 8 0 8 0 0 0 11 0 0 14 25 2 2 21 0 1 
9 42 2 2 4 2 4 23 8 7 0 0 14 10 0 0 15 10 0 0 3 0 0 25 2 23 9 5 0 0 52 0 5 
23 10 0 9 3 0 0 6 46 0 0 18 0 6 4 0 0 0 0 0 28 0 0 23 0 5 18 0 0 0 0 13 0 
22 7 7 31 48 0 0 15 14 12 0 0 0 0 14 7 16 0 0 11 0 1 0 0 0 0 12 37 20 25 17 0 11 
