33 19
7 8 14 0 24 0 0 0 23 18 0 0 0 0 13 0 1 16 14 4 0 0 0 15 20 14 0 18 0 11 0 0 0 
0 0 0 0 0 15 0 18 5 0 0 0 17 0 2 6 0 14 0 0 0 0 14 12 17 8 14 14 0 0 0 0 0 
10 0 3 7 7 14 20 0 41 12 48 21 15 0 10 0 4 14 1 0 6 0 8 10 0 0 0 0 0 1 20 0 47 
9 10 1 0 24 0 0 19 0 0 0 2 1 0 2 14 0 0 8 8 17 6 11 0 0 16 14 2 10 28 18 0 33 
0 0 0 0 11 0 2 4 6 0 1 2 7 0 8 12 0 2 13 11 0 10 0 4 0 0 0 2 0 12 7 10 1 
10 0 3 11 5 0 12 0 0 3 13 9 0 3 3 5 0 0 0 0 10 0 7 0 0 0 10 3 0 0 0 11 0 
22 3 0 18 20 0 0 12 19 0 0 2 5 11 4 12 2 6 0 19 7 45 5 0 26 0 0 28 0 2 0 0 11 
7 0 7 0 7 0 8 28 1 0 0 6 17 13 7 6 0 15 0 2 7 10 24 0 0 14 0 10 0 0 0 7 0 
0 6 4 23 6 0 4 0 4 0 0 1 0 16 3 9 0 0 7 0 0 0 0 0 9 5 0 4 0 48 0 0 7 
6 0 3 42 30 0 0 0 0 5 7 0 2 0 0 0 17 0 0 0 0 4 18 20 1 0 5 0 0 7 0 0 10 
5 0 40 25 5 7 8 9 0 0 28 8 5 2 0 13 7 13 0 17 7 1 11 0 16 0 0 0 0 0 33 0 3 
0 0 34 0 0 18 3 6 21 25 1 2 22 6 0 12 4 6 7 0 0 0 0 29 0 0 0 20 18 9 8 29 0 
2 12 3 4 0 0 0 13 14 0 11 3 13 2 11 0 9 16 10 8 3 4 10 0 7 17 0 0 0 4 0 7 0 
0 0 0 9 0 0 4 0 37 0 42 8 0 0 0 0 13 0 11 0 31 0 0 0 6 12 0 7 38 15 26 0 3 
0 17 20 43 0 22 9 0 12 26 0 11 0 1 1 16 0 8 16 1 0 0 0 0 15 0 0 35 11 27 15 44 0 
0 0 1 3 11 0 18 19 0 0 3 0 8 0 15 11 0 14 7 19 2 0 5 0 16 0 11 8 2 4 0 11 13 
0 0 6 26 31 0 0 0 14 11 0 6 25 0 14 0 0 12 0 0 14 0 9 16 0 0 15 0 12 16 0 0 20 
0 0 13 12 0 1 11 10 2 0 0 0 0 6 0 3 7 0 29 9 0 1 4 20 0 0 0 13 17 0 0 0 0 
6 31 0 26 28 0 8 0 0 0 8 5 17 0 0 0 12 0 18 0 17 12 8 0 33 0 0 0 0 0 0 13 51 
