33 19
0 8 37 19 0 1 13 0 0 32 1 18 0 0 0 0 0 13 12 25 10 18 15 14 2 11 2 0 9 27 3 0 2 
0 5 24 0 1 7 0 0 10 0 31 25 12 8 0 0 0 0 0 0 0 10 0 5 14 28 0 1 0 0 16 10 30 
0 12 0 0 0 0 14 0 7 0 0 1 1 0 0 0 0 0 0 0 7 0 14 0 0 10 0 8 0 13 0 0 0 
35 0 12 6 0 5 0 0 0 0 5 4 0 10 14 4 0 0 0 18 0 19 5 0 3 3 0 0 0 0 0 0 0 
0 3 14 12 23 2 9 19 0 20 12 0 0 0 19 10 14 4 9 0 4 0 12 1 6 24 35 23 13 27 4 8 0 
9 4 6 4 0 0 0 0 0 13 6 0 0 0 17 0 0 6 0 0 0 0 0 0 0 11 0 0 0 15 3 1 18 
0 39 20 0 12 2 0 16 0 0 16 28 16 0 2 0 2 5 0 0 3 19 11 4 7 1 18 16 3 28 0 0 0 
0 17 6 5 0 0 0 25 6 0 0 0 1 0 6 0 0 13 0 4 0 0 21 0 3 0 0 20 4 0 14 0 0 
32 0 0 18 36 7 0 7 0 0 0 8 1 8 1 0 0 9 11 2 0 24 0 0 0 0 10 0 24 5 1 0 24 
9 0 19 8 0 20 0 22 20 4 0 0 8 0 11 3 0 0 17 0 4 18 15 1 4 14 21 0 17 0 0 13 0 
0 0 0 0 2 1 2 5 9 0 0 9 4 0 9 3 0 0 1 8 9 6 9 10 1 0 0 0 19 14 19 12 5 
9 0 18 1 3 0 21 5 0 8 6 0 6 4 0 0 0 5 4 12 0 0 22 0 0 4 14 26 0 15 0 22 0 
0 1 20 5 35 0 8 16 3 3 1 10 20 3 16 0 7 11 0 57 0 17 18 12 3 10 3 0 17 17 7 24 0 
17 4 0 0 0 11 0 3 0 9 10 10 0 0 5 25 11 0 9 5 0 8 7 0 3 0 0 0 0 4 8 0 17 
0 7 2 7 0 0 0 16 2 0 7 3 3 11 0 13 0 14 6 0 0 0 0 16 9 10 0 0 0 9 0 9 0 
34 0 12 5 7 10 0 4 18 0 22 14 0 14 0 0 0 7 0 5 0 0 7 0 17 0 15 0 9 11 0 8 5 
5 45 0 1 5 0 14 22 23 1 0 15 0 2 8 16 0 2 16 0 2 0 32 0 0 11 27 25 0 0 17 0 22 
14 0 19 0 7 10 0 0 4 0 2 4 0 15 8 10 15 4 0 0 4 6 1 0 0 1 1 6 14 1 16 0 1 
9 16 25 0 0 18 0 0 28 0 0 0 0 0 5 5 0 0 0 11 0 0 9 7 0 14 11 33 8 6 0 0 13 
