33 19
19 9 13 20 13 0 0 7 15 10 0 0 0 20 5 1 18 21 3 16 0 4 6 26 8 12 12 1 11 4 5 13 14 
31 0 27 13 22 2 0 16 0 0 0 15 0 0 0 0 1 0 4 0 0 4 8 2 14 0 22 3 0 29 3 33 2 
9 0 0 0 4 5 0 0 10 0 0 0 4 12 2 3 1 0 14 0 0 0 0 15 0 0 0 2 0 11 0 0 0 
0 0 12 0 19 0 0 0 0 0 19 8 0 0 0 15 2 3 14 0 14 11 0 32 6 0 0 0 12 0 0 3 0 
30 2 16 57 26 16 17 2 16 0 5 19 14 13 26 6 14 3 20 1 1 4 19 24 4 22 8 1 5 3 78 3 34 
32 0 0 0 16 22 0 0 0 0 17 16 0 0 0 0 5 8 0 0 22 17 0 8 0 0 5 5 0 7 0 0 62 
20 7 9 0 13 18 4 17 12 0 2 9 0 47 12 0 0 21 0 2 20 5 1 41 27 0 1 0 0 0 0 1 40 
0 0 1 1 26 4 4 2 12 2 0 0 0 17 0 0 14 0 0 0 9 0 0 0 22 7 8 0 0 0 43 0 0 
44 3 0 1 3 8 0 0 0 0 0 10 0 5 14 6 2 0 14 13 0 0 0 0 0 11 0 0 9 0 4 31 27 
0 12 0 18 3 0 10 0 0 0 0 0 4 5 9 4 8 3 6 12 7 10 0 0 0 0 0 11 3 0 0 12 0 
0 29 0 14 4 0 18 0 4 13 3 0 0 29 21 0 1 14 13 0 14 0 0 0 10 0 8 9 0 15 46 1 5 
0 0 3 0 0 0 0 0 5 14 0 2 0 0 1 0 0 0 0 13 11 11 0 7 0 11 0 0 2 2 0 2 13 
0 0 29 0 19 0 4 0 0 19 15 1 0 6 18 5 0 0 0 11 1 0 0 14 4 0 4 0 14 19 15 29 0 
23 2 13 25 3 17 6 1 29 0 9 0 5 0 18 23 0 19 2 0 16 0 4 3 0 0 40 12 13 3 27 10 0 
13 27 3 0 0 0 0 12 8 0 0 11 0 8 8 10 0 1 0 8 0 0 0 15 1 0 0 0 0 37 4 0 9 
18 43 12 0 13 3 0 0 15 5 0 7 0 0 0 9 0 13 23 1 3 20 0 7 15 0 0 0 12 10 10 0 0 
3 0 0 27 0 14 1 0 22 0 7 1 0 6 0 2 0 12 0 0 17 0 0 20 26 23 0 0 0 0 0 6 0 
26 0 0 0 0 0 1 34 0 0 0 21 0 8 0 0 0 0 0 0 4 20 0 8 1 5 0 0 9 22 0 0 21 
0 0 11 14 0 3 24 12 18 8 0 2 0 31 9 27 0 27 0 7 0 17 0 14 20 2 26 0 15 0 25 14 0 
