33 19
25 0 10 31 0 5 0 0 11 9 18 8 8 2 0 0 9 25 0 16 8 3 10 8 0 14 0 0 28 0 0 0 10 
5 11 2 0 26 22 13 2 0 12 11 0 10 3 12 0 0 2 12 12 0 41 5 0 3 0 25 20 0 8 34 8 6 
0 9 0 0 0 0 0 10 0 8 0 0 17 0 0 0 16 2 0 27 8 9 0 0 0 0 0 5 8 17 4 14 16 
0 0 18 0 22 19 15 0 5 21 0 0 10 4 0 15 14 0 0 0 23 16 6 0 0 11 1 2 0 22 5 0 0 
0 0 34 0 0 0 0 0 0 10 22 1 23 12 5 11 1 7 4 8 9 0 19 11 0 13 6 14 0 0 0 4 22 
4 26 0 0 0 24 4 14 2 0 1 1 13 16 5 0 13 3 0 5 7 15 0 0 0 5 0 23 0 3 0 0 0 
5 22 0 16 22 0 15 0 0 3 0 9 0 0 6 1 1 0 0 9 0 0 3 10 0 1 29 21 0 0 0 0 21 
0 21 10 0 2 6 0 0 0 18 8 0 0 3 4 0 10 0 4 0 2 6 27 0 0 4 0 34 0 0 0 0 0 
0 0 32 0 0 7 0 0 10 6 2 11 8 0 0 0 3 0 0 0 0 4 11 0 0 4 14 6 0 27 3 0 0 
4 12 5 0 6 5 0 2 9 12 6 6 0 0 0 0 9 14 6 0 17 20 0 6 0 0 0 0 24 11 0 12 0 
2 0 5 0 0 1 0 5 0 0 2 0 7 0 12 13 2 1 14 0 18 0 4 0 0 0 6 0 0 11 0 1 14 
0 9 0 1 0 1 29 23 0 0 6 0 13 10 16 0 0 5 0 1 9 9 32 0 1 10 6 3 0 0 72 0 0 
39 28 2 1 13 9 6 0 0 0 13 0 4 16 10 4 7 0 18 6 0 3 17 13 1 0 5 14 0 47 0 0 0 
0 0 4 0 0 25 0 4 0 2 0 5 1 1 0 1 5 9 13 6 1 0 7 0 0 0 9 13 0 2 0 0 0 
0 0 8 0 23 9 1 49 2 0 2 0 6 2 0 2 10 10 16 2 2 0 0 0 0 0 0 23 0 1 0 3 21 
0 0 5 0 0 10 16 0 7 26 6 5 10 2 0 13 26 2 7 18 1 2 45 2 0 15 2 5 15 8 8 0 16 
0 0 1 9 9 12 1 0 3 9 15 0 9 9 0 0 0 16 15 27 0 15 0 0 0 0 15 0 0 7 0 26 3 
0 16 17 0 0 16 6 0 0 0 2 0 0 17 0 0 32 31 7 16 4 11 14 0 10 7 9 10 0 0 8 3 7 
0 0 14 0 0 0 2 0 19 0 0 0 1 0 0 0 11 4 0 11 0 4 5 0 0 0 0 0 12 0 0 0 0 
