33 19
0 13 0 0 11 7 0 16 9 30 9 0 0 8 0 0 0 13 14 3 0 16 18 12 0 0 17 0 19 0 18 0 9 
0 17 1 0 0 0 0 20 21 0 0 0 15 0 0 0 0 0 2 19 0 14 3 0 0 0 0 15 0 8 0 0 0 
0 0 16 0 15 20 0 10 21 0 0 9 8 0 0 0 0 0 0 41 24 0 0 16 0 0 21 0 0 21 7 26 0 
1 37 9 51 4 0 0 11 0 0 7 6 0 18 0 0 0 2 6 2 0 0 0 0 0 24 0 7 25 26 19 0 4 
0 0 0 0 1 22 0 31 0 0 0 0 0 8 16 8 16 0 2 0 0 0 6 2 8 0 0 25 0 8 36 0 5 
0 0 0 0 1 0 7 0 0 18 0 15 11 7 8 0 4 13 4 0 0 0 1 0 0 4 40 41 0 0 0 0 9 
13 18 21 8 25 17 0 0 0 6 7 3 5 10 16 29 0 7 2 12 0 0 25 19 24 1 0 0 0 28 16 10 3 
25 0 30 49 0 27 0 10 0 0 0 11 5 13 0 4 7 0 0 0 0 11 8 0 0 16 2 0 0 7 27 0 24 
7 0 28 18 5 0 0 0 0 8 0 0 12 7 7 0 0 9 7 0 0 11 3 7 11 18 6 15 5 0 28 6 0 
0 0 7 20 11 0 0 9 14 4 0 7 12 26 5 7 1 10 16 15 1 0 13 12 19 4 0 0 4 1 14 0 10 
5 36 0 6 28 3 5 0 0 5 8 23 14 3 0 27 0 4 17 0 1 0 0 0 0 6 13 0 18 18 0 0 10 
9 8 28 1 12 20 1 0 3 17 0 1 11 13 0 1 26 11 0 2 12 3 7 14 0 13 24 8 10 3 13 0 12 
7 12 38 0 3 20 0 23 1 0 9 14 0 6 14 1 8 6 14 2 0 0 0 5 0 1 0 0 3 4 15 26 32 
3 0 1 0 1 0 7 0 4 2 0 1 0 10 0 1 0 0 0 0 0 2 0 0 0 0 0 0 0 0 0 0 0 
0 0 0 0 25 0 11 0 0 5 0 2 0 3 8 1 7 7 0 0 0 0 0 0 0 19 0 0 19 41 0 0 13 
2 0 0 20 0 15 1 3 0 0 20 2 0 19 26 0 0 0 0 11 10 0 0 0 0 0 0 3 3 0 7 17 31 
0 29 6 3 19 3 1 24 0 0 0 9 11 7 8 2 0 2 6 0 0 2 0 9 6 6 0 13 7 40 8 35 0 
7 0 18 0 0 10 0 0 0 0 4 11 0 18 0 0 18 10 1 13 27 0 3 0 0 10 13 18 0 13 0 4 0 
0 0 9 3 30 0 8 0 0 21 8 0 0 0 12 0 14 9 0 0 0 4 18 0 0 2 0 0 3 25 11 0 0 
