33 19
13 18 0 0 0 0 16 2 4 0 0 16 0 19 16 0 11 0 0 17 13 0 9 0 0 2 0 5 4 0 34 33 4 
0 19 23 0 0 14 8 0 10 12 0 0 0 12 0 0 14 0 0 0 13 13 0 8 0 0 20 0 0 0 60 37 26 
24 0 0 0 0 10 13 2 0 0 9 13 0 7 9 11 8 0 12 18 0 0 0 0 0 10 5 0 0 0 2 5 0 
5 2 0 0 8 0 0 0 0 0 0 0 1 0 9 0 0 0 0 0 0 3 0 9 3 0 0 4 2 0 3 0 8 
15 17 28 14 0 11 6 5 1 9 0 0 0 37 0 0 6 0 0 12 1 0 5 0 0 0 0 0 4 13 13 2 0 
44 10 0 26 25 0 3 14 0 7 1 0 12 0 5 2 2 32 3 2 0 31 7 13 9 25 3 3 3 1 13 0 15 
0 5 0 0 22 4 0 4 0 0 0 4 3 0 0 6 0 0 0 8 5 0 0 0 0 0 1 0 0 10 3 0 0 
13 6 0 0 0 79 0 0 6 8 26 0 0 3 5 5 8 8 13 7 11 9 0 13 5 0 28 7 0 2 6 19 27 
4 5 5 0 0 31 11 8 0 0 10 0 0 0 16 10 0 3 0 0 8 3 0 0 9 2 6 9 0 0 7 8 0 
0 2 32 0 0 0 0 10 0 0 0 1 1 2 0 0 0 0 0 5 0 0 5 0 17 0 0 0 26 0 0 0 0 
0 0 0 7 0 0 0 0 0 0 3 0 0 1 0 0 13 3 0 0 9 11 1 0 0 2 0 0 8 3 9 0 8 
0 3 0 1 7 0 1 3 0 3 5 0 4 1 16 0 18 7 0 0 0 0 0 0 3 9 6 3 0 28 16 30 11 
7 0 2 8 2 21 0 19 0 13 0 23 2 0 11 0 0 8 0 0 0 0 13 2 0 18 19 0 6 0 0 4 21 
0 9 33 0 0 1 0 0 0 8 9 10 0 20 0 1 0 7 11 9 0 17 8 0 0 0 0 25 3 0 19 0 5 
17 7 0 3 27 0 27 17 37 25 9 0 10 25 2 5 0 15 0 12 18 12 14 0 13 3 0 4 44 21 4 27 12 
0 5 28 11 2 5 8 1 9 13 2 21 3 0 15 0 5 9 19 3 6 0 2 10 22 7 0 21 3 1 32 0 0 
9 6 0 12 0 9 6 1 16 6 3 16 4 9 18 32 2 0 5 13 6 26 0 13 18 1 28 6 2 3 0 24 23 
0 13 19 33 24 10 8 0 0 27 0 3 14 0 0 11 0 11 9 0 36 35 0 28 26 3 4 4 13 13 8 8 8 
4 24 0 14 0 3 0 6 3 0 0 0 0 5 0 0 3 7 0 0 10 8 4 0 0 0 12 10 13 13 3 0 0 
