33 19
30 0 26 0 0 0 0 3 0 23 2 15 0 0 5 8 0 0 12 3 10 0 0 0 12 0 0 0 26 12 48 0 14 
11 0 12 21 0 0 18 3 16 16 0 15 0 17 3 0 0 0 0 6 0 13 0 0 47 6 15 3 2 0 2 0 1 
17 3 0 0 33 0 0 0 0 10 12 0 12 0 2 6 0 0 0 18 4 0 0 5 16 0 26 0 32 2 0 9 14 
0 27 12 0 33 17 11 25 0 13 6 4 9 0 8 5 1 10 10 2 18 0 16 18 10 6 3 0 6 2 0 27 0 
0 0 0 4 1 1 0 34 21 1 23 21 1 13 11 0 0 12 0 0 0 0 15 1 11 0 14 3 17 6 0 21 12 
1 25 26 6 0 11 0 0 6 6 12 16 7 4 10 0 9 7 2 24 22 11 11 4 10 0 6 0 26 1 13 0 11 
0 18 9 0 21 2 0 0 20 0 9 0 9 10 0 0 4 0 8 18 0 0 0 0 0 34 0 0 20 3 11 5 6 
7 0 0 0 0 0 0 0 0 7 0 0 12 0 0 0 2 11 2 5 9 0 0 0 5 17 3 2 1 1 0 0 5 
0 7 8 0 0 13 0 3 0 9 8 15 0 0 9 4 0 0 0 5 3 14 0 2 0 9 19 8 7 1 9 6 0 
0 4 8 0 3 25 0 27 15 0 16 4 10 11 0 0 0 0 0 0 13 0 18 18 7 24 0 0 4 1 44 0 0 
30 19 5 32 10 3 18 7 16 10 17 18 0 9 10 0 0 14 5 5 25 18 7 20 3 0 16 19 37 7 29 0 5 
0 17 0 0 0 8 0 13 0 0 8 11 0 7 0 0 0 0 19 3 4 2 8 18 0 0 0 7 0 0 0 31 0 
16 0 0 12 6 0 21 0 0 16 21 0 7 9 0 27 0 0 0 7 5 5 3 21 0 4 9 45 18 0 0 0 5 
0 0 16 0 10 7 0 0 3 0 14 0 0 9 0 0 4 0 4 0 10 0 0 23 0 20 18 4 0 21 0 15 27 
9 12 11 0 0 0 20 0 13 24 0 2 0 11 11 0 0 9 0 0 0 25 0 0 0 11 11 3 0 0 11 0 2 
0 0 28 0 9 0 0 0 11 1 45 9 0 9 11 0 0 0 16 11 20 0 3 0 10 6 0 21 0 0 48 3 0 
0 0 7 7 0 0 0 12 6 0 7 0 17 31 13 0 0 0 8 0 5 10 0 0 0 10 20 8 0 19 0 2 12 
0 29 27 0 0 3 0 0 3 23 0 0 0 16 7 0 0 0 0 9 11 9 7 5 0 0 5 0 25 9 18 10 0 
0 10 20 14 3 10 10 4 19 7 0 0 8 1 14 10 17 4 0 3 8 6 21 6 0 2 14 16 0 15 0 3 0 
