21 12
15 0 2 4 2 0 9 0 5 0 0 0 4 0 3 1 16 8 6 0 0 
1 0 0 0 0 11 7 0 9 0 0 0 3 1 7 4 21 0 0 0 0 
18 2 0 0 0 13 0 3 10 0 1 8 0 0 0 0 0 0 9 0 20 
15 13 2 0 2 7 3 0 11 10 0 0 0 6 14 2 0 0 2 10 2 
2 43 0 9 0 12 0 0 3 0 0 10 8 4 0 20 0 1 0 0 39 
3 2 0 3 0 12 10 0 5 0 0 0 0 0 0 5 10 12 0 0 0 
4 0 2 7 0 3 8 0 0 0 12 0 12 0 0 0 20 1 7 0 4 
5 14 5 14 0 4 4 4 6 9 10 0 7 0 6 0 0 15 0 0 0 
0 18 2 9 13 4 3 0 0 0 10 0 4 6 0 2 4 12 23 0 10 
0 0 16 9 14 5 2 5 2 0 6 0 5 5 0 0 6 0 32 6 2 
16 18 18 0 0 1 1 0 9 9 4 8 0 3 0 8 0 0 0 18 18 
9 2 1 8 3 6 4 17 0 0 6 0 0 0 13 0 15 12 11 0 19 
