21 12
11 3 0 0 4 0 11 3 0 0 4 8 0 7 3 0 0 4 10 0 4 
0 29 8 3 9 1 9 1 3 10 27 14 5 0 1 4 6 3 4 5 19 
0 0 0 0 0 0 2 0 0 0 0 0 0 2 0 7 0 4 0 4 0 
13 10 0 7 1 3 5 0 1 0 9 7 2 8 0 0 0 1 6 0 10 
10 12 0 1 4 6 1 9 2 1 4 2 1 16 1 0 3 0 8 0 10 
0 0 0 2 5 0 6 1 0 0 0 6 1 0 0 0 0 3 0 0 0 
0 0 18 9 13 15 5 1 3 0 1 4 17 0 4 4 0 19 0 6 33 
0 0 0 17 0 0 4 0 0 0 0 5 6 0 0 12 0 0 0 1 0 
0 0 0 0 0 2 0 9 10 0 2 5 0 0 0 0 5 0 11 0 4 
0 10 0 0 0 0 0 8 0 7 0 18 0 1 0 15 7 0 0 8 0 
0 7 7 6 2 4 0 9 0 19 0 1 0 0 0 0 0 8 10 2 22 
0 6 8 4 1 2 0 3 0 10 36 4 0 9 0 16 3 0 8 4 0 
