21 12
51 0 18 4 6 0 0 0 6 5 13 0 8 13 5 0 0 0 0 0 2 
15 8 0 0 10 1 2 8 5 0 3 0 5 0 0 12 5 0 0 7 8 
9 14 1 9 4 1 5 13 6 0 0 0 4 0 0 0 2 1 1 0 13 
0 0 1 9 0 0 0 0 8 7 6 0 3 5 2 0 3 0 2 0 0 
3 15 0 16 2 3 1 11 6 0 0 1 5 7 6 3 3 16 18 35 20 
5 6 11 3 3 8 3 0 7 1 15 0 0 13 13 0 12 7 0 2 0 
0 10 7 9 3 0 7 1 20 7 7 1 10 4 6 4 8 21 4 9 0 
0 5 17 1 9 5 0 0 0 0 0 1 0 0 4 10 12 0 4 17 0 
0 0 0 8 9 0 14 4 3 0 0 5 0 5 0 0 0 0 12 1 0 
0 13 0 0 0 0 0 0 0 0 0 0 0 0 0 0 7 2 0 4 8 
18 0 10 0 0 0 0 0 0 0 3 0 10 3 0 0 0 0 22 0 0 
12 2 2 11 1 0 9 0 8 0 0 0 8 6 7 11 2 12 0 0 0 
