21 12
0 0 0 0 0 1 0 7 3 0 0 6 5 3 0 0 4 0 0 0 0 
2 2 23 0 0 0 9 6 8 0 3 0 0 0 1 17 8 0 0 0 5 
0 4 9 6 0 27 0 10 0 0 5 15 10 0 7 2 1 3 13 14 4 
19 6 0 0 7 10 3 6 3 2 0 5 6 0 0 1 0 17 3 2 0 
3 0 0 7 0 7 1 3 4 0 4 6 0 1 0 0 0 3 0 1 10 
5 0 6 0 5 5 0 2 0 5 4 0 4 12 4 3 0 0 0 0 0 
0 17 9 0 0 0 10 6 11 0 0 21 0 0 3 0 8 9 2 3 32 
17 0 0 0 12 6 10 11 1 0 8 0 13 0 11 2 5 1 2 0 15 
33 0 6 6 0 5 0 0 17 0 1 0 0 0 12 2 2 9 0 19 0 
0 5 0 13 0 22 18 3 0 20 0 0 3 0 0 0 16 2 20 10 11 
6 0 14 0 0 0 6 1 0 0 6 9 7 0 0 0 2 0 0 0 6 
0 0 10 0 11 11 0 2 12 0 0 6 9 11 6 21 1 15 0 0 6 
