21 12
20 0 0 0 3 12 1 9 11 7 0 0 0 2 5 0 6 1 0 8 31 
19 4 19 0 10 7 0 0 14 0 9 7 1 4 9 0 16 9 0 17 0 
11 0 0 0 8 0 6 2 0 0 0 0 5 0 0 0 5 17 0 0 2 
0 7 0 11 3 4 0 7 1 5 1 6 3 5 7 0 1 0 5 0 0 
3 17 1 15 2 0 7 10 7 0 0 0 0 1 1 7 6 1 15 0 5 
0 3 1 0 14 6 0 19 1 0 0 5 3 0 9 8 5 0 7 3 0 
27 0 0 1 6 0 0 0 8 0 0 5 12 2 3 15 3 0 0 0 0 
0 6 0 1 0 17 3 6 0 7 0 5 8 0 11 3 7 11 15 0 0 
0 0 7 0 0 0 14 8 0 0 0 1 3 3 5 0 6 8 0 3 13 
9 0 0 6 13 6 4 0 0 7 1 6 0 0 2 5 2 12 11 9 6 
0 0 16 10 18 1 9 3 6 0 12 0 0 4 18 2 16 4 30 5 0 
11 6 0 0 11 17 0 6 11 11 0 15 0 0 0 3 3 8 0 0 15 
