21 12
7 32 13 32 1 3 13 10 0 4 2 0 11 13 5 22 10 13 3 14 9 
0 15 0 0 0 17 0 0 0 0 5 0 0 8 1 4 14 11 0 0 4 
4 1 20 3 22 2 16 4 4 10 2 1 12 1 10 37 17 4 0 13 21 
0 1 0 0 5 0 0 1 4 15 0 3 0 1 3 0 3 4 3 10 1 
16 0 0 17 1 5 2 1 0 4 6 0 0 0 2 15 8 0 0 16 3 
1 10 10 28 8 15 2 10 7 0 0 0 29 0 11 3 3 3 13 1 13 
0 0 0 0 0 0 2 13 9 0 0 0 0 0 3 0 7 10 0 0 13 
0 14 0 1 11 0 2 4 0 0 0 4 3 4 0 4 0 0 0 1 2 
0 0 6 8 0 0 0 0 0 0 6 0 0 7 0 6 6 0 0 1 1 
22 0 0 14 0 0 0 10 5 5 0 1 0 13 12 0 9 7 7 9 17 
10 1 0 23 8 2 0 3 8 0 0 0 0 0 0 27 8 0 0 0 0 
0 3 0 13 3 0 0 0 0 0 10 5 0 0 0 0 8 0 0 0 0 
