21 12
18 0 0 33 0 13 6 2 0 15 0 3 7 5 0 4 13 14 31 6 2 
17 0 2 0 8 0 0 0 16 9 2 9 0 0 24 3 5 4 4 4 0 
32 4 5 3 0 6 8 4 8 0 0 6 13 0 8 0 0 0 19 1 8 
6 0 12 17 0 3 0 0 6 0 0 3 0 2 3 0 8 0 0 0 10 
18 1 2 0 1 3 2 4 8 0 3 3 0 0 0 0 0 0 8 0 1 
0 5 0 3 11 0 0 5 2 0 2 9 2 2 0 2 16 1 4 0 8 
0 14 0 2 0 15 5 16 0 8 0 1 6 2 9 20 5 24 0 4 0 
6 2 0 3 0 6 14 0 10 0 0 10 19 0 0 0 14 1 0 0 0 
6 1 10 0 0 0 0 0 7 0 0 9 0 0 0 7 0 0 0 0 0 
9 2 0 4 2 0 3 4 3 0 7 5 0 0 0 0 0 0 0 0 0 
16 1 6 14 2 3 0 3 14 0 0 3 0 0 6 4 16 14 0 0 14 
10 1 0 3 16 5 0 9 0 11 9 0 0 11 0 0 0 2 0 7 17 
