21 12
0 11 0 0 13 0 9 6 11 7 1 4 0 7 0 0 7 15 17 11 7 
0 0 3 0 0 0 4 0 0 0 5 9 10 11 2 0 3 7 6 0 1 
0 13 19 13 0 7 0 8 12 8 0 6 16 5 2 6 39 34 6 0 7 
9 1 16 0 8 17 1 3 3 9 6 0 6 2 4 11 22 0 0 6 0 
0 1 3 0 0 0 0 0 0 0 0 2 4 2 6 0 0 1 0 0 6 
0 3 10 3 0 11 0 0 0 6 1 0 3 3 3 0 8 2 5 0 4 
18 0 0 0 0 5 6 0 3 7 6 0 3 0 0 15 7 11 0 0 0 
3 0 8 0 0 0 4 5 0 0 10 0 0 8 4 0 2 0 6 0 0 
7 11 0 2 0 0 0 20 0 0 2 0 11 12 3 0 0 6 0 0 14 
29 0 0 0 7 2 2 9 0 4 5 16 5 2 5 0 7 19 7 0 20 
23 2 0 10 7 0 0 12 0 0 12 2 0 10 7 0 0 0 5 12 0 
0 0 9 0 0 1 1 1 0 9 14 0 2 0 14 0 9 11 13 9 0 
