21 12
0 7 15 0 7 0 12 0 3 18 9 3 0 0 8 5 0 17 1 8 0 
11 7 17 0 0 0 1 0 8 0 0 0 6 12 0 1 4 0 7 29 19 
14 4 1 4 0 7 0 2 8 6 0 3 0 0 15 8 0 3 9 0 0 
16 7 0 0 0 0 1 0 11 0 0 0 0 2 0 0 17 0 5 0 0 
9 10 16 7 0 16 7 0 9 2 0 13 2 0 7 3 12 7 17 0 0 
1 0 6 3 0 5 3 10 0 0 4 11 4 0 0 2 6 27 0 0 0 
18 0 0 0 0 0 3 0 0 0 1 2 2 3 0 3 0 17 0 0 0 
13 0 1 4 0 10 2 11 6 1 7 1 12 0 4 5 0 0 26 0 1 
2 0 5 0 0 0 0 8 5 0 0 6 5 0 0 0 9 8 0 0 1 
10 10 0 2 12 5 3 3 12 9 3 18 1 0 0 3 0 0 18 0 16 
9 0 8 0 12 0 0 1 14 25 8 0 0 0 0 6 0 9 0 0 16 
0 0 6 22 11 0 14 2 4 2 1 1 4 0 3 9 6 16 0 5 0 
