21 12
14 12 10 8 20 0 0 10 0 0 0 9 12 12 10 5 0 2 2 0 4 
0 0 15 1 10 12 0 5 10 7 0 0 5 7 1 6 2 18 2 9 3 
33 18 6 7 13 0 0 1 6 9 6 2 0 0 13 4 12 12 2 25 5 
0 13 0 0 0 0 0 0 7 1 0 0 0 0 18 0 0 1 0 1 1 
0 3 5 0 2 0 0 5 0 2 10 0 0 0 0 0 0 6 7 0 2 
0 0 6 15 0 5 12 0 4 0 20 0 0 0 0 3 0 3 22 1 2 
0 1 0 9 0 5 8 0 0 0 5 0 3 0 7 1 0 0 0 18 19 
0 13 2 0 5 0 0 7 0 3 5 0 0 0 4 0 0 0 0 0 19 
0 11 0 14 3 0 2 0 10 6 0 9 0 14 5 7 0 0 2 6 13 
22 0 0 11 0 0 12 16 9 9 0 3 0 1 2 15 1 7 27 0 0 
0 18 0 13 11 15 0 0 1 2 8 0 0 1 6 11 13 0 7 27 15 
7 8 9 0 12 0 8 0 6 8 10 0 0 3 13 0 0 17 4 5 13 
