21 12
0 4 3 16 13 7 10 0 10 0 0 7 9 0 6 5 2 11 0 0 9 
16 9 0 14 4 0 22 0 16 9 10 1 6 0 0 5 0 11 11 5 24 
2 0 2 0 0 0 5 9 0 1 0 0 5 0 0 4 2 0 0 0 1 
5 0 0 0 1 20 0 0 0 1 0 0 0 0 0 1 1 0 5 14 0 
20 0 17 1 0 0 5 0 0 1 0 0 0 0 0 0 0 17 0 0 18 
4 6 17 11 13 5 2 11 0 2 5 1 0 0 0 1 0 17 0 12 7 
20 10 3 1 0 5 4 13 0 0 0 25 3 0 0 12 9 6 6 5 11 
1 0 15 7 0 0 5 4 7 4 17 4 0 0 0 3 0 28 0 0 25 
0 13 0 2 0 6 0 3 0 6 4 14 1 3 0 3 18 3 4 0 3 
9 1 0 10 0 5 8 7 10 0 0 0 0 10 0 2 0 0 22 8 0 
13 0 0 0 9 5 12 5 0 0 6 5 7 6 0 0 1 7 0 22 10 
33 0 3 0 1 2 10 9 0 5 0 11 7 0 0 12 8 0 0 22 0 
