21 12
0 27 7 1 3 0 3 0 3 3 0 0 11 9 6 11 14 16 0 0 0 
0 5 0 14 1 0 0 0 0 9 0 0 0 18 5 0 6 0 5 0 0 
0 12 6 0 13 0 0 0 0 0 0 4 0 7 0 8 2 29 2 17 0 
2 5 0 11 5 0 0 3 4 9 4 0 8 7 12 6 15 5 0 18 0 
1 7 3 3 6 3 5 0 6 8 5 0 0 0 24 10 0 0 0 0 0 
2 4 9 0 3 16 0 7 0 7 3 0 0 0 0 0 0 0 6 6 15 
1 7 16 0 3 1 0 9 0 3 7 2 10 2 0 0 1 8 0 0 0 
0 3 0 0 9 5 0 0 0 7 3 2 0 6 0 1 0 0 17 0 0 
2 17 16 13 15 0 5 0 10 8 0 14 13 4 4 7 20 8 11 4 9 
3 7 34 2 3 0 11 9 1 1 1 2 0 15 12 5 10 0 0 17 0 
2 0 0 0 0 0 6 0 0 0 1 0 0 0 0 6 2 0 0 8 0 
9 0 10 5 2 13 0 0 11 19 0 2 2 9 4 12 1 0 9 1 8 
