21 12
9 10 2 0 0 0 12 0 11 0 2 0 0 0 13 14 2 9 2 0 6 
1 11 1 7 15 0 3 4 1 8 0 0 4 5 0 0 1 1 0 13 0 
1 9 3 0 0 0 0 0 13 0 2 6 0 0 10 5 1 10 4 0 1 
7 23 0 12 4 0 0 10 7 0 9 5 0 7 1 6 6 10 0 5 0 
2 0 15 0 5 0 11 20 6 0 6 0 5 6 5 11 2 14 9 0 0 
2 4 13 3 8 0 29 13 4 0 0 3 8 9 6 9 3 1 16 8 13 
13 10 9 5 0 0 0 0 13 5 1 30 1 0 0 0 8 0 6 3 0 
0 0 0 0 11 0 0 0 0 0 0 1 0 0 0 6 0 0 0 0 5 
12 0 3 0 0 10 8 9 4 0 0 4 4 0 14 10 4 0 11 0 17 
12 0 0 3 14 0 11 6 1 0 0 8 5 0 20 0 0 7 3 11 0 
15 0 15 0 6 0 0 0 9 0 6 0 0 12 1 7 4 2 10 0 4 
0 5 3 0 0 0 6 3 4 5 0 6 4 3 7 0 0 29 0 0 3 
