23 13
20 0 0 0 0 0 14 0 0 0 0 0 5 0 10 0 4 0 4 0 37 6 0 
18 7 1 1 22 7 1 0 20 0 4 10 37 4 0 7 2 13 21 0 9 13 0 
0 5 0 0 0 14 0 0 0 0 0 0 2 15 5 0 0 0 1 0 0 0 9 
20 7 12 32 17 0 3 14 10 0 0 0 0 17 8 6 0 14 6 0 15 29 4 
0 0 0 0 3 7 3 0 0 0 0 0 1 0 0 1 7 0 4 0 0 0 0 
12 0 4 0 18 9 13 9 0 0 4 6 17 0 9 0 4 0 1 0 0 0 18 
0 11 0 0 0 0 8 0 0 0 0 0 11 0 0 0 0 5 0 4 0 6 5 
0 0 0 12 4 14 2 0 0 0 2 0 1 2 5 14 5 0 3 14 0 5 0 
11 22 5 0 0 0 3 0 0 0 10 21 8 6 0 2 0 0 0 2 2 12 0 
0 2 0 0 7 2 0 0 2 0 3 7 7 0 0 0 8 0 0 0 0 1 0 
0 28 7 18 0 0 0 1 0 8 0 0 11 9 10 9 0 0 9 13 0 18 3 
13 24 0 4 19 36 16 2 6 0 12 25 7 10 20 4 17 5 1 11 1 10 5 
0 4 0 0 1 10 0 8 0 0 0 0 0 9 0 8 0 0 0 0 0 0 0 
