23 13
0 12 8 0 0 0 12 5 0 0 0 0 0 0 0 3 0 0 8 0 0 0 0 
0 21 11 23 0 0 1 0 0 3 0 0 0 11 6 0 0 1 4 5 17 0 24 
0 5 4 19 0 0 6 0 0 2 0 2 0 0 10 0 0 0 5 0 0 10 19 
0 5 0 0 0 8 5 0 0 0 0 0 9 8 0 3 0 0 0 0 0 0 7 
0 8 6 1 0 0 0 0 17 7 0 0 2 6 0 3 0 0 0 17 12 12 7 
0 0 1 1 11 0 1 17 0 0 2 0 3 1 0 16 3 11 9 9 0 5 7 
3 0 3 0 10 1 0 0 7 0 0 1 2 0 25 10 0 6 5 9 6 0 0 
29 22 0 2 0 9 15 0 12 6 17 18 10 0 1 17 4 6 13 9 32 31 10 
9 1 8 11 0 0 0 0 0 0 4 11 1 4 0 0 3 0 7 4 0 0 5 
20 0 0 0 0 3 7 0 0 0 0 2 0 0 0 7 3 5 4 3 18 0 4 
21 19 1 17 0 0 0 0 0 8 6 0 11 0 0 0 7 0 0 35 0 0 0 
5 0 6 5 0 0 11 0 3 14 8 0 3 0 6 4 6 2 22 3 18 0 20 
0 12 0 4 13 0 0 0 0 0 0 0 14 0 8 0 2 3 0 0 0 5 2 
