23 13
0 0 0 0 36 0 0 9 0 0 5 0 0 0 0 10 0 11 0 0 16 2 0 
6 10 18 5 18 7 0 0 3 7 14 12 4 6 6 9 9 0 10 6 0 7 13 
0 20 0 0 6 0 4 7 0 0 10 0 0 8 16 6 2 0 0 0 0 12 0 
7 0 0 0 0 0 16 12 0 0 0 0 3 2 2 2 0 0 2 0 2 0 14 
12 11 19 3 11 3 2 0 5 0 4 0 14 0 14 4 0 10 0 0 0 4 1 
0 20 0 0 0 0 20 0 0 0 0 4 0 0 0 6 0 0 0 0 0 19 16 
24 0 0 0 18 0 0 0 0 0 4 0 0 0 4 4 0 0 0 0 0 1 45 
6 7 0 2 7 3 6 15 3 7 7 0 3 0 2 14 2 4 0 0 1 3 9 
0 22 4 0 0 8 11 18 0 0 5 10 6 7 7 23 0 10 0 0 3 30 7 
0 0 8 0 6 0 4 9 0 0 11 0 9 7 8 0 0 0 0 0 3 11 3 
0 0 9 0 6 2 0 0 0 0 23 0 0 3 1 4 0 0 0 17 0 0 0 
27 23 0 17 0 0 0 0 13 4 0 11 0 16 0 6 5 10 0 0 16 13 18 
15 0 6 0 21 0 8 13 6 6 0 0 0 7 8 19 1 0 0 0 15 0 0 
