23 13
0 0 0 5 0 9 0 2 6 0 1 0 0 12 13 7 0 3 4 0 0 0 12 
8 13 11 12 4 0 0 1 8 9 6 4 0 0 9 25 0 17 8 0 0 0 0 
7 0 7 5 9 0 0 1 6 6 0 0 0 9 10 13 0 0 0 0 7 9 21 
29 0 10 5 6 0 2 7 14 18 0 0 12 0 3 2 0 33 11 0 4 10 13 
0 0 0 13 6 0 1 1 0 3 8 0 0 0 4 7 0 1 0 0 4 0 0 
0 20 0 8 10 0 8 0 0 0 6 0 0 0 3 0 17 0 2 0 0 20 2 
3 17 0 12 4 0 0 2 2 2 1 4 9 2 5 3 0 2 14 0 0 0 4 
14 13 0 0 4 18 15 5 0 5 1 0 8 4 23 17 0 4 0 7 18 0 8 
0 0 4 0 0 0 17 0 0 0 0 0 0 0 3 5 0 2 7 0 4 4 6 
0 0 9 0 0 0 11 0 0 0 5 9 0 2 0 0 0 11 1 2 7 0 0 
4 0 6 10 14 0 5 8 0 2 21 0 9 1 1 0 0 0 10 0 10 23 20 
5 0 27 7 0 0 0 0 0 6 10 4 0 2 0 12 0 0 0 0 0 28 0 
14 0 11 0 0 0 0 6 0 0 0 0 0 10 22 0 0 15 0 0 0 0 20 
