23 13
0 0 19 25 0 0 13 5 6 0 3 0 0 0 15 0 8 0 1 0 34 18 6 
0 0 0 0 10 1 14 0 2 0 6 6 0 0 8 11 0 0 1 0 0 0 16 
13 0 0 0 30 0 3 0 9 0 0 0 0 13 0 6 5 30 1 4 0 30 0 
16 0 4 0 2 3 8 0 11 0 0 0 0 0 8 12 16 4 0 0 7 10 8 
7 0 8 0 3 11 0 7 0 0 6 5 0 0 0 0 10 4 0 0 0 4 0 
12 0 20 12 10 5 0 0 0 10 5 0 19 0 11 13 6 0 1 7 0 0 14 
0 5 18 3 0 14 11 0 0 4 0 0 0 4 0 0 4 12 0 3 20 15 6 
3 19 6 17 0 4 7 0 4 0 0 6 7 0 0 14 4 2 0 3 33 23 22 
0 0 0 8 0 0 0 8 0 22 0 0 0 0 0 8 8 3 6 0 0 0 13 
13 0 20 0 9 0 2 0 1 0 12 3 0 2 0 0 2 7 2 6 0 15 32 
22 13 5 1 0 16 9 32 12 6 10 0 5 0 7 20 0 0 3 13 23 13 33 
3 1 0 0 4 10 8 4 0 0 3 0 0 0 0 0 0 3 1 1 0 0 0 
0 14 8 0 12 5 0 10 2 0 5 0 7 0 0 14 7 10 0 0 1 4 0 
