23 13
1 58 0 2 0 12 1 9 10 10 9 6 11 6 3 5 0 0 0 9 19 8 0 
0 13 0 12 0 0 0 9 4 5 0 11 0 0 13 12 9 8 4 1 0 0 0 
1 5 0 19 0 3 6 0 11 0 1 1 0 12 3 2 2 0 0 1 3 2 0 
28 7 8 7 12 20 4 0 8 1 0 0 0 0 9 7 7 0 8 0 20 16 0 
4 0 0 0 0 8 9 0 0 2 0 3 9 3 8 9 0 0 0 0 0 11 0 
7 0 0 0 3 0 0 12 20 7 3 2 3 0 3 8 0 0 4 11 0 13 0 
20 13 6 3 0 13 2 6 1 4 0 0 0 4 7 0 2 5 2 0 26 0 14 
7 0 0 0 0 3 0 33 1 0 0 6 0 6 3 0 0 4 4 6 13 0 19 
9 8 2 13 0 0 2 0 0 0 0 2 0 0 0 0 10 0 0 0 4 0 0 
3 0 0 17 0 0 0 14 0 4 0 11 0 5 11 0 0 0 0 0 9 14 3 
23 7 6 0 0 3 8 0 4 0 5 6 0 0 0 5 0 6 0 13 0 21 4 
2 33 6 0 0 6 3 2 0 1 0 9 6 11 0 11 4 4 2 18 0 0 17 
18 0 4 4 2 8 0 0 0 6 0 11 0 0 0 0 0 0 0 0 4 0 1 
