23 13
0 20 0 0 6 12 0 0 10 0 6 0 0 0 0 6 4 8 10 0 22 26 0 
5 0 0 9 10 3 0 5 5 7 0 0 5 0 6 10 0 0 0 0 5 0 18 
0 4 16 13 6 15 2 0 22 9 0 8 1 2 2 2 0 15 17 14 5 9 0 
34 1 0 0 0 0 0 22 5 0 0 0 2 0 14 5 0 0 0 1 8 2 7 
0 3 12 2 0 11 2 0 0 0 0 1 0 2 10 0 0 4 17 0 19 0 0 
29 5 1 3 31 0 4 14 11 5 7 8 4 6 1 14 7 22 2 15 16 6 22 
4 10 7 2 14 6 1 1 11 3 0 4 0 0 0 0 0 0 13 18 0 0 0 
0 0 0 6 0 11 0 3 1 8 8 0 0 0 0 0 0 0 3 14 0 3 0 
0 21 14 0 6 0 0 0 8 2 3 4 5 3 7 0 20 0 9 0 4 7 15 
0 0 0 0 13 0 12 0 0 16 0 0 0 0 0 9 0 0 0 0 11 0 0 
1 1 11 0 8 0 14 0 0 0 0 0 0 3 0 0 0 0 4 0 4 7 2 
0 6 0 6 9 0 7 0 6 5 0 0 9 12 0 3 0 0 0 0 0 9 0 
0 0 0 17 0 8 0 9 3 0 0 0 0 0 0 7 0 0 5 0 25 16 0 
