23 13
19 0 11 3 4 16 18 0 6 4 13 1 8 0 9 11 3 7 0 25 3 16 20 
0 0 0 1 1 1 1 2 0 0 0 0 0 0 0 4 0 0 0 0 0 0 0 
16 0 4 0 0 0 0 6 3 8 2 3 14 9 0 1 4 9 6 5 0 0 19 
10 1 29 19 12 3 0 2 14 0 6 4 10 3 0 4 15 0 0 0 0 19 17 
14 25 0 0 14 2 8 5 0 0 6 4 3 4 9 0 5 11 26 23 0 5 0 
8 0 13 0 1 6 26 0 0 12 0 4 6 0 0 27 0 11 0 0 0 12 0 
4 0 5 0 0 4 0 0 0 0 0 0 0 0 0 0 6 0 0 8 0 2 0 
0 17 47 0 0 16 5 6 13 0 6 4 4 22 12 0 13 2 16 10 0 0 14 
0 7 8 0 0 14 0 2 16 0 0 10 0 0 0 2 0 3 0 0 15 0 5 
8 0 2 0 6 0 8 0 0 0 6 0 0 0 0 0 0 0 0 0 0 0 0 
19 10 0 13 0 0 0 0 0 0 0 5 7 0 5 21 16 0 18 8 5 0 21 
0 1 0 13 1 0 1 0 2 8 0 0 0 0 0 6 1 7 15 0 1 0 0 
9 5 18 0 5 0 0 0 0 5 0 10 0 6 0 7 0 2 0 14 19 10 0 
