23 13
13 8 26 11 0 0 1 5 18 7 0 6 7 0 0 4 12 0 6 6 0 21 0 
0 1 1 0 0 7 17 2 8 0 0 4 0 3 0 0 14 0 12 0 14 2 0 
0 0 28 33 19 1 11 3 31 0 3 27 4 11 0 0 0 15 2 13 14 10 16 
0 0 0 0 0 0 0 9 6 3 0 0 3 0 0 0 8 0 10 0 0 0 0 
0 9 2 0 4 5 11 11 1 8 9 0 0 2 0 0 8 9 3 0 0 3 0 
0 3 0 0 4 0 0 1 3 2 3 0 8 7 0 0 1 0 0 0 4 0 0 
0 0 6 0 1 1 16 9 4 15 0 5 0 6 13 0 3 1 7 0 1 6 23 
0 0 1 0 16 14 0 3 7 0 3 0 0 8 0 0 6 5 0 14 4 17 1 
16 0 3 0 1 10 0 0 0 0 4 1 0 0 2 0 14 7 0 0 0 0 0 
0 0 11 2 0 5 0 4 0 9 0 5 0 0 12 0 5 5 0 0 0 24 20 
35 0 2 0 6 6 9 0 8 4 10 3 0 0 0 0 0 0 0 19 1 0 22 
1 0 0 14 9 5 2 2 0 8 5 0 0 7 2 3 10 15 3 0 4 0 8 
0 0 19 1 1 4 0 21 12 0 0 0 0 1 0 13 12 10 0 0 0 0 0 
