23 13
18 9 0 18 6 1 5 0 2 5 0 9 6 4 8 1 4 4 3 0 7 15 0 
9 11 10 0 29 10 0 0 1 6 4 9 1 1 1 6 0 5 14 5 25 0 5 
0 7 0 0 0 0 3 0 0 0 0 20 10 6 7 14 6 8 0 0 0 1 1 
0 9 27 0 5 8 7 6 4 0 0 0 0 7 12 0 0 15 0 0 0 8 0 
2 0 6 0 3 8 0 6 0 10 0 4 0 3 0 0 9 0 7 2 0 0 0 
15 1 1 0 5 0 0 0 0 0 0 9 0 0 0 3 16 0 0 0 9 0 0 
18 0 0 0 0 0 6 0 3 9 0 0 2 2 2 0 3 0 41 0 2 4 0 
1 0 2 0 3 0 0 0 0 0 0 3 12 4 1 5 10 0 14 0 7 5 0 
0 0 3 17 0 0 9 12 0 4 4 9 0 11 16 16 3 0 2 14 10 0 0 
1 2 5 10 6 10 8 6 1 1 7 11 0 3 0 0 10 1 0 1 1 35 11 
9 0 0 1 5 7 0 0 0 0 0 6 0 0 0 0 2 9 0 19 0 4 0 
2 0 10 0 4 18 13 0 3 9 4 7 10 0 4 9 0 0 7 0 0 2 10 
2 19 1 0 10 9 0 0 0 0 0 10 0 0 0 0 3 0 0 0 6 0 0 
