23 13
25 27 0 0 17 4 1 6 0 0 10 0 0 5 0 7 4 2 5 2 7 38 7 
0 0 0 10 0 15 0 0 0 0 8 0 0 1 0 11 0 0 3 0 13 0 0 
0 0 13 0 3 0 0 3 0 0 9 0 1 1 0 13 0 0 0 0 0 0 0 
0 0 0 0 0 0 12 5 0 0 2 5 4 0 0 0 5 0 15 0 0 5 3 
0 21 0 1 11 4 0 0 0 4 0 0 0 8 10 8 1 6 2 2 3 0 30 
0 0 0 6 2 0 0 0 9 4 0 0 0 1 2 1 0 9 5 14 0 5 0 
3 0 5 0 0 20 0 0 5 9 8 6 9 15 9 2 0 0 3 2 1 8 3 
0 10 0 0 2 1 0 4 1 13 5 0 0 0 6 0 3 0 18 0 7 0 13 
6 15 29 11 4 7 2 0 4 0 0 9 2 10 21 3 3 5 1 17 7 0 0 
10 9 0 0 0 0 14 0 0 0 10 0 11 9 0 4 6 0 0 2 3 0 2 
0 0 2 1 1 2 2 0 0 0 10 4 1 0 2 4 1 5 0 0 1 7 0 
8 0 15 9 4 5 0 0 4 0 2 8 6 0 4 0 0 0 16 2 8 1 2 
3 38 2 0 14 12 3 23 11 3 3 11 4 3 0 9 2 0 43 8 23 0 27 
