23 13
11 7 1 10 0 33 12 0 0 4 12 15 14 0 6 0 7 13 0 3 6 3 12 
28 10 3 7 3 3 4 8 3 5 0 18 0 0 8 15 8 10 0 11 6 0 0 
0 0 10 0 2 3 9 35 5 0 1 2 2 0 0 7 18 2 3 4 7 13 15 
0 0 7 6 1 2 0 9 8 6 7 0 3 0 0 1 6 3 0 0 0 0 0 
0 9 0 0 8 0 7 0 3 1 9 4 0 1 0 0 0 6 0 0 0 5 1 
1 5 0 10 0 5 0 11 5 0 0 0 1 0 0 3 0 5 26 4 0 0 1 
0 0 0 2 35 0 20 0 0 20 3 0 6 0 0 0 12 8 27 16 14 15 19 
12 0 0 11 0 0 0 0 0 0 4 0 0 15 0 15 0 0 0 0 0 1 0 
18 14 0 0 0 5 0 0 0 0 6 0 0 13 0 14 0 0 0 3 6 0 4 
5 0 0 21 1 4 0 10 0 3 6 0 0 0 0 11 6 10 15 2 5 6 3 
2 0 7 0 0 0 7 14 0 0 0 0 0 0 0 0 8 14 1 0 3 1 0 
43 10 7 10 10 0 0 0 1 3 0 0 11 0 0 0 0 9 0 9 18 21 2 
0 0 10 0 8 12 23 10 0 12 0 0 0 5 0 0 12 0 0 1 0 22 7 
