23 13
37 9 31 0 0 0 4 7 0 0 0 0 0 10 0 13 16 2 11 0 18 0 30 
5 8 13 0 0 4 0 3 0 0 5 0 11 0 3 0 21 9 0 12 19 0 8 
0 0 1 0 0 0 0 0 0 0 9 10 0 6 3 0 3 13 0 14 0 2 5 
0 0 5 0 0 0 0 5 0 0 0 0 9 3 2 0 2 0 11 0 2 9 7 
0 6 0 0 9 8 0 9 3 3 0 2 17 0 8 8 2 5 2 7 6 16 13 
0 16 0 24 0 13 3 0 0 15 17 0 2 0 11 0 6 3 21 0 9 5 6 
7 0 6 1 2 0 0 3 3 9 5 4 0 4 0 0 3 0 5 0 0 1 13 
0 6 0 4 0 4 0 1 0 0 0 6 0 0 9 0 4 2 4 5 0 1 0 
8 0 3 0 18 0 4 0 0 0 6 2 0 8 8 0 6 0 5 0 3 9 11 
0 7 7 17 10 0 0 0 0 7 0 0 0 0 10 0 0 27 3 0 20 0 9 
17 5 2 5 0 9 0 0 5 7 8 0 2 0 6 0 5 12 0 8 15 5 7 
4 0 14 18 0 6 2 7 2 0 7 15 3 0 4 2 8 3 12 0 18 18 11 
0 0 0 0 0 10 3 8 1 0 1 0 6 2 0 2 0 1 1 0 7 7 12 
