23 13
0 14 0 0 16 0 7 0 0 0 0 12 2 7 5 14 4 8 0 0 16 0 15 
25 12 1 3 9 20 23 5 0 0 32 1 4 0 0 7 1 7 4 4 25 0 12 
13 13 0 0 0 6 0 7 0 12 9 5 2 2 7 1 6 2 3 5 0 12 0 
0 1 0 0 0 7 0 5 0 0 0 0 0 0 9 0 7 0 8 0 0 0 0 
4 21 0 14 0 0 0 14 0 0 11 11 2 20 3 0 10 14 6 6 7 3 21 
0 0 0 11 3 0 1 14 1 6 0 0 0 0 11 0 0 13 4 0 3 0 0 
0 33 6 0 10 0 6 9 5 8 0 0 5 0 29 2 9 17 0 11 10 20 0 
0 0 0 0 0 0 0 13 0 0 9 0 0 3 10 0 12 4 0 7 9 0 0 
17 17 3 23 2 9 4 18 0 4 0 8 0 0 11 10 8 0 0 8 13 23 21 
0 3 0 0 3 0 0 4 0 0 8 0 0 3 7 0 0 3 5 0 8 7 0 
0 0 0 15 11 7 9 0 4 9 6 0 7 7 0 0 7 0 21 9 15 2 0 
21 0 3 0 0 16 4 4 0 1 10 10 0 0 4 10 7 4 8 0 21 17 11 
1 4 15 4 3 0 4 10 6 11 11 32 8 5 7 6 12 0 0 0 11 14 12 
