23 13
0 20 0 19 0 0 0 0 8 0 9 0 7 0 0 3 0 5 6 23 0 21 7 
5 9 4 0 2 2 13 0 0 11 10 0 0 9 9 0 4 4 0 24 11 0 6 
18 0 0 9 0 0 0 0 6 0 0 5 9 13 6 0 0 2 1 2 0 0 0 
0 0 0 12 2 2 1 8 0 0 7 7 0 4 0 12 0 0 1 2 9 0 0 
0 0 9 0 0 8 0 0 0 5 7 9 0 0 5 0 0 5 0 2 6 0 0 
0 4 6 0 23 29 3 26 5 1 8 5 3 3 0 0 1 2 16 22 14 8 18 
5 0 0 19 0 5 0 12 1 0 1 0 0 0 11 10 4 0 6 8 9 4 19 
5 0 3 11 17 12 0 0 0 2 0 6 1 13 14 5 0 12 1 1 5 9 1 
1 7 0 2 16 1 26 0 13 8 0 0 0 0 0 9 8 0 14 4 14 0 0 
7 0 13 19 0 0 0 12 0 0 5 0 5 0 3 8 0 0 1 1 0 0 19 
0 37 14 18 6 0 2 7 2 0 29 7 10 9 13 0 0 0 0 18 6 22 8 
6 10 0 16 16 3 9 0 10 12 0 0 11 0 0 0 0 8 9 0 4 6 0 
0 19 0 1 5 14 1 13 0 6 0 8 7 1 8 0 1 1 0 23 52 0 0 
