23 13
0 20 0 0 0 3 1 0 4 7 0 0 6 3 7 11 15 0 6 1 0 27 9 
11 5 8 0 12 0 5 14 18 11 7 7 5 8 14 23 1 0 9 12 17 17 0 
6 0 0 15 0 0 6 0 0 0 0 7 9 8 0 2 1 0 6 0 0 8 0 
14 2 11 0 8 0 0 4 0 0 4 1 0 11 21 0 0 0 11 4 0 0 4 
0 2 22 7 18 5 1 0 5 0 5 0 3 0 0 0 1 0 0 0 12 19 18 
0 0 0 26 11 0 0 3 0 0 9 0 4 9 0 0 8 14 34 8 0 0 13 
0 0 3 4 0 0 10 0 0 4 0 2 0 3 0 0 7 0 0 3 0 0 0 
0 0 20 10 2 0 26 4 0 6 4 1 0 1 12 0 3 14 12 9 0 0 4 
0 10 0 19 4 0 0 7 4 2 6 11 0 2 4 15 0 0 7 0 4 0 1 
0 0 5 0 17 5 5 5 7 9 7 0 0 4 0 0 1 6 4 1 5 17 16 
2 12 10 0 0 0 15 0 0 0 3 1 1 5 0 6 0 0 5 3 7 15 0 
0 0 0 0 6 4 0 0 12 5 0 4 7 13 0 8 4 4 0 0 0 13 0 
14 20 1 7 4 0 0 3 9 0 0 0 0 6 1 11 7 14 0 6 0 18 40 
