23 13
12 0 12 1 3 0 4 0 0 0 6 0 0 13 0 0 9 1 0 0 18 0 0 
15 0 34 0 4 0 15 16 10 7 1 4 7 0 19 0 7 0 11 0 0 16 12 
0 0 14 19 14 0 2 3 0 0 0 2 0 9 0 0 14 6 0 2 16 3 20 
0 0 8 9 0 0 2 0 1 0 0 3 3 10 5 0 0 25 28 21 1 0 0 
0 1 29 16 12 0 20 8 0 2 2 9 7 7 0 5 1 11 14 16 5 0 20 
0 0 19 8 7 0 2 16 12 0 7 0 2 1 9 5 10 7 0 0 16 12 18 
1 1 24 1 14 0 0 1 0 7 7 2 4 2 0 0 1 3 0 0 18 17 0 
0 0 15 10 5 0 0 2 0 0 5 6 2 7 0 0 0 16 0 0 0 6 0 
0 0 0 12 0 0 0 5 0 0 3 0 4 0 7 11 1 2 11 0 0 7 0 
0 6 15 16 0 0 8 13 1 0 9 3 6 6 0 14 0 11 6 1 13 0 0 
16 1 0 0 18 0 3 0 7 0 0 0 1 0 0 0 6 4 0 0 0 0 18 
0 17 34 20 2 0 0 9 18 5 8 7 2 0 13 6 14 10 0 0 0 0 19 
0 7 0 1 0 0 2 4 2 0 1 14 4 0 0 0 1 5 0 0 12 0 10 
