23 13
4 0 0 0 5 0 0 29 0 5 0 8 0 0 0 5 9 6 1 12 0 0 0 
0 2 0 0 10 0 8 0 0 1 1 0 0 0 8 0 0 0 0 0 0 0 9 
0 0 0 0 0 4 0 12 0 0 6 2 0 0 0 0 6 0 1 11 10 0 0 
0 17 3 9 2 19 2 5 2 0 9 9 0 0 0 3 3 7 0 12 17 7 14 
17 15 4 0 4 0 8 9 7 2 5 6 5 5 0 5 21 2 12 4 0 8 27 
0 2 0 0 0 5 0 5 0 7 2 0 0 0 0 7 5 7 9 0 0 12 0 
0 1 2 16 3 2 3 11 0 2 1 0 0 0 0 0 9 5 0 3 0 0 24 
5 6 0 1 16 5 14 7 4 0 7 0 5 0 0 3 12 25 8 0 0 0 0 
4 3 3 4 22 1 3 15 4 13 0 12 0 6 8 2 0 0 0 0 16 1 2 
0 0 13 0 18 1 4 0 1 0 1 8 6 1 10 0 6 0 3 0 1 3 5 
11 15 0 13 42 12 3 0 13 13 17 4 4 0 0 6 45 24 22 9 10 4 7 
7 6 3 0 18 4 0 8 3 0 0 0 15 0 0 0 0 0 0 0 10 0 2 
0 0 13 0 0 0 0 10 0 0 3 0 0 0 0 14 0 0 0 9 10 3 0 
