23 13
22 6 0 8 0 0 0 5 0 10 0 10 11 4 2 0 15 10 0 10 13 13 27 
8 0 0 5 0 0 0 3 0 0 7 10 2 6 2 1 16 11 0 45 5 14 8 
0 0 0 39 0 1 0 0 3 0 0 4 0 0 3 0 0 0 0 0 0 18 19 
9 0 5 8 30 1 11 7 18 3 0 19 4 0 0 1 3 2 33 2 16 4 14 
3 5 0 1 0 0 24 3 8 22 1 8 0 0 0 0 0 6 9 0 14 15 13 
18 0 0 2 18 1 0 0 13 2 8 7 0 3 10 0 5 0 33 3 2 8 3 
0 0 0 0 0 0 0 0 3 0 0 0 0 0 0 0 0 0 0 0 5 0 0 
14 16 2 4 0 0 13 13 16 6 15 0 0 0 0 0 9 27 8 2 3 0 0 
7 0 24 0 0 10 3 18 0 0 0 5 8 5 0 8 10 5 13 0 4 0 0 
8 0 8 8 0 7 5 0 13 0 0 5 12 0 12 7 0 5 0 0 0 6 23 
3 3 2 3 0 13 10 21 0 11 3 0 0 4 13 0 1 11 4 18 0 14 1 
0 0 17 1 0 14 4 3 5 0 0 4 2 3 0 0 0 11 0 4 0 2 0 
9 0 25 17 1 0 11 0 7 0 0 0 0 6 7 13 2 0 12 18 0 0 0 
