23 13
0 19 0 5 0 8 5 12 24 4 0 2 4 0 3 8 0 0 8 0 12 14 0 
0 0 0 11 0 3 0 7 10 0 0 0 9 0 11 0 0 0 0 8 0 9 0 
0 14 1 19 0 2 0 0 10 0 16 4 0 12 0 17 9 0 5 0 17 1 18 
0 7 4 17 0 0 0 0 6 0 7 0 3 1 0 0 3 5 0 3 17 25 0 
3 0 20 0 0 9 0 2 0 4 1 0 4 2 0 0 0 0 3 0 0 0 24 
0 0 1 0 4 5 16 0 16 4 2 3 0 0 0 3 0 0 3 0 0 16 11 
0 0 1 4 5 2 0 10 11 5 1 11 3 8 0 0 3 4 0 6 9 12 3 
17 4 15 14 0 17 13 0 1 1 0 0 1 0 12 0 3 3 9 13 2 0 0 
19 4 8 4 0 0 0 19 2 1 2 15 10 0 1 1 5 8 4 21 0 9 11 
0 0 0 3 16 0 8 12 2 7 3 7 4 5 1 9 12 0 2 20 2 6 8 
3 7 2 18 0 10 0 10 0 1 6 0 0 7 0 2 0 12 0 19 0 18 0 
2 0 8 0 0 6 10 0 8 1 8 0 2 6 2 0 17 3 0 6 18 0 0 
18 12 10 0 1 6 0 4 21 0 2 0 0 0 6 0 13 10 28 0 0 0 0 
