23 13
0 0 0 0 0 8 16 9 12 0 0 9 10 3 0 0 15 0 0 0 0 1 27 
0 12 0 4 8 8 13 1 15 6 5 1 0 4 14 8 0 4 1 2 6 0 9 
20 19 4 0 0 0 0 5 12 0 13 10 11 1 5 2 0 0 4 3 20 19 18 
11 0 7 0 0 0 2 0 0 7 5 14 0 0 0 4 5 0 0 5 0 0 0 
17 7 0 5 2 3 0 0 8 0 0 0 0 1 0 2 0 12 5 0 7 0 2 
0 0 2 0 0 0 9 0 0 5 3 17 3 0 2 0 0 7 0 5 0 0 3 
20 0 0 0 2 3 0 0 3 0 0 0 0 0 0 0 6 0 1 4 20 0 8 
12 0 5 0 16 5 4 19 0 5 0 0 3 0 8 6 1 4 5 19 16 0 8 
7 0 17 18 0 12 0 14 11 4 5 0 8 6 4 0 5 0 0 16 26 18 15 
15 0 3 0 4 2 0 2 3 3 0 2 5 8 3 0 4 1 0 0 4 0 0 
0 18 0 0 0 5 5 17 3 0 2 4 27 0 10 14 1 0 2 23 5 21 3 
0 10 11 0 7 8 0 0 6 2 0 1 4 25 0 7 9 0 2 6 4 5 21 
8 0 0 0 4 0 0 0 12 6 4 2 12 1 0 0 12 0 7 0 10 0 12 
