23 13
0 15 34 13 7 6 1 5 12 17 0 0 0 0 5 0 32 3 3 3 34 7 13 
0 4 0 1 3 0 0 0 0 8 9 1 1 0 4 1 2 0 0 0 0 0 0 
4 1 17 1 13 0 10 6 2 0 10 0 0 0 20 3 1 1 13 1 18 0 0 
0 14 11 0 9 10 13 2 0 2 10 0 5 7 0 4 8 1 0 22 10 5 0 
9 1 0 1 0 0 0 0 2 9 3 9 0 2 3 2 4 0 0 0 0 0 0 
0 3 17 4 4 0 12 0 0 11 0 0 7 0 0 3 0 0 9 15 0 3 0 
3 11 6 10 6 0 0 0 0 0 9 6 10 10 13 0 0 6 4 0 0 1 4 
0 0 0 0 0 7 4 2 0 5 1 0 0 0 8 0 0 0 32 0 6 0 0 
0 35 0 7 0 9 5 1 11 1 19 1 9 9 20 7 3 16 10 5 0 20 0 
12 8 3 9 0 2 12 5 12 21 3 4 32 5 0 13 16 10 6 9 2 21 0 
0 0 20 11 0 0 3 0 4 0 0 1 6 0 12 1 0 15 7 0 3 7 0 
1 26 28 0 4 0 0 2 3 1 0 9 0 0 13 0 0 16 6 0 0 19 0 
0 0 13 7 9 0 10 5 0 0 1 2 10 0 0 4 0 0 6 9 0 10 0 
