23 13
17 0 0 0 16 0 17 0 7 0 14 5 2 9 0 0 13 7 0 0 19 1 12 
14 6 3 0 0 3 7 9 0 2 0 0 5 1 22 0 0 9 5 0 0 0 12 
13 7 9 7 8 0 0 8 0 0 7 12 5 13 0 8 5 2 7 0 0 4 0 
0 1 5 0 7 4 9 14 2 1 3 0 4 12 2 1 2 3 1 3 4 0 11 
0 0 6 20 2 5 11 5 1 0 0 7 0 7 0 1 6 8 5 41 15 0 2 
20 5 16 8 4 0 6 0 2 0 0 11 9 8 5 0 0 0 16 5 25 0 0 
0 11 34 4 13 4 0 2 0 9 4 0 14 0 7 5 5 5 7 0 0 20 0 
0 0 0 0 4 15 4 0 7 3 1 0 3 0 0 0 0 1 3 0 11 3 0 
17 3 4 2 13 16 6 0 0 0 0 2 0 2 13 0 8 17 0 0 0 16 0 
0 17 12 1 0 4 0 14 0 13 12 16 6 5 20 8 11 12 0 0 9 16 34 
0 7 12 8 0 2 2 0 7 0 0 0 7 2 0 0 6 6 0 16 18 0 0 
0 0 25 16 6 7 0 0 0 0 6 2 3 0 5 16 6 0 15 3 4 0 11 
0 4 4 10 0 8 0 0 0 0 0 0 11 13 1 0 0 0 0 0 0 0 0 
