23 13
0 0 0 0 0 11 0 0 0 0 0 0 6 0 12 0 6 0 0 0 15 0 0 
4 0 0 18 26 8 0 6 8 1 3 7 0 0 0 2 5 0 9 1 13 1 8 
0 3 0 1 1 0 1 0 0 17 1 1 9 4 0 5 2 0 7 0 4 0 13 
3 0 0 4 0 0 0 3 0 1 9 1 1 0 7 0 3 0 5 4 0 2 0 
8 0 0 17 1 0 10 4 6 1 0 7 8 0 0 0 3 0 7 11 3 0 0 
0 1 10 2 4 2 3 0 0 10 0 0 10 0 5 0 0 0 0 0 0 3 0 
22 30 9 8 5 0 2 9 3 0 0 17 2 0 5 4 0 0 10 4 4 15 33 
0 0 0 19 6 13 3 0 6 0 6 0 0 5 7 6 3 12 0 2 0 5 14 
2 11 1 0 16 3 0 0 15 3 0 10 3 0 0 3 0 0 9 8 0 24 21 
0 15 3 3 6 0 9 7 0 0 0 0 0 9 9 3 22 1 3 0 0 1 0 
0 6 0 0 14 0 0 5 0 0 4 0 10 4 16 9 14 19 1 0 0 20 6 
0 1 2 0 0 11 0 5 0 6 0 0 4 0 0 0 0 0 2 0 11 0 0 
23 2 1 11 4 0 15 6 10 3 10 15 16 23 4 4 9 0 7 3 0 20 17 
