23 13
0 4 8 3 0 5 4 12 8 14 17 6 11 0 5 5 14 8 0 15 10 0 3 
4 4 12 3 7 23 0 7 7 0 12 11 9 1 10 5 23 4 5 9 0 7 37 
0 1 0 8 0 0 16 0 0 0 2 5 0 7 0 0 7 6 6 2 0 0 16 
0 0 0 0 2 19 3 0 4 8 6 0 0 0 0 0 0 8 0 0 0 16 0 
0 16 15 2 5 6 8 7 0 5 26 8 0 3 7 6 2 5 0 14 10 21 0 
4 3 0 0 4 3 0 4 11 3 1 4 1 4 6 1 0 4 0 6 4 7 0 
6 3 0 0 0 6 0 8 4 6 6 0 1 12 0 3 12 0 5 0 1 0 0 
17 0 0 16 14 6 14 7 13 4 0 0 0 2 6 5 0 20 0 0 7 16 0 
0 24 0 5 0 0 3 0 15 3 4 0 0 8 13 0 8 0 6 0 0 28 0 
31 19 0 7 10 16 0 14 3 0 17 8 0 0 2 0 3 5 0 0 15 14 0 
0 0 7 3 6 1 7 3 9 22 0 0 1 0 0 6 3 8 2 9 3 0 14 
9 0 0 7 0 0 0 0 0 9 7 0 0 9 10 2 9 2 0 0 0 0 1 
6 10 0 18 0 0 8 0 3 6 0 0 9 0 0 0 0 0 0 0 0 1 11 
