24 14
4 0 11 19 2 26 0 0 22 0 0 19 0 13 0 6 4 0 0 0 0 0 1 1 
0 7 1 12 6 34 3 1 8 7 1 7 2 7 3 13 9 0 0 17 0 12 17 33 
0 0 0 0 6 0 0 0 15 0 0 12 10 6 6 0 0 0 4 0 4 4 11 2 
0 12 9 0 0 2 0 0 12 0 0 3 0 13 1 0 4 0 10 5 7 6 0 0 
0 0 0 0 0 2 0 9 0 15 0 4 0 6 0 8 4 0 1 0 20 0 0 0 
0 21 1 1 0 0 0 0 0 0 0 0 8 0 0 0 0 0 0 0 0 4 21 0 
6 8 14 0 5 3 0 17 2 17 5 0 10 0 2 5 21 1 5 12 19 25 11 23 
0 0 0 7 9 4 4 0 17 0 4 1 1 15 10 0 0 0 8 8 7 0 0 0 
0 0 12 0 32 0 0 7 11 5 6 0 0 3 4 0 0 5 0 3 0 0 13 12 
9 8 17 8 0 7 0 0 0 0 3 4 5 0 7 0 0 0 2 13 0 10 0 4 
10 0 2 3 27 10 0 7 0 0 6 0 2 0 0 0 5 0 0 0 3 7 0 20 
0 0 0 0 10 10 0 5 15 1 0 2 0 0 6 0 0 8 0 2 0 0 14 0 
0 2 10 8 1 0 0 0 18 0 0 0 8 10 0 13 0 4 9 0 0 0 10 0 
0 0 13 0 10 0 0 0 0 9 13 13 8 9 0 0 0 0 0 0 6 7 6 5 
