24 14
9 0 7 13 13 0 2 28 4 14 1 2 0 0 5 0 15 0 9 1 24 7 15 20 
6 0 0 0 2 4 0 17 6 4 11 0 0 3 13 1 3 0 11 9 0 0 0 11 
4 5 7 0 15 13 9 0 19 10 0 12 0 13 4 21 0 17 0 18 0 0 0 27 
0 0 0 0 8 14 0 5 0 6 0 7 0 6 0 6 0 8 0 14 0 0 0 3 
0 0 15 0 0 0 15 2 9 2 0 9 0 0 0 0 0 0 0 0 0 0 0 17 
0 0 31 16 0 4 0 2 0 10 0 0 2 18 0 1 0 0 0 13 0 0 20 8 
0 2 0 12 3 4 1 1 1 12 0 0 0 0 0 27 0 8 0 4 5 0 0 0 
17 6 8 9 2 11 0 20 27 0 11 3 13 0 0 7 0 0 17 11 4 18 10 7 
13 4 0 0 0 0 5 0 4 0 4 10 0 13 0 0 0 0 0 0 0 0 0 0 
0 0 6 9 0 13 1 9 9 0 0 0 10 0 1 10 10 1 0 8 0 0 0 0 
3 0 11 0 0 8 0 7 0 0 0 0 1 0 1 0 0 10 0 3 0 0 0 10 
0 16 0 5 18 0 2 0 0 0 0 0 11 0 4 12 0 8 4 0 21 2 18 2 
12 0 2 13 21 0 0 0 5 1 16 0 0 7 0 5 9 0 12 0 0 0 18 7 
5 15 1 9 14 0 5 0 24 14 0 0 11 1 12 36 14 0 0 3 0 0 1 58 
