24 14
0 7 4 0 22 11 20 0 17 19 14 2 0 12 10 6 11 0 1 5 16 0 13 9 
0 0 24 8 11 11 13 2 11 1 7 18 7 9 0 0 18 0 12 3 14 0 0 6 
13 4 21 34 2 5 2 0 0 11 6 10 0 11 4 11 3 0 2 25 0 35 0 21 
0 9 12 6 0 0 0 8 0 0 8 0 10 0 0 0 5 7 0 0 7 0 20 1 
4 19 8 0 15 0 0 0 0 12 9 5 2 0 4 1 2 15 0 9 0 0 0 0 
0 0 5 0 1 1 0 14 0 0 0 1 0 0 0 0 4 0 0 0 0 14 0 0 
0 6 16 0 0 0 0 0 19 0 7 6 0 0 13 0 0 0 16 0 0 13 0 9 
0 0 0 0 7 9 0 0 0 3 5 0 6 0 0 0 0 0 6 17 0 0 4 5 
7 0 0 0 6 0 0 5 0 4 7 5 14 0 0 0 0 4 0 19 0 0 5 1 
0 0 0 6 0 1 0 0 0 0 0 0 6 0 0 1 9 6 8 0 0 7 0 0 
17 4 6 1 1 13 0 6 0 7 7 0 5 10 7 0 17 9 6 1 24 0 20 3 
0 0 10 4 0 13 0 4 9 1 10 1 0 0 0 0 0 3 3 1 0 0 4 8 
2 10 2 2 9 1 0 0 12 0 4 11 0 12 0 0 0 9 0 1 10 20 39 31 
0 0 0 0 0 0 13 0 0 0 19 21 10 0 0 12 1 0 12 0 0 0 12 28 
