24 14
0 0 6 0 5 0 16 0 0 0 9 0 1 10 0 0 0 3 0 12 13 0 14 0 
49 13 4 0 1 1 20 4 7 1 5 11 13 9 1 7 9 29 18 13 8 7 9 12 
0 38 9 0 0 0 0 23 0 0 6 12 1 0 0 8 9 0 17 0 0 0 0 0 
2 0 6 0 2 3 10 0 0 4 0 9 0 0 0 0 25 6 8 0 0 0 0 0 
13 0 8 0 4 0 0 0 0 0 0 0 0 0 12 0 4 17 1 0 4 0 0 0 
21 0 21 0 0 2 0 6 0 3 8 0 0 0 5 8 0 0 9 0 0 21 0 15 
0 22 1 0 6 2 15 9 0 0 7 5 1 0 0 7 9 0 0 0 0 15 7 22 
0 0 11 0 0 7 0 0 0 21 6 1 4 6 7 3 11 0 4 0 2 13 10 0 
15 0 7 22 17 17 11 11 0 3 0 13 0 0 4 2 0 3 13 1 9 16 37 20 
0 8 0 1 0 3 0 0 0 6 0 11 0 0 0 6 4 17 1 0 6 7 0 0 
3 1 3 6 0 4 0 4 2 0 8 31 4 10 0 7 14 9 8 0 0 0 11 10 
0 0 0 0 22 15 0 31 0 0 1 5 0 1 0 5 6 0 0 15 0 0 0 16 
0 7 28 0 8 18 11 0 10 7 0 8 8 1 0 0 3 15 0 0 0 0 0 2 
0 0 22 0 0 5 0 0 0 1 7 0 0 0 0 0 0 7 17 1 13 0 0 0 
