24 14
0 17 13 0 0 0 15 0 0 7 4 6 0 0 0 5 0 0 21 0 0 0 0 17 
0 1 0 2 3 2 8 0 3 4 12 0 0 11 0 0 0 8 0 15 3 0 1 0 
0 0 15 1 0 0 4 13 0 6 6 7 0 0 0 6 0 0 9 0 13 0 1 2 
0 0 7 9 0 13 3 6 6 5 0 0 0 4 6 7 4 8 23 0 0 22 0 7 
0 10 18 0 5 8 2 0 0 0 3 15 0 0 0 0 5 13 1 20 0 0 18 3 
0 21 9 0 7 11 3 0 13 18 0 24 0 8 0 2 16 2 0 8 9 5 21 0 
0 35 21 2 0 3 10 6 0 13 13 6 0 0 0 28 0 15 2 2 10 11 20 0 
22 0 9 0 0 0 5 0 0 8 0 0 0 12 0 5 0 4 9 3 1 7 22 0 
0 0 2 8 2 6 8 2 8 4 12 0 0 25 9 2 0 14 7 7 3 0 5 10 
0 4 2 12 0 0 0 0 9 0 1 19 0 0 0 13 0 15 0 8 0 19 0 33 
3 0 0 0 5 0 16 0 0 5 0 5 0 0 0 0 0 0 0 13 0 7 0 1 
13 14 0 0 0 4 0 0 0 6 10 1 14 12 12 3 0 0 13 18 3 0 15 1 
11 1 10 12 0 8 6 9 1 8 3 16 1 24 14 4 0 0 9 2 20 2 0 0 
7 4 0 0 0 0 3 1 1 0 10 0 9 0 0 0 7 0 0 5 0 21 0 5 
