24 14
0 0 0 8 9 0 0 0 0 8 0 20 0 0 0 0 5 0 0 0 0 0 12 0 
0 2 12 0 15 12 29 1 11 0 0 2 0 2 2 1 0 1 0 2 8 6 67 0 
11 0 0 0 16 9 3 0 6 1 0 9 0 4 5 11 8 9 13 1 16 19 0 0 
19 15 4 0 17 22 11 0 0 3 17 1 7 15 4 0 7 20 8 32 17 5 0 13 
0 3 13 0 6 0 3 0 14 0 0 3 1 1 1 13 0 6 0 0 0 2 1 20 
7 21 0 0 14 0 2 7 13 5 0 0 9 4 0 0 0 4 3 1 2 1 15 0 
5 25 1 15 1 0 7 6 0 7 3 0 3 0 5 0 0 0 0 21 14 0 0 0 
0 17 3 5 4 0 4 0 0 0 7 7 9 2 0 12 4 0 0 0 3 27 0 0 
0 0 0 0 0 0 5 0 0 0 0 0 0 0 0 0 0 0 0 0 0 6 0 0 
2 31 8 10 9 0 0 0 0 6 6 0 11 26 0 7 3 0 1 16 19 0 15 11 
0 0 0 1 14 2 0 2 9 1 17 0 8 9 0 0 8 6 24 3 10 3 0 2 
8 1 0 7 9 0 2 13 9 2 0 26 0 10 0 0 0 9 11 0 5 0 0 0 
0 21 0 0 9 0 0 0 11 0 0 9 0 18 0 5 0 0 5 0 6 0 8 1 
0 16 0 0 16 0 6 1 0 0 5 0 8 10 0 16 12 16 0 3 0 10 0 0 
