24 14
0 6 0 1 0 12 17 0 0 12 10 16 2 14 5 0 0 25 0 0 0 0 0 17 
10 8 0 11 1 1 0 0 7 4 10 3 2 1 0 7 8 0 3 0 0 9 0 10 
0 9 0 0 0 0 0 0 0 0 11 0 0 3 0 0 3 0 2 8 0 11 0 10 
0 2 1 5 5 0 12 0 1 5 0 0 8 0 6 0 0 3 12 0 1 12 0 11 
14 1 3 10 0 8 0 0 3 0 0 3 0 10 5 12 0 4 2 14 0 0 0 9 
16 13 0 12 6 0 0 6 0 1 13 0 2 0 5 5 18 0 6 0 8 0 0 9 
0 6 0 0 5 13 9 13 13 4 0 0 8 0 8 1 12 7 0 0 0 10 15 0 
0 5 0 0 5 0 1 0 4 0 0 0 2 9 0 0 3 13 3 0 3 3 0 11 
3 5 0 7 11 15 0 0 0 2 2 7 6 0 0 6 0 12 5 0 13 0 0 0 
24 2 0 8 0 0 0 0 0 0 0 9 0 1 6 0 0 0 0 0 26 21 0 2 
1 3 5 10 4 4 0 5 13 2 10 10 9 13 4 0 0 0 23 21 0 15 0 5 
11 0 0 26 6 0 12 0 0 0 0 0 9 0 14 1 0 0 6 0 0 2 19 4 
3 4 0 11 14 17 0 16 7 21 0 14 18 2 3 0 12 0 0 2 0 9 7 11 
0 17 0 5 12 0 0 14 12 13 13 4 5 15 0 0 9 0 14 2 11 6 0 0 
