24 14
19 11 0 26 0 4 1 6 11 0 11 0 6 10 11 0 0 0 15 26 2 21 2 17 
0 0 6 0 0 1 7 3 2 4 0 0 3 0 0 3 10 0 0 0 0 0 0 0 
36 0 0 0 1 3 0 0 15 5 0 9 3 0 9 15 0 0 9 3 15 17 0 17 
6 0 0 0 2 17 7 16 3 29 1 0 7 14 6 0 5 4 0 11 10 2 0 46 
17 5 4 0 0 4 0 3 0 8 2 0 4 13 7 0 3 0 0 3 0 0 1 5 
19 18 0 0 0 3 0 0 0 5 7 0 6 0 0 5 7 3 0 10 0 3 1 0 
14 6 0 2 10 17 0 2 4 19 2 0 0 0 7 10 0 0 9 0 0 3 7 0 
4 0 13 0 0 0 12 0 8 4 2 0 3 11 0 9 1 0 0 1 3 15 3 1 
22 13 25 0 0 6 0 2 2 2 2 0 2 0 9 4 2 3 22 4 6 0 6 0 
13 5 6 1 0 0 0 19 0 23 13 0 0 5 7 0 0 0 0 10 0 41 0 7 
2 0 0 4 0 0 0 0 0 0 10 2 2 2 0 0 0 0 0 5 10 2 3 0 
0 0 2 0 15 0 0 7 0 2 0 0 0 8 23 0 0 5 0 0 9 0 0 0 
0 0 20 0 0 0 0 0 9 22 0 0 2 0 0 1 7 0 9 0 0 0 20 6 
21 0 7 9 25 12 1 1 13 4 0 4 0 0 12 2 0 0 14 4 38 8 29 10 
