24 14
0 0 0 5 2 0 2 0 0 0 0 10 9 1 7 0 0 5 5 0 2 23 0 0 
0 5 44 3 35 0 4 4 0 3 0 9 5 0 2 0 8 6 16 0 0 1 0 21 
0 0 3 0 7 6 0 0 0 0 3 6 0 11 0 0 0 10 0 0 3 6 1 0 
13 6 0 0 2 0 0 0 0 0 0 0 11 4 0 0 0 3 9 0 0 3 1 0 
21 4 2 18 0 3 4 7 0 35 0 0 12 0 9 0 0 22 0 0 0 25 3 6 
3 19 12 7 0 10 1 0 3 13 3 7 1 1 4 0 16 1 25 9 19 0 18 0 
11 16 4 2 0 0 4 0 0 0 7 4 0 0 3 0 0 30 5 0 17 0 2 0 
27 13 0 1 10 13 0 16 0 0 0 0 0 9 13 0 2 16 15 1 2 1 3 23 
4 18 9 10 24 2 7 13 0 0 22 0 5 0 8 13 6 0 12 19 13 18 0 0 
0 0 0 0 8 0 14 7 0 0 3 1 0 0 5 0 8 0 0 2 20 0 5 0 
2 7 0 4 16 3 0 0 2 0 1 9 0 8 14 0 6 0 0 0 16 21 6 0 
0 0 5 19 0 0 3 0 0 7 1 0 7 0 5 0 10 0 2 3 0 0 19 0 
12 0 10 0 0 2 13 0 9 0 0 0 0 0 0 0 0 3 11 11 0 2 0 18 
14 15 19 1 2 31 0 20 0 0 5 2 6 0 0 15 15 6 9 0 15 50 0 0 
