24 14
14 6 4 0 19 0 1 24 7 9 0 9 0 4 12 13 0 0 16 12 0 13 0 4 
0 7 0 0 5 0 8 12 5 0 7 11 0 7 3 0 0 7 0 0 0 0 0 2 
1 5 10 12 8 17 3 10 0 15 2 5 12 10 8 9 3 4 0 14 0 6 9 7 
13 3 0 23 10 0 0 3 3 0 0 3 0 7 15 0 0 6 0 0 0 7 0 22 
0 26 0 0 4 5 6 0 0 0 5 0 0 0 12 0 5 0 0 8 0 25 0 9 
23 1 7 35 0 0 5 0 0 6 0 2 8 3 0 19 0 0 0 0 0 0 19 3 
29 5 0 3 13 1 0 3 23 0 5 7 0 6 2 4 2 2 4 2 10 2 14 17 
0 0 0 0 0 2 0 0 0 0 9 0 3 0 0 3 0 5 0 9 0 0 5 7 
0 4 0 18 4 4 0 13 5 14 0 0 0 7 0 10 13 1 11 13 9 7 5 15 
0 5 0 4 0 5 0 0 0 0 0 0 0 0 0 0 0 0 0 4 0 0 0 4 
8 0 0 18 0 0 15 5 0 0 0 8 11 17 0 0 0 0 4 4 2 25 0 8 
14 8 6 27 0 0 0 16 9 4 0 0 0 6 9 9 18 5 0 0 4 0 9 3 
6 0 0 0 0 0 13 14 2 6 1 8 0 10 21 14 1 0 2 9 4 0 0 28 
22 0 11 7 11 0 4 25 6 14 7 0 4 0 4 0 0 0 4 4 0 0 0 10 
