24 14
0 3 0 0 21 0 9 11 5 0 0 5 1 0 0 2 2 3 10 8 1 4 18 0 
17 21 9 5 0 0 0 17 19 0 0 3 4 0 0 1 0 9 10 22 0 0 7 23 
24 0 7 0 15 3 0 0 0 0 10 0 4 10 14 21 4 11 6 15 11 20 7 10 
7 1 3 12 7 0 1 1 5 0 0 8 7 0 0 0 0 0 0 15 0 1 0 0 
6 0 0 15 0 4 10 1 0 3 8 4 0 24 5 5 15 4 12 1 14 5 2 5 
0 9 0 13 7 0 1 0 32 0 0 3 0 19 11 4 23 0 10 4 15 8 9 22 
2 0 4 0 0 3 1 12 1 1 2 12 0 0 0 0 0 0 4 12 0 4 4 10 
20 0 4 4 0 0 3 1 1 7 0 7 2 2 2 3 2 4 0 3 0 4 3 0 
17 0 1 7 3 10 0 0 5 2 0 0 0 0 0 10 8 4 0 0 4 0 0 0 
0 2 1 5 1 1 9 0 9 0 0 0 1 7 6 4 0 0 3 6 0 9 9 0 
36 0 22 0 5 0 0 9 1 2 0 1 6 13 14 9 16 10 2 0 5 0 6 0 
0 2 0 14 1 0 0 12 5 0 9 0 3 0 0 0 0 13 14 17 0 0 9 0 
0 33 1 0 0 0 0 0 1 0 0 11 1 0 5 0 4 0 3 0 10 20 3 0 
6 0 4 12 0 0 0 0 6 0 0 0 0 0 6 0 0 11 2 0 0 0 0 0 
