24 14
0 0 0 1 0 2 0 5 1 0 1 10 3 1 10 7 0 0 10 0 0 10 0 0 
0 8 0 0 8 0 0 19 0 0 1 0 0 0 0 0 0 0 10 0 0 0 0 0 
18 22 11 0 7 18 13 0 0 0 10 7 12 4 8 0 4 0 13 4 17 11 4 22 
8 0 22 3 10 0 6 3 0 2 3 14 0 0 10 13 0 0 2 3 1 1 12 0 
0 0 27 34 18 10 3 7 0 8 0 1 6 4 9 6 0 5 0 17 12 18 38 0 
0 26 4 18 3 5 1 2 7 0 0 11 0 0 0 20 5 2 7 0 1 0 0 0 
0 0 16 2 3 4 0 6 12 0 0 6 0 6 0 0 0 0 16 4 12 0 0 0 
18 0 6 24 13 5 2 2 5 15 0 4 3 7 0 2 0 15 22 3 0 0 13 20 
2 0 2 0 2 0 1 0 0 0 7 0 0 0 4 0 3 1 0 0 0 1 5 0 
0 11 1 4 6 0 6 13 0 0 0 0 8 7 5 0 0 13 0 0 12 1 0 0 
10 1 19 18 2 14 15 11 0 16 1 2 5 0 5 10 0 0 3 3 0 50 24 19 
8 17 15 13 0 8 0 6 6 1 13 8 16 3 0 0 6 6 4 7 0 18 0 16 
32 24 8 0 0 0 0 11 0 0 0 0 12 13 12 16 7 2 11 0 20 6 10 0 
0 0 10 0 0 0 0 0 0 0 5 12 11 0 0 1 0 0 0 3 11 11 8 0 
