24 14
2 0 0 0 0 0 0 16 0 0 9 4 0 11 0 0 0 0 0 20 0 0 0 0 
5 8 3 3 4 1 4 6 4 7 0 0 0 1 0 0 0 0 15 4 2 10 2 13 
15 3 3 14 19 1 20 26 3 1 6 8 1 12 8 10 0 23 18 4 1 12 4 7 
10 15 0 0 0 0 0 10 4 7 0 6 4 0 3 0 15 13 0 0 5 0 10 0 
26 5 13 0 7 4 0 8 3 11 0 3 8 8 0 15 16 0 16 5 8 0 3 0 
42 47 10 12 13 0 0 1 0 13 0 0 16 16 0 4 13 0 0 13 19 43 0 2 
22 23 13 19 4 0 0 3 6 2 6 2 6 0 10 0 0 5 0 0 2 15 4 27 
0 1 0 0 0 0 0 2 0 7 3 0 0 3 4 0 2 0 0 0 6 0 5 6 
0 0 0 17 0 14 3 14 0 13 0 5 2 0 3 0 15 3 0 12 17 16 0 0 
34 5 0 0 0 0 0 11 13 2 3 6 0 13 0 0 0 6 0 5 0 8 2 0 
20 0 0 0 0 0 0 0 0 2 12 7 2 5 5 1 0 0 1 0 12 9 12 9 
7 0 26 0 7 24 0 5 0 5 9 0 6 3 0 3 11 1 23 26 3 30 7 5 
0 5 1 0 11 0 0 22 0 2 0 0 1 11 0 21 0 0 0 12 6 0 0 0 
18 3 12 1 11 0 12 9 0 0 0 11 1 19 0 0 0 0 0 3 0 0 13 7 
