24 14
24 0 4 6 4 5 0 0 2 6 15 0 4 6 0 5 0 1 0 0 10 0 1 20 
2 1 17 2 5 3 0 10 17 0 0 0 12 3 0 0 0 0 0 17 12 9 0 21 
1 12 0 0 23 0 0 0 0 8 3 11 5 4 2 11 10 13 1 8 9 0 2 6 
3 0 0 0 4 0 0 9 0 0 0 0 1 0 0 7 9 10 0 0 0 0 2 0 
12 14 3 26 0 14 9 0 11 1 3 6 31 9 1 0 2 3 0 11 5 18 15 0 
15 18 11 7 0 5 0 20 5 0 12 10 5 6 18 0 4 0 0 6 3 7 12 7 
8 0 0 0 14 0 0 4 0 14 11 4 12 6 0 0 3 23 4 3 1 0 10 18 
18 16 16 0 5 0 0 0 14 0 2 0 0 3 0 0 0 16 2 0 3 0 14 0 
7 9 7 7 4 1 13 7 0 7 6 13 0 3 4 4 1 0 2 0 15 0 5 0 
3 0 0 0 21 1 0 14 0 0 0 0 0 0 0 0 1 10 1 15 15 16 0 0 
0 0 0 1 14 6 0 10 0 8 4 6 0 9 0 0 4 18 13 6 2 0 0 15 
0 8 16 1 5 0 0 2 5 2 9 0 6 11 0 8 0 5 6 5 0 10 0 0 
9 0 0 0 7 0 0 0 4 0 0 0 6 0 4 0 16 0 0 6 7 0 8 7 
8 21 1 1 10 0 9 0 0 0 7 10 19 0 0 14 0 6 0 0 0 1 1 0 
