24 14
0 0 0 0 9 26 0 0 0 0 0 0 0 0 3 12 0 2 0 16 10 0 0 0 
20 18 0 0 18 0 15 0 0 0 7 0 0 1 0 5 3 3 3 18 22 26 18 0 
15 0 12 3 0 0 0 0 10 0 0 8 0 0 12 0 0 0 18 1 0 0 0 0 
0 18 28 28 0 0 0 21 4 16 11 0 7 0 3 6 8 0 0 5 15 14 0 16 
0 31 21 9 15 0 11 0 0 0 3 5 0 0 0 0 0 5 1 13 0 0 12 51 
0 0 0 0 7 0 0 0 4 2 8 0 7 2 0 0 0 0 0 0 0 0 0 0 
7 0 18 36 3 2 0 3 0 7 0 0 0 11 9 16 0 0 0 4 12 7 0 9 
0 32 0 1 1 4 0 3 5 20 0 0 10 2 0 14 0 9 3 0 1 12 13 0 
0 0 0 2 0 18 10 1 3 2 0 1 2 0 0 0 0 11 1 0 1 0 0 17 
0 0 17 5 20 0 12 17 3 0 1 5 15 10 0 0 1 9 8 26 8 14 16 1 
20 1 1 9 1 4 15 1 1 14 0 0 0 7 7 3 1 14 4 5 4 4 3 12 
0 2 8 9 1 0 13 0 0 0 0 0 10 0 0 0 0 0 0 13 1 0 29 0 
3 0 5 1 6 3 11 0 31 1 9 8 0 0 4 22 0 11 18 3 6 11 0 23 
7 6 8 18 14 0 3 0 0 7 23 0 0 5 3 3 0 13 21 0 3 0 5 0 
