24 14
2 0 4 8 27 0 0 10 3 9 0 6 8 0 0 2 9 31 14 7 14 6 10 0 
0 7 2 0 1 13 8 6 0 0 5 8 0 0 3 0 0 0 1 3 2 1 4 0 
5 22 0 11 2 0 0 7 4 14 0 0 4 9 22 7 8 0 0 0 0 0 8 40 
0 0 0 1 9 2 0 6 7 3 8 0 0 8 7 0 7 0 0 0 0 0 0 2 
38 2 21 1 3 0 8 9 8 2 0 11 0 0 3 0 25 0 14 17 13 1 4 0 
0 6 0 0 0 0 0 10 4 3 0 3 0 0 3 1 0 0 10 0 0 1 7 0 
11 17 0 7 0 13 16 0 19 4 0 0 0 0 0 1 0 17 4 0 0 11 16 2 
5 0 11 6 8 4 4 11 14 0 0 6 0 7 0 6 0 6 0 4 3 7 0 4 
6 7 2 9 4 0 0 9 5 1 0 0 7 6 0 3 0 0 7 17 13 0 0 5 
0 0 11 0 0 8 19 0 2 0 17 0 2 18 7 0 7 0 0 0 6 0 0 13 
22 1 0 12 6 0 0 0 3 2 0 8 0 0 14 10 8 0 0 5 3 0 14 20 
6 1 0 2 9 9 20 5 19 1 15 7 6 6 4 0 0 2 7 0 14 20 0 14 
0 0 35 1 10 16 0 0 14 0 0 10 0 0 6 1 0 15 0 11 3 16 13 0 
0 20 0 1 0 0 9 10 0 5 5 3 2 0 24 26 13 10 0 0 4 20 0 0 
