24 14
0 0 29 10 2 14 6 5 10 6 0 5 7 13 6 0 0 0 5 8 7 10 13 0 
4 5 5 0 2 2 14 0 6 0 0 11 20 9 3 12 0 0 1 0 0 0 9 16 
3 26 0 7 17 15 2 5 1 0 0 0 3 1 10 0 4 4 17 0 19 4 0 11 
2 0 2 0 4 3 0 1 19 18 0 5 3 17 4 5 9 0 2 2 0 0 14 16 
0 0 2 0 2 0 2 0 0 0 0 0 0 11 2 3 0 0 5 4 0 0 9 0 
5 27 7 0 14 2 0 0 7 17 0 5 0 1 0 12 12 0 0 8 0 18 5 0 
22 0 4 9 0 0 9 2 7 0 0 0 30 5 0 7 0 4 6 6 2 19 19 5 
0 1 6 0 0 2 0 11 6 2 1 0 2 0 2 0 0 3 0 0 16 0 0 0 
9 4 17 5 19 2 4 4 12 9 11 12 5 0 7 23 13 1 0 21 6 21 2 12 
0 0 11 0 8 6 0 0 8 7 2 8 3 19 0 0 0 0 6 3 0 0 4 6 
0 0 15 0 0 0 0 16 0 7 0 0 9 10 20 5 0 0 0 6 0 0 0 16 
12 30 4 0 2 0 3 0 0 11 14 0 15 33 0 0 6 0 16 0 0 8 1 12 
1 12 0 0 0 0 0 0 0 3 4 0 13 3 0 0 3 0 0 3 0 0 6 1 
0 0 0 0 10 12 5 5 1 0 0 4 14 0 0 0 0 0 0 0 0 0 17 0 
