24 14
0 0 0 0 0 28 11 0 0 0 2 0 2 0 9 0 16 0 0 0 11 5 17 8 
0 0 0 0 32 0 0 9 4 0 5 0 4 16 0 0 4 7 9 0 13 0 1 3 
18 0 5 0 18 16 1 1 11 13 3 1 0 5 0 11 0 10 1 0 0 16 1 0 
0 0 10 6 16 10 0 0 8 10 0 0 0 0 10 10 4 11 3 14 25 2 0 2 
22 0 0 27 4 0 0 7 22 0 12 0 0 4 7 0 8 0 5 1 16 0 36 22 
6 2 31 6 3 0 6 4 6 6 9 9 0 8 0 13 7 0 0 0 0 0 0 19 
23 0 1 10 22 13 0 0 26 0 6 0 0 10 2 4 0 0 14 4 0 0 32 23 
3 12 11 3 0 0 0 6 5 4 0 0 0 6 4 0 1 7 3 0 7 4 0 6 
0 0 0 0 2 0 7 0 6 0 0 0 0 4 0 0 5 0 0 4 5 0 14 1 
7 0 15 4 0 0 0 0 3 0 0 0 10 5 0 0 3 15 3 1 0 0 0 1 
3 30 1 20 2 7 0 9 5 1 11 0 13 0 2 0 1 1 2 0 19 21 1 20 
44 16 6 12 7 1 4 6 1 4 10 3 0 0 8 15 8 9 0 0 8 17 9 47 
7 0 3 8 0 4 1 0 8 0 5 12 2 0 2 3 3 19 2 0 2 0 0 8 
21 17 9 6 0 0 0 0 7 7 5 1 2 0 2 1 0 0 17 0 0 27 0 0 
