24 14
39 0 0 0 0 6 1 5 0 0 0 6 5 10 20 22 12 0 7 19 0 0 7 8 
4 24 6 4 3 8 4 0 5 0 0 4 10 8 9 4 11 0 1 20 21 0 8 9 
0 3 3 0 38 11 4 0 2 0 0 0 8 9 3 0 4 0 0 15 0 0 8 19 
3 2 0 23 4 0 3 1 5 0 5 1 0 0 3 4 11 0 1 0 8 0 0 15 
5 5 0 0 0 0 13 0 6 9 13 4 0 7 20 2 7 6 0 13 0 0 2 20 
19 3 9 1 3 3 12 22 0 7 8 11 4 0 11 0 12 17 18 13 0 14 28 5 
7 0 14 0 2 7 2 5 9 2 0 0 0 0 1 11 1 15 5 0 0 14 1 0 
0 0 11 10 0 0 0 5 0 0 0 3 5 1 0 0 0 0 3 4 1 0 0 0 
19 7 5 17 3 15 0 5 0 4 14 17 0 0 3 0 0 0 5 10 32 0 8 0 
18 9 0 0 0 10 0 14 2 2 5 2 9 0 9 0 3 0 0 1 5 22 0 0 
9 5 0 1 1 12 0 5 8 6 9 1 0 0 8 20 0 23 0 3 2 0 11 0 
0 6 0 0 0 0 2 6 5 0 0 0 0 7 13 0 2 0 7 5 2 13 0 0 
6 0 11 0 0 0 0 0 0 18 0 11 3 3 12 3 13 17 0 0 0 4 7 12 
0 9 0 4 0 2 21 6 4 0 25 0 7 0 8 10 2 0 8 20 0 0 0 0 
