24 14
25 22 0 12 11 0 0 0 0 9 4 4 2 0 10 5 29 0 0 0 11 2 0 22 
5 6 0 0 7 1 12 0 0 1 7 2 0 1 9 0 4 0 7 7 4 7 0 21 
0 0 0 10 0 4 1 3 13 2 0 37 4 0 0 0 5 14 0 0 9 29 6 4 
15 14 8 11 20 0 0 3 14 0 7 6 4 1 1 1 4 5 2 0 6 29 2 10 
3 0 15 3 7 0 0 0 0 0 9 6 0 0 0 8 4 2 3 0 5 4 0 0 
0 20 9 0 0 1 0 8 4 0 0 1 4 6 0 0 7 0 2 8 4 20 4 7 
50 6 1 2 0 19 0 20 0 0 3 3 12 7 0 2 16 22 5 7 20 16 12 5 
0 6 1 0 0 1 15 0 8 0 0 0 0 5 8 0 3 0 2 1 3 15 8 5 
4 0 4 3 0 12 7 0 17 0 0 0 0 0 7 7 2 6 16 6 4 10 14 15 
0 0 0 0 0 0 4 15 0 4 5 6 0 12 0 4 0 1 10 1 3 0 4 0 
23 0 0 0 1 1 0 2 1 2 0 3 0 0 0 0 0 1 0 2 0 0 0 23 
0 0 11 0 6 0 1 0 14 0 6 2 1 1 0 0 2 0 2 0 10 17 14 9 
26 12 21 2 0 6 11 4 0 10 0 6 0 10 0 3 7 0 15 19 18 0 1 20 
19 0 0 0 15 0 4 6 5 2 0 11 0 3 4 8 9 12 6 3 0 11 7 14 
