24 14
13 1 18 0 28 23 4 5 4 9 10 11 0 8 3 11 12 0 1 8 25 0 0 5 
6 0 0 8 0 12 4 1 0 0 0 0 0 0 11 0 0 0 0 3 0 0 3 7 
0 18 1 1 0 9 1 1 23 0 0 0 0 10 9 0 13 1 4 16 17 2 0 17 
0 0 1 0 23 3 6 0 2 0 6 7 4 0 16 7 8 12 9 6 5 0 8 0 
5 19 4 0 0 0 3 11 25 9 0 0 3 16 0 1 0 6 8 14 19 2 0 15 
0 0 20 5 0 0 0 8 4 8 0 0 0 3 4 0 8 2 14 0 0 0 22 4 
7 2 0 5 7 13 3 4 3 0 0 6 0 11 0 0 3 0 1 0 2 2 1 1 
2 14 0 0 13 0 0 16 3 2 0 4 5 10 3 8 1 13 2 6 4 0 0 16 
23 0 14 0 11 0 13 3 24 4 3 9 8 9 0 8 25 0 3 5 7 0 14 7 
2 0 0 7 0 0 3 0 8 4 11 7 0 13 10 4 3 7 10 6 0 0 19 7 
0 0 0 5 0 0 15 1 6 0 0 10 0 1 0 7 0 2 0 0 0 0 16 0 
0 0 7 8 19 14 0 5 2 4 0 12 5 10 2 0 2 4 16 2 5 0 3 37 
0 0 0 10 0 12 1 7 6 0 0 0 0 8 17 0 12 0 5 0 0 0 0 3 
0 11 2 9 0 10 4 18 9 8 10 0 0 2 0 2 0 5 0 0 0 4 15 8 
