26 15
0 11 2 0 6 5 0 11 16 4 0 0 0 7 0 3 12 9 14 0 16 13 0 11 11 0 
8 0 7 7 0 11 0 9 8 14 0 0 12 9 4 11 24 5 9 0 4 0 15 0 16 0 
0 0 23 0 0 0 0 0 1 14 11 0 0 0 0 0 0 10 3 9 0 14 0 14 22 10 
0 20 22 1 27 0 0 0 27 3 5 3 3 1 22 10 2 6 16 7 17 3 3 20 16 11 
7 0 27 5 0 0 17 17 14 26 14 0 0 4 0 0 0 8 0 21 11 0 4 25 8 2 
0 0 0 22 5 14 0 0 0 0 0 0 0 0 3 2 0 2 13 0 0 0 0 0 0 14 
0 0 0 0 19 17 6 0 22 0 6 0 8 0 7 0 6 0 0 9 2 16 0 16 16 0 
0 0 0 0 0 0 0 0 0 1 0 13 6 9 10 0 0 2 0 5 4 0 2 0 28 0 
0 0 8 0 8 0 0 0 6 16 8 0 3 0 21 0 0 5 9 5 6 19 0 0 0 0 
0 0 1 5 0 0 0 0 0 1 2 0 4 5 0 0 0 0 0 0 0 0 2 0 0 0 
19 0 10 9 0 0 0 0 9 4 9 6 16 0 0 5 0 6 0 10 18 1 0 0 0 5 
17 9 0 2 0 0 0 18 0 1 2 0 0 0 16 1 0 0 0 0 0 1 8 17 13 0 
0 0 9 6 0 0 5 0 6 6 0 0 1 0 9 12 1 6 0 9 0 0 0 0 5 10 
0 0 0 0 18 12 0 0 0 12 0 0 16 3 8 0 12 5 0 4 0 2 10 0 0 9 
0 0 9 4 11 0 0 20 0 6 11 16 0 16 13 0 19 0 7 11 0 14 11 14 11 0 
