26 15
14 6 6 2 0 0 11 11 1 4 0 9 0 0 0 4 16 0 9 4 9 0 0 0 0 0 
12 11 12 2 0 0 0 0 11 0 7 0 11 11 0 2 3 21 18 19 0 0 1 3 1 0 
2 4 20 3 0 7 8 0 0 11 20 17 14 16 1 5 0 0 0 13 8 11 12 0 0 0 
18 0 21 11 9 0 0 0 0 0 0 0 0 9 0 0 0 0 9 0 0 0 0 39 0 2 
3 2 0 0 0 3 0 0 3 8 3 0 11 8 4 0 0 8 15 0 0 0 0 0 1 0 
1 0 25 12 9 0 0 17 0 0 0 13 4 0 0 5 3 8 7 0 0 9 20 7 26 10 
4 5 3 0 2 0 0 5 0 0 1 5 0 5 0 4 0 0 3 0 0 4 0 0 1 0 
0 0 6 4 0 0 0 0 0 0 0 0 10 0 0 0 0 2 19 10 6 0 0 0 1 0 
10 0 12 8 0 0 0 16 0 0 0 0 0 0 12 4 7 0 2 0 4 0 16 1 0 0 
2 6 15 3 0 0 5 13 0 0 4 3 0 3 8 8 2 4 5 3 4 3 1 8 0 0 
4 29 14 18 0 0 41 0 3 0 0 18 6 11 11 0 0 11 13 8 14 23 0 19 7 1 
0 12 0 0 2 19 2 11 14 17 9 0 8 21 0 0 0 0 0 0 0 0 0 3 16 0 
0 2 0 2 0 0 0 12 10 0 0 3 11 0 0 4 0 0 11 0 0 0 0 24 0 0 
3 2 16 0 5 0 9 0 10 31 12 4 3 10 6 0 3 3 2 0 6 5 9 0 15 3 
14 0 0 0 9 0 14 17 0 3 0 0 0 4 0 0 0 0 0 7 0 0 0 1 16 0 
