26 15
0 13 11 0 0 0 8 0 0 2 0 4 0 14 20 4 8 0 4 3 9 5 0 0 11 0 
0 11 0 0 0 12 0 0 0 0 7 10 11 15 0 0 9 19 13 0 0 0 0 11 0 3 
0 0 0 2 0 0 0 0 8 0 0 7 6 0 0 7 5 1 24 0 9 0 4 0 13 0 
30 0 0 0 0 3 2 2 21 3 7 8 12 0 0 0 0 0 3 6 9 3 1 0 4 4 
5 0 0 0 0 5 0 13 0 7 6 1 12 0 13 0 10 0 0 0 16 0 5 0 0 20 
0 3 0 22 0 18 15 13 20 0 0 0 0 1 0 7 0 2 0 3 0 7 13 18 7 17 
12 38 19 0 3 0 0 11 0 0 0 11 17 5 7 14 1 0 7 0 3 11 7 0 0 36 
17 26 0 2 12 0 0 0 9 0 7 0 0 0 0 0 11 9 0 2 4 0 0 0 8 25 
0 8 14 0 0 0 0 0 14 0 0 2 11 0 0 0 0 15 7 6 3 0 3 3 0 6 
0 0 1 0 10 17 9 15 0 0 0 10 5 0 3 2 12 0 5 2 7 5 32 2 1 1 
24 23 1 0 1 2 0 19 28 0 0 7 0 0 0 0 10 0 0 0 3 13 5 13 16 0 
22 0 7 0 0 20 8 0 0 3 9 6 10 10 0 0 5 0 0 5 14 18 25 2 15 15 
0 21 0 19 0 0 24 0 4 0 0 0 4 9 8 0 0 0 3 0 15 15 47 11 2 0 
0 24 0 16 0 0 0 0 1 0 8 5 0 0 0 0 3 0 6 10 0 0 0 0 0 2 
25 15 0 0 0 0 0 0 12 16 0 3 0 6 2 0 17 0 0 0 5 26 0 0 14 12 
