26 15
6 23 0 0 0 1 1 0 0 0 5 0 0 2 0 8 3 3 22 18 2 3 0 2 1 26 
0 0 19 8 7 4 1 12 3 0 5 0 0 4 9 0 0 0 0 2 0 9 0 9 0 0 
0 0 2 0 17 3 0 0 3 2 10 3 0 0 5 0 0 0 7 0 16 4 0 5 0 24 
0 4 0 18 0 9 0 0 7 0 5 0 0 5 0 9 3 0 0 0 0 27 0 0 3 0 
0 10 0 0 0 0 5 0 5 3 0 8 6 0 0 0 0 5 0 7 5 23 0 14 0 1 
0 6 4 10 0 9 11 0 8 19 11 15 0 14 0 0 8 5 4 2 11 1 0 0 5 0 
6 0 0 16 12 0 0 0 0 0 4 2 8 6 0 0 0 2 0 24 0 8 0 0 3 0 
4 12 0 0 15 0 0 3 0 0 0 0 0 12 0 0 0 0 0 37 0 5 0 28 0 0 
17 24 22 3 8 17 0 6 0 22 1 3 1 0 0 4 0 23 13 15 1 4 0 14 0 1 
18 2 0 30 10 3 0 15 3 1 0 9 0 6 10 0 0 3 22 6 30 5 0 2 5 8 
0 25 0 0 37 0 9 14 0 2 12 10 9 0 3 11 6 2 0 0 15 8 30 0 19 1 
16 26 0 0 14 20 6 5 11 0 5 0 0 6 0 14 16 0 18 10 0 14 17 20 0 4 
0 0 0 0 0 0 8 0 2 0 10 0 5 1 0 0 0 0 0 0 1 3 0 0 6 0 
3 28 15 9 3 2 0 6 0 9 0 0 0 0 3 12 0 24 0 3 0 0 3 0 0 24 
19 1 16 0 2 4 0 8 0 0 3 0 0 0 0 0 1 0 0 19 5 5 0 0 8 0 
