26 15
8 0 0 4 5 0 1 13 0 2 9 7 3 14 5 1 12 0 0 2 8 6 3 0 0 0 
0 9 10 11 6 28 0 5 44 0 0 1 0 1 29 1 0 12 16 0 0 5 20 0 0 17 
0 0 3 0 3 6 19 5 0 27 0 5 0 9 1 5 0 0 0 0 14 12 0 0 18 19 
3 0 0 0 7 0 0 0 0 0 0 3 0 0 0 0 0 0 0 0 0 2 0 0 0 2 
0 0 11 0 0 6 19 0 0 5 0 0 0 11 5 4 0 0 3 0 0 0 0 0 10 19 
12 0 18 0 19 0 0 48 4 12 15 7 0 5 9 2 9 12 4 0 45 12 0 0 0 17 
0 0 9 0 0 0 9 6 8 4 0 29 2 9 0 2 0 6 6 6 21 2 0 12 0 4 
0 0 0 0 6 1 1 7 0 0 0 0 7 0 0 0 0 0 3 0 5 7 0 0 0 0 
13 0 4 0 13 0 10 0 7 7 0 2 0 15 0 3 19 17 0 0 9 5 0 0 0 19 
8 4 23 0 2 0 2 0 1 0 8 0 0 0 0 3 0 0 0 2 5 1 0 0 3 24 
0 9 22 0 28 6 8 0 3 0 1 19 0 2 0 0 0 2 20 2 0 4 0 12 1 23 
38 0 1 1 2 0 8 10 0 3 1 4 0 0 0 6 0 6 0 11 3 0 15 6 24 3 
11 0 4 16 0 0 2 16 13 7 0 17 0 0 6 8 8 12 11 11 1 25 0 0 17 18 
0 4 5 13 0 0 0 13 0 9 4 0 0 0 4 0 13 0 0 10 0 4 0 0 0 4 
0 0 2 0 0 0 4 0 9 1 2 0 7 12 13 0 0 2 4 1 0 4 0 4 0 6 
