26 15
0 0 23 14 0 0 0 0 16 0 0 7 0 0 0 0 0 33 0 0 0 10 5 2 3 13 
15 12 0 0 0 0 12 0 13 6 7 1 12 10 14 5 17 1 30 0 0 13 2 9 1 0 
39 8 10 6 14 18 0 4 0 3 0 4 2 10 2 0 2 17 11 5 0 24 3 28 3 0 
0 0 0 0 0 0 3 0 2 9 0 15 3 3 3 3 5 4 7 0 0 5 1 0 8 14 
0 0 11 19 0 0 0 0 13 7 4 0 0 11 13 6 9 2 4 0 0 10 19 0 0 17 
0 0 23 0 0 4 18 7 0 0 0 11 0 0 3 15 0 2 1 4 0 0 0 0 9 9 
25 0 11 8 2 38 12 8 0 28 0 6 0 5 8 2 10 1 7 10 4 7 2 10 8 83 
0 14 15 0 0 0 0 0 0 0 6 4 0 0 0 14 0 13 0 0 0 1 5 0 0 5 
7 16 6 3 7 13 0 2 2 8 0 7 6 7 0 1 6 13 13 3 19 5 0 0 0 0 
5 0 0 0 19 10 0 0 0 2 0 6 0 5 0 0 0 0 0 0 0 0 0 17 0 2 
0 12 3 9 0 3 12 2 0 0 23 10 9 0 7 0 0 3 12 9 0 0 0 32 5 0 
3 0 0 3 0 0 0 0 0 5 10 3 1 1 4 0 7 3 0 0 10 0 9 1 0 0 
0 16 20 0 0 16 6 3 5 19 0 0 6 1 0 0 0 20 2 10 0 17 18 0 1 5 
0 0 7 0 2 0 6 0 0 13 0 10 12 13 3 0 0 0 0 0 0 0 0 0 11 0 
8 0 8 11 0 0 0 19 6 0 0 0 0 1 7 0 9 1 10 0 1 7 0 8 4 0 
