26 15
0 35 0 0 0 0 0 0 0 0 0 0 0 12 0 0 0 0 0 28 1 0 0 0 23 5 
0 0 0 27 3 9 15 3 13 0 15 20 0 0 4 5 0 4 4 0 5 28 1 0 0 54 
5 0 0 0 0 5 0 6 0 0 10 10 0 9 0 0 0 10 3 0 20 10 19 0 0 0 
2 0 6 1 0 0 3 1 19 1 13 0 0 5 2 0 2 9 17 0 11 12 5 0 0 26 
0 0 0 20 0 0 0 0 0 0 4 0 0 3 28 6 3 7 1 0 7 0 3 8 19 11 
3 0 9 0 0 0 0 3 0 5 0 0 0 5 7 0 2 17 11 10 0 0 0 0 0 3 
6 16 0 5 15 0 0 0 10 0 2 0 0 2 2 2 8 0 0 10 0 0 6 10 0 0 
4 1 11 0 0 0 0 0 0 7 7 0 0 11 0 0 1 7 0 7 0 0 4 0 7 0 
8 10 1 0 0 5 0 6 0 0 0 21 0 0 0 0 0 5 7 19 0 0 0 0 7 0 
2 7 3 0 0 8 0 7 7 1 7 8 0 9 8 0 0 15 0 9 18 0 5 0 0 0 
7 0 0 0 0 1 0 5 3 0 8 1 0 4 0 0 3 0 3 4 0 3 0 0 3 0 
18 0 0 16 11 1 0 0 20 14 0 6 3 11 3 11 23 19 3 6 0 0 0 14 0 0 
20 10 0 2 0 11 0 0 15 0 2 13 9 0 18 0 0 1 2 6 2 2 21 0 8 19 
2 4 0 10 0 1 0 1 6 0 0 12 1 8 7 0 5 12 2 13 0 5 0 0 0 0 
20 9 32 15 15 5 5 27 2 13 0 0 4 11 2 18 15 0 36 19 13 0 7 16 31 36 
