26 15
9 0 0 0 0 0 19 39 10 7 9 0 0 6 12 10 14 0 19 0 0 0 0 19 18 0 
35 0 0 12 0 0 0 4 0 0 6 2 8 0 7 0 6 0 0 12 18 9 16 23 7 0 
12 8 3 9 9 3 9 10 9 8 12 14 7 0 3 12 0 19 0 0 0 8 15 0 0 22 
6 0 0 3 7 0 0 6 4 6 0 2 6 7 3 11 0 0 0 0 8 13 9 0 9 0 
36 0 0 7 0 0 2 9 0 4 7 0 0 5 0 2 0 6 0 0 13 0 0 6 0 0 
4 12 0 2 21 2 9 4 2 8 2 0 0 13 5 9 11 0 0 2 5 0 13 0 0 5 
0 0 3 0 1 1 0 16 0 0 0 0 0 8 12 0 0 0 0 6 0 3 0 16 10 0 
9 0 2 2 6 10 16 6 3 12 4 11 0 6 0 10 13 0 5 1 0 12 9 1 0 0 
0 0 3 7 0 0 0 8 0 0 0 0 6 0 0 0 8 0 0 2 0 2 0 0 7 0 
9 0 3 4 0 0 0 14 0 12 13 0 0 7 1 9 13 0 0 5 0 2 3 10 11 0 
39 0 0 0 11 0 0 0 1 0 0 13 2 0 10 0 0 17 0 1 14 13 22 0 13 0 
14 2 3 11 10 0 0 4 1 0 22 4 3 0 2 0 0 9 0 0 18 21 0 13 0 0 
0 0 0 2 5 3 6 16 8 5 0 0 20 5 12 3 7 1 8 6 13 0 3 12 0 0 
2 0 0 2 0 5 15 3 14 5 0 2 9 7 0 0 0 0 0 0 0 16 12 17 2 0 
0 0 0 4 1 0 0 24 0 0 0 5 15 0 2 0 7 0 3 0 0 4 1 0 17 13 
