26 15
0 28 0 2 3 20 0 10 0 14 0 1 12 2 5 0 7 10 7 14 1 0 9 7 0 0 
1 11 23 0 1 13 18 0 0 13 6 9 3 0 12 5 7 0 18 0 6 9 0 0 14 27 
2 24 14 0 4 3 0 0 0 0 0 0 0 5 5 0 0 8 6 13 0 0 0 0 0 1 
24 9 0 4 10 11 3 3 1 2 0 11 0 3 19 0 0 0 6 1 5 0 0 0 25 5 
0 0 0 2 0 0 0 0 9 0 0 0 4 15 0 0 3 0 0 1 0 0 0 0 0 6 
0 13 0 0 0 2 14 10 5 8 0 13 3 0 7 12 5 0 17 0 5 0 0 0 40 19 
6 0 0 2 4 0 8 0 0 7 0 4 0 7 0 7 1 0 0 6 4 0 0 1 4 0 
18 30 9 3 4 0 7 0 2 0 0 2 0 0 9 15 0 1 4 0 0 2 0 9 24 24 
0 6 0 38 5 20 0 0 0 12 0 6 0 0 7 5 8 1 0 24 5 1 0 0 3 22 
13 5 0 21 0 0 16 0 0 0 10 0 0 0 0 0 0 7 6 5 0 0 7 0 20 0 
18 23 1 21 0 0 0 2 5 14 0 4 0 12 0 8 0 0 0 0 9 0 22 14 1 65 
0 0 0 0 0 11 9 0 1 0 0 7 0 0 3 4 11 9 0 0 0 10 7 0 9 1 
0 2 0 6 3 0 0 3 1 6 0 1 0 0 0 7 0 0 11 0 0 0 0 0 3 0 
22 0 0 3 10 12 8 7 16 0 0 1 0 7 21 22 8 0 1 4 2 0 30 0 25 2 
7 10 12 2 3 16 8 0 0 4 0 2 0 32 0 0 0 0 7 24 20 8 0 0 24 3 
