26 15
19 9 17 3 0 0 15 17 13 9 9 0 11 0 1 5 0 15 0 8 5 15 0 23 7 0 
24 2 0 0 0 2 0 6 0 6 0 0 9 12 5 11 8 1 0 0 6 9 0 0 24 12 
16 4 20 0 11 1 0 0 0 3 0 0 3 12 0 0 21 1 0 0 1 11 0 11 16 0 
5 0 0 0 20 0 15 3 0 0 0 0 0 0 0 2 0 7 0 0 0 11 0 0 25 4 
4 0 2 0 21 8 0 0 0 3 11 6 8 20 3 0 0 3 6 16 5 2 0 0 11 13 
47 0 0 2 0 0 5 16 0 1 0 0 0 4 0 0 0 7 0 0 0 0 15 23 24 1 
0 15 8 17 18 0 1 13 0 1 8 8 5 9 7 10 5 0 0 6 17 20 0 0 11 10 
0 19 5 0 2 0 0 0 5 3 0 3 5 0 0 0 0 0 0 18 6 3 0 0 15 4 
36 30 12 18 0 17 0 16 4 0 4 0 15 12 1 11 0 3 0 8 7 17 40 11 1 18 
0 8 5 0 2 8 2 0 7 2 11 0 2 5 5 2 0 2 10 0 0 0 0 0 9 0 
21 0 0 9 13 2 0 15 0 12 11 2 0 0 9 10 5 0 6 0 0 3 33 13 15 10 
3 0 0 6 1 23 2 3 3 10 7 0 4 0 0 0 7 0 0 0 15 9 1 18 0 0 
0 6 0 0 0 22 3 0 0 4 4 2 2 0 10 1 0 7 13 10 16 0 2 0 5 13 
0 0 6 0 6 0 0 0 50 0 0 4 0 9 0 7 0 0 0 0 0 5 0 15 16 5 
0 0 24 1 1 0 3 22 9 0 0 0 0 20 11 13 0 2 0 0 0 3 4 0 0 11 
