26 15
2 0 2 29 8 0 0 15 17 0 1 0 8 8 14 8 0 4 0 0 12 19 1 0 0 0 
4 0 10 2 0 6 16 0 17 0 2 0 8 11 5 1 6 5 13 0 0 0 13 0 11 15 
16 10 0 21 0 0 10 6 4 12 0 1 5 12 0 12 1 5 0 6 0 21 5 5 21 5 
5 23 7 11 12 0 0 0 0 12 6 0 12 0 3 12 5 3 12 18 0 23 3 19 9 21 
0 0 0 0 1 0 44 0 0 13 6 3 2 3 4 0 0 11 0 2 14 0 13 0 18 0 
19 1 6 20 0 21 24 0 15 0 5 0 5 10 4 0 0 12 0 6 0 10 0 22 0 6 
0 0 1 25 4 0 1 0 6 2 5 5 8 4 3 0 0 4 10 0 0 18 0 0 5 5 
0 24 0 23 0 14 3 7 2 13 12 9 7 15 11 6 5 5 1 6 0 0 12 10 0 3 
11 47 0 0 4 20 14 1 0 9 0 26 2 20 0 3 0 4 6 5 19 0 5 18 0 17 
5 0 0 0 0 8 0 0 0 4 0 0 7 9 0 1 0 0 0 0 5 0 8 7 2 0 
0 0 0 18 0 3 0 0 4 0 0 0 9 3 0 0 0 0 0 0 0 23 7 0 0 0 
6 9 0 2 0 0 0 0 27 0 0 11 15 0 0 0 0 0 8 11 20 0 10 0 9 0 
0 6 7 0 0 4 1 0 12 11 5 0 0 0 7 5 0 0 0 0 0 7 10 0 0 17 
5 19 0 0 0 0 9 0 1 0 9 10 0 0 0 0 0 0 0 0 0 0 0 0 0 0 
3 30 0 0 0 3 0 0 9 0 0 8 1 0 8 5 0 7 0 0 0 0 7 0 23 0 
