26 15
2 0 0 0 0 0 10 2 8 3 8 0 6 0 3 0 0 3 6 11 0 10 10 0 0 0 
9 2 0 22 3 7 4 10 9 3 0 13 7 0 10 12 5 9 0 11 0 7 6 52 16 0 
12 19 37 3 0 6 20 9 9 24 4 0 19 0 9 19 1 21 2 17 4 0 13 0 7 30 
0 0 0 1 7 7 18 17 2 3 0 6 0 0 11 0 13 15 24 0 2 5 17 20 63 5 
7 19 0 0 14 1 8 0 0 9 15 0 0 0 8 9 0 16 1 1 2 0 10 0 0 17 
9 0 0 5 0 0 0 29 7 5 3 0 0 4 0 0 0 0 15 12 0 14 4 0 6 0 
13 0 4 0 3 19 7 7 16 0 0 0 0 30 7 0 8 0 5 0 0 0 0 5 35 0 
0 5 0 2 7 14 20 19 0 3 1 7 5 7 0 0 1 15 8 6 4 0 0 0 17 11 
0 0 9 0 0 6 0 14 3 0 2 9 0 0 8 0 0 0 0 11 0 6 7 0 0 0 
0 19 0 0 0 0 7 2 0 0 0 0 0 15 0 0 8 0 3 0 18 6 0 0 8 0 
11 0 0 0 4 0 10 0 6 0 2 0 0 0 0 0 3 11 3 0 0 10 10 0 9 8 
20 0 16 0 0 2 0 19 0 14 0 2 0 4 6 0 6 8 16 15 17 14 0 18 8 8 
2 0 0 0 15 0 1 16 15 0 0 7 0 0 1 1 0 0 0 0 0 0 8 12 2 0 
0 0 2 22 4 8 7 0 3 0 0 0 11 0 2 3 1 0 11 0 10 0 0 0 10 22 
24 9 0 12 0 0 0 0 6 8 0 0 0 5 6 12 15 6 24 0 0 0 0 14 27 0 
