26 15
0 6 12 0 1 19 3 5 0 27 0 6 3 0 0 0 0 0 0 12 4 12 0 5 29 0 
9 8 0 0 3 2 17 3 0 2 0 12 0 0 0 0 0 12 0 0 0 0 0 16 0 0 
14 5 12 0 11 17 6 11 11 0 7 0 0 2 24 0 3 6 12 1 0 7 0 3 1 0 
0 0 0 10 0 2 12 0 0 0 0 0 0 9 0 0 0 10 9 10 1 8 0 0 0 0 
0 0 0 0 9 0 0 0 7 0 0 0 0 10 8 4 12 8 1 4 1 0 0 0 3 0 
0 0 11 7 30 1 11 0 7 4 0 5 0 6 0 8 13 4 9 0 5 8 0 27 7 5 
0 6 0 0 5 18 2 5 0 9 0 0 0 1 0 6 5 0 9 0 0 1 0 18 3 0 
0 0 0 0 1 2 5 0 0 7 0 0 0 0 0 0 8 0 4 2 0 0 0 0 3 5 
0 0 0 3 18 10 1 0 3 0 0 0 0 0 0 2 5 0 0 1 0 5 0 19 0 0 
0 18 0 4 0 0 4 0 7 0 18 21 0 3 5 4 0 0 6 0 25 4 9 12 10 0 
18 18 4 0 0 3 0 0 0 0 0 0 0 7 0 0 0 0 0 20 13 1 0 0 8 0 
0 2 0 12 37 1 1 0 12 0 0 10 0 19 15 9 8 27 1 13 0 9 0 0 19 0 
10 0 7 0 0 15 8 2 3 23 0 0 0 0 15 4 0 9 0 14 3 12 0 14 2 9 
1 0 6 0 16 2 0 0 0 0 8 0 0 21 0 17 1 30 0 3 12 4 0 10 0 0 
18 13 5 21 4 23 7 2 6 2 0 5 9 6 19 2 11 10 9 5 10 11 22 13 28 0 
