26 15
8 0 17 0 0 3 13 0 6 0 0 9 11 0 0 4 12 0 0 9 0 0 30 3 0 0 
23 0 0 0 0 18 3 0 0 5 17 1 5 0 0 0 0 5 0 5 10 0 0 41 0 3 
44 0 8 13 8 11 27 27 9 5 30 5 0 2 0 5 5 19 0 4 2 2 6 0 7 25 
24 0 0 0 0 0 19 0 9 0 9 0 0 12 0 0 3 2 12 10 9 0 0 10 38 5 
16 0 2 12 0 0 6 0 4 0 0 13 10 9 1 0 13 0 0 5 3 9 19 0 13 2 
3 0 37 30 0 0 15 0 0 0 0 0 10 0 5 9 14 0 4 0 0 15 0 1 11 22 
0 13 0 10 0 8 0 23 0 13 12 0 0 1 13 0 4 7 11 3 8 16 5 6 5 18 
12 0 8 0 14 4 5 0 0 13 7 0 12 4 3 2 14 27 13 1 2 0 0 14 5 0 
3 0 1 6 0 6 2 8 3 0 0 0 0 5 7 0 0 0 0 0 8 0 0 3 0 9 
0 21 6 2 13 17 0 7 0 2 0 0 0 0 0 0 1 2 17 17 2 0 19 8 7 0 
0 0 1 1 1 9 5 0 10 1 0 0 0 8 3 0 2 0 0 7 0 0 10 1 0 0 
16 38 11 7 0 11 7 0 0 0 0 0 11 11 0 0 9 16 0 13 1 1 22 23 0 9 
0 0 14 0 0 0 5 12 0 12 0 1 0 0 0 0 12 0 0 2 0 4 3 0 5 26 
16 0 15 8 10 6 0 7 10 3 26 5 2 6 2 5 9 0 28 8 18 13 0 23 0 14 
37 0 0 0 0 0 0 0 0 0 0 0 21 0 0 0 0 0 0 1 8 9 0 0 0 25 
