26 15
0 9 20 0 0 0 0 10 5 3 14 0 0 7 5 7 0 10 0 0 11 0 33 0 13 0 
24 6 14 0 0 13 4 0 0 23 12 12 0 0 0 4 1 0 14 4 11 0 0 38 24 0 
30 0 22 0 0 0 1 7 2 14 0 0 4 1 0 0 1 1 0 0 8 0 5 23 21 9 
0 3 0 0 12 0 1 0 0 0 0 18 8 0 0 5 11 0 9 0 5 0 4 0 0 0 
0 10 13 0 1 6 20 36 0 5 2 4 5 12 10 27 4 2 7 2 10 9 10 0 19 7 
4 0 0 0 11 0 2 0 7 0 7 0 0 9 0 5 0 2 0 1 0 0 0 0 1 0 
0 18 14 10 0 0 6 0 0 0 13 12 11 0 18 5 13 0 3 0 0 19 0 9 10 0 
0 0 16 17 1 5 4 0 0 19 0 0 6 4 8 6 0 4 2 0 17 0 22 3 1 0 
1 0 10 0 0 0 0 0 0 0 0 0 10 4 0 3 0 3 3 0 5 0 0 0 0 0 
19 16 6 34 18 2 0 6 13 22 13 2 9 2 8 8 28 12 3 15 16 18 0 7 0 0 
4 7 21 2 19 2 5 11 15 14 1 3 13 1 1 2 2 8 6 6 6 4 11 9 24 5 
21 0 5 0 8 0 0 1 0 0 0 0 8 0 0 0 0 0 13 0 0 2 20 6 1 0 
1 6 0 0 0 0 0 1 9 14 3 0 0 11 2 0 1 12 5 0 1 2 0 11 12 10 
0 0 23 0 7 9 0 0 0 11 6 3 0 0 0 2 0 0 0 0 0 0 13 8 13 23 
0 0 0 0 1 7 0 3 0 2 1 11 0 0 0 5 2 0 0 0 0 0 0 0 0 0 
