26 15
12 17 11 16 15 10 9 8 0 0 7 0 12 11 22 4 7 0 14 2 4 7 0 8 0 3 
15 11 2 0 2 5 3 1 0 0 16 0 0 4 1 0 29 0 3 0 0 3 0 0 0 8 
8 0 0 0 0 0 0 0 17 0 9 0 0 18 2 0 0 4 0 15 5 0 11 0 0 20 
9 5 19 0 2 24 0 11 4 6 0 0 7 0 9 0 3 0 0 14 0 5 6 0 0 0 
6 4 0 1 1 3 6 1 6 5 12 0 5 2 5 0 19 0 0 7 11 0 9 9 12 0 
0 31 0 3 10 24 1 15 9 2 15 0 24 0 7 5 13 1 14 9 7 14 17 22 8 16 
16 10 0 23 17 0 0 6 6 4 0 0 0 9 6 4 28 1 0 4 17 12 0 0 0 6 
7 0 11 25 0 0 0 0 0 0 0 0 0 17 3 0 7 3 0 0 0 0 0 2 21 0 
1 0 5 0 11 18 10 0 0 0 4 0 0 0 0 8 22 0 0 15 4 17 0 18 0 0 
23 25 1 29 4 0 3 4 0 3 1 0 0 4 0 0 4 9 15 5 4 0 22 0 46 32 
8 4 0 4 0 0 0 3 0 1 0 0 0 4 0 0 0 4 0 0 0 8 0 5 0 0 
0 4 15 4 0 27 0 3 3 0 3 7 2 15 0 7 3 15 7 0 0 0 7 0 0 20 
9 0 0 0 3 0 0 14 6 8 8 0 0 0 13 0 7 4 0 12 2 4 0 0 5 6 
19 12 11 0 0 17 0 3 5 1 0 0 2 0 3 0 9 3 0 1 0 0 6 9 0 25 
18 0 10 0 3 19 1 3 15 0 4 1 11 3 0 0 10 9 18 3 0 0 3 15 0 20 
