26 15
0 0 9 8 0 0 0 13 0 18 0 4 9 0 0 14 0 12 0 0 0 12 5 10 0 0 
0 0 0 0 6 5 0 9 6 0 5 0 0 0 7 0 2 0 3 5 5 0 5 4 6 11 
0 0 8 15 16 22 0 0 14 9 0 10 9 9 6 0 5 2 0 0 19 32 24 18 0 0 
50 19 26 10 13 5 10 2 3 0 4 1 2 21 0 0 14 3 0 0 1 35 20 0 3 1 
20 0 12 9 0 2 17 13 0 0 12 6 8 7 13 20 0 1 0 0 44 6 0 35 14 0 
0 20 0 0 2 0 0 0 0 0 8 5 0 0 6 0 0 0 0 0 0 20 5 4 0 0 
3 6 0 22 6 8 10 19 17 13 10 0 11 0 3 14 1 9 0 0 0 16 4 0 22 22 
10 24 28 42 7 14 0 0 11 6 0 1 10 2 14 2 0 8 1 20 0 0 5 0 16 58 
0 6 0 0 13 21 5 6 2 0 5 0 8 0 2 0 4 0 0 0 6 11 7 4 3 0 
0 0 7 0 5 0 3 13 13 22 5 0 9 0 3 0 0 0 8 3 13 19 5 3 15 0 
10 10 0 8 4 8 18 5 3 0 5 6 8 0 3 0 4 0 0 0 12 0 13 10 18 3 
7 0 0 0 0 0 0 1 0 9 1 0 12 0 3 0 16 8 6 2 0 0 2 0 25 0 
0 6 0 45 32 20 0 0 0 0 0 0 0 0 0 0 4 12 0 4 19 18 24 11 19 0 
15 0 0 0 0 0 8 13 1 2 6 0 4 0 0 0 0 0 0 11 11 4 22 0 0 6 
3 11 0 0 0 10 0 0 8 5 3 0 0 0 0 24 6 0 0 0 0 0 0 0 0 0 
