26 15
0 0 0 0 0 0 0 0 0 0 0 1 11 5 0 0 0 4 0 0 0 9 0 0 0 0 
13 13 0 0 13 0 0 0 10 6 11 0 12 0 0 3 0 5 17 0 5 6 0 0 23 8 
7 4 0 5 5 0 0 7 7 14 6 10 0 1 7 0 0 5 1 12 0 9 12 0 0 0 
11 9 16 10 13 3 0 0 15 0 5 0 3 10 0 5 16 12 17 17 0 2 22 12 24 0 
0 12 5 31 8 0 3 21 0 6 1 2 0 16 0 11 0 4 8 1 1 18 5 3 0 0 
2 0 2 0 18 11 0 14 3 0 4 5 12 6 18 7 16 0 11 0 9 10 8 0 1 2 
35 5 14 4 0 12 0 8 16 0 2 2 9 15 11 7 17 0 11 11 15 0 19 3 0 5 
7 1 3 9 7 0 3 15 2 9 2 3 0 6 3 6 0 13 1 0 19 1 1 15 0 20 
7 1 1 9 0 8 0 0 4 9 19 11 6 8 0 7 6 7 0 0 12 0 0 0 7 0 
3 12 0 3 15 0 0 9 5 0 8 7 3 12 7 0 0 1 0 0 3 14 5 19 0 0 
8 9 0 2 4 0 0 5 27 8 0 0 5 0 0 0 0 1 0 8 0 13 0 0 0 0 
0 8 0 0 8 7 0 4 0 0 0 0 8 0 0 10 0 0 7 0 0 5 17 0 0 0 
8 0 0 0 8 0 0 5 7 0 15 7 0 10 7 1 4 5 2 0 9 9 12 5 0 38 
0 0 0 0 0 8 0 0 0 0 0 1 0 3 0 0 0 4 0 0 9 4 8 0 0 0 
0 0 0 0 21 0 16 5 14 0 6 15 0 3 0 0 0 5 0 5 0 2 16 10 5 35 
