26 15
23 0 7 9 19 6 10 11 4 16 11 4 8 4 6 0 5 20 10 17 1 6 0 26 19 29 
5 0 3 5 25 5 0 0 0 5 10 13 0 0 0 0 0 0 7 4 0 0 19 16 39 22 
11 6 15 0 2 0 0 0 2 5 0 9 0 3 1 0 0 0 4 5 0 9 0 0 0 0 
0 0 5 2 21 8 0 22 0 8 6 6 13 3 0 8 0 11 1 6 0 2 12 3 23 11 
4 5 14 0 22 2 0 4 2 0 3 1 0 0 4 0 0 15 1 18 0 0 0 4 20 15 
0 0 11 4 0 0 0 0 0 5 0 0 8 13 0 0 4 0 0 6 11 0 0 0 2 7 
5 0 0 0 25 0 11 0 0 2 17 0 16 4 0 0 9 0 0 6 0 11 0 11 1 12 
0 43 26 0 0 0 0 0 0 4 1 4 0 13 0 6 0 0 7 7 8 14 20 0 16 0 
0 10 0 0 0 4 1 4 20 5 0 0 14 6 5 0 12 8 6 0 0 5 14 3 0 3 
2 12 0 0 0 14 4 0 1 9 22 2 9 4 23 0 0 0 9 9 0 17 4 0 4 0 
0 0 0 0 3 6 4 0 1 0 9 0 0 0 0 0 3 0 2 3 0 0 0 0 10 0 
2 23 11 0 0 0 0 0 1 28 1 7 5 3 0 1 1 8 7 8 0 9 2 8 25 1 
0 0 0 14 0 4 4 0 0 4 4 2 0 0 0 0 0 14 2 5 0 0 0 0 5 5 
0 0 6 0 3 0 7 0 17 11 3 0 3 13 9 0 0 6 6 4 6 0 0 18 0 4 
11 0 0 0 0 0 0 5 0 1 0 9 6 3 0 0 0 11 13 3 0 14 0 1 7 14 
