26 15
0 17 0 5 6 0 19 0 4 14 0 1 4 0 0 0 0 0 22 4 14 15 1 8 15 0 
0 22 0 0 16 5 6 4 0 1 0 1 0 0 0 10 0 1 5 12 5 0 11 19 11 4 
12 0 8 10 0 5 12 6 0 0 0 9 0 5 10 0 7 0 0 1 11 0 0 5 15 3 
3 0 9 0 0 16 14 10 6 5 7 0 8 0 0 0 0 3 4 0 16 0 0 0 1 1 
11 3 0 0 4 1 0 0 11 0 0 21 3 0 0 0 8 9 0 19 0 0 0 2 1 0 
0 0 6 6 2 0 0 3 21 9 0 0 17 0 0 5 0 7 15 6 0 0 0 15 11 3 
0 12 11 0 1 16 12 1 0 0 0 0 1 21 1 1 8 0 0 0 5 16 0 17 1 1 
18 3 12 18 3 4 0 14 0 0 14 5 27 0 8 0 5 0 20 0 4 49 3 0 12 33 
5 0 6 0 1 6 8 5 0 16 1 3 0 15 6 0 7 0 7 6 17 17 2 0 25 21 
0 0 0 0 0 6 0 0 6 3 0 0 0 0 0 10 0 0 0 0 0 0 2 0 0 12 
20 4 0 0 0 4 0 12 0 0 9 0 11 0 8 4 4 3 0 0 20 0 5 0 14 3 
8 6 3 0 2 0 5 5 7 2 0 1 8 3 7 1 15 10 14 6 0 15 2 11 18 0 
0 13 20 10 0 12 9 0 10 11 0 4 0 0 12 9 10 1 0 0 9 0 0 1 6 17 
0 0 0 0 16 0 13 14 0 8 0 0 6 0 0 9 0 12 11 5 10 0 0 4 2 1 
12 0 13 0 17 11 26 0 14 1 0 0 1 0 0 13 8 0 12 10 13 0 18 0 0 17 
