26 15
0 0 0 2 14 11 1 0 0 4 0 0 1 4 4 12 8 0 4 0 0 0 0 11 0 6 
3 0 0 20 0 9 18 13 1 21 11 17 5 0 9 4 8 4 7 4 14 3 0 20 18 16 
0 0 0 3 33 10 6 5 0 0 0 9 4 0 0 15 4 22 0 0 12 0 15 2 0 12 
0 6 13 0 7 0 0 1 0 2 0 0 0 4 0 13 0 0 1 0 1 3 0 0 9 7 
8 0 26 5 0 2 25 20 0 3 6 12 9 5 0 9 10 7 5 20 16 11 2 30 9 4 
0 0 6 0 9 0 0 9 1 0 0 0 5 10 0 7 9 2 0 0 0 1 0 0 0 0 
0 12 0 4 0 9 8 7 14 0 0 0 0 3 7 0 4 2 0 11 4 0 23 6 8 9 
0 0 0 4 0 0 3 18 12 0 17 0 12 0 0 0 0 0 7 11 0 0 0 0 12 18 
7 0 18 12 27 17 0 5 0 8 0 4 7 1 2 7 2 8 1 4 0 1 18 3 1 21 
2 6 5 1 1 4 0 0 0 4 0 0 0 5 0 4 0 0 6 0 0 2 1 2 0 0 
10 4 22 26 8 16 2 2 3 0 0 0 5 5 10 2 10 13 4 6 0 18 1 7 10 38 
14 0 0 2 9 11 0 11 0 0 5 8 1 8 1 1 0 7 18 11 9 3 23 1 3 5 
13 0 0 0 0 7 10 13 15 0 10 12 0 7 0 12 30 0 8 3 13 0 0 15 1 0 
9 0 3 5 0 2 0 0 0 0 0 0 8 13 0 9 13 0 18 0 0 5 0 1 17 0 
0 0 0 7 19 0 12 20 0 5 7 0 6 0 0 0 0 11 0 14 0 14 0 1 22 6 
