26 15
0 5 21 9 6 0 0 0 0 0 0 2 13 2 0 5 0 6 0 5 5 0 0 19 1 12 
0 0 0 0 10 0 12 3 0 10 4 0 0 0 8 8 0 0 25 0 0 0 8 0 12 0 
0 29 0 7 0 2 5 1 1 11 5 14 0 6 0 4 0 0 7 0 0 0 0 0 20 31 
1 0 0 0 0 0 2 0 0 10 0 0 9 0 0 0 0 0 0 0 5 0 0 0 4 0 
1 11 0 5 0 0 8 0 12 11 0 0 10 0 13 7 7 0 0 5 12 0 11 2 3 26 
11 5 0 10 9 0 12 32 6 0 12 11 0 3 8 0 7 0 16 16 17 14 7 0 0 18 
4 10 11 0 5 0 36 6 1 7 0 0 0 19 4 0 0 22 1 6 0 0 16 8 18 0 
25 17 0 3 18 0 0 3 10 2 1 5 11 0 11 0 14 0 16 0 5 5 18 11 3 18 
0 11 1 0 8 0 0 10 0 0 0 10 0 2 9 2 0 15 3 1 3 8 2 1 0 0 
19 0 0 20 0 0 0 0 0 2 7 4 0 0 3 4 4 8 7 14 12 0 0 0 0 3 
4 0 9 19 4 0 0 0 3 0 0 9 0 0 9 7 0 0 3 0 0 3 33 10 4 1 
0 15 0 0 0 0 5 0 5 8 3 0 1 6 6 2 8 4 0 11 0 3 0 0 13 0 
0 0 19 1 0 18 8 10 1 3 13 3 23 0 0 8 0 0 0 0 20 0 0 3 0 13 
4 9 7 14 25 0 1 3 19 31 15 8 0 6 3 5 2 21 11 8 0 0 0 27 15 0 
35 19 0 38 2 6 0 2 3 7 3 18 5 1 4 0 2 17 19 18 2 7 10 9 12 18 
