26 15
24 0 0 0 0 3 8 8 0 0 14 3 14 10 3 0 0 0 0 0 0 16 12 19 30 13 
0 0 0 2 6 3 0 0 1 2 8 10 28 8 13 0 1 7 22 7 3 0 4 4 13 15 
3 10 0 0 8 0 2 14 0 0 11 20 0 0 0 0 16 0 0 19 7 14 11 2 0 0 
17 0 11 11 14 0 2 3 0 14 6 15 0 11 1 0 5 17 14 8 0 2 0 12 0 8 
0 10 0 4 20 6 4 0 0 6 9 8 4 0 4 6 0 9 11 6 6 0 19 0 20 0 
0 22 20 13 2 4 1 15 0 3 7 3 0 2 0 0 25 0 2 21 8 14 0 0 19 9 
0 1 1 0 8 0 0 0 0 15 14 7 0 0 0 0 6 5 0 0 0 0 7 1 1 0 
19 0 0 0 6 0 0 0 0 0 0 3 0 0 0 0 0 0 3 6 0 0 0 0 0 31 
1 11 0 5 17 4 14 0 2 8 1 0 8 10 6 17 0 0 9 13 2 0 0 2 0 2 
60 12 1 8 7 1 4 5 11 8 22 4 7 0 2 0 14 12 17 10 33 2 2 8 7 20 
0 0 17 0 1 0 7 0 0 0 0 6 0 1 1 0 7 0 0 23 0 5 10 0 0 0 
2 4 0 22 5 14 0 0 22 1 1 12 0 3 6 0 0 0 0 0 6 0 0 26 0 14 
14 2 0 9 15 0 6 5 0 0 1 23 19 0 0 0 0 0 0 1 1 9 0 12 0 0 
6 18 10 21 10 0 0 0 0 1 12 7 10 0 0 0 0 0 0 18 16 0 3 4 21 3 
17 1 0 11 5 37 16 0 0 0 7 0 19 13 6 6 10 15 13 9 4 0 5 22 0 4 
