26 15
16 0 7 0 0 15 9 0 0 4 0 1 0 0 0 1 29 0 6 1 6 0 0 2 5 0 
0 0 10 0 0 25 27 23 0 0 6 1 10 12 0 9 6 0 0 14 5 0 0 8 24 7 
3 1 1 19 0 0 12 15 0 13 4 0 0 12 5 0 2 0 0 13 0 12 15 9 0 15 
1 10 7 0 3 0 11 15 0 0 0 0 5 0 1 11 0 5 1 0 0 0 7 0 0 0 
27 8 0 0 0 0 0 3 0 4 0 1 0 0 0 4 18 11 0 0 2 0 0 0 0 5 
1 14 23 3 9 11 19 14 3 13 10 7 1 9 0 8 22 5 6 3 27 11 29 8 13 18 
0 19 5 2 3 13 0 0 6 11 0 5 0 1 6 6 0 0 7 1 10 14 11 7 0 0 
21 0 23 0 7 18 2 2 4 6 0 0 0 0 0 11 0 0 0 0 0 23 0 5 6 2 
0 0 0 0 15 0 0 6 0 4 10 6 7 3 0 0 4 7 0 1 6 0 5 3 0 15 
5 0 21 0 0 5 9 0 0 2 1 11 0 0 0 2 9 5 0 0 4 0 2 29 0 5 
9 5 12 0 0 0 0 0 2 11 0 2 0 0 15 6 8 0 0 0 0 19 0 23 3 0 
0 3 0 0 0 0 10 10 0 0 0 0 0 0 0 2 6 0 0 4 0 0 13 4 0 0 
0 9 15 20 0 11 11 1 1 2 0 8 7 0 0 10 0 4 0 0 0 0 0 18 0 1 
0 0 6 0 0 0 2 7 12 6 13 3 8 7 6 0 0 0 6 5 11 3 14 5 11 0 
7 16 21 9 15 0 0 28 0 2 15 6 9 0 9 8 5 10 1 0 10 32 3 4 0 0 
