26 15
17 13 8 2 15 0 0 5 2 2 0 13 0 0 0 5 14 15 2 1 0 1 17 0 13 0 
0 10 0 10 18 0 17 13 1 0 0 10 8 9 0 5 0 0 0 0 18 0 17 14 0 0 
0 6 7 20 8 3 0 0 19 7 13 3 0 0 0 7 7 10 6 5 5 40 20 22 5 5 
25 11 9 0 20 15 16 10 8 10 21 0 0 0 21 0 8 0 17 1 0 11 13 30 0 25 
7 3 0 0 15 30 12 17 0 12 0 7 0 0 0 10 0 2 13 9 0 8 1 19 0 0 
1 0 0 3 18 3 15 0 14 10 8 3 0 0 5 0 0 1 9 2 5 15 8 6 7 0 
0 0 0 0 0 7 1 5 0 0 0 0 9 6 6 7 0 8 0 0 16 8 10 0 0 8 
10 3 23 2 7 7 7 0 8 0 10 5 13 7 6 6 12 15 0 0 9 5 19 25 0 13 
0 22 17 0 10 5 6 19 2 2 2 6 3 15 3 6 26 11 0 0 2 8 0 0 23 12 
19 9 1 8 0 6 5 0 1 0 0 0 2 11 9 0 30 0 7 7 0 0 18 0 0 4 
0 0 0 0 16 19 0 2 33 11 0 0 4 10 2 0 9 0 11 6 3 13 6 7 23 0 
0 9 0 13 0 17 0 13 14 0 0 7 0 3 6 3 0 0 0 9 16 15 36 1 9 0 
0 0 2 0 9 0 0 0 0 0 0 5 0 0 7 0 0 6 0 0 0 0 0 9 0 3 
0 2 0 0 11 7 1 3 0 10 2 0 0 0 11 0 0 0 0 11 12 0 0 0 0 21 
0 0 2 21 0 0 4 6 0 0 0 6 0 10 0 10 13 0 24 0 8 12 19 7 0 0 
