26 15
20 0 18 0 2 11 5 0 0 4 0 0 7 7 14 0 5 0 7 0 6 1 0 7 1 0 
8 0 0 0 1 0 8 0 0 5 9 3 0 0 3 9 10 6 12 7 4 9 0 7 17 5 
34 4 0 11 15 10 10 4 2 13 4 14 4 7 21 17 10 2 0 4 16 0 0 10 15 56 
0 0 0 24 16 21 11 4 0 10 8 8 5 9 0 4 4 3 2 2 33 5 4 8 0 0 
1 1 0 0 10 0 3 0 7 9 24 1 1 7 4 9 0 9 4 2 10 0 0 13 16 0 
19 0 17 17 0 11 0 0 0 8 0 0 0 10 0 8 17 9 11 2 21 0 0 9 0 0 
17 19 23 14 4 21 28 4 9 7 11 14 17 5 0 4 0 20 17 0 4 0 1 19 0 62 
0 16 0 0 3 17 16 3 6 1 0 0 13 4 9 0 0 16 0 0 15 2 16 6 0 18 
0 1 0 11 8 6 2 0 2 0 0 0 31 12 0 2 0 0 0 0 5 0 0 7 0 13 
8 0 3 2 0 0 0 18 0 2 0 12 13 3 0 10 0 0 0 0 0 0 0 1 0 39 
0 0 0 2 19 0 32 11 0 0 9 0 0 0 0 3 0 0 1 9 7 0 7 21 18 0 
9 30 2 16 7 3 6 1 7 0 0 16 6 12 9 8 6 0 6 18 8 13 15 29 0 23 
0 0 20 0 4 0 8 15 1 0 10 2 0 9 0 2 8 0 12 0 12 0 35 0 19 0 
0 0 15 0 0 29 0 2 10 17 0 2 6 0 0 0 0 14 13 0 0 6 0 6 19 0 
0 0 0 12 0 13 11 0 3 0 7 3 11 0 0 10 0 9 0 0 17 0 0 9 0 12 
