26 15
0 4 21 3 13 0 37 0 11 12 0 0 6 4 7 4 3 15 0 7 2 22 14 23 3 11 
0 21 0 13 1 0 0 18 0 3 0 0 0 4 0 3 13 4 10 7 0 9 21 0 0 12 
22 22 15 17 0 6 0 5 1 6 21 4 9 0 2 18 5 1 20 0 2 18 42 21 10 15 
16 0 9 34 72 0 10 0 0 7 0 3 12 0 9 0 13 14 2 15 15 17 20 4 23 3 
0 49 8 3 0 0 0 0 16 3 15 0 4 10 0 11 7 8 17 9 1 5 21 0 16 8 
21 45 9 11 0 30 27 14 0 7 0 0 0 0 0 10 26 7 14 0 0 10 0 22 43 6 
0 0 4 8 12 0 12 0 0 1 6 0 2 0 6 0 4 0 0 0 0 1 19 0 0 3 
0 16 7 2 3 0 0 0 0 11 0 0 0 0 13 0 0 0 0 0 0 12 7 3 0 0 
19 6 6 6 9 7 1 0 0 0 0 0 0 17 8 0 2 0 3 12 7 0 0 9 0 0 
0 0 0 6 0 0 1 0 0 6 0 11 0 0 6 0 4 0 0 0 0 3 11 0 2 0 
21 0 26 22 17 0 1 3 10 0 0 0 2 0 28 0 11 0 9 0 0 27 8 0 5 12 
0 7 1 0 1 3 25 0 3 14 14 0 0 18 0 6 9 11 3 6 11 7 9 17 6 13 
12 0 16 3 11 0 3 5 3 0 4 0 12 6 0 0 0 7 16 9 0 0 2 13 0 0 
0 0 2 1 1 1 8 0 0 0 0 0 0 0 0 0 4 0 11 0 0 0 0 0 0 0 
4 10 25 2 14 31 0 4 22 8 4 0 9 0 5 15 23 38 15 4 0 2 6 23 8 4 
