26 15
9 37 25 17 2 0 0 1 4 22 11 4 11 0 0 0 4 1 12 0 36 30 0 0 0 27 
9 0 0 3 7 0 6 0 9 0 0 20 1 14 0 0 7 5 3 0 0 15 11 7 3 3 
25 0 4 0 10 0 8 7 0 0 0 10 12 8 0 0 0 0 18 0 3 8 0 3 5 7 
11 9 5 11 9 0 7 0 11 0 12 3 9 11 17 9 11 2 12 2 3 0 10 7 0 8 
0 25 0 0 3 9 2 0 10 11 0 0 0 0 0 0 0 0 10 0 0 0 21 0 0 12 
0 0 0 22 2 0 3 0 7 5 0 0 8 0 0 11 5 0 2 4 8 0 3 0 8 22 
0 0 4 0 0 7 8 0 0 0 6 0 1 0 0 0 4 0 0 0 0 15 0 0 1 0 
2 0 4 0 5 0 12 11 21 11 0 0 0 0 9 6 6 7 12 0 0 0 0 7 28 0 
4 5 0 4 16 3 1 14 40 2 2 5 0 0 0 0 5 9 9 0 5 0 21 0 0 2 
2 1 0 0 7 0 17 0 0 13 0 1 9 0 3 0 9 0 2 0 4 0 20 17 7 4 
0 1 0 0 0 19 0 0 3 15 12 10 0 0 4 2 0 1 2 1 2 10 0 0 34 0 
0 13 4 3 13 0 0 0 5 0 13 2 12 5 13 0 0 19 0 0 0 0 11 1 1 6 
15 24 0 3 14 0 6 3 4 15 1 17 4 12 13 2 6 9 6 6 0 17 7 0 5 1 
8 5 0 16 12 22 1 0 1 4 13 5 0 4 5 0 13 1 2 20 0 3 6 0 9 20 
5 9 14 0 10 0 6 0 0 6 4 0 0 0 0 11 9 6 0 0 0 0 0 0 0 15 
