26 15
3 0 10 21 16 17 6 0 4 0 0 0 9 3 2 14 16 2 0 2 4 6 26 28 5 9 
15 0 0 0 0 0 0 7 17 10 11 0 0 0 3 3 16 7 1 0 6 11 2 0 0 17 
0 5 16 0 0 16 3 2 11 2 0 11 10 10 2 4 0 0 20 7 0 16 15 12 6 0 
11 0 15 7 7 0 0 2 1 14 5 4 0 3 8 0 6 26 0 6 0 14 15 0 0 0 
19 13 21 19 17 0 5 4 0 0 0 5 0 11 10 3 5 3 9 0 20 21 23 19 11 9 
7 45 31 8 0 37 7 16 7 0 4 9 7 1 5 0 3 0 17 12 7 3 0 21 22 0 
0 3 1 5 14 0 0 0 1 3 0 10 0 1 0 14 0 0 14 0 0 0 0 0 0 0 
6 5 0 0 0 0 0 8 0 5 7 2 1 6 1 8 0 4 0 13 7 2 0 4 0 0 
0 0 10 25 19 0 5 13 0 0 0 5 17 4 0 0 4 0 4 2 0 6 4 8 19 22 
12 4 14 16 1 19 9 1 11 2 0 15 17 3 6 7 0 11 15 8 0 1 1 11 4 3 
16 0 0 0 0 3 0 1 0 1 0 0 0 0 9 0 25 1 0 0 7 0 1 1 0 4 
6 14 20 5 8 0 6 0 0 3 0 0 8 2 0 27 0 1 0 0 6 11 2 0 2 0 
0 11 0 0 0 7 0 10 0 6 0 0 6 4 2 2 0 0 0 0 2 0 0 0 0 0 
17 0 0 16 0 10 1 0 10 0 15 0 8 0 0 8 5 15 3 12 8 2 14 3 8 15 
0 0 6 17 16 14 10 0 0 0 10 0 2 11 2 13 15 0 0 14 44 0 0 0 5 5 
