28 16
0 0 0 0 0 0 0 12 8 10 3 0 0 0 0 0 0 0 3 13 5 0 8 0 0 0 0 0 
0 0 15 2 1 6 22 1 0 10 0 3 0 4 0 6 5 11 0 8 9 2 13 0 0 19 0 17 
5 7 0 10 18 8 4 7 0 33 27 13 3 23 0 10 0 8 6 1 11 11 0 8 45 18 0 1 
2 0 6 0 0 3 18 10 13 0 3 2 0 0 5 11 0 1 23 9 0 6 26 2 16 0 0 16 
41 6 0 3 0 23 0 6 19 7 4 6 2 0 3 0 0 14 0 9 0 22 0 0 5 4 0 3 
0 19 0 0 0 7 0 0 0 0 0 0 2 0 0 0 0 0 0 0 26 0 3 7 0 3 0 3 
17 21 0 0 0 6 5 0 0 4 0 0 2 4 12 0 0 17 5 8 0 2 18 21 8 11 6 4 
0 0 0 9 16 19 19 3 4 1 2 0 14 0 0 5 12 8 4 0 9 0 17 0 17 0 15 20 
0 10 16 9 0 3 5 0 8 1 20 10 7 0 5 0 0 7 0 0 0 17 8 2 0 15 0 2 
0 1 1 0 0 4 5 0 0 0 0 0 0 0 12 0 0 3 0 17 18 6 2 0 9 0 0 0 
8 1 0 0 0 19 0 0 0 1 0 5 0 2 0 0 0 7 0 0 20 0 0 13 20 0 0 2 
3 0 0 1 4 16 0 26 3 7 0 0 0 0 0 0 4 0 32 9 0 0 15 0 0 0 0 0 
30 10 8 1 0 11 12 2 0 2 0 9 0 0 14 0 16 24 6 10 0 0 0 0 0 7 0 0 
0 11 0 0 0 13 0 18 0 0 0 0 0 0 4 0 0 0 13 0 0 13 8 2 4 18 0 0 
0 6 0 0 2 0 20 6 0 3 0 19 10 9 5 11 0 11 0 5 0 15 12 1 4 0 2 3 
0 0 9 0 4 16 1 0 8 0 13 0 4 9 0 10 0 8 8 0 0 0 0 0 19 10 18 9 
