28 16
0 10 7 0 10 0 0 0 11 15 7 0 0 9 1 3 12 8 0 19 0 3 4 0 0 6 4 0 
0 0 6 0 0 0 8 17 0 0 13 3 0 11 14 11 0 5 5 2 3 0 0 14 3 0 11 0 
0 0 14 0 0 0 0 0 0 0 12 0 0 0 0 0 14 0 0 7 0 0 8 1 0 0 7 0 
0 21 0 20 5 36 0 2 5 0 0 2 8 7 0 0 0 0 0 1 1 12 30 35 8 8 0 22 
0 11 22 0 0 1 9 0 0 0 0 3 3 0 3 7 0 14 0 0 0 5 0 1 22 4 0 0 
0 0 0 0 0 10 0 0 0 1 0 3 1 5 5 4 9 0 0 4 0 10 18 4 0 9 0 0 
11 2 9 0 0 0 0 0 0 9 0 21 0 16 0 0 0 10 3 0 0 0 0 0 0 0 0 14 
10 0 8 19 2 0 0 0 10 0 17 11 0 0 0 0 0 10 12 4 0 3 19 12 0 5 8 0 
25 20 9 0 41 3 3 0 0 6 10 10 0 1 5 9 7 14 7 20 3 6 0 7 0 5 1 23 
6 5 0 15 0 0 7 0 7 0 0 4 1 2 0 7 11 1 12 2 0 4 14 6 0 0 0 3 
40 2 0 14 12 2 2 0 10 0 15 25 0 12 5 0 0 27 16 0 4 18 9 14 2 15 15 0 
29 19 0 0 4 3 6 0 0 0 0 12 8 0 0 0 0 0 0 4 2 0 21 3 8 5 0 27 
0 24 0 0 3 17 17 23 0 0 0 0 0 14 10 8 15 0 0 0 0 4 0 16 0 7 20 3 
0 1 15 0 6 0 20 5 1 5 4 0 18 0 0 0 0 15 6 0 0 19 10 0 9 0 5 20 
0 0 0 0 22 0 0 0 0 0 14 6 16 0 0 11 0 0 7 0 0 5 0 0 0 0 3 0 
3 0 0 11 4 4 0 7 9 1 0 2 0 10 10 0 0 15 0 5 0 14 10 4 5 0 0 0 
