28 16
5 12 8 0 3 5 10 3 2 0 0 0 0 0 0 0 11 16 22 15 10 0 0 6 16 7 0 1 
0 21 20 21 20 2 0 6 5 20 1 1 0 10 0 2 0 5 3 5 0 3 9 9 47 0 29 9 
24 0 13 8 15 8 0 0 11 0 0 8 15 1 3 14 0 9 1 26 0 0 0 0 0 0 0 14 
0 57 8 0 5 0 10 0 1 8 5 29 15 1 0 5 10 7 0 0 30 9 0 0 13 0 0 11 
0 13 0 0 16 4 20 9 6 0 0 0 0 0 13 5 12 0 5 7 16 0 1 5 0 18 27 20 
10 0 0 48 0 0 22 0 5 13 14 0 0 6 1 0 13 6 1 16 4 2 1 23 0 0 18 0 
0 0 0 0 0 13 0 2 3 0 0 0 0 0 0 8 9 0 19 0 0 0 0 5 0 0 19 5 
5 0 16 0 0 13 0 6 0 2 2 21 0 5 11 3 0 8 41 8 9 2 1 0 2 11 2 0 
0 0 8 0 0 19 0 0 5 13 0 0 0 0 0 7 4 2 6 1 3 0 1 0 19 4 7 12 
0 0 0 0 0 0 2 17 0 0 0 0 6 0 2 0 0 12 4 0 0 7 0 0 19 3 0 0 
40 11 4 8 18 14 19 1 2 17 4 13 11 0 5 21 0 2 0 5 11 0 20 0 0 25 0 22 
3 0 0 0 0 0 0 0 13 0 0 0 0 0 0 0 0 0 0 0 0 0 0 0 0 0 0 12 
5 12 0 0 0 10 0 0 0 6 0 9 0 0 11 10 8 0 0 0 0 9 11 0 0 12 4 0 
10 0 0 0 4 0 12 9 18 2 0 4 0 0 13 8 9 0 19 0 13 0 0 0 0 19 0 0 
13 20 8 0 18 20 15 0 13 0 18 0 0 8 1 0 0 0 10 0 11 13 12 0 0 20 0 0 
18 12 19 18 0 0 5 0 5 12 4 0 12 5 1 6 0 0 31 18 2 23 1 15 30 4 0 19 
