28 16
9 15 0 6 13 0 0 0 0 15 11 13 20 1 8 0 0 13 0 0 3 11 8 0 0 0 0 2 
11 8 25 0 5 0 0 20 0 4 0 0 0 3 11 0 23 0 0 0 0 3 11 1 12 11 0 8 
9 0 31 11 0 0 0 3 0 0 8 0 7 0 11 3 1 4 8 0 0 4 0 21 0 0 0 2 
15 37 0 0 0 12 0 0 0 22 0 8 11 12 4 10 1 8 10 2 18 16 5 0 0 8 8 35 
0 0 0 5 0 0 0 37 10 0 17 0 0 2 0 12 0 5 0 7 0 3 12 0 17 0 1 29 
0 22 13 0 0 19 0 1 1 29 0 0 1 2 5 2 4 0 0 3 0 19 7 28 16 16 1 8 
16 0 0 0 12 0 2 0 18 8 0 0 11 2 0 7 16 0 0 0 0 14 1 0 16 0 16 0 
0 0 0 0 0 0 0 6 1 3 0 2 2 0 0 0 7 0 0 0 2 0 6 3 0 0 3 0 
7 17 14 0 0 0 0 7 5 16 0 0 3 0 0 0 16 0 17 0 0 0 13 0 0 0 0 0 
19 2 22 0 26 23 0 4 0 4 0 0 27 13 1 7 14 17 1 0 18 3 18 0 27 7 0 6 
0 11 0 8 17 0 0 0 0 0 6 4 7 0 0 12 4 6 6 3 0 17 0 7 0 10 0 4 
9 3 10 0 0 0 0 9 0 18 0 0 14 4 1 2 0 1 0 0 13 0 3 16 0 15 11 23 
3 32 11 19 0 0 7 8 0 0 25 5 2 7 13 8 16 4 1 1 6 0 53 13 0 0 8 0 
0 0 8 0 0 0 0 0 0 0 8 13 0 0 0 5 10 0 0 2 10 2 2 0 8 2 10 5 
5 2 0 0 0 0 0 1 0 3 0 4 3 0 0 0 0 1 8 0 11 0 4 0 23 24 0 0 
21 3 0 6 0 2 0 13 0 9 25 9 4 4 0 0 6 5 11 0 12 35 9 3 14 6 14 0 
