28 16
44 11 16 10 5 7 14 0 11 18 6 0 0 0 0 0 0 0 22 0 0 8 0 23 0 0 0 43 
0 23 22 0 0 0 4 5 0 0 0 0 21 0 0 0 8 0 0 3 0 9 5 0 4 0 0 3 
0 9 23 4 0 0 0 0 0 5 9 13 0 0 0 0 0 0 0 9 0 0 0 0 6 18 0 0 
0 20 0 0 13 0 0 9 3 0 0 13 0 0 0 0 20 13 0 0 0 10 0 0 0 0 7 19 
19 4 29 23 4 0 18 5 18 0 0 0 15 10 10 0 11 0 2 3 4 19 2 0 14 5 32 27 
10 11 0 0 5 10 13 0 0 5 4 0 14 15 7 0 7 0 0 11 0 7 17 0 8 9 14 0 
11 1 9 4 0 15 0 33 7 4 27 36 0 5 6 0 0 2 10 3 0 11 9 25 17 3 19 0 
4 32 15 1 0 2 25 0 17 5 18 0 0 10 8 0 15 0 11 30 0 1 3 9 0 7 0 0 
26 20 32 0 0 0 0 0 0 0 15 3 6 12 0 7 0 7 0 17 9 11 0 12 37 27 4 1 
0 0 0 0 0 3 0 2 1 2 1 2 10 0 0 0 5 0 2 0 0 0 10 2 4 3 0 1 
9 9 0 0 0 21 13 0 4 0 2 0 0 0 14 0 0 0 5 13 10 0 0 2 0 0 14 0 
0 8 0 0 0 18 10 0 16 0 0 0 0 0 15 0 0 0 13 0 0 0 0 0 10 0 7 0 
0 7 0 23 0 4 0 3 0 0 12 0 0 7 0 0 3 2 5 2 8 0 0 0 0 0 23 0 
7 7 14 0 3 19 0 8 19 0 0 0 0 8 5 0 3 0 0 24 1 2 0 9 23 0 26 19 
0 12 8 37 0 0 13 1 14 0 8 0 0 12 18 0 1 0 0 0 6 18 26 21 0 12 12 0 
8 61 21 15 16 15 0 14 3 4 16 10 0 0 5 7 3 0 8 0 6 14 0 0 22 0 3 26 
