28 16
14 21 0 1 22 0 0 0 16 1 0 0 8 3 27 0 5 0 5 15 0 2 32 2 9 24 0 1 
24 0 7 26 6 0 0 18 12 13 1 4 0 12 0 8 0 0 0 0 6 0 2 10 31 18 13 8 
15 20 15 0 0 3 0 0 0 8 1 0 1 12 0 0 0 25 8 19 0 20 3 0 0 0 0 22 
0 0 0 0 2 7 0 21 15 0 4 0 0 0 4 11 0 7 0 0 0 0 5 5 0 18 7 0 
4 0 0 0 0 17 0 14 7 6 0 0 10 0 0 13 0 9 3 14 1 21 8 0 0 0 12 0 
18 5 3 16 2 0 30 4 12 9 0 6 1 1 0 4 15 0 5 3 19 0 22 0 0 0 0 0 
8 9 35 18 17 18 21 0 0 9 0 0 0 10 0 0 0 0 0 0 0 1 17 0 0 23 0 26 
1 4 31 0 7 8 6 0 0 0 12 0 6 0 3 0 0 0 16 0 6 6 12 0 0 0 0 25 
30 5 15 7 2 4 0 7 12 0 7 6 12 4 9 12 11 6 16 5 12 20 17 2 1 1 0 12 
7 5 0 0 0 0 11 5 0 6 0 0 9 0 21 0 9 5 8 0 0 9 11 0 9 3 8 13 
0 29 20 12 13 6 12 0 1 8 0 16 17 2 3 13 0 9 2 18 7 0 20 8 53 1 1 6 
0 0 2 0 25 0 17 0 0 0 6 0 7 0 0 0 0 0 0 7 0 0 9 7 10 21 0 0 
1 0 0 0 0 5 7 0 6 0 14 0 2 7 6 0 0 4 0 0 7 4 40 0 0 0 0 0 
0 51 0 0 8 4 0 0 12 0 1 5 12 0 11 26 5 0 0 5 0 6 0 0 0 34 1 3 
7 11 9 0 15 24 0 0 0 17 0 2 10 12 0 2 0 0 4 15 0 0 12 18 10 1 0 2 
6 0 0 0 0 1 0 7 6 19 0 10 0 0 6 6 0 6 18 15 0 31 13 0 0 4 0 0 
