28 16
0 1 26 4 16 33 10 0 3 14 0 0 0 9 5 0 0 10 0 9 14 19 0 0 32 21 20 5 
0 6 0 2 0 5 12 0 0 0 11 10 4 6 10 6 0 8 0 19 0 6 11 0 0 7 1 0 
0 8 0 15 0 0 0 0 11 0 8 0 5 1 0 0 0 5 7 0 0 2 1 0 0 0 0 0 
7 2 0 15 0 0 16 4 0 0 0 0 11 13 0 16 9 7 26 4 11 17 8 11 1 0 0 14 
7 0 8 1 1 5 16 0 5 0 8 0 25 0 0 6 11 3 24 19 0 6 13 7 10 0 3 19 
10 0 21 4 0 3 0 0 0 6 11 15 0 0 4 0 0 0 0 2 0 0 0 24 0 0 17 32 
0 21 0 0 16 12 14 3 12 0 0 6 0 0 3 2 0 2 13 0 26 1 19 16 0 27 0 0 
0 2 8 0 4 9 0 0 11 0 3 6 2 0 8 6 0 0 0 10 4 9 26 0 0 0 0 0 
0 11 0 0 0 11 1 0 0 0 0 0 11 0 8 0 11 0 0 0 12 0 0 0 0 0 4 0 
0 2 0 21 0 3 19 1 12 0 7 0 0 2 0 0 6 0 0 0 12 18 0 1 6 11 1 0 
13 5 15 16 3 0 10 1 0 11 15 0 11 16 4 1 8 21 0 4 0 8 12 1 0 16 1 3 
3 9 0 1 6 11 3 5 1 6 0 9 0 0 10 8 19 0 0 0 1 1 15 3 0 0 0 1 
0 7 2 0 11 0 5 1 0 0 5 12 0 0 2 1 2 0 0 0 0 0 11 0 8 0 4 15 
41 0 19 0 3 1 6 0 2 0 10 0 0 0 1 11 0 1 1 12 0 32 0 23 13 7 0 0 
26 0 14 15 2 1 0 2 0 14 10 2 10 13 0 0 16 4 23 14 25 7 0 11 10 0 8 9 
2 0 0 0 0 0 0 0 0 5 12 0 0 6 0 0 0 7 0 0 7 0 12 0 7 0 0 10 
