28 16
0 0 22 9 0 7 0 14 0 8 11 0 0 13 2 4 18 15 0 0 0 18 19 10 29 15 16 1 
9 0 15 1 1 1 0 2 6 26 0 0 6 0 0 0 1 0 0 0 0 0 0 1 23 16 0 0 
0 12 14 1 9 11 0 0 0 3 0 0 3 0 13 2 5 3 0 2 0 2 4 4 0 0 0 8 
17 7 1 0 15 1 1 6 0 0 0 6 0 0 0 12 2 15 2 15 10 0 0 3 0 18 0 7 
24 0 1 4 16 9 0 0 0 0 3 1 0 11 4 2 0 13 0 0 0 0 2 0 44 0 0 13 
0 0 14 0 6 9 0 0 0 11 0 0 0 0 4 0 0 3 7 0 4 0 0 22 1 0 9 0 
0 6 0 0 10 11 10 7 0 0 8 1 0 8 10 9 13 0 8 0 0 4 0 0 23 5 2 0 
0 0 0 0 0 16 6 4 14 7 3 7 2 3 3 4 6 9 0 5 0 0 14 0 15 0 12 0 
0 2 0 0 10 4 0 3 7 18 3 0 3 0 10 0 11 16 0 18 10 3 13 0 3 0 0 8 
0 0 14 0 0 0 15 0 2 0 2 10 9 0 4 0 11 4 4 0 4 19 0 4 0 0 0 4 
20 8 0 0 16 0 2 7 0 0 0 3 2 1 1 0 0 0 8 0 0 6 18 0 0 0 5 2 
23 2 0 2 22 22 0 3 0 16 0 4 9 1 4 11 0 8 0 0 4 0 18 23 5 11 4 23 
14 2 0 3 0 9 0 11 2 0 0 4 0 10 9 7 0 0 7 5 0 18 4 0 5 0 4 2 
27 0 0 0 17 11 19 0 2 21 2 3 0 0 0 9 0 4 0 0 0 17 0 0 9 35 0 27 
24 3 36 19 0 0 0 11 11 16 6 7 5 11 4 1 15 0 4 11 6 17 19 0 21 16 12 21 
21 0 0 17 5 4 16 9 0 1 3 4 7 2 7 21 0 0 0 7 4 62 7 0 21 22 10 0 
