28 16
2 13 0 0 2 4 31 0 27 1 4 0 1 4 0 0 17 4 13 0 0 0 14 0 12 4 0 0 
4 7 10 0 1 0 0 13 3 0 0 0 21 6 10 0 10 0 0 2 1 0 3 8 0 0 0 0 
18 0 7 23 18 0 0 4 0 19 0 11 0 0 2 8 36 2 9 1 43 0 0 0 4 0 22 1 
14 19 5 6 0 21 0 5 5 0 15 0 0 5 23 0 16 0 7 1 20 0 0 10 8 2 1 0 
0 0 2 0 0 1 0 4 14 1 0 12 6 0 3 0 0 0 10 5 9 0 0 9 0 0 0 0 
9 0 0 0 9 0 5 0 0 9 4 0 0 4 0 0 0 6 0 0 0 0 0 9 1 0 0 0 
0 3 6 45 3 3 0 5 8 6 0 0 11 10 0 0 9 0 0 0 0 0 0 9 5 22 0 0 
0 17 0 0 0 0 0 13 0 0 0 0 0 0 0 0 0 0 17 0 0 0 0 5 0 3 0 20 
0 0 46 0 0 0 1 3 0 4 0 0 14 0 5 5 10 0 0 15 0 0 0 21 0 0 13 25 
0 4 9 13 7 12 9 0 12 0 12 9 0 2 0 5 1 0 0 13 24 19 0 4 4 5 0 0 
0 0 3 0 1 0 0 0 0 0 0 13 11 0 0 0 12 0 0 0 7 0 0 3 12 1 2 0 
4 9 9 1 3 17 0 0 0 13 7 9 16 8 23 3 11 14 3 7 8 0 13 5 0 4 0 8 
24 18 0 0 1 21 12 7 8 20 5 0 14 0 0 0 19 17 9 18 15 0 0 0 15 0 4 1 
0 24 14 0 0 0 0 19 3 0 0 16 0 0 0 1 8 6 19 26 0 0 0 13 0 7 19 17 
0 46 3 0 5 5 1 20 0 0 2 0 0 0 0 12 0 0 30 0 0 20 12 14 14 25 0 26 
27 0 16 0 15 17 0 0 0 3 18 0 5 3 9 4 13 0 8 6 0 0 0 9 6 0 0 27 
