28 16
0 13 0 2 0 0 0 23 0 0 0 0 1 0 6 0 9 0 0 0 2 0 0 0 11 0 0 0 
13 0 1 0 4 0 13 8 6 13 13 0 10 7 0 4 0 0 0 15 10 14 2 18 1 28 0 6 
0 0 0 0 0 0 0 0 0 9 0 0 12 7 5 6 13 0 0 10 0 0 9 0 7 0 0 0 
0 38 1 2 0 3 4 1 6 0 4 0 0 5 15 0 0 0 0 5 0 0 0 4 5 0 25 4 
0 14 11 0 1 0 0 0 4 18 0 5 17 0 0 0 2 0 0 3 6 0 3 0 4 9 31 18 
12 6 3 10 20 6 9 0 0 0 15 0 27 2 1 23 0 1 0 7 3 0 3 28 0 15 0 12 
0 7 0 0 0 4 14 0 7 0 4 10 18 0 25 0 9 0 12 1 0 0 11 4 5 2 14 5 
0 4 3 0 3 2 39 15 6 17 0 0 6 2 19 9 1 9 8 18 18 3 26 0 10 6 8 21 
0 14 8 0 0 0 19 19 16 0 15 13 7 11 3 22 0 10 1 8 33 2 18 6 7 33 18 0 
0 0 1 3 0 0 3 0 4 8 0 5 0 3 0 0 0 8 0 0 0 1 0 4 0 8 0 0 
4 14 12 3 18 6 5 2 18 15 0 0 6 0 21 14 0 0 4 0 0 1 13 5 15 0 18 0 
0 0 7 0 0 0 6 0 0 9 0 0 6 0 3 0 0 0 0 0 4 0 9 0 0 0 0 0 
0 16 0 0 0 0 6 6 0 10 0 4 4 0 5 0 15 5 4 0 0 0 0 11 0 0 2 10 
17 13 9 3 0 0 0 0 13 0 8 0 13 24 0 0 0 20 2 0 1 3 0 11 0 7 9 2 
11 11 1 0 0 21 22 40 2 0 12 0 0 3 0 1 0 0 3 0 14 3 0 6 0 1 20 22 
5 23 4 10 0 11 1 18 13 0 0 5 7 0 5 7 18 0 13 25 3 15 0 8 7 18 0 0 
