28 16
13 0 7 13 25 0 2 19 12 11 0 13 0 13 0 14 8 9 0 0 0 0 20 0 13 0 2 23 
7 0 1 11 19 5 0 1 0 11 15 4 6 19 0 12 0 0 0 0 11 7 1 0 12 0 0 23 
9 47 16 6 23 1 9 25 2 25 12 9 9 15 9 3 12 8 31 8 0 10 8 19 19 3 0 26 
0 0 0 0 6 7 0 0 3 0 0 6 1 18 7 0 0 0 5 0 2 7 0 0 0 9 13 0 
10 3 6 11 0 0 0 1 1 0 4 0 1 4 3 0 0 4 2 0 0 0 0 0 0 0 4 0 
27 0 24 14 2 11 5 0 5 8 1 13 18 1 0 6 14 5 9 0 4 9 13 14 5 9 14 27 
0 0 0 0 0 0 0 9 1 0 0 5 0 1 0 0 0 9 0 0 9 0 0 0 0 1 8 0 
18 9 0 3 13 13 14 0 4 0 1 13 14 0 10 5 1 3 0 9 19 0 0 0 13 0 0 0 
19 6 14 0 0 3 15 0 16 1 0 0 0 13 8 11 0 0 3 5 12 7 0 21 19 19 0 0 
30 33 0 11 2 0 5 0 2 6 0 0 11 0 0 0 0 0 0 0 0 0 0 22 23 0 21 0 
0 2 0 1 13 0 5 0 0 8 9 5 11 0 0 0 5 18 0 18 0 0 0 0 2 2 0 2 
0 0 16 0 2 0 8 0 0 0 0 5 6 0 0 0 16 0 8 0 10 0 0 0 1 0 0 0 
0 12 9 0 16 15 1 0 0 9 0 23 3 1 0 0 0 3 9 0 5 1 1 0 1 3 6 2 
4 0 13 0 16 25 0 4 1 0 5 14 0 9 0 0 3 7 0 2 0 5 0 0 12 21 4 0 
29 8 0 3 7 19 0 8 16 17 0 7 0 13 0 0 0 0 15 19 0 0 0 0 12 0 0 0 
0 2 0 15 0 15 0 0 0 0 10 1 15 1 0 3 0 5 10 9 24 10 5 0 12 8 0 5 
