28 16
4 2 0 0 1 19 0 0 10 9 0 8 0 0 8 0 0 10 10 8 2 0 0 0 12 0 0 0 
0 14 20 0 7 1 0 0 3 0 0 0 0 0 0 16 1 0 0 0 0 7 12 0 0 0 0 0 
22 14 3 0 0 18 20 0 7 8 0 2 25 2 0 22 11 26 0 17 17 0 12 0 0 10 31 23 
2 11 53 14 22 12 9 19 14 7 0 6 18 0 0 29 14 14 5 25 31 46 5 5 20 17 17 0 
14 0 1 0 0 5 1 1 0 0 0 0 11 2 7 3 13 2 0 10 3 4 5 9 0 6 1 0 
0 0 0 0 5 0 17 0 11 0 0 0 0 7 0 0 0 2 6 4 0 0 9 11 0 0 0 0 
5 4 5 0 1 5 7 0 1 0 0 9 0 0 3 0 2 0 5 0 5 0 0 9 0 14 0 0 
0 0 9 0 29 0 6 3 3 10 4 25 0 0 9 1 0 11 14 0 3 3 4 0 5 16 0 16 
0 8 0 0 5 4 0 0 0 5 9 1 9 0 1 7 3 9 0 2 0 4 10 13 10 0 1 0 
10 0 0 0 5 0 21 6 6 0 16 0 0 0 0 0 1 6 0 0 0 6 3 0 0 0 1 24 
0 20 0 1 4 0 4 0 0 18 1 0 0 0 0 3 5 9 0 0 0 5 0 0 0 7 0 44 
14 2 5 10 0 5 12 0 0 10 0 14 0 10 0 0 6 0 23 1 0 0 3 0 1 23 1 0 
3 0 2 3 22 0 16 4 4 4 0 5 14 4 5 0 7 9 0 9 9 11 0 2 32 10 1 3 
2 2 4 23 10 11 26 0 0 8 0 0 0 0 0 9 0 8 0 0 0 12 0 0 0 0 34 1 
11 16 0 0 9 4 0 0 9 14 0 11 8 0 0 15 0 4 9 0 2 0 26 3 0 5 6 1 
13 0 0 0 0 0 9 0 14 1 11 2 0 0 6 1 1 0 12 0 6 0 14 0 0 0 16 0 
