53 30
51 8 13 21 16 0 24 0 9 85 0 16 0 23 5 24 33 9 29 0 11 31 25 4 0 0 37 20 0 36 0 20 0 0 0 0 9 28 0 0 0 0 29 0 4 0 0 0 0 25 0 29 31 
0 13 0 0 47 0 7 0 0 0 6 19 11 10 6 0 5 0 0 41 0 0 0 24 9 0 25 0 0 25 1 0 24 0 16 0 8 0 6 0 7 0 38 0 35 0 0 0 0 1 95 37 21 
0 17 0 0 19 24 0 0 10 10 0 26 0 32 23 0 0 30 4 13 0 0 0 24 17 32 0 0 39 8 0 2 7 7 0 0 25 36 0 7 0 0 0 0 0 0 0 6 20 0 1 23 0 
0 6 48 27 0 0 17 0 0 7 18 0 0 30 0 0 8 0 0 4 0 11 0 0 8 20 0 20 7 30 11 0 33 0 16 7 0 10 26 0 6 28 15 0 7 0 22 0 3 1 32 7 2 
0 14 40 9 6 25 0 8 32 0 6 7 21 11 0 14 4 0 4 0 0 0 4 15 31 0 0 4 48 0 9 0 0 36 0 0 15 0 0 0 3 0 15 0 35 24 16 0 20 0 42 18 0 
6 23 0 0 0 0 18 0 23 0 0 24 25 8 0 34 20 35 0 3 0 8 21 12 17 0 12 0 0 0 16 21 0 4 0 13 0 0 18 0 0 11 0 0 6 15 11 18 24 39 0 23 31 
26 0 21 0 0 0 0 36 0 11 25 0 30 0 0 0 5 0 4 0 11 15 4 24 0 11 28 35 2 0 0 0 26 0 11 0 15 0 21 6 0 0 15 33 0 14 19 25 0 0 0 0 0 
0 44 0 8 16 22 43 12 44 10 0 20 3 0 19 0 3 0 12 16 1 4 0 4 0 0 23 32 18 27 0 0 12 0 22 0 6 6 54 0 0 0 0 0 10 50 1 0 27 0 0 0 31 
15 8 0 40 0 24 0 32 10 9 18 7 0 0 0 3 21 0 8 25 0 0 13 24 20 0 0 5 0 29 8 12 3 18 18 3 0 0 0 32 0 0 11 0 58 0 0 0 45 4 0 0 0 
52 3 0 3 22 35 21 45 17 0 7 0 39 8 0 18 7 14 31 24 10 23 20 0 0 0 0 21 0 2 0 0 3 10 0 0 11 31 2 0 30 41 0 9 25 0 1 0 8 6 0 32 49 
0 16 22 25 32 0 0 5 26 18 42 39 41 24 0 14 30 4 57 0 2 20 26 34 25 18 24 10 25 0 0 16 9 0 5 0 32 26 0 26 0 7 3 30 28 11 5 39 36 10 33 10 57 
18 0 15 3 0 0 0 40 24 0 12 0 0 21 0 7 18 0 0 12 0 1 18 3 36 0 5 0 0 36 6 5 0 0 21 11 13 10 0 0 0 0 0 0 6 10 22 50 32 0 21 9 0 
0 5 3 0 0 0 0 14 10 17 0 0 11 0 5 2 31 2 11 0 2 10 21 0 8 0 0 4 0 3 9 0 0 10 12 0 0 11 0 17 0 0 8 10 5 0 3 0 11 18 0 0 0 
35 0 0 81 23 0 0 0 0 0 9 0 0 10 0 19 0 0 0 36 0 0 0 0 10 0 15 0 1 13 0 0 0 12 9 67 2 40 0 0 36 0 22 12 7 6 27 5 75 12 0 0 3 
0 7 0 3 0 0 0 0 0 21 3 0 9 0 8 0 0 0 0 9 14 0 11 6 0 0 2 13 26 0 21 0 7 13 0 0 10 0 0 0 0 0 0 10 24 25 31 0 12 0 0 0 10 
0 0 27 0 14 0 0 0 2 24 0 7 0 0 0 51 2 6 4 2 0 2 0 0 0 0 0 12 11 24 15 0 0 20 0 0 0 0 0 23 0 0 0 0 7 0 3 0 0 9 0 15 0 
0 0 6 0 0 8 0 0 7 16 21 0 11 0 0 0 16 0 16 0 0 0 0 7 6 0 12 11 13 16 0 21 0 0 4 0 9 0 0 6 6 0 0 6 6 0 6 2 0 0 6 0 0 
26 78 13 18 40 0 12 20 2 15 0 0 0 0 32 29 7 27 24 19 3 6 9 14 1 29 20 11 0 0 0 24 0 12 0 6 12 0 16 13 0 1 25 0 21 0 20 0 0 3 0 50 17 
0 36 6 3 0 0 3 0 11 0 0 23 0 10 0 0 11 24 10 0 0 11 9 12 5 0 0 0 17 0 0 0 0 18 17 8 0 9 0 0 0 24 11 6 0 0 35 2 0 0 0 18 0 
46 1 10 26 0 0 38 4 0 46 0 21 1 0 0 0 21 0 0 10 0 15 29 3 8 0 2 16 0 26 2 14 5 24 27 0 23 15 0 0 0 0 24 0 26 6 46 14 14 0 0 17 0 
11 5 0 11 0 4 18 0 0 3 2 27 32 32 0 6 4 13 6 0 0 2 0 9 0 14 0 0 0 8 13 0 0 0 44 34 7 1 12 28 0 0 16 18 48 34 5 0 4 15 12 15 12 
18 22 0 19 28 5 15 0 14 0 26 30 0 0 9 57 13 6 4 0 5 0 4 0 4 1 20 0 0 6 7 2 7 12 4 36 22 0 3 0 2 0 5 29 39 37 9 0 2 28 0 16 47 
27 0 4 15 20 0 22 0 0 31 2 0 86 0 11 25 0 0 7 0 0 9 7 14 26 27 7 16 0 0 0 0 24 9 0 11 36 5 0 0 3 0 5 17 0 0 5 35 20 26 6 5 0 
17 17 20 0 0 0 0 4 24 15 34 27 12 45 0 0 3 29 36 5 30 0 0 0 2 5 7 3 5 0 18 0 6 8 0 17 10 0 13 1 0 0 0 0 34 18 29 0 10 2 2 0 41 
0 38 0 0 0 10 24 75 39 52 0 0 0 0 0 0 0 2 0 5 0 0 22 9 14 14 8 3 22 13 0 5 4 4 0 0 5 0 0 52 0 37 0 26 4 0 20 39 0 0 65 4 13 
0 0 0 26 39 0 24 8 0 13 30 0 52 30 23 17 68 0 0 2 0 3 79 42 0 11 2 0 0 26 20 0 8 9 0 14 20 10 0 0 69 0 0 60 7 8 37 0 32 14 20 29 0 
2 28 103 102 38 11 0 0 23 29 2 24 0 15 20 24 14 12 4 4 0 0 29 0 5 0 59 12 39 11 25 2 1 16 5 25 33 12 34 24 0 0 1 0 0 36 44 62 53 3 0 0 0 
41 7 34 35 0 38 0 43 0 21 20 63 0 17 17 18 22 0 0 23 53 0 6 0 0 0 27 13 1 16 87 3 7 28 9 0 6 0 33 6 0 41 6 49 0 23 26 0 0 27 43 21 0 
3 32 0 92 1 3 27 76 31 10 35 30 0 0 0 55 0 11 9 8 0 0 4 4 21 0 22 12 24 25 0 22 17 7 0 18 0 13 0 0 0 4 27 0 41 59 39 32 45 18 0 77 26 
45 0 10 0 0 4 0 14 0 29 0 10 0 6 7 0 11 0 0 0 15 18 27 9 19 0 1 19 14 6 0 38 18 27 25 6 13 0 12 17 0 0 54 2 0 30 7 24 0 0 18 14 7 
