53 30
3 0 30 76 47 11 14 0 25 37 18 42 0 48 2 16 4 0 0 11 53 23 20 12 0 16 0 14 21 4 2 7 10 11 27 0 13 17 18 24 0 18 42 21 12 51 36 0 29 39 85 33 41 
0 0 0 0 0 16 15 0 33 30 0 22 0 1 20 12 1 10 1 0 0 17 0 0 28 0 0 31 0 0 0 0 25 14 16 0 0 27 6 72 32 4 15 0 13 0 0 0 24 1 0 19 0 
6 6 8 0 12 0 6 0 36 0 0 17 25 16 2 6 0 0 5 0 13 12 12 0 17 0 8 10 18 0 9 0 21 0 12 2 0 46 23 29 0 17 0 0 36 0 0 5 1 9 26 0 11 
3 17 4 0 49 36 18 14 0 13 9 0 0 2 8 0 34 10 0 19 41 39 0 0 33 0 8 0 8 4 0 0 0 7 0 0 0 17 18 0 0 36 32 24 0 28 0 3 14 0 13 0 0 
0 25 0 10 10 0 16 7 4 0 10 0 0 10 0 0 0 17 3 0 0 3 1 19 24 19 0 2 3 48 6 3 0 0 22 0 14 20 14 0 7 14 21 0 4 0 40 32 6 1 16 0 14 
0 32 36 5 0 4 9 0 19 2 11 9 0 0 1 0 17 0 0 13 11 28 0 13 0 0 2 29 15 0 11 17 31 34 0 0 0 0 0 0 9 0 21 0 39 0 6 0 43 18 0 1 6 
0 0 4 0 19 71 18 0 39 0 0 0 4 17 10 0 3 21 29 32 0 22 0 0 14 16 0 0 26 22 0 0 0 0 2 0 0 0 0 0 35 0 0 0 0 0 0 45 0 0 45 33 0 
0 0 1 21 3 0 13 0 9 14 3 0 0 0 0 7 0 9 0 0 21 0 14 1 7 23 0 0 1 16 0 2 0 0 0 10 0 2 17 2 0 17 0 0 0 23 3 28 23 9 9 0 0 
0 49 0 0 0 0 0 17 9 0 0 3 0 10 0 6 0 6 0 24 0 0 8 1 0 10 4 0 0 11 0 6 18 16 0 10 25 26 0 0 11 0 0 0 43 0 0 64 29 8 0 0 33 
0 0 0 0 41 7 0 20 12 25 0 0 0 0 0 0 0 20 0 3 0 0 0 0 0 0 0 1 0 0 0 6 0 1 38 0 0 11 0 31 0 0 0 0 0 41 6 0 29 0 0 0 0 
0 17 36 7 2 3 0 0 10 7 0 0 19 0 25 33 0 10 17 0 24 9 0 0 21 19 0 10 16 0 0 0 0 0 20 4 0 35 0 2 15 0 16 0 19 0 3 0 33 8 0 0 17 
0 0 26 0 35 14 31 30 18 4 1 24 15 11 26 0 21 32 4 14 34 20 8 0 0 11 0 14 30 6 11 1 21 0 23 29 4 31 22 35 15 6 6 0 37 10 26 0 8 15 36 20 0 
0 0 39 16 2 47 0 61 30 0 30 0 17 17 3 0 1 1 2 27 6 9 13 0 18 16 24 3 0 0 16 0 40 26 0 29 0 8 22 38 30 14 40 0 13 1 7 30 0 7 24 21 14 
10 0 13 18 9 0 0 0 39 12 30 0 32 8 0 28 33 26 29 13 0 0 0 0 13 0 7 9 14 2 0 2 10 6 15 2 20 8 0 0 30 2 42 0 34 13 19 43 0 41 0 0 24 
31 0 55 0 12 0 9 21 0 31 0 0 1 1 0 32 5 15 11 0 0 19 0 27 0 4 15 0 9 0 0 25 0 0 0 0 10 0 0 0 7 6 4 22 0 1 31 6 46 0 30 0 7 
6 0 0 0 69 9 40 0 38 0 26 5 0 0 9 0 0 0 20 6 0 0 19 19 4 27 0 0 15 10 7 16 2 15 0 0 12 0 11 8 16 0 15 15 18 13 18 9 30 0 0 55 44 
4 0 3 39 37 55 48 0 68 28 96 0 33 29 0 3 11 0 0 0 0 0 0 19 33 0 7 62 2 0 5 17 24 7 19 7 0 31 15 0 3 0 71 0 6 76 11 0 51 18 3 0 40 
0 7 36 1 3 0 17 0 0 10 0 23 0 48 0 5 3 0 0 20 17 0 10 16 9 0 9 0 7 0 0 16 35 0 16 0 2 52 0 20 0 0 0 28 16 0 8 0 1 0 0 17 39 
0 6 40 10 43 24 11 0 1 0 0 31 0 26 6 0 5 19 0 0 2 0 12 46 0 0 9 11 0 12 0 0 10 0 0 3 1 26 0 0 0 12 9 41 0 28 0 43 25 0 0 27 9 
0 0 49 11 34 0 0 5 4 8 0 0 0 0 61 11 0 15 0 3 0 11 0 3 22 0 0 0 3 8 0 8 2 19 0 31 2 0 0 0 0 10 0 0 0 0 20 0 0 18 0 45 38 
0 22 2 1 3 0 10 0 0 0 28 0 46 0 0 29 4 0 0 1 0 0 12 20 18 20 9 0 2 0 22 0 6 1 7 2 0 19 0 0 0 21 9 20 29 19 0 6 4 0 38 28 22 
11 0 1 36 0 0 0 29 8 2 0 0 9 0 11 10 1 25 0 19 0 7 1 0 0 10 33 0 2 8 0 0 0 0 1 0 12 15 0 0 23 15 0 3 0 0 12 5 45 0 0 31 0 
0 47 69 32 0 20 3 21 18 38 0 2 0 5 3 2 32 6 11 29 39 25 17 0 24 23 21 4 18 33 1 8 4 19 1 24 46 5 0 37 31 21 0 12 0 0 25 21 26 0 20 16 19 
26 21 79 24 3 0 21 5 6 3 27 0 14 65 24 0 9 17 12 0 0 6 0 0 2 0 34 8 21 16 12 0 8 0 22 2 0 29 1 0 44 6 29 41 0 16 0 0 14 3 0 0 0 
0 7 2 14 0 45 0 36 42 0 0 0 0 0 13 0 0 0 0 5 0 0 13 5 0 0 0 0 5 20 0 0 0 14 0 11 10 0 26 0 0 0 0 39 0 24 21 0 1 0 108 0 0 
0 0 22 0 19 0 17 12 24 12 39 15 7 0 31 0 15 7 2 3 21 0 3 0 23 0 15 12 0 0 0 10 1 0 0 0 0 0 23 0 0 14 0 0 30 0 4 0 5 39 14 4 13 
0 42 21 21 6 0 24 13 0 38 2 8 47 0 30 30 16 0 8 0 23 0 0 21 18 4 9 0 8 19 15 1 4 18 1 7 8 5 25 0 0 12 1 42 0 13 0 30 48 0 0 0 14 
0 1 1 7 24 21 0 17 0 57 8 0 0 0 3 0 22 18 0 0 0 0 12 29 23 16 8 0 0 10 21 0 37 0 16 0 0 5 14 25 0 12 5 0 0 36 13 15 18 0 0 28 9 
0 0 9 23 25 0 12 0 22 1 51 0 0 9 0 0 0 0 0 0 51 20 0 0 15 0 0 14 8 0 0 0 0 8 24 7 23 27 0 14 0 0 0 0 0 41 14 21 0 0 45 41 26 
0 74 39 10 0 2 41 0 26 19 0 2 24 15 0 12 0 20 0 13 11 6 17 25 0 0 15 23 9 17 3 4 36 14 0 12 0 0 7 27 0 29 0 20 29 0 42 29 29 13 49 7 0 
