53 30
0 0 0 70 21 0 3 0 1 6 27 0 19 42 0 80 0 2 0 21 19 0 13 46 10 21 0 0 34 0 0 2 29 41 14 17 0 3 21 24 0 0 0 0 12 16 0 0 33 0 0 22 0 
33 0 22 0 0 0 0 0 23 0 0 0 0 0 34 0 24 0 4 26 0 0 0 13 12 17 0 0 22 0 22 0 0 0 0 1 12 0 0 0 16 34 5 0 9 11 0 0 4 2 81 2 34 
6 33 0 28 2 0 4 8 2 9 6 0 31 20 2 21 36 0 0 50 45 24 19 12 19 7 2 16 28 0 15 36 0 39 15 2 0 20 0 0 32 56 14 41 24 10 0 46 25 30 9 28 55 
0 6 0 6 10 44 0 0 10 60 6 0 51 0 0 0 6 2 50 7 0 19 0 0 0 5 16 1 3 0 11 2 0 61 0 6 5 9 0 14 19 35 0 10 25 0 0 0 0 10 18 0 44 
0 0 35 34 29 0 0 0 0 77 0 0 0 0 0 0 17 0 32 14 0 0 18 10 0 0 12 5 4 35 13 22 9 8 10 4 0 58 0 27 19 9 0 6 4 20 57 0 0 42 20 19 1 
0 20 6 12 0 0 0 0 17 11 8 9 7 10 0 0 55 0 17 2 3 0 10 42 0 1 0 4 0 0 0 0 0 0 0 26 0 21 0 0 0 0 0 0 21 0 0 0 54 22 2 0 30 
45 0 42 84 0 11 2 0 0 0 0 4 38 0 63 30 17 0 0 13 21 28 15 10 0 3 0 7 0 0 13 0 33 6 3 8 0 24 6 8 0 17 30 0 70 39 3 0 45 51 13 6 3 
0 0 36 44 0 53 39 31 30 13 17 0 0 0 4 10 0 20 55 0 0 1 13 29 30 0 0 0 0 5 0 7 0 0 7 6 9 0 37 0 0 13 0 1 4 48 0 31 1 33 32 23 31 
0 9 0 13 4 29 20 18 80 0 0 0 39 0 10 12 2 0 11 17 0 20 0 0 7 7 12 0 29 16 0 2 16 0 25 8 5 2 15 3 0 0 0 12 0 1 0 26 0 37 0 63 0 
62 31 40 7 34 0 26 0 25 20 25 7 22 15 14 0 10 0 31 9 0 0 14 32 2 28 0 2 0 20 0 0 0 20 17 34 0 0 4 5 0 8 36 0 2 41 0 1 0 38 6 0 50 
16 7 58 11 41 30 9 0 52 9 8 0 4 14 18 0 2 9 8 10 0 0 5 26 10 0 0 15 21 0 4 8 15 9 0 3 11 17 3 0 0 22 0 0 25 22 0 12 5 21 43 13 3 
9 0 0 31 29 0 0 0 36 22 36 0 0 0 5 0 16 4 1 0 26 0 3 7 19 0 0 3 0 10 0 35 4 45 0 26 0 20 0 10 8 0 32 19 46 0 26 31 8 2 19 0 0 
22 0 0 0 33 23 0 0 0 0 0 17 1 12 6 2 0 49 0 0 6 10 22 5 3 10 22 7 35 0 14 0 0 0 10 15 0 0 0 16 0 0 19 0 0 11 4 0 2 32 0 0 0 
0 0 0 0 21 0 10 0 0 3 3 12 0 0 0 0 0 0 0 4 8 0 0 4 20 0 0 0 8 0 0 16 0 10 20 15 1 1 0 5 0 16 22 2 0 0 0 0 0 0 14 0 3 
31 18 0 3 30 40 23 41 0 7 0 30 0 8 1 11 3 0 32 21 20 0 6 13 0 21 9 0 34 23 8 9 8 0 0 4 0 0 0 43 21 12 7 0 0 21 0 19 39 0 33 14 11 
49 0 15 4 0 0 0 0 2 0 4 0 0 0 0 34 0 22 3 0 0 11 0 0 4 0 22 0 17 0 15 0 0 5 20 33 6 22 7 22 0 0 7 14 0 17 0 0 22 45 48 0 0 
44 0 0 2 75 27 40 38 14 8 6 22 0 8 0 20 27 6 47 0 8 0 0 20 0 9 0 10 24 9 0 0 45 0 9 3 14 0 0 28 0 0 14 36 44 0 44 43 0 0 34 33 37 
15 9 58 13 47 15 0 0 1 0 23 21 27 0 21 29 0 32 14 12 59 5 16 0 0 3 0 38 0 19 28 0 0 0 0 21 31 0 16 20 0 8 5 41 4 20 37 1 37 25 30 134 0 
19 47 0 16 0 0 16 0 7 0 0 4 22 7 0 19 13 0 0 0 0 0 8 7 0 1 0 7 0 26 4 0 0 33 12 24 36 0 11 0 0 11 12 0 0 11 0 1 35 27 0 18 38 
0 40 23 22 0 0 21 0 13 0 0 0 18 1 18 0 0 15 0 0 14 13 0 9 6 22 0 28 1 0 0 0 2 19 10 11 0 0 4 0 10 31 0 0 0 0 0 0 42 0 9 1 17 
0 0 15 10 28 21 0 13 18 0 0 0 8 0 39 14 0 15 0 0 19 0 0 0 0 2 21 14 20 0 25 1 0 5 12 5 0 0 34 0 0 14 0 0 30 40 32 0 0 4 0 0 0 
0 51 0 18 41 21 46 0 13 28 13 11 17 12 1 33 0 22 0 20 19 0 21 0 0 10 8 15 3 2 0 9 7 0 31 26 6 0 0 6 0 9 0 26 0 41 17 35 73 88 9 3 5 
20 7 8 0 6 20 63 7 28 18 17 6 0 0 0 0 0 0 0 13 0 5 0 0 0 20 18 5 0 0 2 21 2 0 28 0 0 7 0 0 9 4 5 5 4 0 3 0 4 3 16 0 5 
25 15 19 0 4 28 0 21 4 0 2 0 4 5 3 25 21 0 0 11 8 0 0 18 11 2 12 0 19 19 0 0 4 31 20 16 6 0 3 0 0 1 10 43 20 0 5 0 5 24 5 0 0 
6 7 0 0 0 0 6 0 13 46 1 0 0 36 0 0 0 27 0 0 1 7 0 0 5 0 0 0 5 0 2 0 16 18 9 6 23 3 5 1 23 0 33 1 16 0 13 0 0 0 0 0 35 
0 44 0 0 0 0 16 0 16 30 2 3 22 16 0 0 20 28 1 0 20 0 0 6 0 7 36 22 0 16 11 0 8 16 9 14 3 0 4 9 10 0 4 3 0 36 15 0 20 0 21 8 7 
23 0 0 31 20 0 0 1 1 6 0 0 0 0 3 0 0 0 0 6 0 8 15 16 0 0 0 0 17 0 31 0 0 4 11 0 16 17 0 5 126 58 0 4 24 25 18 53 0 9 0 0 16 
0 35 63 23 0 0 17 0 65 40 29 0 40 37 0 13 22 29 8 0 21 0 0 0 20 0 18 0 15 0 14 0 19 31 14 15 35 17 5 0 5 8 0 42 34 0 20 0 0 40 15 20 21 
22 0 0 0 0 0 0 0 40 4 23 16 15 12 0 83 0 0 0 28 52 0 4 25 0 2 0 0 0 0 0 0 19 9 0 23 0 0 0 0 43 26 40 0 0 0 0 27 18 0 0 53 0 
0 5 17 18 0 6 0 6 16 0 10 16 0 1 0 33 7 6 13 30 9 0 15 0 11 6 11 1 0 12 14 22 5 0 0 18 6 6 22 0 22 23 0 0 14 32 0 0 3 30 13 0 15 
