53 30
45 27 16 0 19 0 39 18 0 41 17 63 0 0 0 0 35 13 0 6 26 0 15 27 14 25 0 25 3 14 23 26 0 0 0 0 0 0 0 21 0 0 0 0 0 51 1 2 0 0 61 1 14 
0 58 0 63 26 0 1 28 29 10 12 0 2 27 25 7 28 0 5 23 15 0 10 49 15 0 4 11 0 0 0 0 22 2 27 0 0 0 13 8 18 0 13 0 0 0 0 48 17 0 20 0 0 
2 31 0 26 0 0 0 0 0 0 36 23 0 0 1 16 0 4 39 0 5 9 12 0 16 5 0 1 0 42 19 27 22 23 23 36 2 22 2 38 0 0 41 2 22 59 11 0 0 48 1 17 0 
76 0 43 3 6 68 42 35 8 8 0 22 0 14 0 11 23 7 35 25 28 16 2 13 6 0 27 14 0 20 0 0 0 20 0 8 23 0 0 0 2 10 0 43 0 16 41 0 115 22 31 23 26 
10 5 47 0 0 0 0 43 0 37 3 47 20 0 0 16 0 0 7 0 0 14 7 0 0 3 17 24 0 22 8 33 20 12 23 19 0 0 28 0 12 31 23 0 0 60 0 0 11 51 0 25 10 
21 0 24 74 8 0 0 0 43 6 15 0 8 54 0 0 20 9 0 0 21 0 0 5 11 0 0 0 22 0 0 0 12 4 10 0 3 26 0 0 37 2 40 0 31 21 43 0 1 0 11 1 0 
10 0 1 0 4 0 24 30 4 16 0 38 0 0 44 4 12 15 21 4 6 12 4 0 0 2 2 7 17 0 12 7 16 0 0 34 0 30 0 9 13 0 0 7 0 8 2 0 20 52 7 1 1 
12 0 1 43 0 0 0 43 0 0 0 38 0 40 19 19 20 19 0 10 26 0 0 21 0 0 0 0 12 0 0 0 0 0 0 10 0 0 0 5 0 2 23 0 8 3 17 0 35 37 6 0 0 
0 0 0 0 0 24 15 4 0 0 34 35 0 37 38 0 0 0 8 1 15 15 0 0 19 0 0 25 0 0 0 19 0 11 17 21 0 0 0 0 0 8 0 0 10 18 35 0 0 0 9 18 2 
19 55 0 0 5 0 11 0 0 0 0 0 0 8 0 35 5 14 10 45 2 21 48 0 0 0 4 0 16 0 17 11 18 17 0 0 0 6 0 8 10 0 33 0 0 4 0 0 0 19 44 50 33 
0 20 33 34 11 44 0 25 102 0 0 12 3 3 38 10 32 14 0 0 30 0 15 7 2 3 2 40 14 0 19 0 12 0 13 54 45 44 17 38 0 14 0 20 21 20 0 39 32 44 30 0 0 
30 0 26 0 25 13 0 6 42 0 0 19 0 2 14 0 8 35 0 4 0 28 13 0 0 0 0 0 26 9 49 0 0 0 0 12 13 0 17 7 0 0 6 0 0 0 0 0 0 20 44 0 35 
3 0 0 0 32 47 7 0 0 0 0 19 2 44 53 9 14 3 16 0 4 0 0 11 20 9 1 25 0 7 19 14 0 0 0 0 41 18 0 0 11 0 5 0 20 0 0 14 1 0 0 0 12 
12 0 8 0 0 0 0 0 0 71 8 24 0 30 16 7 25 0 0 0 0 10 18 23 0 0 45 0 0 0 0 7 0 0 10 35 0 9 0 0 18 32 0 4 50 4 0 0 0 12 8 0 0 
0 0 0 25 0 47 0 0 6 0 0 0 0 0 3 20 5 12 12 14 0 5 0 0 14 0 5 0 22 14 0 0 0 0 0 11 9 0 7 0 0 0 7 0 0 19 18 0 0 0 4 0 61 
28 24 0 0 0 0 28 0 29 2 17 19 0 3 0 0 3 16 12 31 42 3 26 0 3 0 21 35 29 0 2 23 0 4 27 14 16 7 0 0 0 31 0 0 13 19 0 0 15 0 55 0 0 
78 0 13 0 0 1 43 0 44 0 37 5 3 33 0 26 38 53 11 6 4 0 0 0 0 33 1 22 0 29 0 30 0 12 0 1 10 0 0 0 12 18 25 0 0 30 22 37 6 22 42 51 29 
0 0 0 0 23 12 4 37 0 0 2 10 0 18 14 17 18 28 1 8 10 16 0 10 14 19 0 0 14 32 5 30 4 0 0 11 0 0 30 11 10 0 21 0 56 5 6 0 28 3 6 0 31 
38 17 60 3 56 0 72 73 17 97 39 27 6 3 29 4 6 22 28 4 6 7 20 0 12 15 0 12 28 17 35 22 23 0 10 0 0 0 38 2 14 35 26 12 34 35 3 12 21 0 55 0 5 
2 49 19 0 42 0 32 16 0 5 11 3 11 8 3 5 0 0 32 8 14 3 0 0 16 0 35 9 9 0 0 29 5 26 2 11 2 1 36 7 0 0 18 1 0 0 0 35 0 10 46 32 19 
12 0 2 0 39 5 0 17 6 0 15 6 49 0 0 7 0 0 15 8 31 0 0 0 0 0 0 0 0 6 20 0 0 54 0 6 0 0 10 0 8 0 0 39 36 0 0 14 8 0 5 0 39 
0 45 0 17 4 0 48 0 42 11 0 5 19 6 0 20 5 0 36 14 28 5 0 2 1 14 0 0 0 0 6 17 0 18 2 0 0 0 20 35 0 0 4 3 14 0 45 0 0 0 51 18 0 
4 8 27 0 18 6 0 0 48 26 0 27 1 21 3 6 6 0 10 19 9 10 0 19 0 0 11 12 9 36 0 0 36 0 0 16 0 38 25 0 0 0 19 0 0 0 0 39 19 3 4 0 20 
40 0 0 0 8 34 4 42 0 14 4 0 8 44 32 4 0 28 5 20 25 12 0 27 19 0 0 0 23 20 10 20 0 0 12 47 9 7 1 37 13 0 0 0 0 28 0 4 0 42 0 20 0 
38 0 0 0 0 13 34 21 2 0 2 0 0 0 16 5 0 5 0 0 5 0 3 0 0 8 21 0 6 0 20 25 0 0 0 0 0 0 0 2 66 1 0 5 4 0 29 5 0 5 18 38 0 
0 0 0 0 44 5 1 43 16 5 0 0 0 34 1 0 15 0 0 29 0 0 0 0 2 0 22 25 0 0 0 0 0 0 0 0 15 22 0 16 21 0 7 0 31 0 7 0 11 20 20 0 0 
19 0 0 0 8 0 0 0 0 0 2 9 44 20 9 5 24 48 0 23 7 0 2 9 0 13 12 17 7 17 34 41 0 2 16 3 10 16 14 26 52 3 0 0 27 15 0 35 0 51 16 5 23 
0 35 61 43 11 0 25 0 0 21 0 14 0 0 0 33 70 26 10 0 0 16 18 20 0 0 16 12 0 0 12 27 5 2 0 17 16 22 37 0 0 0 40 0 0 13 37 16 33 0 46 5 23 
32 107 32 0 0 2 0 2 0 25 0 65 38 0 57 0 2 22 45 0 18 0 21 44 0 5 0 0 0 0 5 13 0 15 32 0 22 0 55 4 0 0 10 8 0 0 0 0 39 0 38 38 41 
0 1 24 28 21 14 24 51 0 0 0 29 0 19 59 0 2 11 21 26 0 3 0 29 16 21 0 0 25 13 37 53 2 0 37 16 0 4 1 1 4 9 25 7 9 10 0 31 1 30 28 0 29 
