53 30
0 12 0 39 0 0 0 21 25 42 9 0 0 10 27 0 3 28 0 9 0 0 0 0 13 0 14 11 16 16 0 0 28 25 0 0 25 0 8 0 35 0 16 0 16 0 0 0 0 14 0 69 19 
0 0 0 8 24 47 0 51 0 16 0 0 0 0 0 8 28 0 6 12 23 0 9 31 0 19 11 13 0 5 0 33 0 0 23 0 9 14 18 30 7 10 9 33 19 15 39 0 30 0 10 14 61 
0 0 0 47 0 65 11 41 0 5 40 0 0 0 11 0 0 11 0 0 0 0 0 13 19 14 19 0 0 0 31 0 9 12 0 0 4 0 5 34 2 22 32 5 0 29 35 0 24 0 47 20 0 
13 31 49 13 19 25 0 95 10 0 28 0 19 3 11 1 11 8 4 0 9 5 4 0 0 18 1 0 0 3 0 0 0 0 3 1 2 7 0 46 7 0 0 0 0 35 0 43 15 0 0 25 52 
31 32 14 0 1 0 31 8 0 29 37 0 0 0 0 12 3 0 0 13 0 19 0 0 62 25 4 26 13 0 0 12 0 1 10 12 0 3 3 39 0 0 5 0 16 1 30 37 13 0 0 18 13 
0 0 0 12 26 9 6 45 2 15 16 41 2 21 15 0 0 0 0 0 18 0 8 6 26 12 0 4 0 0 38 23 9 0 0 0 12 0 0 12 1 16 0 1 35 8 44 0 0 4 0 12 70 
13 36 0 0 1 17 0 33 21 0 21 7 8 8 4 24 33 0 16 14 0 8 0 4 24 0 18 37 28 24 17 32 20 6 16 13 31 10 0 33 33 26 0 11 23 20 17 5 0 0 23 0 56 
0 0 19 1 0 10 41 0 35 25 0 0 6 59 19 10 6 16 32 33 0 5 0 0 21 0 1 6 2 0 0 0 0 9 4 0 12 5 20 20 0 9 12 41 0 5 7 34 0 7 0 38 33 
0 0 0 0 0 0 0 0 0 0 44 0 0 8 2 0 4 0 0 0 0 12 0 0 0 0 17 0 0 2 0 0 2 1 0 0 1 9 9 1 3 0 0 12 0 21 8 17 0 28 7 0 0 
0 27 0 1 8 56 0 9 42 0 46 8 23 0 4 15 3 0 6 13 0 27 0 29 6 4 0 25 48 19 15 19 13 0 13 15 0 16 33 2 0 11 0 7 0 0 17 17 9 0 20 0 1 
20 58 14 40 7 153 10 10 94 32 33 0 1 41 10 11 2 17 3 32 20 16 17 40 35 8 6 19 0 23 18 12 19 0 11 41 9 45 12 48 14 0 2 38 16 52 95 0 6 17 33 35 64 
0 0 0 10 48 0 5 0 35 0 0 5 2 0 0 3 15 0 18 0 0 2 1 0 16 0 8 7 0 0 22 0 0 13 0 4 14 5 0 27 0 16 0 45 0 0 9 0 0 0 10 27 70 
0 18 21 40 2 31 25 15 0 3 1 0 0 6 0 0 6 0 8 0 0 5 0 46 0 0 0 14 26 15 1 4 29 4 9 0 31 0 0 9 11 0 0 30 0 17 0 18 41 0 0 17 2 
0 0 0 25 10 0 0 20 0 0 0 0 4 0 37 9 0 1 0 10 0 0 0 0 7 4 11 14 25 16 14 0 8 0 0 0 11 11 0 12 14 8 0 0 10 11 22 14 0 0 8 6 0 
37 8 0 44 0 0 0 0 0 0 0 0 0 2 7 0 5 8 6 47 0 0 20 49 14 0 0 51 17 10 2 5 3 15 0 11 1 36 1 3 10 11 4 45 0 16 13 49 0 7 27 14 2 
0 0 12 0 0 32 42 31 0 0 17 0 0 0 9 0 14 0 4 0 10 0 8 10 1 0 13 1 0 0 0 3 15 8 0 0 0 34 44 13 15 14 21 0 8 0 11 9 0 0 0 0 12 
39 53 0 60 0 4 0 46 0 21 1 0 0 18 22 8 0 0 0 0 17 0 0 31 0 25 0 0 0 16 6 12 4 0 0 0 30 0 8 39 13 9 14 9 0 7 43 0 35 0 49 0 0 
3 0 6 12 0 8 17 3 59 0 16 10 0 7 15 0 5 9 4 0 12 0 3 13 10 12 0 0 0 19 3 3 8 9 0 8 16 3 0 0 0 10 9 19 0 21 0 0 0 25 0 2 10 
0 0 3 0 35 3 36 26 0 21 8 6 0 47 5 17 50 6 0 0 0 7 0 0 20 4 0 0 16 0 14 0 17 2 0 0 6 0 10 12 0 35 0 25 19 0 0 0 6 0 0 3 8 
52 0 17 0 0 46 1 0 5 15 11 10 6 25 3 17 5 26 7 32 12 20 8 13 13 0 7 9 18 19 9 16 17 13 15 13 13 0 3 0 25 3 0 29 31 25 18 0 2 0 29 28 64 
3 0 36 0 0 48 0 0 0 15 4 1 7 8 0 0 0 0 8 7 0 11 21 0 15 19 24 7 0 0 0 31 8 2 5 2 0 2 17 0 3 7 16 24 61 0 0 10 26 0 0 5 10 
68 0 8 0 19 0 16 0 0 11 23 0 0 0 7 28 0 7 13 0 11 7 0 17 26 5 24 36 7 25 0 20 0 0 0 0 17 0 3 0 17 0 0 43 0 0 31 52 0 0 0 0 11 
2 0 0 24 55 4 0 28 32 34 39 2 0 0 11 0 11 45 0 12 0 11 3 15 5 19 19 20 19 5 0 43 11 33 1 21 0 14 0 12 0 33 0 10 0 20 0 0 0 7 0 25 0 
0 0 39 0 0 19 0 12 34 50 0 0 0 4 1 4 0 15 4 11 0 8 0 0 18 18 0 0 5 23 0 0 25 8 41 0 2 0 13 0 16 44 11 34 13 0 3 4 0 2 16 7 0 
5 14 17 45 0 4 0 0 21 0 0 0 0 42 38 9 12 49 25 32 0 0 47 24 0 8 0 12 12 21 0 14 0 30 8 6 24 0 0 17 10 22 8 33 0 0 0 24 14 1 11 6 60 
0 23 13 0 27 0 27 0 0 0 12 0 0 0 0 13 47 0 19 0 10 0 3 10 2 4 58 0 3 0 5 17 32 31 11 18 25 6 0 3 0 11 26 0 0 0 11 17 17 0 16 5 0 
0 17 0 0 39 46 0 45 0 42 0 36 0 9 19 0 0 0 26 32 10 22 0 9 21 17 16 0 0 22 10 25 12 15 21 6 9 0 0 0 26 0 24 35 0 31 11 74 0 0 0 23 6 
23 23 12 12 0 0 9 30 15 17 0 10 0 6 27 12 0 0 30 19 17 0 11 38 19 0 0 19 0 2 0 28 0 13 0 0 9 64 41 21 14 12 0 0 13 25 0 45 0 0 12 3 1 
0 4 16 0 0 25 0 0 4 5 0 6 9 0 5 0 0 39 26 0 0 10 21 1 0 13 7 0 3 0 26 23 28 9 0 0 17 0 0 25 0 5 0 14 19 0 0 0 16 0 0 0 0 
28 0 0 0 35 9 29 45 0 0 35 0 35 18 8 1 19 30 24 0 0 0 0 20 6 5 13 21 28 0 18 0 13 0 25 0 29 24 0 47 0 0 8 0 23 2 0 32 0 0 19 12 52 
