53 30
25 0 9 0 0 10 0 9 0 4 0 44 0 0 0 0 56 27 0 0 4 0 0 0 0 0 17 25 22 0 0 0 4 5 0 0 31 10 1 0 29 27 4 17 0 0 0 0 31 0 13 38 32 
0 0 0 0 0 0 12 17 24 10 0 0 4 3 15 0 18 1 34 9 31 0 0 27 17 0 0 10 0 13 0 0 0 0 0 0 12 0 13 0 28 1 6 0 18 1 0 0 6 0 0 18 16 
33 36 23 43 14 6 0 0 5 34 8 0 12 0 14 0 0 20 23 20 0 18 17 0 22 7 0 0 10 0 0 16 0 17 0 0 8 11 22 0 21 0 0 61 0 6 0 0 0 0 5 13 11 
0 0 12 0 0 0 19 0 0 0 22 34 0 2 35 0 40 0 0 0 2 5 2 19 0 0 7 15 0 19 0 6 0 22 0 4 37 6 45 3 17 1 11 20 0 41 5 23 18 34 0 40 21 
0 0 0 0 2 0 2 0 24 0 0 0 28 30 38 0 0 0 0 4 0 0 0 1 0 0 18 23 0 0 0 18 0 0 0 0 1 0 2 0 28 0 16 0 0 0 0 0 0 0 0 2 62 
23 5 31 59 1 0 0 21 0 0 0 16 3 0 23 7 13 0 4 8 32 0 0 17 0 0 0 0 10 7 0 0 23 36 0 0 7 0 21 18 0 2 0 22 8 22 0 0 28 18 0 0 44 
0 19 0 10 0 0 24 23 1 0 0 23 0 10 25 0 0 1 1 0 0 16 20 2 0 0 0 0 4 0 0 45 18 16 0 4 0 0 0 0 4 0 20 0 0 0 18 0 0 0 19 3 0 
46 0 0 0 2 39 1 44 6 9 17 27 0 31 0 0 28 17 6 0 4 0 5 0 0 20 0 22 15 41 12 20 3 27 0 12 0 0 6 5 0 20 0 0 70 16 0 20 17 0 0 45 30 
48 1 0 0 11 6 39 3 0 0 18 31 0 0 0 10 0 0 0 18 0 8 0 23 0 10 15 19 11 29 0 5 0 0 30 0 29 37 0 6 0 15 31 0 15 69 29 0 1 0 0 15 4 
32 36 26 4 2 0 45 22 0 0 31 5 3 47 13 0 0 0 11 0 0 0 0 5 6 0 7 34 25 22 3 0 14 26 0 5 0 30 32 0 22 0 42 0 0 0 14 0 1 0 0 41 0 
13 8 34 4 0 55 0 23 19 54 33 11 0 11 65 44 21 0 0 6 42 6 0 0 43 12 32 26 4 5 0 0 10 25 0 16 34 0 27 8 4 14 0 0 30 7 0 27 0 35 40 78 9 
0 2 8 0 39 0 39 3 46 17 26 12 0 18 29 0 0 0 18 5 4 17 8 0 0 11 2 12 0 0 8 12 6 7 0 0 2 0 17 0 12 4 10 39 42 0 0 0 0 22 0 0 16 
29 25 0 0 3 0 15 15 0 0 11 8 6 0 0 7 29 0 8 0 6 15 0 13 0 32 11 11 0 25 4 0 10 0 4 0 0 0 11 5 0 0 0 4 0 29 0 0 0 0 0 0 4 
0 30 0 0 0 0 35 0 34 0 57 0 0 5 15 9 0 0 0 0 32 0 0 8 3 5 5 17 12 0 12 16 31 23 0 5 15 14 11 0 17 0 58 12 0 5 4 0 0 4 43 0 45 
1 29 0 2 0 29 5 0 6 32 0 5 0 4 15 8 0 19 12 0 4 11 2 4 0 4 0 0 14 6 28 1 15 10 29 0 0 0 2 0 2 0 14 0 23 0 0 20 0 0 21 1 1 
9 0 0 27 9 1 24 24 22 0 0 0 0 3 0 0 0 21 0 0 0 12 30 0 11 6 26 0 0 0 15 0 9 0 1 26 0 0 0 4 5 34 0 0 0 0 41 42 0 21 11 34 19 
26 51 0 26 0 32 0 0 0 6 48 25 0 18 0 10 0 21 26 18 0 0 17 0 3 16 26 0 11 6 0 18 0 0 0 24 0 4 10 0 14 0 0 4 26 0 0 2 48 35 3 2 50 
11 0 0 0 0 24 0 43 31 10 26 1 15 23 0 28 17 0 15 0 53 0 0 31 0 0 0 0 0 24 22 19 0 2 0 19 3 0 0 20 10 21 21 28 0 0 0 0 5 4 29 0 37 
48 11 10 14 21 17 0 11 23 15 20 16 27 30 18 0 24 0 11 0 13 15 27 26 21 17 0 6 0 46 0 19 38 17 2 2 8 29 35 21 0 42 39 36 1 37 51 6 14 52 37 58 6 
11 0 0 0 0 17 50 48 0 1 0 25 32 0 0 5 25 0 50 20 34 0 10 7 3 35 0 9 0 0 29 0 7 0 3 0 41 4 0 16 0 19 5 0 77 0 39 27 0 31 11 45 4 
37 0 0 0 59 0 1 21 0 56 4 3 2 5 30 0 0 0 15 43 1 5 0 3 0 3 0 0 47 5 0 10 12 10 5 31 5 36 2 13 12 0 49 5 9 41 42 7 29 0 27 0 8 
21 0 12 0 0 15 27 31 0 38 11 16 26 24 4 0 4 0 0 0 35 25 7 0 24 13 0 2 4 6 0 0 23 30 0 0 16 11 31 0 20 2 22 5 0 0 0 3 0 0 0 15 28 
37 36 0 6 0 0 50 0 27 29 0 41 0 5 24 37 22 0 0 11 0 28 0 57 1 10 5 3 9 7 22 15 7 29 7 11 0 1 53 15 0 8 0 0 0 19 31 10 61 26 47 28 14 
7 34 0 27 45 0 3 61 21 38 0 5 0 24 0 9 0 0 11 0 0 0 0 2 0 17 11 12 0 0 12 0 0 11 3 42 0 21 0 18 12 14 1 33 26 0 31 38 5 39 20 29 0 
17 0 0 5 0 46 0 1 25 3 0 28 0 23 6 0 17 17 0 0 51 18 0 21 0 0 12 0 15 0 0 0 0 22 1 7 23 0 24 9 7 0 0 52 0 0 18 3 41 2 12 43 7 
6 19 45 9 0 0 0 15 0 14 20 0 0 43 0 66 11 0 0 19 7 0 0 14 0 15 0 20 0 0 32 0 18 22 0 22 0 0 0 10 15 0 0 3 29 0 0 0 0 3 0 24 17 
0 29 0 0 0 0 45 0 19 7 37 0 0 0 0 0 33 0 0 26 16 0 7 0 0 0 0 2 0 29 29 0 0 40 0 11 6 13 30 9 1 0 0 6 0 59 3 29 0 53 13 30 43 
26 0 0 100 7 0 0 0 0 3 9 25 11 0 0 0 0 27 0 0 9 0 29 34 20 15 0 24 0 6 19 0 0 11 0 0 1 20 24 5 17 0 3 5 37 42 4 0 50 49 0 18 0 
12 0 0 68 28 20 43 18 4 0 13 28 8 33 23 0 20 0 3 16 21 8 5 52 24 17 0 26 7 11 0 25 37 45 12 0 20 28 27 9 25 0 42 40 3 20 33 44 4 56 0 0 0 
41 41 38 0 28 12 0 48 18 31 0 8 1 6 11 0 0 12 11 0 14 36 0 0 19 5 0 11 0 34 16 16 20 0 11 0 21 0 9 14 35 37 54 27 31 4 19 13 37 0 29 29 22 
