53 30
48 3 0 0 0 0 0 40 0 0 27 33 0 0 25 0 0 16 26 0 0 19 0 6 0 0 5 0 0 28 24 0 14 2 0 27 10 18 1 6 0 17 13 5 37 0 10 37 57 0 0 11 0 
22 0 0 77 0 0 26 0 4 15 22 26 0 12 0 0 0 0 28 26 0 0 34 0 0 29 17 0 27 0 0 0 0 25 12 16 33 24 16 33 0 0 0 0 2 25 0 44 0 0 0 14 0 
0 22 1 7 67 0 22 23 0 0 0 8 0 0 0 13 0 14 0 0 0 9 26 30 0 0 0 7 11 12 4 0 0 16 31 0 44 14 0 12 0 23 4 0 0 49 0 36 32 0 22 40 0 
52 0 54 0 20 20 33 3 0 0 12 2 32 63 6 2 24 3 0 33 28 6 7 14 20 0 17 4 0 0 12 6 9 11 13 0 8 18 14 33 7 0 25 24 1 14 15 55 12 36 0 0 47 
0 8 21 22 13 19 0 20 7 42 0 0 3 0 10 18 0 14 1 1 19 0 4 1 0 7 25 6 5 0 4 12 8 61 13 7 6 8 0 19 0 8 17 46 18 46 46 5 44 26 4 0 45 
0 0 14 0 16 28 0 0 4 0 40 0 24 0 0 0 6 8 0 0 7 37 0 0 22 15 5 0 5 0 0 0 0 14 0 11 0 0 0 0 17 0 0 15 6 0 25 14 0 1 40 7 0 
0 0 0 0 0 0 0 0 0 0 16 1 8 33 3 0 0 3 36 0 10 13 0 6 14 0 0 21 0 0 3 27 20 6 16 0 18 11 0 3 0 0 0 0 0 18 38 8 8 0 35 5 0 
0 0 39 0 10 0 38 16 0 13 0 0 11 9 0 0 7 0 19 0 0 0 9 8 0 23 18 0 0 25 23 6 0 32 20 0 0 0 0 0 4 40 19 0 62 0 39 17 32 0 0 0 0 
17 21 0 20 0 20 0 0 0 0 2 2 12 0 13 0 73 4 0 0 0 20 0 37 3 5 3 11 13 12 41 8 0 22 4 20 4 21 5 17 18 6 0 21 14 4 20 0 0 0 14 26 14 
0 76 46 1 0 0 0 0 55 0 0 0 1 3 1 0 3 17 17 2 0 6 10 0 0 18 0 0 26 9 26 20 12 0 0 2 26 45 15 0 0 40 17 27 0 0 6 3 18 41 0 20 37 
43 0 14 1 0 5 41 0 10 0 0 0 0 37 0 9 31 47 4 1 0 0 20 27 12 0 16 3 0 11 22 0 0 7 19 0 0 2 1 18 9 15 16 33 0 8 29 0 15 6 12 0 22 
38 0 3 0 11 42 34 21 8 0 0 5 5 0 0 13 28 3 0 0 12 8 0 5 1 0 0 0 2 1 0 9 19 21 0 21 1 35 37 11 31 0 0 0 2 39 14 26 15 0 2 11 0 
33 67 8 0 7 3 25 0 11 0 8 0 6 0 12 0 1 12 12 0 1 7 2 15 14 0 0 0 46 0 0 6 16 34 10 0 9 0 33 0 0 5 0 0 12 4 0 0 4 48 1 0 0 
15 13 0 3 1 47 0 0 40 0 73 63 26 23 45 12 0 28 1 0 0 5 4 0 0 9 2 15 13 0 9 7 9 0 3 9 23 4 17 0 1 18 2 0 0 41 36 43 77 22 11 0 42 
13 51 0 0 44 14 0 0 29 0 30 0 0 0 3 0 0 15 4 0 0 24 17 22 0 5 0 0 0 12 0 3 0 43 1 7 0 26 14 0 40 10 0 0 0 31 0 0 44 0 0 0 51 
0 8 10 17 0 22 15 6 0 20 12 5 16 12 0 16 1 6 30 28 0 7 19 0 22 21 9 11 7 19 0 24 0 0 9 0 0 3 11 0 21 20 6 7 0 0 15 28 30 3 0 20 24 
0 12 13 30 0 0 0 0 34 0 10 18 5 0 7 0 0 12 3 24 10 0 0 8 0 5 5 8 8 18 0 5 0 0 1 19 0 6 0 0 7 0 34 24 0 19 0 7 6 15 0 0 0 
0 0 0 10 27 12 0 13 0 22 14 11 23 6 0 0 0 4 0 12 20 0 0 13 6 12 0 0 0 0 0 45 0 2 12 39 13 13 11 0 13 26 6 0 0 55 5 8 1 38 0 0 0 
0 3 30 0 56 0 51 1 1 40 34 0 0 0 0 0 0 22 0 0 14 32 0 16 0 4 13 0 0 13 10 7 65 1 8 0 0 18 0 3 3 0 0 9 11 0 0 26 5 37 0 45 48 
0 95 11 35 0 0 0 0 0 0 34 2 19 23 2 36 2 15 5 0 12 13 2 0 11 3 8 25 21 0 0 19 25 15 13 4 0 5 35 0 0 13 24 15 22 44 0 13 0 1 1 33 51 
0 44 26 19 0 9 0 0 17 0 0 6 55 35 0 0 51 18 9 6 0 0 19 0 16 7 5 23 3 5 6 8 23 0 31 20 0 0 14 3 6 0 6 0 32 54 0 0 52 7 71 0 36 
0 0 0 0 45 0 0 0 29 0 38 0 4 0 15 5 2 1 19 19 0 51 0 7 10 7 0 28 7 27 7 4 22 0 11 24 0 23 36 0 0 0 1 0 14 0 0 0 40 0 21 6 0 
17 1 102 6 36 30 0 4 23 39 41 0 0 0 0 17 0 17 9 7 10 0 0 1 0 14 0 34 23 19 0 23 17 0 0 7 18 0 0 34 104 0 5 11 7 0 0 0 2 0 0 21 0 
12 11 0 0 0 62 4 0 62 20 66 0 3 21 3 33 9 9 8 0 0 19 0 29 0 13 13 13 3 34 0 0 0 0 26 25 0 8 0 37 6 0 20 14 34 10 0 0 3 0 0 28 0 
38 49 0 0 5 1 23 3 4 0 12 20 0 2 0 0 0 72 20 0 0 0 0 13 0 5 1 21 20 6 50 0 0 17 7 0 19 10 25 0 16 31 0 0 0 18 0 44 18 7 14 24 0 
0 9 10 0 0 0 0 6 40 31 0 17 17 27 0 12 0 0 0 26 74 9 0 15 16 22 24 14 41 10 9 5 7 0 1 13 12 0 12 23 46 37 10 0 14 25 33 11 15 20 30 9 0 
0 46 0 34 0 17 0 7 26 2 29 20 0 29 3 12 0 43 2 6 23 0 0 12 14 0 9 24 0 0 2 1 20 0 20 3 0 3 0 0 5 0 37 0 0 26 0 45 30 39 0 24 0 
84 0 0 5 0 0 22 0 5 0 27 14 37 0 6 0 10 0 6 41 6 0 0 0 0 0 14 21 15 20 2 12 0 0 35 36 0 3 0 0 8 0 5 0 17 7 0 16 18 58 39 33 52 
15 0 0 0 21 25 0 38 0 0 0 0 22 52 0 0 1 19 14 26 0 0 0 0 22 34 0 0 11 0 0 0 17 0 22 3 7 0 0 0 27 18 0 7 7 65 20 23 6 0 0 0 0 
38 21 20 13 88 35 36 4 0 0 0 29 25 0 21 1 0 21 60 0 26 17 0 12 0 9 1 1 0 0 28 37 0 15 11 12 20 0 38 0 0 37 7 8 0 0 0 0 14 45 0 45 0 
