53 30
27 35 37 32 0 41 40 10 0 0 0 0 4 16 0 0 6 0 0 0 0 0 0 23 40 6 32 13 0 18 0 8 19 29 0 27 0 0 0 25 30 14 0 0 0 10 12 0 0 25 0 0 40 
18 34 7 16 0 11 0 0 10 0 7 0 39 14 38 0 0 0 10 0 1 0 21 36 0 12 0 0 0 8 0 12 14 0 0 0 0 10 37 1 0 8 0 34 0 0 14 4 25 64 11 0 38 
0 39 0 14 0 0 0 1 30 0 5 13 40 17 1 21 0 0 6 2 1 35 11 0 6 30 1 0 0 0 11 2 0 60 19 10 12 6 0 0 19 0 0 0 0 10 0 23 23 0 0 0 32 
0 0 22 26 0 43 0 2 5 0 10 12 27 15 3 23 35 0 6 11 10 6 0 0 0 0 0 26 0 0 9 0 0 25 0 11 0 2 0 0 0 26 9 3 0 0 5 0 66 0 0 44 1 
48 0 0 0 4 22 1 35 4 12 12 10 21 24 0 0 4 8 20 2 3 2 24 4 4 8 0 0 0 20 0 28 12 9 27 15 0 0 0 18 46 0 44 5 80 0 7 35 0 49 37 20 50 
4 0 0 23 4 0 0 54 11 0 71 35 4 8 0 0 0 0 0 1 0 16 0 0 0 15 0 0 0 10 0 1 1 0 0 22 9 25 0 0 0 0 38 0 18 1 26 16 52 0 40 0 0 
0 6 0 53 43 44 2 0 1 3 0 11 3 0 15 6 0 0 0 1 0 6 6 0 0 0 14 2 0 13 0 0 0 0 13 8 47 1 0 0 14 0 0 0 0 0 0 10 0 1 0 0 0 
15 0 0 10 15 10 0 35 0 10 33 1 0 0 2 0 16 13 11 8 9 9 3 23 5 0 0 0 18 4 41 0 0 11 0 10 0 0 0 9 7 11 39 37 0 0 18 12 0 0 0 0 0 
1 39 8 16 13 0 16 0 6 11 19 0 42 0 0 6 10 0 0 16 42 0 1 20 22 22 19 25 16 19 26 0 6 32 8 15 16 0 36 0 0 0 38 7 0 7 9 45 0 1 15 27 27 
21 56 0 15 1 4 57 28 46 2 2 21 14 0 0 0 24 0 0 4 4 27 0 45 13 10 8 26 2 5 29 5 19 0 0 37 11 0 28 0 56 43 0 0 13 0 0 0 33 2 15 0 24 
0 0 15 27 1 12 0 26 1 1 0 10 0 0 0 7 7 27 0 0 1 0 15 9 9 18 9 14 0 0 23 0 9 19 0 4 0 4 2 10 0 4 0 16 0 0 10 0 5 46 0 0 19 
0 0 0 41 0 0 0 32 0 25 5 4 7 0 16 0 4 5 0 0 3 0 5 12 0 3 0 0 0 12 6 0 35 0 27 0 19 0 0 38 10 31 0 0 0 0 0 0 16 11 10 12 49 
56 15 14 48 19 11 0 45 0 0 17 53 3 6 24 0 19 11 0 28 0 9 0 3 8 32 0 13 0 0 3 6 1 0 11 8 3 18 39 26 10 29 19 3 23 1 6 8 17 13 0 18 12 
0 49 6 0 0 19 8 16 0 0 26 0 0 14 22 0 0 0 12 12 0 0 0 0 19 0 5 13 5 0 0 18 6 5 0 4 26 0 8 13 0 15 4 0 0 19 0 0 0 5 61 0 0 
131 79 0 11 0 7 11 0 0 42 0 11 30 0 37 0 0 0 0 1 38 5 22 0 12 3 19 0 0 12 12 21 21 0 8 0 36 37 37 0 40 35 0 1 36 5 0 8 0 6 0 48 46 
35 3 0 39 14 0 0 0 18 12 7 19 2 0 6 26 2 3 14 8 6 11 0 7 0 14 18 29 5 21 7 0 29 11 0 0 36 0 0 0 1 21 0 12 23 2 0 0 0 22 10 0 0 
3 13 7 14 0 29 0 1 24 29 4 0 4 16 9 40 0 7 0 0 3 9 17 2 8 0 2 0 0 15 0 3 11 8 3 0 13 15 29 9 27 0 0 0 0 0 0 32 11 0 0 46 0 
20 17 5 12 0 12 8 35 0 10 6 8 9 10 11 8 5 0 0 0 7 12 0 15 0 7 0 13 5 16 0 0 12 5 0 10 21 11 15 6 0 0 0 0 0 16 0 40 0 16 8 15 0 
14 10 32 0 35 3 0 5 28 0 43 11 19 45 17 10 0 0 8 6 30 1 15 2 18 9 0 0 0 0 0 10 22 0 0 34 18 35 10 27 18 0 0 26 6 44 0 0 10 0 30 0 0 
39 9 10 24 0 21 0 40 0 0 0 0 0 0 0 0 34 18 16 0 37 2 24 36 12 32 22 34 0 6 0 0 7 0 19 9 16 35 21 16 0 3 0 41 8 5 0 7 26 1 24 31 2 
0 35 8 33 9 37 39 0 23 0 0 19 19 9 0 2 9 7 15 0 0 18 2 6 9 3 0 0 9 0 18 0 0 0 0 0 35 15 30 1 25 5 37 37 0 17 0 2 0 35 0 23 0 
23 0 2 23 60 7 0 11 16 0 10 29 16 1 10 9 17 9 2 9 7 6 4 0 0 0 5 9 26 17 11 0 13 17 19 10 0 0 2 0 10 6 16 3 2 13 4 0 3 0 46 0 0 
32 16 3 0 28 19 2 7 0 0 0 13 36 1 37 0 0 12 12 1 1 16 0 4 8 2 4 7 11 0 16 0 36 0 0 0 3 0 0 27 18 0 17 7 1 1 1 35 0 0 0 49 0 
18 106 21 46 0 0 0 0 0 0 0 11 1 0 36 3 0 0 31 0 0 0 0 14 0 0 25 7 16 18 23 15 8 0 11 0 35 7 72 11 11 0 22 0 33 0 15 0 2 15 84 0 18 
20 0 12 62 0 0 27 0 4 20 26 5 0 0 3 0 0 3 20 8 51 22 17 20 2 2 0 7 3 3 0 0 12 40 0 24 26 0 0 8 0 0 0 31 4 38 0 0 0 0 15 0 0 
52 32 59 3 13 0 0 4 0 0 0 4 36 27 0 8 0 7 18 0 0 8 6 0 21 23 9 17 24 6 4 1 23 2 0 0 0 0 0 13 21 9 35 3 1 0 0 22 6 25 63 0 7 
0 0 2 54 0 0 0 3 0 0 0 0 7 0 31 97 0 20 0 0 0 0 0 0 7 0 0 26 2 0 0 0 0 10 0 7 2 1 28 0 0 0 7 6 17 30 43 15 34 1 22 0 38 
5 0 6 0 0 18 0 2 0 2 15 0 37 14 0 25 29 0 0 0 0 0 0 0 5 24 0 0 0 3 0 0 2 16 13 0 0 1 0 0 6 0 0 0 42 29 0 0 0 36 58 0 0 
0 36 37 7 0 19 19 8 0 37 27 23 28 51 0 0 0 3 0 0 0 50 7 12 28 19 0 0 14 0 0 0 36 3 0 9 12 72 0 0 0 28 7 37 13 1 47 0 16 0 31 0 2 
0 21 28 33 33 0 41 24 0 67 0 5 20 13 15 14 18 15 0 1 1 13 45 0 0 0 0 17 0 7 0 0 45 29 11 4 11 32 21 4 37 6 0 0 74 23 0 29 0 0 12 4 36 
