53 30
45 10 0 0 2 0 6 3 7 25 0 0 0 4 12 12 62 26 0 0 9 1 0 7 0 0 1 0 41 49 0 15 14 10 0 25 0 5 13 38 0 5 9 17 16 17 9 30 8 18 0 34 0 
27 44 72 0 17 0 45 39 47 9 9 19 0 11 9 13 43 0 23 15 9 46 29 37 9 49 1 7 4 15 23 14 0 16 0 45 24 0 27 9 38 0 9 7 13 0 19 0 19 0 53 81 34 
2 4 13 0 0 0 42 0 43 0 0 0 0 28 0 20 0 14 27 12 0 0 29 39 19 0 0 0 0 28 0 7 0 31 0 14 4 0 14 8 0 28 0 20 0 43 2 3 53 27 0 22 21 
19 7 0 54 15 0 0 0 10 0 0 39 38 0 11 0 21 7 0 0 10 12 0 24 11 16 0 26 16 11 35 45 0 16 18 2 0 2 0 19 0 0 7 0 16 22 7 1 0 0 73 15 0 
0 11 56 47 43 42 0 3 21 14 0 0 5 5 9 4 22 15 6 28 27 0 19 11 8 3 8 12 1 8 0 0 0 15 7 0 20 1 30 37 0 0 0 23 41 0 13 14 4 44 0 18 4 
17 0 14 0 58 48 0 24 0 14 1 35 18 54 48 7 12 21 0 0 6 0 5 10 8 23 9 0 8 22 0 20 26 10 9 25 0 4 0 26 16 0 0 10 4 0 3 0 44 18 16 25 56 
18 0 0 0 0 2 0 8 12 4 37 0 6 5 3 8 18 13 0 29 11 2 0 4 15 0 0 0 24 4 0 14 1 1 30 0 4 0 0 0 0 0 5 0 27 0 0 37 29 42 0 0 4 
47 4 6 32 0 22 0 34 7 0 0 0 26 12 9 17 20 0 18 0 4 11 0 36 11 25 21 0 8 19 12 16 17 20 10 34 3 3 4 0 3 0 0 13 37 0 30 47 0 0 4 0 22 
17 0 37 1 32 0 0 2 0 24 0 4 0 0 10 0 0 17 11 0 0 2 0 0 13 0 3 0 1 0 0 0 0 24 0 2 32 3 0 48 0 0 2 0 17 8 12 0 8 0 11 0 0 
19 28 2 23 4 15 26 0 0 11 17 0 0 0 9 0 43 10 0 32 6 16 0 7 3 7 0 0 0 0 21 21 7 12 33 29 0 0 0 7 19 0 27 9 0 12 0 29 39 2 0 47 30 
0 1 34 31 31 0 27 2 0 36 38 37 33 0 9 14 21 12 13 1 3 2 0 50 4 0 0 0 25 35 19 0 0 0 23 25 3 0 15 27 12 0 4 0 0 72 0 13 0 0 48 0 66 
0 12 38 22 30 0 0 10 12 27 30 1 20 39 26 24 0 8 0 12 18 40 0 2 23 31 4 0 0 0 3 36 25 0 33 0 28 21 17 0 69 0 0 0 25 0 31 23 0 35 0 0 9 
9 30 10 11 0 41 0 0 0 0 5 4 0 0 9 4 1 0 0 0 16 26 0 0 3 16 0 0 14 0 20 40 7 0 0 0 6 0 0 0 0 0 9 0 7 0 41 11 0 5 0 10 1 
0 29 2 48 2 46 45 13 19 12 32 0 16 15 34 28 44 47 0 1 2 5 36 9 10 2 0 45 23 0 0 0 2 0 2 5 0 0 2 29 2 36 8 60 0 2 36 46 75 0 0 2 9 
0 0 11 4 25 13 25 0 18 0 35 29 0 30 24 15 4 45 35 11 13 0 0 9 10 0 18 23 7 0 8 0 9 13 28 25 16 23 14 0 0 0 0 8 27 37 0 36 0 31 0 0 39 
38 30 5 1 44 0 0 0 0 11 0 7 14 42 0 0 0 5 22 0 4 7 9 29 24 0 0 0 5 3 0 49 3 31 0 0 0 0 74 0 22 8 0 0 20 0 44 0 0 37 0 0 29 
50 51 97 0 0 0 0 7 0 0 7 0 0 24 9 0 0 0 0 0 0 58 0 0 0 0 0 0 2 8 15 10 0 13 1 29 34 24 0 0 0 39 0 40 11 2 16 0 0 0 0 37 51 
0 13 0 0 0 0 0 0 41 0 23 18 0 1 27 36 0 8 16 5 0 0 0 0 3 0 0 3 0 18 3 8 10 23 9 12 1 2 7 0 9 0 0 0 0 0 0 0 0 46 0 44 0 
0 0 0 69 49 46 0 0 0 15 17 19 10 31 14 0 0 29 0 0 0 27 0 0 0 5 20 17 0 0 0 0 26 0 12 43 18 5 0 0 0 6 9 17 10 8 12 0 0 15 37 65 17 
0 15 0 0 16 2 19 23 8 15 1 0 13 20 0 19 8 15 4 0 12 21 0 15 0 2 10 15 0 0 23 0 11 27 0 6 23 7 0 0 0 0 42 10 3 0 0 0 39 0 0 0 0 
0 30 4 0 41 6 0 0 0 0 0 17 23 0 0 8 5 21 3 10 0 21 0 20 1 0 4 0 22 0 10 30 0 0 5 27 1 1 0 4 10 0 0 14 63 2 35 0 0 0 15 28 0 
0 2 0 38 1 6 0 0 0 8 6 0 0 10 16 15 0 8 26 1 0 0 12 20 14 10 13 0 0 6 14 7 0 19 31 1 0 0 37 0 39 0 11 25 15 12 0 12 0 3 7 0 0 
19 0 0 0 0 1 4 42 19 52 1 2 0 6 29 41 18 0 6 10 21 1 0 22 0 0 0 6 0 20 0 0 0 20 2 0 10 0 0 2 0 0 0 27 21 1 0 0 0 47 36 42 9 
12 0 0 0 0 10 6 0 9 4 1 5 20 12 30 11 4 0 0 13 0 39 10 23 21 21 11 0 9 0 0 0 0 0 0 21 13 0 10 0 5 0 28 32 57 17 0 0 0 17 0 16 0 
15 0 17 0 0 0 0 0 0 34 0 0 33 24 0 0 0 0 0 4 0 13 0 4 10 15 4 0 0 0 0 1 3 35 20 23 3 0 0 0 0 28 0 53 0 4 34 0 16 2 0 0 0 
3 0 20 0 0 14 8 55 0 25 0 40 20 0 4 10 0 11 0 26 0 7 1 1 33 12 0 0 0 25 0 23 2 31 0 25 0 7 4 8 2 0 21 0 44 68 22 30 23 16 5 34 0 
36 0 16 19 86 11 4 0 41 11 4 2 40 0 16 5 15 0 25 0 2 17 1 9 25 18 0 9 0 19 34 10 0 17 0 10 44 19 0 6 9 0 3 18 3 85 38 2 7 25 27 0 17 
9 0 0 15 0 37 23 0 34 23 47 0 0 0 1 18 2 1 19 23 23 9 0 0 2 18 0 0 35 9 0 0 8 0 10 10 0 0 0 0 2 25 44 24 0 0 0 15 13 0 0 0 0 
22 0 0 1 22 25 0 0 0 0 33 2 0 9 0 0 0 0 6 0 16 0 0 0 0 20 40 10 10 0 20 16 0 0 0 0 34 0 13 9 0 0 0 0 14 13 0 16 0 3 7 26 16 
39 0 24 26 0 0 10 22 15 0 20 0 27 0 21 8 0 16 4 9 0 0 4 0 0 10 14 13 23 3 0 0 0 0 0 34 15 0 3 2 0 2 1 7 0 0 0 43 0 4 7 4 22 
