53 30
51 0 28 0 43 0 0 18 35 0 0 0 0 0 8 28 0 0 0 0 0 9 13 13 44 40 0 0 0 8 16 17 0 26 10 0 0 25 0 11 0 16 0 49 21 0 0 0 8 0 4 64 27 
1 33 0 11 0 0 0 9 0 0 0 0 30 0 0 0 9 0 0 0 0 16 0 21 0 0 0 0 20 0 0 0 0 11 0 13 6 9 0 0 18 29 3 18 2 0 0 7 20 0 0 0 0 
12 0 0 0 0 32 0 0 0 0 0 0 16 0 14 0 0 16 28 26 0 25 2 0 0 0 6 0 0 0 0 24 11 19 0 14 4 1 0 1 12 0 24 0 16 26 54 2 0 7 3 0 0 
5 0 21 0 0 22 16 0 15 47 0 57 10 0 31 19 0 8 0 0 0 3 25 12 0 3 0 0 0 16 0 0 11 0 43 4 27 0 3 0 2 0 0 30 33 33 0 2 5 0 21 0 0 
35 0 18 62 0 0 1 0 0 22 10 34 0 4 0 0 18 51 0 16 22 29 2 15 0 22 24 7 8 0 8 1 0 6 4 6 12 0 9 0 25 7 4 5 0 12 23 19 44 0 3 30 14 
51 0 0 22 23 0 1 68 1 26 18 0 0 0 25 11 0 0 9 0 13 48 4 0 8 17 20 0 4 0 19 22 0 21 16 38 3 0 0 28 8 0 7 69 0 20 0 0 24 42 33 34 0 
39 38 22 0 20 0 38 39 0 30 0 11 5 0 0 0 0 7 0 1 1 0 1 1 40 3 15 0 0 10 4 20 14 7 4 0 0 0 0 21 0 18 44 0 13 3 98 0 0 4 8 0 0 
5 0 0 46 53 14 0 47 39 0 0 20 1 0 0 0 1 3 13 0 0 0 30 21 0 36 0 9 0 0 17 8 17 0 0 0 0 20 34 3 0 9 5 0 0 0 0 14 0 63 0 7 15 
4 20 0 0 45 12 9 35 17 0 2 0 1 21 61 35 1 12 4 0 3 24 19 0 15 0 38 0 20 14 30 7 6 0 39 0 16 38 7 3 0 3 0 20 0 9 8 0 7 46 0 13 29 
27 0 0 4 27 31 22 11 9 0 15 2 0 7 0 0 16 18 0 2 0 28 30 40 0 0 0 23 0 0 19 0 0 0 0 4 30 0 4 0 27 18 7 0 18 0 0 0 25 4 19 34 30 
14 27 28 0 45 0 0 1 1 8 0 24 65 0 57 4 0 7 9 8 0 10 26 3 0 0 17 32 16 3 27 3 3 15 10 7 7 24 19 19 4 0 28 20 0 37 0 0 3 37 31 6 0 
47 18 47 3 4 39 0 26 0 17 2 0 0 15 61 17 15 43 0 31 23 30 0 0 0 0 0 17 12 0 1 6 0 0 29 0 3 30 0 16 20 46 27 0 42 15 6 0 34 0 30 7 0 
21 45 38 7 14 23 1 10 0 12 0 17 0 0 0 35 0 14 14 0 0 10 4 20 0 0 26 0 48 6 48 18 0 11 0 0 0 0 0 0 40 8 10 0 0 0 31 46 0 48 0 18 0 
7 1 0 8 17 0 1 57 0 71 44 0 0 0 0 2 4 26 14 0 9 17 6 8 30 0 0 0 10 1 16 24 4 0 14 3 0 0 0 0 4 0 8 29 37 15 36 11 0 8 0 0 0 
21 50 27 8 15 23 2 50 2 8 31 4 68 0 13 0 0 0 25 3 0 0 14 2 0 5 9 4 7 7 8 10 20 0 5 9 18 0 0 5 24 43 1 49 44 38 14 14 0 0 0 7 7 
12 44 0 0 4 41 4 63 0 16 2 4 49 0 0 29 30 26 0 30 0 8 25 24 0 16 0 0 0 8 6 13 0 10 16 0 1 0 0 0 0 1 21 27 0 18 34 1 41 3 53 0 0 
36 10 23 0 0 3 27 0 30 1 0 10 0 0 19 0 23 0 0 0 4 15 20 0 7 0 0 7 0 10 11 0 0 0 8 2 37 1 31 0 0 34 7 13 5 0 0 0 0 0 6 0 0 
40 0 1 9 49 42 9 0 0 1 26 0 0 10 0 1 14 12 0 0 1 31 3 10 17 3 2 0 17 0 3 19 0 0 2 7 31 7 0 6 40 0 2 3 21 0 45 42 0 0 0 23 0 
0 0 0 14 19 0 0 13 15 0 0 0 0 0 0 0 35 0 0 0 0 0 0 19 0 0 0 2 0 0 4 0 0 0 1 25 5 0 7 3 17 0 3 3 14 0 0 0 32 0 0 0 0 
0 27 0 0 0 22 0 15 34 57 3 0 7 0 13 12 0 2 29 18 15 0 24 36 23 5 15 33 26 0 10 16 0 17 8 0 4 23 7 34 0 7 34 41 2 0 27 76 0 40 22 4 0 
0 0 0 0 0 0 5 45 0 0 22 32 18 0 29 1 5 0 0 0 0 4 0 5 0 4 5 16 0 0 18 5 10 0 11 2 0 2 0 0 2 9 9 4 0 0 0 0 0 7 0 8 3 
0 0 0 0 5 0 5 34 0 0 4 24 0 0 0 0 4 52 0 0 32 15 0 0 0 0 21 0 12 22 0 0 0 7 0 24 6 8 7 0 33 4 6 0 36 35 17 40 28 0 6 12 15 
7 28 38 0 27 32 0 7 0 0 21 16 0 12 39 5 15 0 0 0 9 4 22 11 0 8 25 48 0 14 0 12 0 17 13 7 20 17 13 0 6 27 23 12 22 0 13 20 0 15 0 4 19 
0 6 0 0 12 40 11 0 0 0 14 5 22 36 22 0 12 0 17 0 3 0 2 14 0 0 0 20 0 20 10 0 30 19 6 17 3 0 0 11 0 9 31 0 4 0 4 15 4 12 0 42 21 
0 0 17 0 43 0 0 0 0 0 15 3 16 0 3 0 0 16 0 0 0 0 0 0 0 24 0 4 3 0 9 0 0 16 9 6 34 11 0 16 2 0 1 19 23 39 0 11 31 0 19 23 0 
0 2 0 10 0 22 0 0 5 0 25 0 0 5 0 32 0 0 15 0 0 0 2 12 0 0 16 0 0 0 0 0 17 25 0 36 21 15 7 0 0 0 18 0 6 0 0 7 38 17 0 0 0 
0 0 44 0 6 0 0 12 18 0 8 0 33 11 0 0 29 0 25 12 0 1 13 13 0 19 16 1 5 0 3 15 0 1 0 8 24 3 17 0 15 7 24 25 7 2 44 17 32 0 0 0 2 
7 0 4 1 24 0 17 0 0 11 41 24 0 12 27 0 16 23 0 37 2 11 17 23 0 1 17 22 1 35 0 17 12 14 47 4 0 0 19 5 30 28 6 13 8 18 4 25 3 23 0 10 81 
0 26 30 34 0 3 35 0 34 28 0 5 0 1 0 12 13 19 3 0 0 14 13 9 28 17 21 22 8 13 16 0 18 31 13 10 8 29 24 0 22 0 48 20 17 27 40 46 8 2 30 28 6 
0 75 58 45 44 27 23 0 0 0 0 9 36 0 0 0 0 12 0 0 20 8 7 0 0 0 25 0 0 7 12 2 9 0 0 5 0 3 0 0 53 23 6 0 0 0 25 4 95 3 1 1 0 
