53 30
0 0 0 2 46 45 34 0 14 32 0 0 0 2 5 21 36 0 18 11 12 27 0 0 24 25 0 0 35 0 8 28 2 0 20 0 26 10 1 0 0 0 0 27 12 0 12 17 44 9 11 0 18 
3 0 0 3 0 0 15 0 33 0 0 0 0 14 0 18 3 43 0 16 0 18 1 10 16 24 0 0 0 0 22 10 0 23 0 0 14 0 0 0 9 4 0 0 0 15 0 2 0 9 0 0 22 
0 0 12 46 4 0 22 26 52 0 13 20 17 22 7 0 0 20 26 10 0 0 29 0 0 0 0 17 21 7 14 0 18 18 27 17 3 12 30 3 9 0 20 0 14 38 4 28 16 67 0 0 0 
0 4 12 0 43 4 32 0 40 0 5 0 0 0 108 11 0 0 0 3 26 4 0 29 0 4 0 0 0 15 0 0 0 19 19 0 0 0 37 2 16 0 0 6 8 6 26 45 73 3 36 17 32 
0 0 0 0 0 9 33 0 0 0 7 0 18 0 11 0 0 10 27 0 16 0 13 0 0 17 13 22 0 3 0 1 13 13 17 0 5 0 16 0 17 12 22 0 0 61 0 0 8 9 23 32 0 
0 0 40 0 24 53 0 0 55 0 0 0 7 0 4 10 0 24 27 11 1 2 8 0 6 0 18 18 0 3 21 1 16 5 2 13 32 0 3 6 0 1 57 0 17 11 28 10 81 23 0 0 0 
0 18 11 54 14 0 5 45 0 46 33 53 42 29 34 4 7 0 0 15 0 0 30 0 0 36 5 26 15 21 21 11 5 22 12 0 5 15 25 15 6 5 0 5 7 0 10 0 25 48 38 28 91 
48 0 45 16 0 0 32 0 0 0 3 0 14 5 0 0 0 0 2 2 13 10 0 0 9 11 0 0 0 4 0 0 0 9 17 21 14 11 33 0 5 0 0 41 8 12 0 0 49 15 5 0 2 
0 1 75 48 13 5 2 0 37 26 16 21 39 3 0 12 25 13 13 16 0 0 0 4 1 14 0 26 0 9 1 1 30 0 17 42 0 0 11 0 0 8 24 0 10 55 44 42 45 13 0 30 47 
25 2 8 0 4 0 20 0 8 14 0 0 9 0 7 0 23 0 28 18 5 9 32 14 0 12 0 0 6 7 0 13 0 3 21 0 11 17 0 23 0 0 19 4 10 6 0 3 1 14 0 0 28 
0 10 49 2 39 55 40 56 0 5 0 4 0 0 15 5 20 10 1 0 6 0 4 0 13 0 18 11 0 13 15 0 0 13 0 0 12 10 0 0 0 0 20 57 54 1 0 0 12 50 24 68 0 
1 2 12 25 22 0 0 0 48 2 0 8 6 72 50 2 14 4 0 23 6 2 11 10 10 0 16 0 45 20 30 31 6 0 0 1 9 0 24 25 27 20 0 0 8 36 0 21 2 12 2 38 17 
0 4 0 9 22 0 0 0 25 0 0 42 0 9 32 10 38 0 8 0 6 7 0 3 0 10 19 8 17 25 5 0 32 61 0 0 4 0 35 25 15 0 7 4 14 40 27 15 15 5 0 2 0 
2 6 0 39 0 8 42 10 11 35 18 9 0 24 0 2 32 17 0 0 0 8 21 0 24 0 8 0 0 2 15 0 4 16 1 0 0 4 0 0 0 0 39 28 39 47 16 5 98 16 0 0 0 
6 0 12 0 0 14 6 8 2 26 1 41 9 11 0 37 0 23 21 0 0 13 12 0 0 0 0 5 0 0 11 0 0 18 1 0 4 0 0 10 0 9 25 0 1 1 0 11 0 14 26 40 0 
2 29 0 3 35 4 14 0 10 0 9 0 0 14 0 5 0 0 0 0 9 7 0 0 19 0 25 0 2 25 10 7 5 4 5 4 0 3 8 17 11 0 11 0 1 5 35 10 0 25 0 10 0 
0 0 0 32 43 0 14 26 0 0 0 0 5 0 3 3 0 11 13 0 40 12 0 14 2 0 0 16 13 11 0 11 0 3 0 25 0 24 0 0 7 0 18 12 0 32 0 43 20 6 30 10 0 
28 22 20 45 16 21 15 1 88 32 7 0 26 42 12 21 0 26 11 41 18 11 13 38 7 15 10 43 24 4 1 11 13 11 18 14 1 4 32 16 8 34 0 54 17 32 0 3 17 46 18 9 18 
0 0 0 0 0 0 0 40 0 24 0 0 25 0 24 0 11 0 0 12 0 0 0 0 14 0 12 26 5 6 9 0 1 18 22 17 3 32 10 6 0 1 9 0 0 3 0 45 0 0 26 0 0 
0 71 4 0 31 0 3 0 18 9 9 30 11 0 43 1 9 30 1 9 0 0 0 17 0 2 21 2 28 0 0 9 9 37 11 57 0 0 0 0 17 51 6 9 26 11 0 9 12 0 0 50 5 
9 37 0 84 33 0 18 17 0 46 3 0 0 38 37 4 0 0 30 0 13 14 19 19 0 10 0 8 0 0 0 0 1 0 0 12 10 5 13 0 0 0 0 0 40 0 1 4 36 0 28 4 0 
6 2 18 67 0 0 0 0 21 19 18 0 71 4 14 0 16 27 0 19 0 0 0 15 0 0 32 3 20 25 11 16 16 0 0 7 14 0 14 12 32 0 0 0 1 0 44 17 0 0 0 4 47 
1 0 0 0 0 0 35 24 0 0 3 9 36 3 11 1 0 0 11 0 0 28 0 8 0 16 0 0 0 18 45 26 0 0 21 0 0 0 18 0 0 16 0 0 34 0 9 0 32 27 20 0 3 
0 11 16 16 0 12 12 0 4 0 8 11 0 0 1 0 0 23 12 5 7 0 2 0 4 0 0 15 25 16 3 18 0 22 0 16 0 0 8 0 0 0 7 0 0 20 0 0 0 20 17 0 32 
0 0 0 9 0 0 0 0 16 0 9 0 1 50 4 0 0 33 12 0 2 0 2 16 54 29 0 1 0 15 10 0 0 9 2 0 0 0 0 5 5 0 3 0 4 0 0 4 11 0 4 14 4 
16 0 27 0 33 47 16 0 25 0 0 0 8 0 10 22 25 29 0 0 0 15 0 6 3 1 0 0 25 2 5 5 19 5 13 0 5 7 1 0 37 6 6 0 0 21 19 11 0 63 0 54 3 
20 2 0 21 47 2 22 0 30 0 23 0 0 12 16 7 0 12 0 0 30 0 19 6 0 3 0 22 0 0 23 0 17 0 8 0 11 0 32 23 0 0 19 3 63 1 22 7 18 22 16 18 0 
0 1 23 43 0 0 0 30 10 0 0 0 23 3 0 0 26 6 10 0 13 0 20 0 6 24 0 1 30 5 9 0 0 0 8 0 0 0 0 0 0 0 14 27 0 6 43 16 22 3 48 30 0 
0 2 47 15 0 3 0 2 4 0 0 8 4 0 0 0 9 27 37 14 7 0 0 0 3 9 21 4 0 0 6 41 0 16 0 17 29 26 31 0 0 0 0 19 3 0 0 21 0 47 0 0 7 
55 23 0 0 0 92 0 0 0 18 0 21 0 0 50 13 0 0 0 0 20 0 0 0 0 23 3 18 0 24 12 0 35 0 0 13 10 23 3 13 0 0 0 38 21 0 0 2 0 19 0 8 0 
