53 30
29 28 0 0 0 0 0 33 0 0 0 0 0 2 0 38 0 0 12 0 0 0 0 0 0 0 0 3 0 1 31 0 73 0 12 0 13 20 0 0 0 16 0 0 0 27 4 0 41 58 0 36 0 
0 28 0 3 25 0 3 0 0 23 39 43 31 26 2 17 31 0 27 0 5 24 3 25 29 8 0 25 20 19 10 0 34 6 10 10 32 9 0 44 0 0 0 11 5 91 30 31 23 0 38 39 73 
19 0 5 80 0 21 26 5 20 0 2 28 1 26 0 46 13 0 19 23 18 0 0 17 5 1 1 30 0 16 2 21 9 3 7 17 0 0 7 29 22 0 36 0 11 42 28 12 16 88 0 20 1 
66 26 9 0 0 40 1 10 1 0 1 20 16 31 0 10 16 10 10 21 0 0 5 1 0 7 24 14 16 0 17 18 0 0 25 0 0 0 1 39 24 10 20 0 35 18 23 9 0 2 13 0 4 
23 11 6 0 67 24 41 28 0 0 1 0 26 0 38 25 9 38 4 0 0 0 0 0 10 3 21 3 14 6 0 0 24 33 1 3 0 23 4 6 33 0 18 10 10 0 7 2 10 0 0 51 77 
40 49 0 0 47 47 8 0 28 23 0 0 0 24 7 36 31 38 10 25 0 18 5 7 0 8 0 0 0 13 2 0 11 17 9 2 23 0 5 38 2 8 13 12 7 15 0 33 9 7 49 83 39 
0 51 9 0 10 47 0 18 0 6 23 41 0 18 0 0 47 18 0 3 11 22 6 0 23 0 0 0 0 3 1 15 3 0 21 15 0 0 0 25 0 2 0 10 0 0 0 0 0 0 41 0 3 
43 73 18 11 0 43 20 0 21 33 17 13 0 13 0 6 4 0 7 0 50 13 11 20 0 20 20 7 0 12 51 17 16 6 27 11 13 0 23 14 3 21 0 3 12 0 0 41 0 48 20 35 70 
25 0 4 0 0 0 0 0 35 0 0 0 11 34 0 18 18 0 29 6 0 0 0 11 0 10 0 6 0 0 0 20 1 0 0 3 12 5 0 14 1 28 0 60 7 3 0 0 0 0 0 0 0 
8 25 0 2 0 0 0 14 0 0 14 0 0 29 12 29 11 0 0 0 12 14 0 23 29 25 13 17 0 0 9 0 2 32 34 8 0 5 0 15 0 0 0 18 2 0 15 31 0 9 0 0 37 
0 0 0 3 0 37 46 0 42 0 6 0 0 20 0 0 2 19 12 0 12 6 7 0 0 7 2 0 0 3 34 30 3 20 0 5 0 0 12 0 35 0 40 0 0 0 1 0 0 1 0 13 13 
16 0 68 10 0 4 49 35 9 4 0 0 0 0 0 9 0 0 0 6 25 0 0 0 9 17 11 14 0 0 0 0 0 9 0 0 20 13 0 0 4 0 0 0 37 46 27 11 0 1 0 2 6 
0 18 0 3 4 0 0 27 4 8 0 26 26 0 9 0 20 8 0 0 0 39 0 7 0 0 16 0 0 13 0 0 0 0 40 1 0 0 17 0 0 0 8 0 0 24 1 0 0 4 0 0 0 
10 6 26 29 0 0 0 17 8 12 38 9 0 0 37 8 14 2 4 13 12 0 4 21 40 4 49 35 40 6 0 0 33 1 2 0 5 16 27 2 3 17 7 15 37 0 0 57 0 30 32 41 28 
7 0 47 0 12 0 40 0 0 38 0 2 11 27 14 0 12 0 22 0 15 0 0 24 18 28 17 6 10 6 7 22 0 8 7 6 2 0 0 13 67 0 4 0 0 34 1 20 65 5 50 4 41 
0 2 1 40 0 31 12 0 0 0 41 0 0 15 18 0 11 0 46 0 0 0 0 1 12 28 0 0 0 15 5 0 6 2 0 0 53 0 0 6 0 0 24 0 0 0 43 0 27 17 0 41 15 
7 1 0 0 46 0 29 5 13 0 6 0 12 0 12 1 0 0 35 0 3 24 0 29 4 21 0 12 0 0 21 4 0 14 16 29 0 19 17 0 10 13 0 0 4 0 21 0 17 1 60 0 0 
38 34 0 34 15 0 10 0 11 31 0 0 11 0 3 0 19 11 4 6 4 3 0 28 19 20 0 0 0 0 0 7 6 27 4 12 3 30 19 12 0 0 33 10 43 0 7 8 0 15 3 28 0 
61 11 2 0 14 4 23 7 6 34 49 4 0 31 33 0 10 0 2 0 0 0 28 25 0 0 0 0 0 39 21 15 4 33 24 36 27 23 0 0 40 19 0 0 35 0 0 4 29 18 0 0 0 
15 53 0 0 12 0 18 0 27 16 0 0 8 0 0 0 4 0 0 0 8 0 0 2 0 0 22 0 0 20 5 0 0 0 0 27 8 0 0 0 0 0 0 10 1 14 0 38 22 1 0 50 0 
28 35 0 19 41 46 0 2 0 21 0 5 0 32 13 20 5 5 0 7 9 0 5 0 9 0 4 13 28 0 17 10 22 0 2 0 19 39 22 0 0 0 0 0 0 65 4 0 0 0 3 46 16 
0 38 0 9 46 0 2 27 0 4 10 0 0 4 17 0 4 15 14 19 8 0 17 22 20 0 8 0 0 25 2 7 13 1 28 4 0 12 50 58 0 35 0 0 0 22 0 0 0 0 0 0 0 
0 44 0 0 24 0 0 0 0 43 27 14 39 0 0 11 7 28 38 3 0 0 7 0 21 1 2 31 0 0 11 0 4 20 0 0 0 34 17 35 0 7 0 0 12 32 0 11 0 0 0 24 30 
7 12 0 5 5 50 0 2 51 3 0 0 0 36 0 7 25 0 18 30 9 0 0 43 0 17 0 0 0 13 0 0 0 6 0 6 0 56 0 0 0 19 34 0 0 6 3 0 16 7 0 24 0 
40 27 32 34 0 11 0 50 1 0 8 0 28 32 20 13 2 34 6 0 0 22 42 17 5 0 14 22 30 3 0 17 0 0 20 33 7 15 6 10 10 0 0 1 0 61 11 0 26 32 10 6 0 
24 13 0 0 0 17 13 45 19 34 0 0 0 41 4 0 4 16 0 7 0 0 33 16 24 0 0 35 29 0 0 0 0 3 17 20 10 0 3 24 0 8 1 34 6 17 13 0 7 3 0 1 80 
10 18 2 2 7 0 0 0 51 0 12 0 18 22 0 39 0 18 27 21 0 8 14 10 11 0 0 0 0 0 6 4 19 10 0 0 6 0 25 0 15 0 0 25 0 0 22 29 0 0 19 19 0 
16 8 6 26 27 21 0 0 0 13 16 9 14 0 5 7 0 16 0 24 19 15 25 13 0 8 35 0 3 0 0 18 1 1 30 32 0 0 3 0 12 7 0 42 0 27 0 14 5 0 0 0 0 
0 15 24 55 0 5 4 0 0 0 59 12 0 26 0 34 23 0 0 6 24 12 0 5 27 17 0 4 0 0 9 38 0 17 46 0 0 36 0 0 0 0 0 41 23 57 24 0 0 60 20 0 3 
0 20 0 27 20 0 37 0 0 32 23 6 0 0 17 61 20 25 0 11 32 0 0 20 11 0 17 7 0 0 11 15 0 1 8 15 13 29 37 0 0 32 0 7 1 0 28 0 0 61 0 22 55 
