53 30
18 23 17 21 8 18 0 16 0 21 21 10 0 50 29 28 0 14 16 5 0 14 15 34 37 0 0 0 26 0 0 49 8 0 5 0 24 0 14 0 5 0 29 12 6 26 0 0 0 0 25 20 6 
42 0 16 19 18 3 0 0 0 55 18 33 28 0 22 0 0 15 7 0 1 20 36 0 0 4 0 1 0 0 0 22 6 0 0 16 16 14 26 17 9 0 2 24 9 8 0 0 3 17 3 33 0 
0 27 11 0 30 0 77 0 0 39 0 0 0 0 24 0 0 6 12 0 0 17 13 53 0 0 0 19 11 10 0 0 15 5 46 0 0 4 0 21 0 4 25 0 0 14 0 0 9 0 0 0 0 
3 21 2 21 47 7 0 25 34 23 34 31 18 0 8 0 0 0 20 0 5 28 16 20 0 27 8 6 1 47 14 0 23 0 0 12 8 0 72 0 9 14 82 16 0 54 0 30 1 8 0 0 25 
12 39 0 48 26 0 23 45 0 39 13 38 12 7 0 19 0 0 16 0 22 0 24 53 23 25 2 0 19 9 35 20 10 15 7 3 0 0 0 2 0 0 10 2 0 15 7 22 4 42 2 25 45 
0 0 36 0 21 0 0 58 0 0 42 9 20 28 10 0 0 50 0 15 0 0 0 0 5 4 0 36 15 7 0 0 0 0 11 0 25 0 1 0 22 28 10 0 37 13 6 0 0 15 1 0 67 
0 0 5 0 3 49 44 18 0 40 14 10 16 0 14 0 4 0 1 20 0 15 0 25 17 0 0 17 11 0 4 7 0 0 0 22 15 0 7 7 0 0 0 0 20 0 0 0 0 0 22 0 7 
46 0 0 0 76 41 0 0 0 0 15 6 0 1 26 34 62 7 11 0 0 0 0 21 5 0 22 22 19 0 12 0 0 13 18 0 0 21 0 44 13 0 0 0 1 4 0 41 3 83 0 0 0 
27 22 39 10 51 2 0 68 0 0 18 16 0 27 30 36 0 0 0 14 21 26 8 20 3 0 20 46 37 5 26 0 25 30 2 8 4 7 0 0 17 37 48 13 36 11 0 76 0 34 43 41 50 
45 5 4 25 5 0 4 0 0 0 4 50 0 0 0 0 12 8 32 0 10 6 20 0 0 0 0 0 4 9 0 14 5 4 0 7 14 19 0 4 0 0 10 0 4 62 0 0 4 0 35 6 31 
0 0 0 40 28 2 2 8 0 0 39 5 0 4 0 0 4 0 12 0 0 8 0 4 0 0 0 15 10 0 0 0 22 0 2 0 0 0 0 35 0 11 2 56 11 6 0 0 3 6 1 0 8 
0 11 0 14 52 5 0 0 0 0 5 11 20 0 0 6 0 24 10 3 0 0 28 0 12 21 0 9 16 1 0 13 15 0 0 25 0 13 0 10 0 6 0 46 13 5 8 0 12 1 5 0 0 
0 0 0 40 18 27 8 0 31 0 24 19 2 27 0 4 5 5 0 1 8 5 0 0 0 0 0 16 0 0 0 0 19 8 13 0 0 4 0 31 30 8 11 40 0 0 0 42 37 0 6 1 0 
4 31 11 0 4 40 9 0 0 0 0 31 31 0 16 9 4 0 0 0 0 10 46 7 0 0 19 3 0 0 17 14 20 0 34 12 9 0 8 2 18 1 21 38 0 71 16 18 0 0 38 9 18 
46 0 0 0 39 17 14 38 0 0 7 25 6 1 32 0 0 17 3 23 6 0 29 13 12 6 9 3 0 2 0 16 6 16 18 13 38 2 14 0 0 0 22 46 0 55 46 2 0 9 2 15 27 
0 14 48 39 38 6 15 0 0 0 26 0 31 7 12 2 0 0 8 3 0 15 0 0 13 0 8 9 0 0 0 20 0 0 0 0 0 0 0 0 0 0 71 31 0 0 0 7 0 0 48 20 0 
16 0 0 5 17 0 6 13 0 28 0 4 12 0 9 4 9 0 0 5 8 2 0 23 0 0 0 0 8 17 17 0 0 0 19 0 0 32 17 10 11 0 8 0 0 22 0 15 1 24 0 0 0 
0 8 31 10 38 8 22 12 0 42 10 0 59 27 0 8 23 1 0 0 22 3 15 38 8 25 0 0 22 10 22 39 16 10 13 0 12 0 0 4 0 0 38 0 0 13 0 48 0 0 25 0 22 
77 0 0 0 0 4 5 12 30 34 0 9 9 1 7 17 1 0 7 0 0 0 16 4 13 7 19 0 3 0 16 31 0 0 25 1 0 25 34 33 0 0 27 36 16 33 1 0 20 0 0 0 8 
0 0 8 0 0 110 55 22 0 12 26 0 0 30 0 4 7 17 0 25 7 27 23 0 15 0 0 7 4 45 20 10 0 0 30 1 0 0 32 5 3 36 0 9 34 32 1 0 0 0 20 27 43 
0 49 9 0 19 3 0 25 0 20 18 7 0 0 4 0 2 26 0 9 10 4 13 0 0 16 2 1 4 0 0 0 31 11 0 37 0 14 0 30 13 0 0 0 27 12 24 43 0 4 49 14 0 
65 0 0 21 21 7 11 14 31 15 33 9 8 22 0 1 16 0 34 5 21 1 20 12 0 6 4 14 0 5 26 0 26 0 4 0 13 22 12 25 0 11 0 31 8 11 0 0 0 4 30 14 59 
0 1 0 6 25 35 27 0 72 7 0 17 41 17 0 0 3 7 17 0 0 31 0 0 16 11 0 0 1 4 0 25 0 0 0 18 36 0 0 18 19 0 2 3 0 0 42 0 34 0 0 0 44 
7 45 0 60 26 0 13 5 2 6 22 20 61 0 42 8 16 18 32 5 30 0 0 29 37 13 9 18 46 7 0 1 33 0 4 0 9 0 35 11 4 2 41 15 9 18 0 1 7 21 71 39 13 
0 47 8 18 44 0 42 37 5 0 12 1 19 3 38 0 19 0 13 29 8 40 6 22 0 0 7 19 0 38 0 0 11 16 0 12 54 2 0 27 4 0 7 21 0 33 2 0 18 20 0 16 22 
0 56 0 0 0 0 0 0 2 0 22 0 18 0 27 10 31 0 32 8 0 5 38 17 10 0 6 16 0 0 11 0 0 17 10 15 0 0 11 38 28 2 3 0 0 3 0 0 10 1 46 0 0 
0 0 0 9 0 52 22 39 31 0 35 4 7 0 5 0 0 0 0 2 0 10 12 9 0 0 0 4 26 0 11 11 0 0 0 32 26 10 7 12 0 0 0 3 0 0 41 0 0 0 45 1 37 
0 0 0 10 50 0 31 10 0 25 0 0 4 6 0 2 0 7 0 0 10 0 0 10 23 18 0 24 11 34 19 14 10 0 4 3 0 31 0 0 12 0 20 47 0 10 0 0 0 24 0 32 10 
0 42 0 0 0 22 14 45 17 7 22 0 6 10 0 0 0 0 0 7 0 19 0 21 0 31 13 44 10 22 20 0 35 0 0 28 0 11 10 0 0 9 0 42 0 25 0 15 11 0 0 24 0 
22 51 0 4 0 0 0 0 5 5 34 0 17 0 33 48 22 0 0 13 21 0 41 0 0 0 0 17 27 0 0 0 24 0 0 0 0 1 8 26 0 0 0 15 18 2 16 18 0 10 0 36 96 
