53 30
0 10 44 19 13 0 0 0 38 3 0 0 0 18 0 0 0 0 0 0 0 15 30 0 7 0 0 21 0 0 4 9 0 2 24 9 0 3 11 0 3 0 13 0 0 0 22 9 38 10 0 28 0 
3 1 0 24 0 4 6 17 22 2 0 14 20 0 60 0 4 0 0 0 4 0 0 0 0 0 6 0 0 8 0 0 26 9 0 6 0 1 8 3 0 0 6 0 6 0 0 33 0 38 0 0 0 
0 1 0 94 0 47 0 0 15 10 0 0 22 0 0 0 20 0 0 49 7 22 18 6 16 0 17 15 16 0 4 0 0 26 9 24 0 0 6 0 2 10 5 0 21 0 24 28 45 0 10 31 103 
2 8 1 0 0 0 21 12 26 17 18 13 17 24 3 0 1 9 0 2 0 0 20 12 1 3 0 34 27 3 8 0 3 0 12 13 3 12 11 0 9 0 0 0 31 7 17 1 38 3 16 0 25 
71 0 1 46 39 0 18 3 6 40 77 38 0 0 7 0 0 0 0 0 0 53 13 0 24 19 0 0 0 25 0 42 11 0 15 7 0 4 12 28 5 30 38 0 31 35 0 0 0 65 63 41 0 
0 40 0 64 4 8 1 0 0 0 35 1 33 56 19 12 10 0 13 0 0 29 37 33 7 0 23 0 0 25 8 33 28 0 0 0 36 0 1 17 27 27 64 0 12 11 0 14 31 0 100 20 18 
7 0 0 0 36 0 5 86 2 31 0 0 0 27 0 0 0 0 4 0 18 0 2 4 0 0 5 2 6 5 0 5 22 11 0 28 13 0 3 8 8 0 0 0 25 8 0 0 0 8 0 0 45 
2 0 0 0 18 8 0 0 0 11 0 1 0 8 0 17 0 6 7 28 15 0 8 0 39 0 13 7 0 0 8 0 5 0 0 0 0 16 0 19 33 0 0 0 19 0 0 10 0 0 26 0 12 
1 37 0 4 0 0 29 0 0 6 0 19 0 9 0 0 10 0 8 9 0 0 15 0 38 7 2 2 15 3 11 13 15 0 0 29 11 15 27 20 0 0 0 0 13 18 22 0 0 4 35 6 0 
7 8 0 0 42 6 3 13 32 9 0 6 1 0 16 19 29 0 2 0 43 9 24 4 27 12 2 0 0 0 16 9 0 0 19 37 1 0 2 4 27 0 7 4 0 25 38 0 0 0 22 42 75 
2 1 0 34 0 0 0 3 22 0 57 38 0 11 36 9 27 68 0 19 0 4 8 4 30 1 0 24 23 15 6 7 8 17 0 0 17 0 6 31 3 19 55 0 27 42 0 0 26 60 53 43 0 
0 17 0 20 0 38 0 40 17 7 20 0 23 9 27 16 18 26 12 0 0 0 34 18 15 9 0 0 0 26 10 16 0 3 31 23 6 30 0 15 30 20 0 13 8 0 0 0 0 1 3 21 0 
21 0 0 20 45 0 0 34 6 16 0 0 0 27 1 0 0 15 11 0 18 52 13 22 11 0 19 9 6 0 1 0 9 1 10 28 6 0 0 0 4 10 0 1 5 19 0 13 0 2 0 0 31 
9 0 1 48 22 26 34 0 13 0 59 13 7 29 1 0 27 11 33 11 0 13 0 35 18 0 0 5 29 0 0 0 18 28 11 11 0 4 13 29 37 3 22 32 11 0 0 45 14 9 26 76 0 
42 0 0 10 3 0 0 47 43 15 6 6 29 10 2 0 0 7 0 29 10 6 9 9 0 3 14 13 20 4 6 8 8 3 9 17 2 4 3 9 29 9 44 6 16 8 0 13 9 0 3 1 0 
31 12 0 0 15 14 7 12 0 0 0 0 1 18 0 30 9 0 6 9 7 0 32 3 1 12 12 0 0 14 0 0 17 0 0 1 5 12 0 7 0 5 0 0 0 30 0 47 0 0 0 29 0 
0 42 4 44 0 30 22 0 0 4 0 104 0 24 5 3 27 0 0 0 0 0 0 27 6 0 19 0 2 11 25 10 8 7 0 9 27 24 0 24 5 30 66 2 33 16 0 40 37 1 13 13 0 
3 0 0 7 0 5 31 0 16 8 3 0 0 0 35 0 0 8 15 18 25 0 0 0 2 25 0 0 0 0 14 5 20 4 0 16 4 13 0 0 7 0 7 18 12 2 8 12 17 35 0 0 0 
0 0 0 9 0 0 29 4 0 0 0 23 0 18 0 0 0 0 0 0 7 0 0 0 3 10 13 0 0 9 14 0 9 0 23 29 7 0 19 13 0 0 0 19 14 3 0 0 3 0 0 0 0 
15 6 6 0 0 17 0 29 27 33 0 0 0 33 0 18 0 0 0 0 0 27 26 14 0 7 17 3 31 13 3 10 0 20 17 0 41 11 13 0 10 0 9 36 14 0 0 4 15 0 22 59 0 
7 0 15 3 6 0 3 6 0 1 3 4 0 0 5 0 31 28 16 14 48 26 0 5 0 25 0 1 24 14 13 0 55 18 0 8 0 0 36 13 0 2 0 14 14 0 35 58 0 31 39 0 0 
0 0 0 3 0 9 0 0 7 0 10 2 33 22 2 0 4 7 0 0 0 0 26 8 0 12 9 0 15 7 8 0 11 4 8 9 0 0 0 0 18 1 24 0 0 0 0 0 0 0 17 11 0 
6 12 9 6 47 26 39 0 0 28 0 61 0 0 5 0 0 0 0 0 58 10 23 0 7 0 0 0 0 15 6 26 25 30 5 0 0 0 26 28 8 0 0 0 15 0 6 3 0 47 31 78 0 
0 21 0 24 20 32 36 0 4 28 7 31 0 28 58 0 0 44 1 0 6 0 0 11 34 0 0 2 15 0 7 23 13 21 17 34 3 50 0 0 0 31 61 11 0 0 0 41 9 0 0 71 18 
24 25 39 15 35 0 28 0 12 7 0 0 0 19 23 9 4 4 15 0 12 25 6 0 26 6 49 0 19 1 0 9 11 7 0 2 0 0 0 40 14 0 0 0 0 0 0 2 0 2 24 0 55 
36 1 67 9 38 0 2 2 0 31 15 56 37 14 0 7 4 0 15 30 26 0 4 0 21 10 19 7 0 1 0 0 10 0 0 35 11 0 5 0 39 0 0 37 1 20 9 34 23 7 25 4 34 
6 47 0 10 12 23 50 10 18 33 0 0 0 10 8 16 0 14 9 16 2 0 16 40 8 12 0 9 23 12 0 26 6 16 0 21 3 0 6 0 0 40 3 6 2 18 2 0 0 6 3 28 0 
15 0 88 14 18 0 37 10 0 0 15 28 0 0 0 26 0 26 0 0 0 49 23 0 22 16 12 17 0 6 13 23 17 0 0 13 3 0 0 0 0 20 0 37 50 43 0 8 0 47 0 41 0 
0 5 0 42 0 21 0 11 42 8 0 0 0 0 0 36 4 28 8 0 0 0 0 0 0 0 6 0 0 0 0 30 16 18 34 8 0 9 4 0 32 0 0 12 0 14 28 0 0 22 0 64 0 
43 0 0 8 0 0 0 4 25 44 0 3 0 14 0 0 9 19 14 0 27 4 0 10 9 10 10 11 19 38 0 0 13 15 0 0 0 0 29 5 0 0 1 58 28 0 0 39 25 20 24 0 5 
