53 30
7 0 0 58 0 0 4 0 23 46 47 20 7 0 36 18 4 1 8 13 0 5 0 13 8 14 23 1 26 0 14 12 17 12 11 23 9 23 0 0 0 8 8 67 0 1 0 5 13 5 44 0 26 
0 0 11 37 2 0 0 0 18 0 0 2 20 1 0 20 0 5 0 14 0 0 0 13 0 23 18 1 0 2 6 0 10 14 0 0 0 17 0 0 37 0 0 0 0 3 0 0 21 0 0 5 0 
0 0 2 0 0 20 27 41 0 4 0 10 0 0 3 0 53 0 9 0 4 27 11 0 0 0 35 9 0 27 14 4 6 0 18 21 0 8 0 2 0 1 0 0 0 0 59 22 22 0 18 25 0 
22 5 21 60 7 31 5 1 22 42 19 0 0 45 1 6 0 0 3 4 1 7 13 25 0 11 26 0 28 0 0 26 55 18 11 0 16 13 26 10 22 1 10 9 9 0 14 0 0 10 37 65 12 
0 0 0 0 16 32 6 54 2 16 25 0 34 0 26 0 0 16 15 0 1 9 0 37 0 0 0 8 21 5 0 0 0 0 7 10 0 8 33 0 52 44 4 9 0 8 0 0 25 0 45 0 0 
19 47 0 23 43 21 0 0 0 4 1 0 0 27 0 11 0 29 4 5 0 23 7 0 5 0 15 0 14 7 12 23 0 0 5 0 15 0 18 41 27 20 5 5 0 5 4 85 6 7 46 10 0 
0 31 44 0 0 44 0 0 1 7 0 0 7 29 0 0 0 0 0 18 0 24 3 0 14 7 4 34 0 3 15 20 53 7 4 26 0 16 4 8 19 0 36 0 7 0 72 0 0 44 0 12 0 
8 0 11 0 15 37 32 0 4 0 29 3 55 37 14 0 17 13 3 2 0 6 0 5 0 12 0 6 14 2 28 8 0 3 0 0 0 32 32 0 0 28 15 0 0 15 0 5 48 0 0 0 0 
0 12 0 0 0 0 0 9 0 0 18 0 0 10 11 37 0 0 0 19 0 0 11 10 15 0 0 0 22 15 0 9 0 11 0 0 0 18 0 13 0 0 0 0 0 8 0 0 6 0 0 0 50 
13 25 7 1 0 3 0 12 1 4 13 16 0 16 0 8 29 0 4 0 0 27 44 29 12 10 9 29 0 3 0 19 0 4 0 25 12 26 0 4 2 0 3 48 0 23 18 22 27 0 2 11 29 
1 16 39 0 5 3 0 38 15 3 11 0 0 0 0 0 31 12 0 3 0 12 8 37 0 0 0 0 5 0 0 0 0 5 25 0 0 0 0 0 30 7 0 0 0 88 3 31 0 8 0 0 10 
20 0 12 9 0 42 0 7 0 27 6 0 7 0 12 6 0 10 0 0 0 0 2 27 21 3 10 27 5 7 0 1 18 11 10 6 7 2 16 14 5 5 6 0 7 0 4 42 6 15 25 0 0 
2 37 3 0 29 29 22 16 0 0 17 0 36 13 4 34 6 0 0 2 0 0 1 10 19 0 28 21 12 22 4 29 0 0 9 0 10 36 14 38 0 0 0 40 9 0 3 13 36 54 24 22 10 
0 28 23 3 15 0 21 10 4 4 38 0 5 12 14 0 7 26 31 0 0 0 41 3 0 16 22 0 0 4 44 0 0 4 21 0 12 15 0 17 0 0 0 33 0 19 31 0 41 19 24 0 79 
12 57 12 3 30 0 44 0 14 10 20 38 0 22 0 50 0 13 0 2 0 28 14 3 5 12 25 20 0 16 47 2 0 10 30 0 0 16 0 9 11 33 11 0 0 0 0 20 6 26 9 0 0 
0 3 13 0 0 14 17 25 16 43 0 4 0 0 56 28 28 0 0 14 9 11 0 15 10 12 3 20 0 0 0 13 25 0 13 3 0 11 17 0 31 8 0 26 41 0 22 16 0 6 5 37 31 
65 23 20 48 4 56 11 0 14 19 113 0 6 0 5 7 50 42 14 18 14 5 12 2 42 0 18 1 6 19 3 12 6 73 32 8 1 36 0 25 37 39 1 3 5 28 36 47 57 10 45 41 10 
14 0 0 6 0 5 14 34 40 12 47 0 36 18 0 0 2 0 2 20 5 22 0 0 21 23 6 1 0 9 0 9 8 0 12 13 14 0 0 23 0 8 0 33 0 0 25 40 33 0 26 0 4 
11 53 0 33 7 1 0 9 0 18 0 11 2 0 8 11 5 0 17 0 0 0 0 2 0 0 24 13 0 0 27 4 0 0 33 8 0 0 0 3 12 0 7 0 7 0 0 0 5 5 0 0 0 
42 0 0 0 0 31 0 6 1 1 0 29 3 13 0 0 8 0 0 0 0 13 0 0 26 0 1 0 8 8 6 0 14 8 2 0 56 37 14 0 0 7 0 0 0 29 0 0 21 3 0 0 17 
20 12 2 0 22 0 32 10 22 0 0 0 21 6 4 0 0 6 18 0 20 7 41 2 15 1 2 0 0 11 22 0 0 21 0 0 28 0 32 4 20 18 6 4 4 0 0 8 0 27 14 0 0 
0 0 31 0 0 32 0 27 2 0 11 0 0 0 31 42 21 10 0 0 6 17 15 17 13 0 0 1 0 0 0 0 8 24 18 5 20 19 1 5 4 0 1 16 5 0 0 0 0 0 20 0 33 
50 14 0 23 29 0 0 2 16 32 51 0 0 43 7 7 36 11 0 3 0 0 2 0 0 7 28 0 4 0 0 12 11 18 15 22 6 7 7 0 0 17 0 26 4 0 20 0 37 39 50 0 3 
0 0 0 59 0 0 21 0 0 35 36 2 0 0 0 9 0 1 6 0 0 14 22 7 15 0 18 28 24 0 20 0 0 0 0 9 0 3 1 26 3 3 7 0 25 0 13 3 3 11 12 5 22 
19 0 0 21 0 0 0 12 9 0 0 0 4 3 33 0 5 7 1 0 0 13 0 0 6 23 0 19 14 0 0 0 0 0 0 0 22 13 0 0 4 0 0 8 1 0 3 23 0 0 32 0 0 
19 29 23 0 45 15 7 6 22 6 0 27 9 4 4 18 0 25 0 0 0 8 3 13 24 8 0 22 0 0 2 11 17 36 11 23 1 7 38 14 46 31 5 46 1 13 2 5 43 23 0 0 0 
66 0 0 48 19 45 0 0 0 0 0 38 0 13 23 0 0 26 0 0 13 0 0 34 0 23 0 10 26 0 24 19 36 2 10 3 0 52 18 0 0 0 0 40 0 45 0 42 21 41 20 52 5 
16 0 36 0 0 11 0 0 0 36 25 0 0 11 46 2 97 0 18 25 1 19 0 0 18 0 17 11 15 0 0 9 0 11 2 51 0 20 14 0 22 0 54 35 42 0 8 35 0 0 24 8 0 
0 23 48 62 0 63 0 16 0 0 57 0 16 0 0 14 0 0 33 0 0 0 0 0 0 0 0 0 0 14 0 29 5 0 0 8 0 15 0 0 0 0 39 24 13 0 26 42 0 17 48 69 0 
0 24 0 6 30 0 23 0 0 0 25 0 0 23 0 33 14 39 4 18 0 36 16 0 0 0 26 10 0 0 0 15 3 17 50 0 0 9 35 0 0 7 0 4 0 16 0 0 0 0 37 0 2 
