53 30
26 35 29 2 0 8 0 0 29 0 0 0 12 0 0 10 0 30 0 0 0 12 0 0 12 15 0 14 6 21 29 0 0 12 0 0 0 35 0 0 14 0 17 0 11 2 2 30 2 0 6 0 0 
0 11 32 0 15 0 0 0 0 0 0 0 0 28 2 0 4 0 22 21 0 7 29 1 0 7 3 3 27 10 0 0 10 22 32 3 0 15 0 6 22 0 0 0 0 0 29 0 15 6 31 0 0 
0 0 23 0 1 77 19 44 34 0 18 25 11 0 0 38 17 11 3 0 11 1 5 19 0 6 18 0 6 6 0 0 10 34 6 23 19 14 0 14 49 5 17 36 0 0 38 36 27 26 7 2 0 
21 46 0 22 19 24 0 0 2 32 20 0 9 0 2 9 6 0 4 3 0 0 3 1 7 13 14 0 19 24 12 0 0 0 9 13 11 38 0 10 14 0 0 0 0 21 0 81 0 6 0 0 0 
144 7 0 12 0 21 0 7 0 0 21 0 8 3 24 14 32 0 0 1 1 0 11 0 0 3 33 26 4 0 0 37 22 33 0 0 11 0 23 4 0 0 0 0 0 77 21 3 3 0 0 51 16 
0 0 7 35 1 3 4 11 38 16 3 0 20 0 0 0 20 18 11 17 15 0 5 2 9 41 0 0 0 12 20 17 28 20 0 15 42 13 35 0 0 1 2 0 3 5 0 4 23 0 0 9 42 
25 22 5 53 24 21 23 8 24 0 36 0 1 0 11 76 0 0 0 10 17 23 14 1 0 14 0 4 6 10 15 2 0 16 0 6 57 0 76 0 0 2 15 0 19 0 8 0 0 14 0 31 0 
14 0 71 0 24 11 42 34 15 0 0 33 0 30 14 16 0 45 17 13 0 20 0 11 0 0 24 0 0 0 0 0 28 0 23 0 0 0 12 0 29 15 0 37 29 18 18 3 86 9 20 87 11 
20 0 6 0 0 8 6 33 36 0 0 20 20 0 5 39 30 17 15 0 0 13 0 0 19 20 20 0 26 3 4 20 5 9 0 0 0 15 0 13 7 2 8 4 98 0 4 7 32 0 10 7 15 
38 41 0 18 0 23 40 0 0 25 24 0 0 0 1 16 28 2 3 13 0 23 0 0 28 0 0 15 18 15 7 8 0 5 24 15 0 7 22 0 31 41 26 0 25 14 50 4 0 0 15 0 28 
27 0 0 0 33 4 0 0 8 41 0 40 39 12 1 15 6 0 0 14 22 0 25 0 0 0 0 0 8 0 0 0 5 9 0 4 0 33 13 8 0 21 0 0 9 5 0 0 0 29 41 13 0 
0 17 10 4 8 12 44 5 20 40 19 3 0 0 0 28 0 0 17 5 0 0 9 18 23 9 0 0 0 3 3 1 7 0 18 0 0 0 0 8 1 19 8 37 0 16 36 23 0 48 0 45 9 
9 58 0 28 2 21 0 5 0 14 48 0 27 0 25 0 2 10 0 18 5 27 0 0 12 43 37 6 1 12 4 21 8 6 0 11 12 18 21 25 0 0 20 2 18 0 7 37 90 23 0 26 0 
11 0 0 15 31 25 32 12 0 0 1 17 0 9 14 34 1 9 0 0 31 7 11 13 21 0 9 11 17 18 49 17 1 0 14 46 0 8 23 39 0 11 3 2 1 73 8 2 7 34 2 10 24 
14 0 17 13 36 31 1 0 0 69 1 0 0 0 5 37 13 0 0 10 41 12 0 0 0 8 0 21 9 47 3 0 0 13 7 26 23 31 28 5 34 21 0 0 34 10 44 0 12 0 2 9 0 
0 29 15 0 77 0 6 0 24 6 29 0 3 7 7 18 6 7 0 0 30 13 27 31 43 4 8 0 0 0 3 0 6 0 17 13 11 25 5 0 17 10 0 0 0 0 0 0 20 64 29 47 0 
0 12 26 12 20 39 0 8 0 0 0 0 0 14 36 5 0 11 3 17 0 0 0 0 0 0 0 0 26 0 0 0 8 0 0 22 31 26 2 0 0 0 0 3 4 0 3 28 15 0 28 0 0 
0 17 11 44 20 14 37 1 0 27 20 32 5 0 11 24 28 25 11 12 24 38 5 0 36 4 10 0 0 20 0 21 15 1 24 0 28 0 2 28 0 20 37 5 14 0 0 17 33 40 38 0 0 
0 0 0 0 0 48 0 22 25 25 0 10 3 26 0 7 0 0 3 0 0 2 0 0 3 0 3 12 0 22 0 0 12 6 25 0 0 13 4 30 7 8 39 6 12 3 1 4 1 1 0 18 7 
26 17 0 22 26 13 14 22 0 24 0 0 0 15 0 28 18 0 17 0 13 0 41 8 16 0 0 28 15 20 3 0 0 9 0 3 0 0 24 1 7 13 34 3 32 19 12 0 0 0 0 0 0 
11 25 0 0 16 28 15 30 0 0 28 21 3 0 0 7 12 0 17 8 16 18 7 28 3 2 17 27 12 4 0 0 0 28 0 12 25 24 39 24 0 0 0 42 0 0 0 16 4 11 0 24 7 
2 0 7 0 19 12 0 0 0 4 0 0 0 0 12 41 0 8 0 71 0 0 0 3 5 20 31 0 24 10 6 0 20 0 0 0 17 0 0 0 12 0 43 1 3 39 27 39 0 3 35 0 53 
1 23 0 5 44 0 6 0 60 0 0 0 11 16 0 14 40 0 0 18 29 0 0 9 0 0 0 0 0 3 0 7 9 8 0 12 0 18 16 5 0 28 0 0 5 0 41 42 0 29 0 30 4 
8 0 0 33 0 60 61 0 15 4 28 17 15 0 0 5 22 0 20 0 17 13 6 49 8 20 20 0 40 0 9 0 0 0 16 3 16 0 2 0 6 21 6 22 2 0 40 3 14 29 5 28 0 
19 0 3 18 5 3 0 0 0 0 0 33 0 0 0 0 0 0 17 21 11 3 0 2 1 7 0 5 5 26 11 9 8 0 22 0 0 0 5 12 0 0 13 0 43 7 23 0 5 4 0 2 0 
3 0 0 39 0 0 5 20 2 4 11 18 13 0 0 5 14 3 3 32 44 19 0 18 9 43 0 0 18 37 36 3 0 0 0 0 0 27 3 0 7 29 33 1 0 6 0 27 19 21 2 32 0 
16 30 0 0 0 0 0 0 0 15 35 0 13 0 0 33 25 0 0 5 0 0 0 14 1 0 0 0 5 8 11 30 9 0 0 0 0 19 43 8 0 33 0 31 30 36 0 8 0 0 0 10 6 
27 33 0 0 0 33 53 0 12 0 10 29 0 0 38 54 15 0 1 0 12 16 9 0 5 0 20 4 18 6 0 9 0 0 6 0 22 1 54 2 4 9 9 0 0 39 31 3 14 2 36 36 38 
23 58 0 3 21 12 0 0 0 0 6 10 31 12 0 21 0 0 4 27 0 27 0 0 19 25 0 0 27 2 2 2 35 17 17 0 7 1 15 0 0 3 9 28 0 0 37 46 16 41 2 19 14 
7 0 0 0 0 0 21 7 29 0 0 0 26 45 0 25 29 17 0 0 0 4 13 0 6 0 0 16 5 0 36 0 25 28 55 13 1 26 11 0 25 18 0 25 0 25 12 0 0 11 16 0 0 
