53 30
0 48 0 47 44 18 2 29 2 5 29 0 12 15 14 15 4 2 11 2 0 27 23 11 19 22 5 0 15 0 2 5 0 21 11 1 0 18 0 26 19 6 37 0 32 0 15 18 0 48 0 48 0 
4 10 10 0 20 4 28 0 0 23 25 17 25 0 0 0 30 17 25 10 15 0 0 2 0 10 0 13 17 14 23 20 0 0 19 33 26 0 0 10 25 30 0 14 0 0 7 2 13 0 10 0 0 
0 15 25 0 34 30 8 23 27 0 12 50 2 0 0 25 0 0 0 17 25 0 8 0 12 0 2 11 2 7 18 0 37 26 42 32 26 0 11 0 5 0 22 11 25 71 0 1 0 0 0 42 18 
21 15 25 0 0 0 6 24 18 0 38 34 26 0 9 0 46 34 4 9 0 0 23 26 22 23 10 0 21 0 1 1 24 0 0 10 0 15 1 9 0 10 5 0 0 24 23 25 47 0 0 0 0 
0 7 0 0 22 0 15 2 7 2 0 0 0 33 0 0 7 0 0 0 17 2 0 8 29 8 0 11 0 1 18 5 18 8 0 16 8 21 1 13 0 3 0 0 0 1 42 4 18 0 15 18 28 
41 24 0 0 0 4 0 0 37 0 0 0 65 0 0 21 0 0 10 0 0 26 13 0 1 24 7 0 22 14 1 0 0 0 9 14 0 0 1 9 24 41 8 25 0 76 0 26 45 11 14 2 17 
0 13 0 0 0 82 10 0 0 31 0 0 6 27 32 0 3 0 0 38 0 2 4 0 0 24 0 0 3 0 0 3 0 0 16 9 0 16 18 11 39 28 0 4 9 0 0 0 0 36 31 0 47 
27 5 23 0 0 5 0 4 11 32 12 0 20 28 3 0 7 16 27 12 19 7 0 0 7 15 0 9 0 5 0 20 20 0 15 0 5 0 0 0 22 28 18 49 14 27 30 7 8 1 0 31 0 
27 25 8 4 91 6 0 3 1 67 10 0 23 37 10 11 42 10 5 19 7 14 0 13 17 3 43 9 0 0 6 1 13 0 14 82 0 0 6 0 0 0 29 0 13 48 0 9 0 11 41 0 48 
50 23 0 45 22 0 6 0 0 0 8 0 0 7 0 9 15 0 0 13 0 0 0 0 0 0 9 27 0 2 0 20 0 0 8 0 0 0 0 10 14 12 43 7 20 0 0 0 0 46 5 6 0 
33 9 0 121 24 0 28 9 0 35 32 39 0 15 4 0 0 10 0 9 21 20 16 0 4 0 10 23 0 22 32 0 0 0 4 0 23 0 33 29 13 21 0 0 60 0 16 0 0 42 43 21 17 
8 32 0 15 0 4 0 0 0 39 0 0 0 9 0 8 0 5 15 8 0 3 40 19 3 7 0 7 0 0 15 0 8 0 9 20 0 0 0 0 0 7 9 42 0 1 8 32 46 0 27 20 0 
130 2 0 0 22 2 0 14 15 9 39 0 6 0 55 29 1 15 0 57 8 12 1 0 0 13 9 13 27 6 0 0 0 0 43 0 0 0 13 32 6 27 0 0 44 6 0 0 34 86 23 36 10 
25 20 40 0 23 10 20 7 0 0 0 0 3 31 18 15 3 8 8 22 2 20 18 5 0 0 18 25 12 0 11 0 10 0 11 10 16 10 11 8 12 23 48 0 31 5 9 10 0 0 5 10 16 
47 29 1 0 0 0 43 0 13 0 0 11 10 0 0 0 0 13 0 10 0 13 0 22 26 0 15 13 0 0 2 0 0 0 24 5 9 7 0 0 0 7 0 7 10 37 15 47 1 47 4 5 0 
26 30 1 46 3 13 3 0 26 11 0 0 20 35 0 4 0 6 0 0 5 7 19 0 18 0 15 6 6 18 0 30 20 0 32 0 20 10 10 2 0 17 0 2 0 2 15 8 38 3 0 0 51 
3 49 9 0 27 40 0 0 8 9 0 17 5 36 18 0 0 18 6 20 15 0 0 10 0 27 6 9 17 3 0 27 24 0 0 8 22 3 11 0 15 0 0 0 4 37 0 0 7 20 49 28 34 
9 0 17 20 5 0 18 0 3 38 8 56 0 0 11 0 9 0 7 0 0 0 17 32 11 18 1 5 0 9 0 0 19 0 0 0 8 3 8 3 3 0 13 6 11 37 10 53 0 47 18 34 0 
6 61 11 2 3 35 42 34 29 3 0 9 0 4 10 0 0 3 2 11 0 0 10 0 0 0 11 0 0 6 7 0 29 0 0 0 28 17 0 5 0 0 0 0 0 5 43 0 94 0 0 19 0 
18 81 20 0 0 48 24 24 0 11 21 26 0 0 11 28 7 0 14 18 6 10 20 28 8 18 14 17 0 3 17 18 14 0 15 35 0 16 22 34 10 3 17 20 26 38 1 27 3 115 14 4 0 
56 67 5 0 3 7 0 25 9 0 0 57 23 0 0 36 1 46 30 1 0 24 0 0 0 7 0 30 8 11 6 0 0 49 22 11 43 25 12 0 10 0 30 39 8 39 64 30 0 0 18 76 0 
0 0 0 0 17 21 0 0 0 0 0 2 0 0 16 0 0 8 1 0 19 0 0 0 0 3 21 4 2 0 19 0 0 0 0 7 0 0 0 17 0 0 9 0 25 16 0 0 0 0 0 11 4 
38 20 5 0 38 0 24 15 0 2 39 9 0 6 40 0 0 0 7 13 17 38 0 15 0 0 0 9 2 1 14 0 15 14 38 14 11 5 38 16 0 3 0 1 26 31 3 10 5 79 0 12 38 
22 0 13 0 0 46 32 13 0 0 0 0 12 1 31 13 0 0 11 0 16 4 0 0 0 0 36 0 0 0 0 16 0 0 0 0 13 0 32 0 0 36 0 7 0 40 0 0 2 0 0 10 26 
0 75 28 23 0 9 0 0 8 24 0 0 2 20 11 75 15 0 0 1 0 0 9 0 0 0 14 15 20 0 5 2 22 2 28 0 4 0 4 12 4 0 67 24 29 4 18 0 33 0 0 0 9 
13 25 44 19 0 19 19 2 0 34 0 20 5 0 15 1 2 25 73 0 2 0 38 9 22 0 0 12 5 15 19 24 0 0 12 0 0 15 60 0 9 0 3 32 2 23 48 0 0 10 0 42 13 
21 0 19 0 53 38 6 0 27 24 0 0 2 4 0 21 0 19 20 0 2 0 2 25 1 1 0 0 16 8 0 0 0 0 4 27 11 2 9 0 0 0 1 0 16 45 3 26 0 15 0 14 13 
2 44 0 0 0 41 8 20 2 28 0 7 25 0 3 25 0 15 11 27 26 29 0 24 0 7 15 0 15 5 0 14 32 0 34 0 14 18 30 0 15 0 33 0 41 30 83 2 5 0 0 0 17 
0 0 31 40 18 57 0 9 0 0 0 9 0 2 27 2 36 0 7 23 7 0 23 18 24 0 0 4 0 0 0 0 12 26 0 10 9 32 33 22 1 27 20 40 19 21 0 17 0 0 0 38 39 
22 7 0 0 0 0 29 0 2 0 0 0 55 12 1 0 0 0 0 28 0 0 0 0 0 12 0 0 23 0 15 0 0 9 7 0 0 0 32 0 25 71 0 22 0 15 15 0 0 0 0 23 0 
