53 30
36 0 0 26 43 2 25 42 27 0 1 44 32 0 7 16 20 14 41 0 0 7 13 20 10 0 0 0 0 0 18 9 0 16 16 13 18 7 2 28 13 32 0 39 39 85 0 0 2 102 0 27 0 
0 0 1 1 0 29 8 4 29 15 34 33 0 38 4 0 50 12 7 25 4 20 0 9 15 0 10 22 18 20 0 2 0 18 0 0 10 29 9 20 1 0 31 0 0 29 14 0 25 2 0 44 2 
0 15 0 0 8 41 55 50 0 1 0 27 46 29 7 0 34 0 10 0 0 10 0 15 0 0 4 0 0 1 0 3 5 20 31 0 3 9 6 0 0 0 2 7 28 0 13 0 41 20 21 0 3 
0 0 30 4 57 2 0 3 4 1 0 19 9 11 0 10 5 0 14 13 6 0 22 0 14 0 22 0 0 15 2 0 13 0 0 0 21 0 11 16 18 8 38 0 12 0 44 0 7 19 0 0 26 
0 22 31 33 29 22 13 44 40 8 0 5 5 6 33 0 6 0 2 27 11 22 50 24 7 0 32 51 9 4 0 1 8 56 20 0 1 0 22 7 36 0 0 14 17 0 0 11 32 0 0 81 67 
0 0 0 59 19 66 6 45 0 5 6 8 27 0 0 33 0 0 0 6 0 0 0 0 0 13 4 0 0 0 0 38 0 0 7 0 0 0 1 0 0 34 15 0 37 14 37 0 77 1 23 0 47 
0 0 0 45 48 0 30 0 0 0 0 5 0 33 0 0 14 5 0 34 8 5 15 0 0 0 5 16 21 27 22 0 29 4 0 0 30 3 22 0 0 0 0 4 0 0 33 8 0 11 0 2 45 
8 0 16 0 0 0 3 41 16 21 10 0 3 0 0 7 3 1 0 3 0 1 11 0 0 25 0 17 0 8 23 23 5 32 15 27 3 13 9 0 0 0 0 3 2 11 6 9 48 0 11 0 8 
43 0 0 33 22 20 12 49 19 0 0 0 0 11 11 7 6 0 7 0 0 0 7 0 0 22 22 0 0 21 14 0 0 9 0 28 0 0 0 0 0 0 12 43 21 0 39 0 0 0 0 16 19 
9 0 0 5 8 8 0 0 7 27 0 9 45 0 0 14 4 0 12 4 5 0 9 0 0 5 8 2 0 0 7 15 0 0 0 5 0 0 0 0 0 0 5 0 2 0 0 5 2 15 36 42 3 
23 33 1 13 8 9 12 33 31 0 6 7 4 34 18 21 15 12 25 8 0 0 21 19 8 12 43 1 2 41 6 0 0 10 0 0 27 0 7 4 0 5 26 11 4 0 14 12 17 0 26 1 19 
0 29 13 40 0 0 6 19 0 3 1 7 3 7 12 8 0 18 16 26 13 4 17 5 22 0 22 13 10 16 29 0 7 31 6 33 7 4 13 12 0 5 0 40 0 4 0 0 0 0 0 28 16 
36 21 0 19 0 4 10 8 0 8 0 0 2 34 31 0 23 0 11 0 6 0 2 45 0 11 0 13 0 0 0 0 0 0 7 0 60 0 0 0 11 26 1 0 0 0 15 0 8 0 0 10 47 
0 5 0 17 22 0 0 0 18 38 0 0 6 0 0 0 4 12 0 3 23 0 0 0 0 4 22 5 0 0 0 23 0 2 0 0 9 0 0 0 13 0 6 0 0 32 0 38 48 29 0 32 0 
7 0 0 0 0 11 67 7 14 8 11 13 0 32 0 0 0 8 0 0 11 25 16 12 6 20 0 46 0 23 3 10 0 7 0 12 0 0 0 4 10 0 15 10 23 31 25 12 0 0 46 0 33 
11 0 0 0 37 37 58 45 29 0 8 11 0 6 10 0 69 0 0 0 0 0 3 0 18 1 7 0 9 20 0 0 0 4 12 14 3 29 5 3 33 12 37 8 28 0 19 11 0 6 6 0 15 
50 0 0 0 40 25 0 0 7 23 35 0 0 2 11 0 0 0 3 0 30 10 0 0 7 11 13 7 18 0 1 7 12 0 47 0 1 0 52 8 9 31 12 0 40 7 5 0 0 13 30 12 3 
0 15 34 0 9 22 1 0 4 3 16 16 2 0 0 0 0 0 12 0 2 0 3 10 0 4 9 0 11 24 0 3 0 0 0 0 35 0 0 0 2 15 0 10 33 4 8 1 0 0 28 0 29 
13 5 0 3 11 1 46 8 3 0 6 21 38 34 5 2 10 19 17 0 17 10 26 30 0 2 0 5 2 0 28 37 0 16 3 46 22 51 7 2 12 25 6 0 7 0 21 0 31 0 0 41 10 
41 0 7 29 64 0 38 0 0 7 30 20 2 22 5 46 35 0 15 7 0 0 15 14 24 8 15 31 29 0 16 30 27 8 13 8 0 20 4 13 17 51 27 30 44 41 29 6 21 0 16 53 9 
0 0 0 33 1 30 9 0 0 23 47 0 37 0 17 35 20 0 0 3 0 0 0 22 15 0 30 9 0 3 21 8 29 7 0 0 9 0 18 0 14 0 1 0 39 22 12 0 0 40 0 40 66 
0 0 83 4 0 1 4 0 8 8 27 36 1 6 24 0 6 0 11 0 12 12 0 12 28 9 13 7 23 1 0 2 12 14 0 1 0 3 24 8 18 7 0 75 0 43 36 23 9 69 48 0 28 
23 48 10 1 19 0 18 12 0 43 32 9 0 6 28 0 0 33 0 0 39 24 0 30 9 12 21 16 11 0 17 0 0 9 4 0 47 2 10 5 14 27 9 0 0 24 12 0 38 45 1 20 0 
41 49 32 2 39 10 1 0 23 0 0 0 27 0 0 10 12 2 2 32 17 0 0 0 0 0 2 0 0 0 13 0 4 12 0 15 4 14 0 12 22 0 5 41 4 0 0 0 4 14 15 4 55 
97 25 0 0 23 0 0 18 0 14 1 7 0 0 12 0 0 0 3 0 11 0 20 14 18 18 28 7 9 0 4 6 0 0 6 4 9 27 29 0 0 14 0 0 19 9 30 13 14 18 0 51 22 
14 85 61 0 5 11 0 47 0 0 3 1 21 13 29 11 18 2 8 9 0 21 0 0 0 7 11 0 9 15 18 1 6 0 0 0 22 0 6 0 9 0 10 19 6 0 84 40 18 3 0 1 10 
12 12 36 34 0 45 0 14 0 16 41 10 50 0 1 0 36 12 0 0 0 0 0 0 0 16 0 0 0 5 0 0 0 3 0 21 8 19 64 10 30 36 4 5 8 0 0 0 31 0 0 18 0 
16 13 38 0 0 0 0 5 0 31 18 13 71 0 0 0 6 16 3 3 10 0 17 26 14 0 0 0 0 16 0 0 31 7 0 0 0 3 4 17 27 0 15 0 32 0 0 0 0 22 0 12 19 
12 44 0 4 26 6 0 92 7 2 0 18 0 0 11 60 0 0 0 0 0 0 0 16 29 0 24 11 0 9 80 0 0 0 0 4 0 0 20 38 36 0 20 0 0 6 7 0 0 0 12 36 21 
0 19 0 0 6 0 17 46 0 8 0 0 27 0 0 0 0 0 21 0 0 8 0 0 0 0 0 0 10 23 0 2 0 0 0 0 0 0 7 0 0 0 0 6 0 0 0 40 17 0 44 7 0 
