55 31
25 6 50 0 41 8 23 0 26 19 14 0 5 0 11 0 0 17 12 53 0 30 12 8 42 20 0 0 0 5 0 0 0 0 1 0 0 4 9 0 6 22 0 28 9 41 19 0 0 0 0 25 50 29 0 
0 9 0 2 0 0 12 0 0 0 0 0 0 0 7 0 13 0 0 0 12 0 8 19 5 28 0 6 0 3 12 0 22 4 33 34 1 0 0 7 0 0 19 58 18 0 0 0 26 0 20 1 23 28 19 
18 21 50 107 5 12 0 9 9 0 0 21 2 0 0 0 41 16 28 9 47 0 0 0 15 13 0 0 10 0 0 0 21 16 0 32 18 0 0 20 0 0 0 0 0 0 45 0 60 0 44 0 50 0 0 
0 6 20 0 0 0 36 0 24 1 4 11 0 29 13 27 0 12 36 0 0 0 33 72 14 0 11 16 0 28 26 0 0 0 1 20 2 0 14 0 0 0 10 45 15 10 24 12 0 0 21 15 0 8 21 
0 39 22 3 0 7 0 43 0 6 0 0 39 2 3 12 28 29 6 30 7 7 26 0 16 13 0 14 2 16 10 0 0 6 0 24 0 9 0 24 39 0 0 26 28 0 17 0 0 74 43 0 0 41 0 
0 9 45 47 0 12 0 0 0 24 27 0 0 0 0 0 17 30 24 0 0 0 0 9 0 21 0 0 0 40 4 0 0 47 0 2 2 69 19 0 0 5 0 0 0 16 21 56 0 8 47 0 0 0 0 
0 0 0 0 11 0 0 0 0 0 0 5 0 6 23 42 46 0 0 2 29 0 0 0 0 20 11 8 0 18 0 0 0 0 0 15 0 6 18 16 0 0 11 6 13 29 31 0 0 2 0 0 0 0 0 
34 27 0 0 5 13 6 0 12 0 0 0 0 0 0 20 28 0 17 0 0 7 1 20 1 8 13 6 14 0 0 0 13 21 34 25 44 0 10 0 0 8 12 8 28 9 0 12 5 8 6 9 20 25 0 
45 10 37 3 17 44 22 10 1 3 18 9 58 1 8 0 9 0 7 5 21 11 43 0 22 28 0 19 10 17 0 27 39 2 0 12 18 0 0 0 0 21 0 0 39 0 46 6 0 0 0 29 40 5 0 
0 0 0 7 48 0 53 28 0 5 0 74 0 0 5 0 12 0 0 0 0 0 0 9 18 0 0 0 11 0 4 0 0 0 0 16 0 0 0 0 0 0 0 0 0 11 0 0 0 0 0 0 89 0 48 
26 0 19 29 3 26 1 19 25 16 1 0 0 17 61 0 0 0 0 0 41 13 31 3 0 10 15 20 3 26 10 32 0 20 17 0 15 0 2 6 54 27 21 13 0 7 0 0 41 39 0 17 0 81 20 
0 0 0 0 0 1 34 0 8 20 0 6 0 18 0 5 0 6 0 0 0 0 0 0 0 38 4 0 18 0 0 0 0 27 0 3 0 0 2 0 0 0 4 0 0 0 0 2 32 15 0 0 0 0 0 
18 76 10 40 16 42 2 1 50 7 2 0 1 0 6 0 6 9 18 0 20 20 27 0 25 0 0 0 0 5 33 1 18 0 14 0 0 0 0 0 0 1 22 9 0 0 0 27 9 0 0 21 0 52 0 
47 0 0 0 5 17 8 33 23 12 23 0 9 5 7 0 1 9 0 4 26 0 0 0 0 1 19 44 0 0 14 9 4 23 0 10 0 0 13 0 0 2 0 9 3 0 0 62 0 0 18 2 27 32 3 
13 9 0 0 12 30 44 40 0 28 2 19 0 31 0 0 5 0 0 23 3 5 0 14 25 8 14 0 23 0 19 7 13 0 15 8 0 28 0 0 0 0 23 0 11 3 9 62 3 58 17 6 0 17 6 
56 28 0 0 0 0 16 2 10 7 43 3 0 31 8 0 15 12 10 30 1 0 3 0 37 0 2 15 7 0 0 2 0 0 0 7 1 9 7 0 9 0 0 0 31 19 0 25 64 0 28 0 0 35 0 
2 4 42 0 37 0 14 0 1 7 0 0 0 0 1 0 24 16 0 16 0 0 11 0 0 0 4 0 13 32 27 0 9 16 0 19 0 1 4 39 24 53 0 13 14 0 3 7 1 0 0 49 11 0 5 
5 17 70 49 0 19 0 19 47 1 16 0 0 4 2 0 22 0 33 12 14 19 0 0 15 6 3 19 0 7 0 29 0 6 0 25 31 2 10 6 38 25 20 16 17 43 0 5 0 0 10 0 11 6 59 
0 30 0 34 26 0 21 0 0 24 31 31 9 0 19 14 0 15 16 6 28 13 0 0 1 4 0 0 21 8 42 0 13 8 16 0 0 46 14 0 12 1 3 2 8 47 0 5 29 0 0 10 3 0 2 
11 0 14 18 4 32 37 8 112 30 0 0 0 5 18 10 25 17 4 0 23 18 0 0 0 0 5 0 0 16 25 14 7 0 0 0 0 1 0 0 0 0 24 60 13 0 39 44 30 0 46 0 44 6 0 
0 0 0 46 0 52 0 7 11 0 14 0 0 41 0 0 3 0 0 18 0 16 22 20 14 1 0 0 33 0 0 13 0 7 9 0 15 0 0 6 0 0 8 13 26 18 41 3 2 0 33 10 4 22 0 
0 0 19 13 24 0 0 0 0 26 16 8 18 0 0 0 4 0 0 1 0 44 0 0 0 43 0 22 10 0 0 0 0 6 4 4 0 0 13 0 0 16 45 0 0 11 50 4 0 29 0 13 20 0 8 
5 0 0 0 53 0 0 5 43 15 2 37 0 0 14 0 42 9 0 44 0 6 0 0 15 11 17 3 7 0 9 6 6 3 0 5 0 9 5 4 21 0 38 18 25 0 11 0 31 0 0 43 0 0 0 
33 12 3 0 23 4 0 0 7 0 0 15 10 41 0 0 7 0 0 0 0 0 20 15 20 0 0 0 2 0 0 31 0 0 0 10 0 4 0 5 29 4 45 0 0 22 2 0 12 0 0 0 0 6 0 
22 69 0 0 73 0 31 0 0 38 1 0 0 1 10 0 0 0 0 6 20 28 0 0 10 24 0 0 22 12 26 0 2 16 10 62 0 6 19 0 40 0 0 0 0 0 31 32 0 44 10 47 7 12 0 
0 23 5 13 39 5 17 8 0 18 1 30 0 2 13 0 0 0 29 0 0 0 0 19 0 16 0 3 25 0 0 0 1 2 0 0 15 20 0 0 15 8 19 32 0 0 3 41 7 48 0 20 0 11 11 
1 19 36 6 62 58 0 2 0 27 18 0 24 4 0 15 0 0 21 4 0 16 0 0 9 7 0 3 0 0 0 0 0 0 0 0 0 11 49 0 0 0 9 0 26 0 42 38 25 15 0 0 0 0 0 
10 0 33 0 5 36 2 7 0 21 0 0 0 74 11 20 2 22 0 0 0 0 9 20 0 0 0 36 6 0 0 0 83 0 0 0 23 22 0 0 0 73 0 7 43 7 9 7 9 2 1 2 69 17 0 
22 0 0 0 0 0 13 0 17 0 24 19 19 9 0 0 1 13 21 0 0 15 0 0 14 0 0 11 0 10 9 0 15 0 0 11 19 0 37 5 0 31 9 28 0 0 0 6 0 0 0 0 0 0 54 
14 0 12 62 2 0 9 0 17 0 12 13 51 0 7 0 20 15 34 0 0 0 0 0 21 11 0 0 56 19 14 0 0 0 0 35 0 1 0 31 0 0 16 0 28 0 4 35 0 7 0 48 34 9 11 
65 50 12 45 43 42 16 0 5 29 0 4 0 34 32 23 2 0 0 0 40 13 40 14 0 29 0 5 20 28 8 0 28 10 1 31 0 28 29 0 0 0 18 0 0 25 40 2 71 1 28 0 0 0 10 
