55 31
0 10 27 0 0 17 0 0 31 0 20 19 15 0 0 25 0 0 4 0 10 15 4 0 11 7 0 0 0 22 5 0 7 0 0 11 39 0 0 24 1 0 11 9 22 29 14 17 28 0 0 39 22 0 0 
0 28 0 25 0 0 0 13 0 0 0 38 4 31 29 0 36 0 30 0 4 13 4 37 10 0 12 23 0 28 6 6 0 0 30 25 0 6 23 0 0 0 14 3 0 29 12 28 62 38 0 9 0 0 0 
51 24 13 3 1 16 4 0 22 0 26 0 17 0 10 13 19 0 0 0 9 21 15 0 0 0 17 30 17 17 35 1 0 0 0 1 26 0 0 0 13 4 0 11 16 4 0 25 0 25 8 59 0 19 5 
0 3 0 17 0 0 43 42 0 0 0 0 0 8 16 46 25 11 0 0 35 22 0 0 10 0 0 0 0 0 0 23 16 18 31 16 1 14 32 0 0 33 9 0 0 0 0 0 16 24 0 31 0 0 63 
0 0 38 5 0 0 27 9 39 0 0 31 5 8 24 0 0 12 29 0 0 20 0 0 26 0 33 0 0 12 0 18 0 30 16 24 0 23 24 26 38 0 24 2 36 23 23 25 2 3 38 0 33 0 19 
8 3 0 45 0 13 0 0 8 15 9 11 20 0 14 28 29 23 11 9 25 0 3 0 33 47 0 0 17 30 0 13 12 0 0 0 8 0 8 0 0 0 6 18 13 9 0 18 0 11 0 14 52 20 11 
0 3 42 0 0 0 0 0 5 0 41 35 1 37 4 0 0 4 4 18 18 8 0 0 0 0 0 21 0 8 0 0 0 0 5 0 17 18 0 14 11 0 0 0 42 0 39 0 10 17 37 30 0 17 0 
0 0 0 76 17 0 30 57 0 15 15 5 0 0 3 27 3 15 3 20 17 3 13 0 0 20 6 24 20 0 0 5 1 3 28 18 6 20 8 0 0 13 49 6 21 1 33 0 6 24 25 0 14 41 23 
0 35 0 0 16 39 45 18 0 37 23 0 0 0 11 21 0 7 0 0 0 18 8 22 0 0 8 0 0 17 34 0 14 0 0 4 35 0 1 0 0 27 0 8 57 0 45 0 13 0 44 8 26 0 0 
0 0 0 12 1 0 16 0 0 0 20 10 0 0 0 0 6 10 0 0 7 10 29 15 0 17 14 7 38 24 0 0 0 18 0 0 30 18 0 10 0 8 0 12 14 4 0 0 27 6 0 65 0 0 25 
10 11 0 0 19 0 20 0 0 7 10 0 0 3 12 7 0 31 3 0 0 11 90 20 20 24 18 0 2 14 20 9 11 0 0 0 0 0 0 0 0 0 3 44 0 8 4 12 20 3 12 22 35 31 40 
0 0 0 44 0 0 25 0 36 2 0 59 37 0 39 18 6 15 0 0 9 7 6 0 24 17 18 10 4 3 0 13 67 4 0 13 0 13 30 0 19 5 12 1 0 0 5 44 26 37 0 40 0 0 6 
67 0 0 0 0 0 8 0 5 0 0 0 4 6 10 0 4 0 58 0 0 0 0 16 0 0 0 0 7 0 0 0 0 0 5 0 15 0 0 5 0 0 1 25 12 0 0 0 0 49 11 32 0 2 0 
0 17 0 50 0 0 0 0 0 0 18 35 0 1 14 0 0 0 17 0 0 41 32 0 9 1 15 26 23 0 15 0 21 22 0 0 18 12 1 25 0 11 1 4 9 0 3 7 0 45 0 30 10 59 0 
0 20 0 0 0 0 4 13 15 6 26 0 0 0 0 34 0 0 0 0 8 11 0 0 15 21 0 15 3 0 12 10 0 12 0 0 23 10 0 15 0 0 42 0 0 0 14 21 0 0 0 0 0 0 0 
0 0 10 80 7 27 0 0 0 0 0 0 0 3 9 5 5 1 13 33 12 0 0 4 0 0 0 0 0 0 4 0 27 0 31 0 0 0 0 13 0 15 11 13 8 0 0 8 0 7 0 0 93 0 0 
0 7 29 0 29 6 0 0 0 0 57 0 0 0 39 4 0 0 0 11 0 0 11 15 1 9 9 0 3 0 0 0 16 29 0 0 1 1 6 0 0 39 0 20 16 0 0 0 10 28 0 0 0 39 0 
0 0 0 4 9 14 0 29 0 7 0 0 42 0 0 27 12 0 0 10 0 6 13 0 1 0 0 9 9 10 22 13 1 1 0 0 59 0 0 5 0 0 13 7 13 0 9 0 0 5 20 0 1 16 27 
0 0 0 0 7 49 90 0 7 0 2 0 1 0 10 9 0 3 1 0 10 11 0 8 6 30 16 0 0 0 0 0 19 8 0 34 2 0 0 15 0 0 0 8 19 0 0 29 9 0 11 50 0 18 27 
58 47 0 35 0 0 53 15 0 26 0 15 1 0 10 44 16 16 17 0 19 16 0 4 0 16 36 10 8 1 10 14 0 0 0 47 0 8 35 12 0 9 36 8 29 0 6 0 48 48 2 8 0 13 20 
34 0 15 54 0 52 8 0 37 47 15 9 0 0 21 34 0 0 30 19 0 0 34 0 0 0 4 0 17 0 17 0 0 33 0 5 6 28 9 8 40 19 0 2 0 34 3 5 11 0 0 5 34 48 51 
0 15 0 38 11 3 46 22 31 0 0 0 6 37 1 4 19 18 6 8 17 0 12 0 0 14 7 47 25 22 31 4 26 48 1 0 47 0 20 16 0 12 0 0 36 11 0 17 0 22 22 6 11 31 22 
0 0 45 0 0 13 0 11 28 14 6 0 40 0 0 7 0 21 29 0 5 0 6 14 0 4 0 22 28 17 4 26 29 0 14 0 61 0 36 0 23 0 20 2 5 7 0 12 0 17 23 2 50 0 52 
50 28 4 0 48 0 36 0 0 0 17 0 0 0 0 0 0 0 0 35 0 36 0 22 0 5 16 17 0 3 19 12 1 1 8 12 20 0 0 31 0 0 0 0 9 0 3 17 0 0 81 0 48 0 16 
0 0 0 19 3 0 0 2 20 0 21 0 0 0 0 20 1 0 0 0 18 0 16 8 12 17 2 11 8 14 0 4 0 0 0 0 0 0 16 0 24 5 30 0 36 4 17 0 6 0 0 0 0 0 0 
0 0 8 0 7 0 0 0 0 87 0 0 1 0 37 7 44 4 0 0 0 25 6 0 8 18 9 0 0 0 20 0 20 0 0 17 0 30 0 0 0 0 0 0 0 15 40 6 39 0 24 38 20 72 0 
0 0 37 16 0 17 0 8 0 0 29 0 22 16 0 0 38 17 0 0 23 30 0 21 0 15 50 20 0 23 20 0 8 5 4 0 12 15 8 6 0 0 43 0 60 0 7 23 0 4 19 1 0 19 30 
0 0 13 0 30 1 23 24 6 49 0 2 0 0 43 0 0 0 1 18 11 32 16 0 15 0 9 0 0 13 0 3 0 39 30 26 0 24 19 0 0 4 10 60 25 50 0 0 9 8 2 1 1 3 54 
0 0 0 38 29 1 0 0 34 0 72 0 6 0 33 28 0 0 23 16 29 44 14 39 11 0 25 1 10 0 2 4 0 6 12 4 4 23 26 50 0 29 34 49 3 4 11 26 44 5 0 0 0 0 0 
94 72 0 0 18 45 0 0 11 4 32 41 0 0 38 65 2 26 17 11 0 0 0 6 0 3 16 0 0 6 17 30 0 0 24 17 0 0 9 28 40 5 0 24 22 29 0 62 0 26 111 46 0 27 58 
18 0 0 39 0 0 7 0 19 0 0 9 0 5 0 41 0 6 0 5 8 0 20 26 37 13 0 0 7 4 14 22 12 0 0 0 0 0 0 4 6 15 39 18 53 7 0 6 50 26 0 12 0 3 3 
