55 31
33 0 34 27 18 0 15 40 40 0 15 0 11 0 30 0 20 0 35 16 17 0 38 9 0 1 18 0 21 24 21 0 8 0 2 0 52 0 1 2 0 0 0 0 48 0 32 40 20 0 0 51 13 18 8 
0 0 49 0 0 34 0 13 43 0 0 25 0 0 0 8 23 0 0 0 8 0 0 0 42 3 0 0 30 0 0 33 15 8 1 0 0 0 14 13 0 0 0 0 0 0 0 0 22 10 1 91 17 0 0 
6 0 56 28 33 25 4 0 0 0 0 0 0 6 4 11 0 1 0 15 0 4 9 21 2 0 6 20 41 6 27 23 7 31 21 20 0 0 0 8 19 22 14 6 2 0 52 7 34 1 45 15 1 14 58 
48 0 11 12 27 0 18 0 5 0 26 0 0 16 11 15 20 0 14 19 33 0 3 0 18 19 9 12 10 19 0 35 24 0 0 0 31 0 26 23 0 0 12 4 0 0 19 21 30 1 14 0 18 33 12 
52 27 1 43 0 16 21 0 17 0 0 24 0 0 18 9 30 0 19 7 40 16 11 7 1 10 8 3 33 9 19 15 31 5 11 24 1 0 13 0 0 0 0 0 17 4 58 31 0 66 0 0 76 16 20 
0 28 57 6 17 0 23 3 27 0 26 0 0 0 11 0 7 0 0 28 0 3 0 14 4 11 0 0 0 0 0 19 20 32 18 0 26 2 5 0 32 39 24 0 21 8 0 25 0 0 22 0 18 0 0 
23 19 21 27 19 3 10 0 0 28 6 16 5 3 30 0 6 0 0 0 0 19 0 0 4 0 0 0 0 0 5 0 5 24 9 13 0 0 0 0 0 0 28 0 0 3 0 15 6 0 2 21 0 0 0 
9 28 12 8 5 0 0 0 37 0 0 0 0 16 0 21 16 3 0 5 7 19 0 11 11 25 1 7 4 13 14 9 12 3 0 18 18 10 13 16 32 3 0 19 6 0 22 39 0 21 2 8 8 0 0 
26 0 0 2 14 0 0 0 49 42 0 65 65 0 0 0 13 0 7 0 18 6 21 0 0 0 14 19 0 13 0 4 4 11 0 0 16 1 46 23 0 29 0 11 0 2 0 0 50 10 26 59 0 0 41 
42 4 0 0 9 32 38 0 36 6 0 0 0 0 29 0 11 12 0 0 5 0 0 0 0 0 0 15 0 0 3 0 15 3 0 0 17 29 0 0 0 0 42 0 38 0 37 40 0 14 0 42 0 0 0 
35 26 0 2 12 21 26 0 7 0 0 0 0 0 22 0 0 0 0 10 0 14 26 14 16 51 0 1 3 0 13 9 13 1 34 5 0 14 5 7 24 15 10 31 7 10 15 0 34 8 6 0 0 0 2 
0 5 3 6 17 21 0 13 36 0 8 0 0 34 5 2 0 0 0 4 0 46 0 16 0 22 21 26 21 0 0 5 0 7 0 0 17 0 0 0 0 0 21 0 37 13 50 33 21 31 0 5 31 0 0 
14 0 0 0 43 1 47 0 3 34 0 0 0 13 0 53 0 2 0 0 0 0 0 5 6 27 0 5 0 23 0 0 5 0 25 27 0 0 30 0 0 0 0 0 0 0 0 43 64 16 0 3 50 38 3 
0 4 0 0 0 24 1 7 27 0 0 6 11 0 0 0 0 0 0 34 9 0 0 0 0 20 2 0 0 10 0 0 0 0 16 27 0 0 0 0 0 0 0 0 0 8 0 0 0 0 0 0 0 34 0 
21 29 5 0 0 51 0 0 0 7 0 43 15 0 0 22 0 7 3 29 3 0 0 0 27 0 0 65 10 0 22 5 0 0 0 0 40 0 0 13 35 0 16 10 0 0 0 0 41 1 23 20 15 11 16 
37 0 0 11 0 0 15 0 0 0 0 3 0 0 0 0 0 0 35 0 0 0 0 9 0 0 4 1 6 11 0 0 9 0 4 0 1 0 0 6 11 0 0 13 0 48 0 0 22 3 0 0 0 1 0 
18 10 19 16 8 49 0 0 0 3 8 0 0 21 19 6 23 0 22 49 13 2 0 0 0 3 0 14 23 8 2 20 22 0 12 0 0 8 0 14 0 0 35 4 12 24 5 4 0 0 4 0 35 13 57 
0 0 17 0 31 7 32 37 4 45 0 0 4 12 22 1 79 0 0 23 22 0 17 32 28 0 0 0 0 0 3 31 9 0 0 31 22 0 34 0 0 0 7 0 47 0 25 31 21 33 8 0 28 5 45 
40 0 18 0 6 14 6 0 0 11 18 5 6 36 47 31 33 0 0 16 18 9 30 0 26 0 7 0 18 0 9 0 8 0 0 0 0 0 24 4 0 0 0 7 0 26 0 43 9 6 0 0 2 0 89 
0 0 58 0 0 40 0 25 0 0 11 3 0 0 3 13 0 17 0 13 3 11 32 0 0 12 0 0 14 22 0 12 15 11 1 13 19 0 0 5 0 36 16 0 0 0 0 0 5 0 0 0 0 0 32 
54 13 0 0 18 48 12 18 0 13 13 0 0 9 0 0 0 0 27 0 0 26 3 20 2 8 0 0 18 28 20 0 25 15 14 14 0 13 0 0 0 8 10 10 48 44 0 0 6 22 4 0 3 22 0 
0 49 30 0 18 0 27 24 34 0 41 0 0 0 0 24 13 7 46 0 2 1 18 1 8 0 18 14 47 0 0 24 25 27 4 0 18 5 0 22 32 35 0 0 0 37 18 29 11 0 49 7 0 31 0 
28 22 0 0 21 50 2 0 10 0 2 16 11 16 12 0 0 0 0 1 6 0 21 11 0 2 23 61 0 16 0 0 0 4 0 18 0 13 43 13 0 0 17 11 39 18 26 0 10 23 0 12 7 0 28 
41 0 27 26 0 30 38 20 0 4 0 10 0 26 0 9 45 0 0 6 13 0 6 0 0 0 0 34 0 29 3 0 25 31 21 14 14 24 6 8 5 52 47 4 38 30 0 0 0 14 0 15 0 0 0 
31 58 30 42 29 11 6 13 2 6 10 15 1 0 0 0 15 0 0 12 0 11 0 0 0 0 25 26 0 24 0 43 56 0 0 0 0 0 17 12 0 70 31 0 11 55 13 0 3 48 0 4 11 21 0 
18 46 1 1 39 16 43 14 1 0 41 31 6 4 0 6 9 27 18 2 19 31 10 9 30 24 0 16 1 0 27 0 20 0 25 18 0 0 17 0 20 19 29 0 6 0 35 0 22 0 4 2 44 7 30 
0 0 12 0 12 19 23 0 0 0 16 17 0 0 2 0 40 65 0 0 1 2 0 1 19 2 34 19 0 9 0 14 26 0 16 24 15 20 0 23 0 6 8 26 35 19 0 11 3 0 0 0 0 42 0 
40 0 0 13 25 4 37 74 5 0 30 0 1 0 26 16 29 0 0 0 0 0 0 0 0 0 12 0 0 17 21 11 40 1 14 0 0 25 0 0 70 0 17 5 0 17 0 0 7 8 1 0 38 0 25 
0 0 12 33 13 9 10 0 2 0 0 0 0 0 2 13 0 10 69 0 1 3 0 6 0 19 0 0 28 0 0 0 0 26 43 0 15 0 2 36 12 43 0 24 12 0 0 13 0 13 0 0 12 35 11 
38 0 10 36 0 0 0 18 34 0 43 0 14 26 23 22 0 0 0 7 0 16 14 0 10 18 0 5 0 0 0 12 16 0 59 0 60 19 0 62 8 0 58 0 0 0 0 18 3 13 13 0 22 43 0 
10 21 0 7 0 0 12 0 23 0 13 0 0 15 12 0 29 4 7 0 0 0 21 0 36 1 1 14 0 0 0 0 0 0 0 0 0 0 0 7 0 9 16 4 0 15 0 4 0 0 0 27 0 0 0 
