55 31
29 53 50 9 0 19 0 3 31 3 15 7 55 24 0 0 0 0 17 0 15 9 0 29 13 20 0 28 5 37 6 20 10 12 19 15 0 62 0 31 0 17 0 28 0 33 12 0 0 0 0 0 68 15 25 
35 0 32 0 21 12 51 0 0 2 35 0 13 0 26 0 0 42 31 7 0 23 0 23 14 16 39 0 0 16 28 0 26 1 16 17 3 0 49 0 14 23 0 27 5 50 13 30 0 0 29 5 4 0 28 
19 0 0 50 36 16 0 0 11 15 6 0 67 0 10 9 4 0 0 19 0 9 0 0 34 16 32 0 0 14 0 30 38 0 6 4 0 0 0 26 0 30 0 16 0 1 0 1 7 25 0 0 46 9 0 
27 0 52 0 10 18 0 0 44 41 0 0 0 0 0 0 0 12 0 19 34 0 0 8 32 7 0 16 0 0 35 25 0 6 0 0 0 13 6 0 27 1 0 0 78 20 1 46 0 2 31 0 49 0 6 
0 97 12 38 0 0 47 0 0 0 0 0 0 1 33 32 0 0 9 0 0 6 15 0 0 11 0 24 0 2 0 22 2 16 0 3 0 9 0 0 24 0 13 0 0 1 0 12 0 2 0 18 0 7 14 
0 14 15 7 0 12 18 18 0 15 0 105 0 0 0 20 25 0 0 4 0 0 6 4 3 25 0 0 0 6 0 0 1 0 42 20 14 22 0 0 0 0 0 0 16 16 0 10 0 8 61 4 0 19 46 
0 0 51 1 34 0 0 0 0 11 29 0 0 0 50 0 4 24 5 30 29 17 16 0 15 0 19 0 9 0 16 0 0 3 0 0 3 2 45 26 2 1 26 18 10 23 7 0 35 14 15 13 0 53 10 
0 33 12 7 33 0 0 0 0 0 37 40 21 0 10 35 12 0 0 0 1 0 2 0 0 0 17 7 0 13 0 6 6 2 33 6 42 39 0 0 0 0 13 15 0 0 0 37 33 0 35 0 7 12 27 
7 0 107 62 25 2 0 0 0 51 42 6 34 5 47 1 9 23 0 0 0 9 26 2 8 0 0 0 1 31 0 0 22 16 39 26 0 22 0 37 82 0 0 29 20 7 0 0 2 27 7 49 89 4 22 
0 52 0 42 0 7 0 0 0 0 10 0 66 0 75 18 0 55 26 2 2 3 7 0 5 10 6 13 1 5 10 0 0 9 13 12 0 0 16 27 0 0 9 0 22 47 5 0 19 0 0 83 38 88 0 
9 51 0 6 0 11 47 0 0 0 0 1 40 0 9 0 0 16 0 0 0 2 0 9 2 20 11 1 0 12 0 0 10 10 16 0 0 0 27 22 0 0 0 0 0 21 0 0 15 5 4 0 11 67 0 
20 6 0 0 8 23 21 31 0 12 0 3 19 10 5 0 0 0 0 16 39 0 6 24 11 19 14 26 0 25 21 10 40 6 0 24 0 7 13 0 18 1 14 43 19 0 9 16 0 11 21 13 13 12 13 
0 0 51 7 0 30 20 0 10 41 44 29 30 0 29 6 6 0 7 0 17 5 7 0 3 11 24 17 26 5 1 0 8 4 0 30 0 0 0 6 29 0 6 30 0 0 0 0 38 0 43 46 2 0 0 
15 2 0 9 0 0 40 0 15 12 0 32 36 0 5 13 15 1 16 0 0 0 9 34 3 4 0 3 0 0 4 0 42 0 13 9 0 0 3 0 13 0 19 0 0 0 60 0 36 45 0 2 0 1 0 
0 39 0 1 10 0 0 0 15 0 0 1 9 0 10 0 0 0 0 6 8 0 0 24 0 6 18 16 0 6 0 0 0 7 0 6 0 0 15 0 49 0 0 24 28 0 18 0 0 0 4 11 7 12 10 
69 0 0 46 0 8 0 2 0 2 0 18 13 40 26 7 14 0 9 25 0 2 45 21 9 41 8 0 6 6 8 0 1 16 19 2 0 7 10 0 2 8 31 13 11 8 7 61 35 27 38 38 7 52 0 
15 22 0 30 0 82 17 0 2 0 0 0 2 0 8 0 30 0 0 25 0 19 25 15 19 10 25 12 0 5 0 22 0 40 0 0 31 2 11 2 14 0 0 17 25 0 30 0 4 0 57 0 4 22 0 
0 0 0 28 0 12 0 41 4 14 0 0 0 21 54 0 15 0 26 9 1 11 0 0 0 0 0 28 0 0 0 18 0 0 21 11 22 30 29 1 0 17 0 5 0 17 0 20 0 0 41 0 0 7 0 
0 22 0 34 0 0 0 14 0 18 12 5 0 0 35 25 6 0 0 0 0 9 0 22 0 0 0 12 0 6 0 0 0 44 19 4 0 34 17 5 0 6 9 16 0 0 0 40 10 46 3 3 3 5 17 
0 14 41 17 28 0 0 9 0 0 0 8 0 0 4 10 0 0 0 14 5 20 0 13 0 17 28 7 5 6 10 0 28 5 0 12 14 0 0 2 3 0 0 41 0 34 0 14 0 0 0 0 0 50 0 
0 0 15 1 0 0 0 1 0 9 0 0 0 0 9 0 0 7 25 0 23 3 0 0 0 0 0 25 8 6 23 0 23 2 0 0 0 0 0 0 0 12 22 17 0 0 0 0 0 21 0 0 25 11 0 
7 0 0 0 0 0 0 0 42 0 0 0 0 0 0 0 0 0 3 0 13 30 0 2 15 0 0 0 0 14 0 0 9 8 5 26 0 0 0 15 0 41 6 0 16 21 0 0 21 11 66 0 4 0 0 
19 0 0 13 21 11 4 39 39 0 0 0 22 23 5 12 11 0 29 0 15 0 9 0 15 0 0 0 0 0 0 0 8 18 35 0 23 29 0 0 0 0 0 0 21 0 39 6 0 11 0 0 21 5 0 
0 38 84 0 0 13 0 0 40 30 16 25 0 0 12 0 3 5 35 11 12 0 25 3 15 18 2 20 9 0 7 0 24 0 0 3 10 17 0 38 0 32 0 0 20 14 0 0 0 26 0 64 21 35 31 
18 20 0 0 12 43 0 0 0 0 39 0 0 24 9 9 31 0 32 0 5 7 23 20 48 3 15 0 3 0 10 19 4 76 0 0 4 1 1 1 8 6 0 18 0 21 0 0 25 39 0 18 28 12 13 
0 0 0 0 0 27 0 41 17 2 0 0 13 0 20 0 0 0 0 20 0 0 3 18 0 23 14 0 18 0 0 0 21 15 0 0 0 16 16 20 8 0 0 36 30 0 18 10 8 0 81 11 15 18 0 
2 0 30 0 0 0 2 50 0 18 0 0 8 12 17 0 3 0 0 12 8 0 6 10 30 12 19 9 25 1 1 0 14 0 29 3 0 26 0 2 13 50 0 0 30 30 13 0 0 0 21 44 7 27 30 
0 0 5 0 0 0 2 5 29 12 0 27 27 0 0 0 0 25 0 21 0 0 0 19 0 0 2 22 0 0 0 0 7 0 0 0 15 7 0 0 0 0 10 0 0 10 0 0 3 54 22 12 25 0 22 
0 0 0 20 0 0 15 6 6 25 0 11 64 19 10 4 21 31 0 43 25 14 8 17 16 0 0 0 20 0 0 0 13 16 3 25 23 0 0 26 12 22 23 30 20 5 22 24 32 20 11 0 17 3 11 
29 25 0 0 27 6 2 18 0 17 0 6 0 0 44 10 44 34 16 34 10 0 0 21 0 0 42 6 0 0 0 0 14 8 21 16 0 0 15 0 13 15 0 14 5 26 0 4 0 49 34 34 0 13 7 
15 15 14 0 0 0 0 28 0 17 28 16 0 9 27 0 24 0 27 0 6 0 0 0 0 65 0 69 0 9 0 19 15 15 0 21 17 18 0 0 26 6 27 23 31 44 0 3 41 0 50 0 16 0 25 
