55 31
0 0 21 0 0 9 0 0 5 10 29 0 14 0 12 7 30 68 0 0 19 23 1 40 0 4 51 12 12 0 3 0 17 31 6 0 1 9 0 0 0 0 35 0 12 61 47 0 31 16 0 65 0 0 49 
47 21 18 0 38 0 0 17 26 39 23 0 19 0 0 0 0 0 0 0 0 0 0 1 6 0 0 19 0 0 39 34 0 0 14 0 18 9 0 0 0 41 32 3 0 0 1 3 51 0 3 16 0 0 5 
51 0 0 9 26 33 0 4 0 19 0 44 20 0 12 0 1 28 0 27 0 0 17 0 0 0 12 0 25 3 39 24 0 10 0 18 18 37 0 17 0 0 0 13 27 20 0 21 0 12 23 14 1 45 7 
0 25 20 1 46 0 4 0 0 0 0 9 0 1 6 0 0 0 22 8 0 0 31 0 0 20 0 10 27 0 0 0 15 0 3 31 0 25 15 0 22 10 0 0 10 0 0 28 11 4 0 5 0 79 1 
0 0 0 47 0 24 0 8 27 0 0 41 6 2 61 0 0 35 31 0 0 9 1 17 14 6 12 6 25 4 0 17 0 0 0 0 0 0 9 85 0 0 2 37 21 0 0 12 21 31 36 4 14 13 51 
0 2 20 0 43 19 30 12 5 2 42 26 66 0 14 12 10 0 3 0 3 28 18 0 15 20 0 18 0 3 0 22 12 1 0 29 0 0 0 0 18 0 0 0 32 0 1 78 8 28 0 0 42 1 0 
7 10 32 5 40 21 0 30 0 0 48 1 9 0 6 0 20 0 0 0 42 0 0 2 0 0 27 10 0 0 32 21 7 1 9 0 0 10 15 9 14 0 9 13 6 35 19 17 9 0 0 0 12 0 29 
6 0 0 9 0 0 48 0 5 0 4 0 6 2 0 0 0 0 25 4 0 10 24 14 0 0 0 0 0 21 0 0 0 0 0 22 16 0 0 10 0 0 7 22 15 0 33 3 42 0 0 0 0 0 21 
0 0 38 0 10 71 40 0 4 11 0 0 56 0 0 6 0 0 16 0 0 12 17 0 19 19 0 3 0 0 0 3 0 23 13 0 8 15 0 6 38 0 0 0 30 0 81 1 0 0 0 0 0 0 42 
0 9 21 0 44 0 0 0 49 5 19 0 4 12 7 0 10 0 18 20 19 0 3 3 11 2 23 26 18 0 0 44 0 0 15 0 11 0 16 9 15 0 7 39 0 0 13 39 0 10 0 43 32 0 88 
0 49 85 6 22 2 21 0 0 35 20 1 7 18 9 1 24 22 14 16 3 13 12 27 0 15 3 17 24 0 0 2 0 13 16 32 24 2 19 4 35 0 40 10 1 0 0 24 0 0 82 47 0 0 84 
0 0 0 10 12 0 25 0 0 0 2 6 0 0 0 0 19 33 47 12 12 0 0 0 8 0 0 2 0 2 0 40 0 15 0 34 2 0 14 30 0 6 0 0 0 17 7 0 2 33 0 2 0 18 0 
30 17 35 0 30 50 0 18 0 0 0 36 0 20 0 0 0 35 0 21 0 6 0 0 5 0 32 0 0 22 41 18 15 48 22 0 0 40 6 0 21 0 17 22 12 0 17 11 18 0 35 0 35 48 7 
0 68 40 30 0 0 10 38 3 5 0 24 0 14 11 17 0 0 27 0 11 24 0 0 0 13 0 28 36 0 1 7 0 20 0 0 0 1 14 2 0 2 36 47 0 65 31 19 48 26 30 0 0 22 48 
34 0 2 0 13 9 30 12 0 8 0 29 34 0 9 0 20 12 6 0 3 0 5 0 17 0 18 0 2 0 21 0 0 0 43 0 9 0 0 27 18 0 0 5 7 3 0 3 15 13 0 13 0 0 4 
0 0 0 0 18 25 48 10 0 0 0 0 7 10 0 0 3 24 0 0 0 2 18 19 12 31 0 8 0 5 25 0 0 13 0 8 13 0 1 3 0 26 28 0 0 8 8 0 2 13 44 26 0 0 0 
0 0 12 0 0 0 6 66 19 61 0 28 0 13 0 0 0 0 32 32 0 18 11 27 6 0 13 22 0 5 23 13 0 0 2 12 8 26 0 19 10 0 15 3 0 0 9 0 0 0 7 0 43 0 0 
0 49 0 0 3 3 10 8 26 44 0 28 0 0 4 0 7 0 0 1 13 10 14 8 4 3 0 0 0 0 0 24 0 9 3 0 0 17 10 4 3 0 0 3 0 0 0 3 0 4 42 0 13 4 0 
0 21 12 9 10 10 0 53 0 0 0 17 14 0 22 0 0 28 11 0 5 0 21 1 42 0 55 20 0 2 18 25 30 0 12 17 15 5 16 0 0 0 0 5 4 28 31 0 18 0 0 1 11 0 22 
45 0 10 0 16 1 6 0 2 0 0 0 38 37 3 0 30 0 16 19 17 0 0 0 0 23 26 14 25 0 0 16 4 11 0 0 10 0 0 14 3 0 0 7 0 0 30 0 0 0 68 0 0 10 26 
0 0 27 0 0 19 18 0 0 2 3 81 1 47 11 15 24 23 15 11 6 0 0 0 29 11 13 18 14 16 0 4 0 5 7 0 11 7 19 12 20 0 26 3 2 34 20 23 0 1 0 0 0 2 0 
0 53 20 35 50 9 0 0 0 41 0 0 17 0 9 0 15 31 0 23 8 21 0 6 4 19 0 0 23 0 0 45 31 26 0 0 11 0 25 55 0 39 21 0 9 5 8 11 44 47 2 20 2 15 102 
0 21 2 0 0 19 0 18 18 0 0 0 70 0 0 22 0 0 0 2 20 0 12 45 5 0 0 0 8 0 0 19 0 0 3 5 34 0 0 0 5 6 37 0 13 50 23 6 0 4 0 0 17 2 31 
32 51 30 0 12 21 7 40 41 0 15 0 58 12 0 0 18 0 0 21 4 14 0 14 5 20 21 0 0 0 20 19 96 13 0 41 16 6 22 9 39 0 33 0 0 8 0 2 0 10 11 39 95 0 0 
51 0 30 23 0 10 0 0 0 0 23 0 0 12 0 11 1 0 0 2 22 18 0 0 0 0 23 0 5 20 0 0 27 12 0 16 5 0 0 14 1 0 22 11 0 0 0 14 0 4 27 65 2 0 0 
0 0 0 0 0 12 0 8 68 39 36 13 31 10 18 28 0 20 9 5 0 19 0 11 14 9 0 18 0 0 25 0 38 0 20 0 4 43 25 31 17 14 0 15 0 10 25 37 22 0 23 0 0 0 0 
0 78 0 0 0 44 0 12 0 0 0 0 3 0 8 0 2 0 0 0 0 0 0 29 0 17 0 0 0 0 25 20 8 0 0 3 0 6 24 0 24 7 28 0 0 1 65 46 16 40 0 2 52 0 23 
0 18 17 0 0 9 0 0 15 7 28 7 4 14 35 13 10 1 16 5 0 0 6 32 31 0 0 26 24 0 0 22 0 31 0 8 13 0 55 19 0 0 0 8 0 4 0 0 0 4 36 0 0 0 27 
54 0 12 39 0 24 0 5 0 32 0 0 25 4 0 1 15 1 0 0 4 31 0 6 4 0 0 10 21 8 0 9 0 11 7 0 34 21 0 0 14 32 39 0 6 8 10 13 13 0 0 0 0 7 75 
0 38 0 0 13 27 16 37 0 0 0 24 11 0 25 19 24 25 0 27 0 29 21 15 0 0 17 0 25 25 26 13 0 0 0 25 0 1 16 20 52 0 0 22 41 0 21 0 4 0 0 0 0 26 25 
0 0 44 0 32 1 0 15 6 0 20 27 0 9 22 27 70 0 0 5 35 0 6 30 0 30 30 0 0 0 0 18 19 22 11 0 3 5 27 0 32 0 27 0 1 12 0 0 46 17 0 3 16 0 0 
