55 31
46 0 2 26 42 24 0 11 3 91 19 10 33 16 16 38 4 12 0 7 24 11 11 19 3 15 0 28 29 1 18 21 11 0 40 9 13 20 11 9 3 31 0 3 27 3 17 27 0 15 0 14 18 60 45 
38 24 2 0 51 0 11 0 11 31 0 0 0 2 9 0 0 11 5 29 2 0 4 5 32 0 15 0 0 0 0 0 0 5 0 0 3 17 0 13 40 8 0 0 0 6 7 35 3 0 28 0 0 0 30 
0 37 2 0 4 12 0 0 0 0 0 0 2 52 9 0 0 12 0 15 0 18 16 14 5 0 0 0 22 15 0 9 0 0 0 0 28 0 8 14 9 0 0 7 0 0 0 0 10 0 61 0 4 0 0 
0 0 0 9 0 32 0 0 0 0 0 0 0 2 11 0 13 3 0 22 0 58 0 0 11 25 0 1 29 0 11 11 0 0 0 23 0 32 10 23 0 0 0 18 0 0 0 0 10 0 29 0 0 0 33 
0 22 0 16 0 18 26 0 0 23 0 0 0 0 0 44 0 0 0 25 0 0 5 2 0 0 0 7 4 0 4 0 26 14 22 0 0 0 12 4 0 0 0 24 46 31 37 0 0 0 0 1 1 8 0 
0 1 0 4 0 0 0 18 5 0 0 0 22 5 55 0 22 0 0 0 0 0 6 0 0 57 0 25 0 0 17 18 3 0 0 0 11 1 5 0 0 17 28 0 0 0 0 17 11 25 2 0 0 28 20 
52 21 7 0 24 0 18 0 0 7 20 24 0 13 31 19 0 0 14 0 3 20 9 0 1 0 0 17 0 7 0 0 8 0 19 0 29 0 0 7 0 0 0 3 5 0 22 34 0 26 0 6 43 0 0 
0 26 39 23 49 7 13 0 0 0 0 21 31 0 0 10 4 1 13 21 17 19 0 33 31 10 0 4 4 0 29 0 0 5 0 0 0 13 5 3 17 14 3 30 0 21 0 0 0 0 7 0 9 49 0 
0 0 3 6 0 10 25 2 0 28 18 0 31 12 30 9 3 1 19 27 0 0 31 22 14 30 0 0 4 24 0 0 15 8 3 11 30 19 24 55 0 0 5 30 0 42 53 0 21 13 0 13 8 0 21 
0 13 5 10 33 1 20 0 30 3 19 48 22 23 18 20 29 36 0 8 30 30 4 15 7 0 5 12 20 0 8 10 9 23 2 70 2 29 7 37 1 85 38 0 42 4 9 2 28 0 34 0 0 47 46 
53 0 0 0 18 4 25 24 0 0 18 3 0 0 30 0 0 0 0 10 0 0 26 7 0 0 0 0 1 0 0 17 0 0 0 1 0 0 7 7 0 1 0 15 0 0 0 0 48 16 0 0 10 0 0 
0 0 0 18 0 0 0 77 0 0 0 69 5 30 22 0 4 13 0 6 14 16 5 2 0 14 13 13 2 0 0 0 5 0 17 2 2 2 24 0 0 3 0 0 24 18 11 10 0 0 0 55 0 42 40 
51 9 2 14 24 67 0 19 3 0 32 0 0 1 7 0 0 13 4 3 7 0 25 18 0 8 17 0 0 0 0 26 0 11 4 0 6 0 4 0 0 0 16 1 0 38 5 0 0 32 0 50 0 0 52 
38 0 29 1 7 37 5 32 0 0 4 28 0 11 0 0 0 0 19 13 0 3 0 0 8 0 0 12 0 0 0 44 25 0 0 2 30 0 51 41 0 0 37 0 7 0 0 0 0 0 0 17 0 0 6 
15 41 43 2 12 48 15 0 0 65 0 0 30 0 7 25 12 29 8 10 8 15 2 52 7 0 0 27 12 0 0 18 21 7 33 0 24 5 0 0 14 0 0 0 27 7 0 0 0 26 17 2 15 119 0 
0 0 0 0 14 0 0 0 17 0 0 12 10 0 0 0 0 3 0 9 9 0 0 27 11 32 0 9 9 0 0 0 0 0 0 21 0 16 0 0 0 0 0 0 0 0 0 14 0 0 0 0 0 6 3 
87 2 0 10 0 16 0 72 41 24 0 9 0 16 30 0 0 0 0 0 22 25 9 0 0 0 2 0 14 16 0 0 35 51 7 0 5 0 10 14 0 7 22 0 0 16 7 0 16 41 14 0 8 46 54 
8 3 0 0 0 0 0 0 12 0 0 11 33 15 11 30 0 0 0 0 41 0 18 7 0 0 0 0 9 0 0 0 0 0 0 1 1 20 10 15 0 21 0 0 0 13 0 7 0 0 0 29 0 0 16 
0 52 0 52 47 13 31 3 0 14 29 26 0 0 0 26 0 0 13 5 12 0 17 0 5 35 28 0 15 0 20 3 22 10 18 8 6 26 5 20 0 17 20 48 0 0 0 0 8 0 22 47 0 10 28 
24 0 42 5 12 0 0 45 0 0 37 0 0 12 1 2 1 10 0 0 7 0 0 0 16 8 18 0 10 1 26 0 8 18 14 0 0 0 14 17 0 0 38 0 17 9 0 2 14 0 0 0 109 0 6 
0 0 0 0 11 16 0 0 0 8 41 16 0 0 34 18 5 0 5 5 20 7 12 8 9 29 0 1 0 1 0 0 0 9 0 12 9 0 18 0 20 0 0 0 0 0 21 6 0 0 0 34 10 39 0 
50 42 31 28 0 61 36 0 0 4 4 7 0 12 24 0 0 0 0 0 25 20 15 14 0 0 19 0 11 14 0 58 10 0 0 18 8 5 0 17 0 6 13 32 27 21 12 0 0 2 50 48 0 43 8 
0 14 71 0 36 66 0 1 0 0 3 8 0 11 0 6 14 0 20 0 0 17 10 0 6 0 0 19 12 0 3 0 41 13 0 8 24 0 3 0 14 12 0 7 0 15 11 0 2 3 0 29 47 23 0 
0 15 54 31 0 1 11 0 0 0 10 9 27 28 13 0 0 25 0 1 0 0 20 0 14 3 0 0 13 1 9 17 18 0 26 0 17 5 18 32 0 41 18 0 2 0 0 3 0 0 45 7 1 35 0 
0 33 0 5 27 6 18 26 0 0 15 8 7 11 23 8 24 17 0 32 0 1 0 0 39 8 13 9 13 0 24 30 0 0 62 30 26 0 24 0 0 17 1 0 0 9 0 0 0 4 0 0 0 0 29 
48 24 1 47 1 1 42 7 0 24 0 38 1 0 6 0 8 11 0 0 0 5 10 0 24 0 26 7 18 0 0 2 0 0 0 7 23 28 26 0 0 38 0 21 0 0 17 0 18 54 43 0 26 10 20 
3 22 1 47 77 0 0 24 0 0 0 74 5 80 20 3 0 0 6 16 8 0 0 0 0 0 14 0 0 0 0 1 7 0 0 11 0 0 0 7 0 0 29 0 5 0 0 0 25 4 46 3 41 0 0 
0 0 34 0 0 62 0 0 0 0 0 18 5 0 1 8 27 3 11 7 25 0 0 8 6 8 0 0 0 0 0 5 11 0 0 26 1 31 0 7 0 22 3 0 0 25 19 0 0 0 0 0 0 51 0 
5 24 30 10 4 5 0 26 0 23 0 4 0 4 0 2 0 21 0 47 0 25 23 0 0 32 0 3 0 0 0 0 38 26 7 0 14 27 21 3 1 2 0 21 9 11 0 7 0 0 14 32 0 28 0 
0 0 6 39 1 13 12 0 12 0 0 29 0 13 0 13 20 42 25 5 0 0 21 15 33 0 6 0 13 10 16 0 23 3 0 0 13 0 11 23 16 38 0 0 3 10 0 35 21 45 0 0 20 13 7 
0 45 3 26 0 35 3 36 0 7 1 14 82 24 16 20 72 9 44 0 12 26 19 7 0 17 20 2 10 0 35 17 8 15 0 0 0 0 12 12 14 6 17 9 0 33 17 25 0 0 32 39 38 21 15 
