55 31
17 16 45 2 0 12 0 24 100 0 60 33 0 41 17 0 31 19 13 0 10 22 16 0 0 8 18 47 18 24 30 25 0 0 29 4 13 0 0 17 22 8 0 11 23 0 18 14 0 9 11 34 0 14 62 
0 0 0 0 0 29 29 15 22 0 26 0 55 0 40 36 35 0 0 19 0 14 16 18 9 9 0 0 0 3 22 0 9 0 0 68 26 0 0 0 0 0 0 20 6 0 0 35 6 0 2 42 0 28 0 
0 0 46 19 32 10 14 57 46 21 6 52 1 7 3 24 0 3 16 60 3 5 5 2 9 0 0 0 0 14 0 26 10 9 42 8 2 0 25 13 6 12 36 9 51 25 15 2 41 2 2 0 46 33 36 
33 32 0 0 27 0 3 10 0 0 13 0 20 18 0 14 4 34 0 3 0 7 1 30 0 20 22 27 0 4 0 22 20 10 34 0 23 10 2 0 18 0 23 0 18 0 0 4 0 0 33 50 0 4 0 
0 0 0 0 0 0 22 1 35 42 0 17 0 6 37 9 9 0 1 2 0 15 0 0 0 0 19 12 0 3 24 19 0 15 0 0 14 0 29 23 0 0 0 40 0 6 0 0 5 0 7 37 0 0 18 
0 16 0 0 0 0 45 0 0 3 28 0 7 20 31 18 1 8 9 15 0 9 4 6 0 17 4 0 11 23 43 13 0 17 18 0 24 0 3 30 0 0 0 0 17 0 0 0 3 2 31 0 0 13 72 
19 16 0 0 32 0 15 0 0 0 0 39 0 34 17 49 0 19 0 18 0 29 0 0 0 0 33 0 13 33 4 0 0 22 0 5 0 0 0 11 5 0 4 0 26 0 14 2 0 0 23 7 0 0 43 
0 114 20 0 89 7 4 42 11 0 33 3 15 18 0 0 2 5 0 0 36 12 25 28 8 0 2 28 17 0 44 26 0 25 1 3 8 10 32 0 30 0 0 33 40 5 5 27 6 51 0 15 0 35 23 
0 7 17 0 13 0 7 6 0 0 54 0 0 0 0 0 14 0 32 0 15 11 0 0 17 0 15 10 7 0 7 0 0 0 0 0 34 10 0 4 0 15 24 0 6 0 0 0 25 0 8 0 0 0 0 
0 29 7 0 2 0 38 0 30 0 0 35 10 21 0 29 0 0 0 13 0 20 4 0 0 0 4 16 0 0 13 0 11 0 19 0 0 15 17 0 0 24 36 0 29 0 0 0 0 0 12 29 0 23 0 
33 4 29 0 46 0 6 14 54 13 0 14 0 2 26 18 0 0 0 0 0 6 7 0 24 9 0 21 24 0 0 29 0 2 0 11 0 0 0 16 26 37 0 0 0 40 0 10 12 31 0 16 0 0 0 
22 0 33 31 0 39 0 0 0 0 34 7 45 26 7 7 13 0 0 0 42 17 28 0 0 0 12 0 7 0 0 0 0 24 49 17 0 0 0 16 5 0 0 0 6 0 0 0 0 29 0 0 0 14 18 
0 24 20 42 0 8 62 10 35 0 11 0 5 34 13 4 0 11 16 6 0 0 20 0 6 13 20 1 17 3 0 0 0 19 16 0 28 16 10 0 4 28 32 37 28 54 15 0 17 7 0 4 0 28 0 
0 0 16 33 1 35 13 4 0 0 31 8 1 0 27 8 53 0 44 15 0 23 18 7 9 0 30 6 0 0 3 20 15 0 0 0 41 0 0 2 18 40 0 0 16 0 0 12 0 16 0 35 76 2 6 
0 2 0 0 1 1 36 1 0 0 33 0 2 0 4 26 44 11 5 0 4 0 0 0 2 0 10 0 0 23 24 0 0 8 12 11 0 0 0 0 0 34 0 35 20 0 31 0 0 0 0 0 0 0 0 
1 0 0 0 2 43 30 89 0 24 14 14 41 20 30 35 0 12 0 6 0 20 36 0 27 12 18 5 4 0 26 3 11 92 0 31 0 0 0 35 0 0 3 59 69 0 0 37 5 0 63 17 45 61 0 
5 49 29 0 33 0 6 71 9 60 0 13 1 0 4 34 9 6 27 36 20 0 9 1 17 25 41 2 26 32 11 3 10 4 2 13 6 43 0 11 48 1 35 10 37 49 12 42 15 26 81 4 43 7 2 
6 0 51 0 0 0 0 7 0 55 3 35 21 0 6 0 0 24 0 0 3 13 7 0 10 0 0 0 0 0 0 0 0 24 0 0 0 10 0 11 7 0 0 0 0 8 31 0 1 75 0 42 0 8 0 
0 0 2 5 0 0 0 0 0 24 7 7 7 0 17 1 1 7 2 6 2 2 0 9 4 10 0 2 16 12 0 0 0 24 0 0 0 12 0 3 0 9 0 7 16 0 1 0 0 0 2 0 2 16 0 
0 0 16 34 25 0 0 4 0 0 0 20 10 0 0 0 0 13 5 50 0 0 0 0 0 0 35 0 7 36 50 0 0 2 0 0 33 6 36 0 16 0 0 24 0 0 0 21 37 16 0 14 0 0 46 
0 0 0 17 41 0 0 0 0 8 4 19 19 0 0 0 2 22 35 31 17 29 19 0 7 0 0 0 0 0 19 42 0 0 13 0 1 31 0 4 8 0 7 6 0 20 6 6 8 0 29 0 3 35 18 
20 3 0 21 37 24 38 0 35 0 32 9 35 25 22 0 12 0 0 0 19 27 20 0 0 0 0 32 0 0 0 0 15 6 6 10 30 6 33 35 20 0 0 92 14 40 0 15 35 21 11 0 10 33 11 
0 0 0 18 0 0 7 0 49 20 8 0 8 0 4 6 41 37 18 0 12 29 0 9 0 0 0 0 0 20 7 0 0 5 1 0 12 10 0 0 0 20 1 27 7 37 0 0 12 3 0 0 0 0 37 
4 14 0 0 8 21 0 12 0 34 5 0 29 14 0 14 18 0 0 19 0 21 0 0 0 20 35 11 0 0 18 0 0 20 0 0 6 0 0 0 0 29 5 0 0 0 3 17 6 23 0 0 1 9 0 
0 17 0 5 0 0 22 20 29 28 0 15 8 0 47 66 1 0 21 4 9 6 22 2 0 0 8 0 11 9 0 24 0 6 16 0 0 41 0 28 6 19 0 2 5 12 28 12 0 1 0 0 6 38 40 
0 11 12 0 0 10 36 0 0 0 4 0 0 38 0 22 20 11 26 0 0 0 4 0 15 0 41 0 0 0 0 2 0 0 0 15 12 22 6 0 0 0 0 0 20 0 40 0 0 15 0 0 0 0 0 
0 0 0 0 39 24 6 9 26 38 0 10 0 4 4 0 21 4 0 0 7 0 22 19 0 0 0 0 0 0 9 27 0 0 0 25 30 0 3 25 0 0 0 0 22 0 7 38 0 2 0 15 14 11 0 
33 17 2 0 0 6 40 0 17 0 0 26 5 0 0 0 0 11 15 0 4 0 18 22 13 0 0 15 3 21 24 2 0 46 0 36 0 40 25 0 5 36 7 0 12 7 16 39 0 0 21 1 0 0 24 
44 21 20 38 0 0 12 4 0 39 3 0 9 7 15 6 0 0 0 13 2 9 13 14 23 17 7 0 0 0 24 1 28 29 22 0 1 13 0 0 0 38 17 0 22 0 8 0 0 0 2 1 1 19 8 
15 0 14 0 13 0 13 0 0 0 0 0 13 0 27 46 0 12 16 9 10 0 4 0 0 13 7 0 22 11 10 12 22 7 27 26 53 0 3 17 0 0 11 8 34 30 0 0 4 16 0 0 0 23 96 
0 0 9 0 9 29 0 42 0 29 56 9 8 0 7 0 16 0 0 33 0 33 12 29 5 0 0 30 3 6 23 40 16 0 0 0 0 0 4 6 12 0 0 0 9 6 36 4 0 42 0 25 6 34 23 
