55 31
32 0 0 0 13 0 0 28 0 0 0 15 0 0 0 0 0 0 0 35 0 12 1 10 16 0 10 0 37 0 0 0 36 0 19 24 27 0 6 11 16 13 0 0 40 0 13 16 0 0 0 0 24 0 32 
0 32 27 0 38 13 0 3 0 0 15 0 60 0 15 23 0 10 23 5 1 1 6 31 10 29 22 26 0 0 0 5 27 0 6 14 2 10 13 1 7 9 8 1 20 33 0 46 8 0 30 49 0 31 0 
5 0 0 27 0 0 0 0 43 4 0 4 15 0 21 31 0 0 3 18 35 0 5 24 28 7 0 23 0 0 7 0 27 15 0 0 4 7 20 1 4 9 27 3 19 0 0 0 0 4 0 63 0 33 0 
11 46 5 5 0 45 6 1 4 19 16 0 0 0 0 41 25 5 27 0 0 10 3 0 0 0 51 5 16 24 11 5 16 7 0 2 29 0 8 20 0 25 12 25 3 43 14 0 0 0 24 45 20 2 0 
64 3 41 0 6 11 35 27 0 25 31 16 7 0 0 26 12 0 11 0 4 33 0 0 22 18 0 23 16 29 63 31 2 0 0 0 0 0 0 0 0 39 0 0 0 15 14 6 0 0 81 26 0 6 37 
0 0 20 7 32 25 0 21 0 22 44 5 0 0 21 0 6 19 24 31 2 0 20 3 0 0 17 8 1 7 2 0 24 6 0 13 21 30 14 29 24 0 14 7 41 0 0 0 0 23 41 0 43 0 35 
0 0 47 13 0 3 0 5 6 0 32 0 5 0 0 0 6 0 0 0 0 10 6 10 27 0 9 0 12 4 0 0 0 3 0 3 0 24 0 0 12 0 21 0 21 0 11 0 0 47 6 25 0 0 0 
5 0 18 0 30 0 0 0 1 12 14 3 0 0 9 53 0 6 1 0 33 12 10 0 11 0 6 0 0 0 0 0 0 0 24 23 0 22 0 0 30 0 0 0 0 0 53 0 0 0 0 17 32 1 0 
0 14 60 0 0 14 45 8 18 8 0 5 0 0 0 0 5 0 1 0 15 0 16 0 0 0 13 6 0 0 0 0 0 8 0 0 2 0 10 0 0 0 0 0 0 0 10 0 1 0 0 41 50 0 0 
15 45 0 2 6 46 29 10 0 20 0 15 0 31 30 15 30 17 0 0 17 2 23 8 7 4 0 20 21 0 0 33 9 3 0 32 0 33 0 0 0 0 12 19 4 6 0 23 48 0 4 30 0 37 58 
53 0 49 0 0 13 0 0 0 0 5 0 17 0 0 12 19 0 0 15 0 0 0 10 0 1 24 0 25 3 18 0 4 7 0 16 13 0 0 19 14 0 0 0 3 0 0 0 4 0 0 49 0 75 0 
0 0 19 10 3 0 0 3 0 0 11 0 7 12 0 23 0 10 8 18 3 19 0 10 0 29 5 0 15 23 0 0 2 21 0 17 0 42 23 2 0 12 0 38 3 4 1 0 9 0 15 14 0 10 20 
0 0 0 0 0 0 0 0 18 0 8 0 3 0 0 0 0 0 0 0 0 44 35 20 12 0 2 0 0 0 0 0 0 3 0 12 9 0 5 0 0 0 0 0 0 0 26 0 21 0 7 13 30 0 6 
0 44 16 0 24 4 0 0 0 20 66 0 0 0 0 5 0 6 0 0 11 6 29 0 0 1 0 13 0 21 0 0 5 1 4 3 0 0 0 7 15 31 0 0 0 2 8 22 0 0 0 29 0 0 0 
6 0 0 0 0 59 0 9 1 0 10 0 10 0 10 0 6 0 0 0 0 16 2 20 0 37 18 9 0 0 2 0 15 0 0 0 0 0 0 0 0 1 1 20 3 12 41 3 0 0 0 0 0 0 0 
0 0 0 6 0 50 0 22 18 5 29 15 0 14 0 0 16 0 13 0 4 2 3 12 4 1 19 0 0 21 22 0 0 0 0 11 10 0 0 0 30 0 0 0 25 42 38 23 0 7 0 0 22 11 0 
0 0 13 0 12 0 0 0 4 40 12 0 0 30 38 0 0 2 0 2 5 7 11 0 30 0 17 0 11 14 2 0 13 31 0 13 0 18 8 29 0 0 0 29 0 10 0 43 0 0 0 9 0 16 0 
0 33 35 0 0 0 13 2 83 0 28 44 0 7 7 13 0 0 16 10 8 37 10 0 2 23 19 0 0 0 15 15 0 0 48 9 12 0 28 7 0 0 0 0 2 21 25 25 8 0 0 0 0 32 46 
41 37 63 31 21 4 13 13 0 7 0 0 0 11 35 9 11 11 0 0 22 0 0 0 0 48 0 0 11 4 0 28 9 13 33 0 0 0 0 0 11 0 22 0 0 14 24 45 9 0 0 20 27 8 3 
19 11 0 19 0 0 0 15 11 0 0 0 0 10 34 34 0 0 0 29 0 12 0 9 32 0 9 0 4 0 0 0 9 17 19 27 0 0 16 0 0 0 0 0 0 0 0 0 34 51 0 16 28 0 0 
52 0 19 31 0 60 22 0 0 56 0 0 0 4 51 0 46 33 0 0 30 3 4 8 12 0 10 7 10 0 0 0 12 19 31 8 12 0 33 6 22 41 33 9 5 0 0 0 16 0 63 35 0 0 9 
0 18 18 3 99 13 43 6 0 0 5 38 0 3 0 0 20 0 0 0 45 12 20 0 25 0 1 16 9 0 18 0 0 0 0 0 0 0 12 25 24 0 0 1 21 6 30 1 22 30 46 21 0 0 57 
4 0 56 0 35 14 0 0 35 37 12 0 27 0 0 12 19 0 8 9 8 1 16 0 22 18 0 0 17 0 0 12 0 5 4 13 56 0 0 0 28 6 0 47 1 41 37 0 36 16 21 17 0 2 0 
16 51 45 0 0 68 0 22 4 0 15 0 20 0 17 0 12 35 34 0 42 0 0 0 10 27 37 4 0 16 10 9 14 0 10 3 13 0 3 7 6 1 38 18 0 19 8 80 2 0 0 0 39 0 6 
3 26 38 17 0 0 0 0 10 8 2 15 11 24 6 5 0 8 11 0 4 21 4 0 16 0 0 26 15 17 0 0 28 27 33 59 0 0 0 1 31 28 9 0 0 11 11 0 12 1 0 17 1 26 24 
46 0 19 1 0 2 11 44 0 16 0 0 0 7 46 0 0 3 9 15 7 0 0 0 4 19 17 11 1 24 0 14 22 0 0 15 9 0 0 10 11 0 0 9 56 17 48 0 8 0 16 23 45 0 0 
0 0 37 15 21 3 0 0 6 0 3 0 0 17 61 0 18 13 1 24 1 25 0 3 0 0 6 0 4 0 16 0 14 0 14 16 0 0 58 6 25 0 0 0 3 24 21 0 22 0 19 1 0 24 30 
0 5 70 49 0 2 0 0 19 20 33 23 42 28 0 0 27 0 9 18 29 0 3 0 12 0 22 2 0 25 8 30 34 4 5 0 0 0 26 42 14 10 0 27 12 10 0 0 4 0 0 9 50 22 124 
0 4 0 36 24 0 0 26 41 0 22 31 27 0 32 0 21 1 0 0 0 16 12 0 0 17 9 0 14 1 1 0 34 26 0 12 0 21 0 36 51 0 48 36 30 22 4 0 0 42 4 24 0 0 0 
18 0 26 51 0 23 0 0 37 26 1 12 0 13 0 37 8 10 33 22 8 0 28 0 26 3 37 9 14 5 8 27 13 13 4 0 19 22 4 16 14 0 0 13 3 44 22 0 29 1 23 0 7 0 12 
24 35 49 35 21 0 48 25 22 0 24 25 0 18 2 19 0 0 0 0 7 0 29 0 52 10 0 26 28 14 1 0 19 0 18 0 34 24 89 0 0 0 73 30 17 14 0 5 0 34 0 80 0 4 32 
