55 31
23 39 46 0 0 44 4 0 0 0 0 42 1 0 0 0 16 30 0 16 13 14 25 1 22 1 0 0 22 24 14 9 0 40 17 28 5 7 0 14 24 0 0 0 0 0 0 13 37 56 0 20 0 8 0 
0 0 0 0 0 0 0 29 36 7 0 0 46 0 0 2 0 0 0 13 0 6 9 0 55 15 0 0 1 11 0 0 11 9 14 0 0 29 0 10 19 22 3 19 38 0 0 5 23 2 35 1 55 0 18 
48 22 35 40 0 60 0 0 0 0 43 0 0 37 0 7 8 0 1 15 0 27 25 0 0 86 0 0 10 7 57 28 19 3 1 10 0 0 20 14 35 10 0 40 0 33 13 3 142 47 0 0 27 40 27 
25 15 6 1 4 22 0 0 13 0 0 0 0 0 27 64 34 0 0 0 0 0 0 5 0 27 0 22 0 17 4 42 28 3 0 18 0 0 0 18 0 0 15 0 0 2 46 0 33 0 0 0 0 19 16 
3 19 51 10 14 18 12 36 10 0 26 26 0 27 0 0 9 7 14 0 0 4 0 29 3 6 12 0 0 11 0 0 0 9 0 5 0 0 15 0 6 38 9 0 31 0 39 0 8 15 0 11 0 50 25 
0 0 3 0 1 70 54 24 0 10 3 24 7 0 0 21 0 33 0 0 0 30 0 0 0 17 11 0 0 1 0 0 1 15 18 22 10 19 0 0 0 13 24 0 23 19 0 0 0 42 33 30 18 18 13 
0 0 5 0 19 0 0 20 0 0 48 29 0 0 0 39 0 10 0 4 15 1 0 0 4 14 0 0 0 0 16 11 52 6 0 0 0 17 5 0 11 0 0 0 0 0 0 4 0 0 40 16 1 1 22 
0 0 2 12 0 49 55 0 34 13 0 37 19 0 17 5 4 0 24 24 11 14 7 0 21 14 17 0 0 0 14 13 7 0 31 0 7 41 28 21 13 15 40 17 0 39 24 0 37 0 0 0 1 0 52 
0 16 0 0 7 17 24 0 0 60 1 7 19 0 32 38 0 4 0 0 17 19 0 32 0 0 10 0 0 0 42 5 0 0 20 0 0 3 11 0 0 3 0 17 3 10 0 7 39 37 0 0 1 12 2 
0 0 7 0 0 27 10 27 0 2 0 1 0 36 6 32 0 36 0 0 0 30 0 17 10 21 0 18 14 15 0 0 16 0 0 23 29 8 0 0 5 0 1 1 0 42 0 0 18 56 35 34 31 0 91 
0 0 29 41 0 7 0 0 5 0 2 33 0 0 0 0 24 0 0 19 13 27 9 0 17 13 0 16 10 13 3 0 28 13 0 0 0 0 5 0 0 16 5 0 0 0 5 0 27 0 0 40 22 2 0 
8 49 0 0 8 0 0 0 12 0 0 0 43 50 10 1 27 0 0 0 26 0 10 0 1 0 0 0 0 0 0 0 20 1 1 0 2 21 5 2 0 29 2 8 34 2 23 9 0 3 49 2 20 42 0 
6 0 0 0 0 20 15 14 21 26 0 18 0 8 5 5 0 31 0 0 0 17 0 0 16 23 0 0 10 21 12 1 11 6 0 0 14 0 0 0 16 10 36 0 9 0 7 38 54 12 0 0 0 0 23 
0 0 0 16 2 0 0 1 6 0 37 0 2 22 0 0 13 15 0 1 0 0 0 0 0 0 0 0 0 9 0 1 7 0 0 22 2 30 16 15 0 11 0 0 11 35 0 1 0 41 0 0 14 0 63 
7 7 28 3 44 6 44 4 10 15 13 0 0 17 0 0 5 4 35 34 0 11 9 0 28 3 5 0 0 0 42 6 0 0 23 0 1 0 10 0 5 34 0 30 18 0 33 57 38 25 14 0 0 38 10 
32 0 0 14 48 0 4 45 38 22 4 0 0 0 0 0 0 0 0 0 11 4 0 0 25 0 0 1 7 0 9 0 21 0 0 0 0 35 0 0 13 14 0 0 7 3 51 7 3 25 0 0 45 0 50 
0 0 4 0 0 0 2 40 39 17 0 0 4 12 0 0 13 0 14 0 31 15 37 7 0 0 19 6 25 0 20 4 0 0 0 27 0 16 0 0 0 0 0 0 6 0 30 12 41 0 14 26 0 9 12 
38 0 50 0 0 18 0 20 3 0 0 0 2 0 44 0 28 0 23 15 0 0 11 0 0 2 0 10 13 32 2 0 11 7 17 4 3 4 74 24 2 17 38 0 0 0 0 0 83 22 36 0 0 24 52 
0 0 9 50 49 0 42 0 4 33 0 34 14 13 0 0 0 14 0 0 9 8 7 1 29 33 14 14 0 13 0 14 19 4 0 0 0 0 1 1 0 11 48 0 36 24 2 0 40 0 48 0 0 28 4 
13 5 6 0 26 35 40 41 45 0 7 0 2 13 0 69 0 0 5 0 0 8 0 37 28 25 5 0 0 8 41 22 0 0 0 0 0 6 12 11 5 6 0 11 0 4 0 0 41 4 14 0 46 83 27 
5 0 37 0 38 1 16 9 0 13 0 10 0 34 1 50 9 0 17 0 0 24 0 0 0 0 0 0 10 17 19 9 1 6 6 17 21 22 36 13 19 28 10 0 0 0 0 52 0 22 0 20 6 0 33 
48 4 0 11 34 0 12 44 0 0 0 0 0 10 50 0 0 0 32 0 8 7 2 45 3 0 0 4 7 9 0 17 32 0 0 3 0 0 20 0 0 0 35 29 15 0 19 2 0 13 82 19 0 0 31 
0 2 37 0 0 81 0 0 11 10 20 59 21 0 0 0 19 16 0 11 26 26 21 0 0 0 15 0 29 20 10 18 9 65 0 0 0 9 18 1 2 25 0 21 1 19 67 16 0 22 39 7 42 48 0 
9 53 8 10 0 21 18 25 86 2 23 0 5 32 8 0 26 0 0 11 18 34 0 19 21 0 0 0 0 0 0 32 0 13 1 19 3 16 0 19 24 15 3 0 0 12 30 5 0 94 2 0 50 61 46 
21 22 92 0 0 0 18 9 0 41 3 9 40 13 17 0 29 0 0 0 11 5 6 34 21 0 6 0 24 23 32 0 11 21 10 13 10 28 0 8 0 17 0 0 11 11 0 37 0 0 0 0 40 21 15 
127 6 32 51 14 14 45 43 30 9 0 0 0 7 15 24 33 14 0 0 24 7 9 0 0 0 0 24 1 3 23 36 15 0 0 0 0 14 23 0 40 35 0 0 0 53 38 15 0 0 0 25 0 0 0 
0 38 24 17 24 46 34 14 0 0 39 0 0 6 0 0 14 11 0 0 16 25 6 0 17 12 14 24 23 5 4 10 0 6 6 0 1 0 0 2 38 18 63 0 0 2 14 0 0 0 0 60 10 0 12 
9 0 0 27 17 7 15 0 0 0 0 23 0 13 22 0 4 6 0 0 0 18 0 0 0 0 0 0 0 0 27 0 0 0 0 0 22 19 0 0 29 0 0 0 0 0 0 0 0 4 0 0 40 0 8 
0 47 0 0 0 18 37 0 0 0 23 0 24 0 0 28 0 15 30 1 0 21 27 13 30 0 0 0 26 13 2 0 0 7 5 19 20 0 16 25 0 0 0 37 14 9 0 12 6 16 35 0 0 0 15 
0 0 20 25 10 39 36 0 0 9 0 34 34 0 30 35 7 0 0 3 0 1 13 6 4 24 0 0 23 0 0 8 16 29 19 0 0 15 27 7 0 33 36 23 24 0 17 15 5 1 0 1 8 64 20 
37 45 24 1 0 21 0 34 0 0 0 8 29 0 4 0 0 30 0 0 0 2 0 0 30 30 24 0 13 15 0 56 17 4 0 0 0 79 7 22 9 6 0 0 5 7 11 69 0 0 0 0 8 0 37 
