55 31
0 26 0 0 41 42 0 2 0 10 18 7 49 30 12 0 30 8 3 0 0 12 0 22 6 21 13 48 3 40 18 0 0 12 7 28 12 28 0 0 9 0 15 4 0 4 12 64 0 14 4 0 23 0 0 
0 0 24 4 0 21 1 0 0 7 0 0 8 16 24 1 18 7 10 0 51 0 7 17 0 0 31 0 0 0 27 0 0 0 10 29 30 0 0 22 0 23 0 0 7 25 3 0 4 67 25 0 17 0 16 
31 10 0 0 45 37 9 7 0 34 24 2 0 27 24 0 10 28 32 8 4 0 28 26 18 11 0 0 0 25 0 28 3 35 0 0 26 0 13 0 0 8 37 34 0 28 17 0 0 19 30 25 1 0 0 
0 0 23 6 51 0 36 6 1 0 7 0 6 8 28 0 0 18 0 26 0 10 0 20 0 23 0 4 42 0 8 26 0 0 1 0 0 0 13 0 36 0 3 0 29 3 0 4 0 0 16 17 24 9 0 
40 42 39 0 110 21 0 0 0 0 0 36 23 0 18 0 13 1 19 8 20 5 0 18 3 40 14 38 0 11 10 0 3 25 0 3 0 25 0 38 41 3 17 26 39 0 17 29 0 37 2 13 35 0 10 
0 42 21 43 28 14 0 0 13 42 0 0 0 34 0 0 10 0 1 20 6 0 24 0 0 0 14 0 0 0 0 0 28 52 14 11 3 17 0 0 0 4 0 42 26 0 111 0 14 0 0 42 0 18 21 
51 19 20 52 49 16 0 18 25 10 0 8 12 20 19 0 17 0 0 24 10 0 0 46 0 5 0 2 0 7 0 3 0 10 0 0 10 8 0 6 88 0 1 1 0 15 23 0 0 45 36 58 0 0 0 
0 0 0 27 39 0 0 36 5 16 11 7 0 0 44 0 0 25 0 0 13 21 0 0 0 0 0 0 14 7 0 7 0 5 0 0 5 2 0 2 0 5 46 13 3 15 17 36 0 0 17 0 0 0 14 
0 4 0 59 0 0 4 0 0 30 0 0 5 26 0 0 0 28 2 0 8 25 11 17 0 37 0 2 0 1 1 0 6 17 0 0 7 9 19 62 15 32 0 0 0 28 22 10 16 0 0 5 0 0 0 
44 1 0 34 9 43 26 18 35 0 17 0 4 3 0 0 0 16 30 3 18 15 4 21 0 0 12 21 27 0 14 0 26 0 17 13 3 52 24 15 9 0 0 4 51 0 8 27 39 0 0 0 0 6 7 
0 40 12 0 0 94 0 4 0 13 3 10 12 38 12 0 5 0 22 0 18 18 0 6 0 0 15 2 0 25 12 15 0 0 0 10 0 2 18 11 0 4 0 42 0 33 20 0 0 0 12 0 0 16 49 
0 12 1 0 31 0 11 19 39 0 21 9 0 50 61 21 0 11 9 6 21 8 0 0 3 0 8 9 15 14 0 13 0 18 0 14 22 0 0 0 0 0 0 0 0 0 10 37 0 0 0 0 5 39 0 
0 2 2 7 13 23 48 0 0 0 0 0 3 0 5 5 34 9 0 6 0 0 27 0 18 5 0 2 18 24 0 0 0 3 15 0 1 0 31 0 0 27 23 0 0 0 18 0 0 27 44 38 11 24 11 
0 0 15 7 0 0 0 8 16 0 16 0 0 10 0 0 0 15 30 18 3 9 4 10 0 7 0 3 0 11 10 6 9 16 1 18 11 23 0 0 4 24 7 0 17 18 5 11 0 0 0 5 0 0 0 
5 45 0 36 12 0 4 59 0 10 15 41 0 11 11 12 1 5 22 17 4 34 0 20 0 11 0 0 0 23 15 0 25 2 0 17 0 0 0 8 0 34 0 30 0 0 48 8 14 20 60 0 10 0 10 
0 13 6 21 0 0 3 21 38 20 36 0 27 2 2 28 29 23 0 9 33 5 19 18 0 1 14 9 41 14 18 9 5 5 2 4 0 4 6 11 30 0 2 40 7 4 35 12 41 18 43 48 0 0 39 
0 0 11 48 21 0 0 43 30 1 3 5 0 59 0 7 24 0 0 0 20 8 0 0 30 15 5 0 20 0 23 0 0 0 0 0 0 12 0 0 45 28 1 0 0 5 0 0 18 23 85 0 9 0 30 
8 0 0 14 14 8 3 40 26 5 0 0 0 26 23 44 0 31 6 0 0 39 0 16 0 12 13 20 0 15 26 19 8 18 11 0 10 6 14 15 23 26 7 0 0 6 43 40 29 0 19 0 14 0 25 
25 0 0 0 53 0 37 14 0 0 3 0 23 0 4 0 5 0 0 18 0 7 0 0 12 25 34 3 7 23 0 25 0 21 0 4 0 27 0 15 0 0 3 0 0 0 7 69 44 0 0 0 0 1 16 
5 0 44 0 41 0 42 0 0 3 19 61 0 0 15 0 37 0 16 0 0 0 31 4 1 20 0 0 3 18 1 17 0 0 0 23 18 0 10 2 8 30 5 12 4 68 2 12 12 18 9 11 0 31 0 
0 50 0 17 0 4 2 1 37 4 9 1 0 1 1 0 0 0 0 6 5 8 0 22 15 0 0 0 2 20 0 0 0 0 0 17 10 0 0 0 0 0 7 0 0 48 4 0 7 0 0 0 4 0 0 
43 0 0 9 34 0 0 15 17 0 18 5 6 21 43 21 0 7 38 0 47 17 10 9 2 20 8 0 30 0 3 0 0 0 5 0 16 4 39 0 0 0 24 27 0 25 3 0 34 20 0 5 50 0 3 
18 0 5 19 34 16 0 3 0 0 1 0 0 0 0 9 0 8 18 7 0 0 19 22 9 2 7 0 2 0 0 0 0 0 2 27 2 0 0 0 0 0 0 0 0 6 0 13 0 0 10 6 0 0 0 
14 0 0 17 34 0 54 0 25 35 19 0 0 1 4 0 39 1 38 0 36 35 0 5 3 0 7 0 0 0 4 11 12 10 14 0 20 13 41 16 0 15 16 5 23 4 0 3 23 5 122 4 0 14 32 
0 0 0 0 97 0 10 0 6 10 0 0 0 28 8 0 0 0 4 0 20 15 0 17 0 12 24 11 3 12 5 0 0 0 2 13 0 9 21 0 0 14 29 14 0 41 17 0 0 0 0 30 0 49 0 
0 0 0 68 0 8 6 0 5 0 0 14 6 4 0 0 30 0 15 0 0 0 0 0 20 14 0 0 12 12 0 10 0 0 0 0 2 0 9 18 11 22 26 0 20 4 0 7 0 0 0 6 0 0 51 
0 0 31 17 17 3 1 5 53 0 3 19 24 1 24 0 7 0 19 11 0 11 0 7 10 24 6 22 0 2 27 0 28 0 38 31 0 15 28 11 17 10 0 0 20 0 9 0 0 0 23 0 40 0 0 
0 0 5 0 10 0 15 18 0 0 13 0 0 0 0 6 0 0 0 0 14 15 0 13 3 25 1 0 6 0 4 17 3 19 0 15 22 19 19 7 0 0 0 8 0 26 13 0 24 27 12 0 20 0 0 
0 10 31 0 2 0 0 0 54 0 0 10 0 11 25 0 6 0 0 0 0 5 0 0 0 0 44 0 0 17 0 41 31 31 0 28 26 6 12 0 0 0 0 25 36 8 0 10 2 6 9 20 1 0 0 
0 39 12 17 0 3 21 25 38 1 19 34 0 6 12 0 31 30 28 0 4 0 0 6 4 2 0 8 0 19 38 0 13 3 4 29 0 7 27 0 31 0 0 0 0 37 81 30 41 0 0 16 36 0 0 
0 0 0 0 0 19 46 32 1 38 0 0 18 20 20 0 25 10 11 0 0 17 38 1 10 0 15 1 25 0 18 9 22 0 20 29 3 0 18 0 0 22 0 0 0 39 0 17 0 0 34 24 0 0 0 
