55 31
0 0 0 30 0 22 0 34 0 18 19 0 8 55 51 2 27 0 0 0 8 0 0 12 5 13 10 13 12 0 13 10 0 0 0 8 33 22 0 14 20 0 0 103 0 0 0 4 24 0 0 23 0 0 0 
0 0 11 2 63 12 12 62 0 37 22 0 0 14 0 19 10 0 10 14 13 0 0 4 18 10 0 0 0 17 0 52 14 2 12 1 0 33 34 0 25 0 0 0 0 0 40 22 0 6 0 0 0 0 0 
26 0 78 0 57 2 39 19 3 15 28 0 0 0 0 50 0 11 0 24 33 27 0 0 0 0 0 23 21 10 5 0 9 0 0 0 0 0 62 0 4 0 14 7 0 13 14 0 28 24 7 0 50 28 0 
0 29 4 0 28 0 19 41 11 32 0 0 0 0 0 0 3 0 35 16 0 0 26 0 14 0 22 0 0 0 27 0 20 0 18 34 21 6 34 0 0 0 0 34 0 0 0 0 3 0 0 0 24 48 40 
24 0 0 17 23 17 0 19 0 0 0 0 0 13 33 0 0 0 32 2 0 0 8 0 0 0 0 0 14 15 23 0 0 6 16 0 0 0 0 25 0 0 0 0 0 5 13 0 0 0 84 0 19 0 0 
7 0 22 0 16 43 0 23 0 9 10 0 0 10 9 0 0 49 0 44 10 0 0 38 2 18 0 0 9 0 24 2 2 0 0 7 0 14 0 0 6 5 29 7 0 0 0 0 36 3 19 0 0 36 17 
0 27 19 0 49 0 0 0 37 0 0 35 6 2 0 11 5 16 6 0 0 20 0 20 17 0 0 0 84 5 1 0 0 16 0 8 0 0 0 0 6 0 2 0 6 37 51 0 0 14 9 0 24 46 0 
0 1 183 6 5 18 0 6 31 11 0 3 22 3 2 25 17 0 12 0 12 14 7 0 17 0 18 0 4 21 0 8 1 31 0 0 18 19 23 0 0 18 66 5 26 0 0 6 19 0 0 31 43 18 47 
0 16 0 51 35 0 1 16 5 0 0 1 0 2 0 1 15 0 19 0 0 0 0 0 0 14 26 11 13 0 0 0 2 5 11 0 1 0 15 56 14 5 2 0 0 0 0 0 0 0 0 0 20 50 0 
12 21 0 38 6 0 35 9 24 9 0 17 39 6 35 17 0 35 31 5 0 2 0 0 0 14 0 9 22 8 22 1 31 0 3 0 9 30 0 2 9 20 3 15 23 21 34 7 0 37 21 21 13 14 17 
31 0 0 0 37 22 0 0 0 4 39 0 0 52 0 0 0 1 17 0 0 7 0 8 0 9 7 22 23 0 0 15 0 7 0 7 4 0 0 0 0 0 2 18 47 17 0 0 44 75 0 3 0 44 0 
0 0 0 0 0 22 7 15 0 12 0 0 26 16 0 0 9 12 10 50 4 12 0 0 0 0 0 26 0 18 4 19 0 0 0 0 0 24 3 14 0 0 0 6 0 4 5 3 18 4 6 0 45 0 16 
91 0 114 34 1 22 1 35 44 3 2 12 12 0 0 14 39 37 0 13 0 0 0 14 0 0 28 10 28 10 0 0 15 6 0 7 0 71 0 37 28 0 35 0 16 0 2 22 32 0 24 49 0 0 19 
38 113 0 0 32 25 53 0 5 16 43 0 0 0 0 0 0 16 7 31 3 21 29 3 0 30 0 0 0 16 25 0 29 16 14 13 39 8 44 38 0 0 2 18 0 44 7 0 13 1 44 32 0 43 18 
0 0 27 17 72 19 0 3 46 0 0 43 0 0 3 12 29 6 18 0 17 32 31 0 0 21 6 14 26 23 12 27 31 59 0 8 4 33 6 0 11 0 0 0 15 31 19 20 0 3 42 0 0 9 17 
0 0 0 32 14 0 0 43 0 8 0 27 0 32 22 37 37 19 42 0 14 0 20 0 19 0 6 4 0 0 16 2 14 16 6 2 3 0 0 57 0 9 9 0 4 12 0 0 8 0 34 0 35 37 0 
37 0 4 6 41 40 0 0 0 0 23 37 0 0 0 0 0 3 0 0 0 0 15 0 1 0 0 0 0 0 18 0 0 0 11 0 22 24 0 0 0 0 29 33 0 121 11 0 6 0 0 3 16 13 11 
0 0 0 0 32 5 0 0 8 2 6 0 40 0 5 0 12 15 0 13 0 0 0 0 15 0 0 7 13 11 0 27 0 0 7 0 0 13 0 15 0 13 0 0 0 0 22 0 0 37 0 0 0 0 0 
0 0 0 20 12 27 44 23 29 16 24 65 11 41 10 0 30 17 0 0 0 0 0 20 0 9 45 0 14 8 0 13 34 24 35 0 0 21 0 0 0 0 0 30 0 32 30 4 1 5 45 0 5 4 43 
0 40 18 4 15 11 7 0 0 29 17 0 27 19 0 18 2 28 0 16 21 0 0 0 0 0 2 9 2 15 7 0 0 3 11 0 0 23 21 0 0 11 14 0 8 0 0 20 33 0 0 0 12 0 14 
20 30 21 27 5 72 0 74 33 44 35 0 6 9 0 33 9 11 30 7 0 0 3 2 10 0 2 0 0 7 1 0 0 7 8 0 0 25 29 0 15 41 30 0 39 0 7 0 7 0 2 29 42 85 47 
0 22 30 31 17 0 0 43 32 2 0 21 31 0 0 34 0 6 31 34 0 31 0 24 0 0 15 0 0 0 0 12 16 0 0 0 0 8 29 1 0 0 0 25 0 26 0 23 1 3 31 28 4 0 18 
0 0 6 6 0 15 28 6 2 0 1 0 0 7 1 0 24 12 4 0 3 7 0 0 0 12 0 22 14 8 0 17 0 0 0 8 0 13 12 16 10 0 0 0 5 0 16 20 6 20 0 0 0 0 0 
9 0 10 0 10 9 0 0 0 6 7 0 56 18 1 0 0 3 0 0 16 32 17 13 0 0 0 0 6 11 4 0 19 0 0 21 42 0 0 23 4 5 0 0 0 36 34 22 15 0 0 15 3 32 26 
44 0 0 3 0 0 9 28 3 0 0 12 3 19 0 20 3 30 0 20 0 0 0 3 0 5 18 0 11 0 0 0 0 16 0 28 35 0 0 9 0 15 0 0 1 1 0 17 0 39 4 0 5 0 0 
5 53 14 16 28 38 45 0 4 0 0 8 0 0 0 4 0 6 0 22 9 0 0 3 8 66 10 23 2 0 27 25 9 11 0 0 0 0 8 12 21 4 10 15 14 0 0 0 0 0 19 2 6 18 25 
0 40 2 0 37 21 42 78 0 2 4 0 0 0 22 7 2 0 40 24 0 32 12 27 0 0 32 20 52 8 7 9 9 8 10 0 0 22 4 32 54 55 8 0 40 7 0 64 32 3 2 14 91 12 17 
0 4 0 0 15 74 40 38 45 18 0 24 3 0 0 8 0 0 0 0 3 0 0 17 27 12 26 12 8 0 0 0 0 7 0 34 0 12 0 15 9 0 0 38 41 11 42 0 39 10 16 27 43 45 0 
127 3 6 21 88 46 42 40 7 53 3 37 0 4 5 10 0 17 13 0 0 17 0 0 17 18 17 0 0 0 0 6 0 0 1 1 0 31 0 1 0 0 0 0 16 0 7 0 31 0 0 25 67 29 0 
0 8 35 5 0 36 52 0 49 8 0 18 33 21 0 6 0 10 13 15 1 0 49 14 18 19 0 15 0 4 0 29 0 21 15 0 4 35 0 51 34 1 0 19 0 14 0 39 18 3 0 0 28 26 0 
0 52 5 30 25 7 28 0 0 0 2 0 7 30 0 6 15 16 0 0 0 24 0 25 0 0 0 0 21 18 0 26 0 0 0 52 0 2 1 0 0 8 0 0 40 39 0 14 0 25 0 0 4 0 0 
