55 31
52 33 2 0 4 34 0 0 0 29 0 1 0 17 25 74 27 20 81 6 20 0 5 26 6 25 8 26 56 0 8 15 21 0 2 14 0 15 34 78 0 30 31 71 14 0 16 3 47 51 0 0 54 38 26 
22 0 0 38 0 25 75 40 0 0 0 0 34 8 9 5 11 0 29 0 11 6 22 25 20 13 12 0 19 21 52 0 0 0 20 5 17 25 0 33 0 38 0 11 1 18 17 84 67 0 0 0 0 17 54 
0 0 0 0 0 7 0 20 0 19 11 0 7 17 7 12 10 0 24 30 0 4 0 18 13 1 22 46 16 2 0 10 0 0 0 0 0 16 23 0 14 18 24 30 18 0 19 16 0 21 25 18 12 0 14 
9 0 0 0 37 0 0 0 0 15 0 0 0 44 0 0 37 10 0 0 17 19 18 0 0 0 0 24 0 0 0 0 6 6 0 17 0 0 0 0 3 34 0 8 5 0 11 0 0 1 0 0 0 37 0 
22 23 0 0 4 3 0 0 3 0 3 0 0 28 0 2 0 26 20 21 0 0 0 0 0 9 29 4 0 0 0 16 0 0 16 0 15 15 25 0 2 1 0 0 0 0 3 10 0 0 0 0 0 1 0 
15 22 15 0 22 0 0 12 5 5 0 0 16 18 28 0 34 7 9 0 0 32 0 0 24 0 38 14 27 4 0 3 16 0 0 17 0 10 0 21 0 9 17 0 2 10 0 5 5 7 15 14 0 63 0 
0 0 72 25 1 0 0 0 8 12 0 0 6 22 0 19 8 0 22 4 0 10 0 1 14 11 0 0 14 0 0 3 19 8 32 5 18 8 0 13 0 27 0 18 22 9 0 10 0 2 56 0 0 14 1 
39 0 0 10 7 37 0 20 68 0 6 22 31 26 3 32 0 34 0 0 19 13 1 0 27 0 0 5 0 7 0 60 24 4 10 0 0 0 0 24 21 0 53 31 35 6 42 5 0 9 35 1 36 38 0 
11 28 1 10 0 15 3 0 2 0 38 80 0 2 6 20 0 32 0 12 0 3 42 30 2 0 12 0 0 0 0 8 11 0 1 8 0 29 7 9 60 33 5 0 10 0 16 0 46 58 37 0 2 18 0 
23 38 0 69 0 0 0 0 0 0 0 8 14 41 4 23 26 0 4 0 9 5 0 23 18 26 22 6 14 22 0 8 6 3 0 8 0 7 60 38 3 4 9 24 0 10 8 4 5 0 3 32 0 3 33 
28 41 51 0 4 0 44 5 0 0 0 31 25 0 6 33 0 0 14 0 23 7 0 0 0 0 0 0 0 0 0 24 0 12 7 0 23 3 10 10 9 27 30 9 5 12 13 8 28 1 92 0 0 18 0 
0 74 0 0 0 31 28 22 0 0 0 0 9 0 2 0 0 0 0 0 0 0 0 23 0 19 0 6 0 22 0 6 0 5 39 0 0 0 3 0 0 5 0 3 0 51 65 0 0 0 0 2 0 2 0 
2 22 0 0 33 14 0 0 38 15 33 35 6 24 0 0 38 18 19 1 8 0 13 0 0 0 0 24 5 10 0 0 0 21 0 4 0 45 0 10 79 0 0 67 6 7 55 0 0 16 0 58 10 0 13 
45 13 0 57 30 0 39 14 0 33 0 0 32 0 0 45 0 0 0 35 0 0 26 0 0 30 0 0 13 0 35 1 0 3 94 11 0 31 16 15 0 0 5 0 3 114 0 46 25 11 0 13 4 28 0 
2 27 8 13 3 7 83 10 9 42 3 4 6 3 0 0 43 25 34 13 12 25 0 21 13 34 15 9 12 0 0 1 33 13 0 0 18 0 1 12 2 12 24 14 38 15 10 0 42 22 8 55 8 21 29 
72 11 22 0 0 1 15 45 0 0 16 4 0 11 10 0 0 0 24 8 0 18 0 0 8 20 16 6 9 0 0 0 0 41 10 13 0 0 3 57 16 0 12 0 0 0 0 13 13 0 17 0 56 12 4 
0 0 21 0 0 3 0 37 0 0 0 17 6 0 2 10 7 0 0 8 0 15 21 52 16 0 22 0 2 0 23 0 19 0 19 0 0 0 0 0 33 0 14 11 0 22 7 15 23 17 14 19 0 35 10 
52 26 0 10 0 9 8 0 2 0 0 34 0 19 0 0 0 0 0 7 0 0 31 21 0 0 7 13 0 0 0 11 0 0 0 0 0 0 0 0 20 11 11 6 21 36 0 0 0 9 2 9 57 40 0 
0 0 0 0 0 35 72 25 36 1 2 0 5 4 2 37 0 0 9 0 12 43 0 0 3 0 0 0 6 4 0 25 8 9 6 5 8 0 19 0 11 0 9 0 36 0 24 6 0 0 29 0 14 40 17 
0 36 0 10 0 1 8 1 17 17 27 1 20 5 15 54 22 3 8 24 0 0 21 5 20 0 0 5 0 14 0 19 4 0 18 0 15 7 3 7 45 14 0 26 61 18 0 13 2 0 0 31 51 0 5 
31 0 59 0 0 0 0 0 5 0 38 0 6 57 16 0 0 0 45 3 53 20 0 0 1 29 24 10 9 0 0 0 0 0 20 0 0 1 6 10 0 8 0 28 0 0 49 19 3 8 0 1 0 39 45 
99 0 5 15 0 0 9 0 0 16 0 17 8 0 11 5 34 14 0 32 18 36 0 11 52 10 20 0 2 0 0 19 28 6 0 24 8 8 6 15 19 0 29 59 76 0 0 0 48 60 26 53 16 11 5 
102 0 0 0 0 26 5 0 15 4 0 0 0 0 0 13 10 0 48 1 0 10 0 21 0 18 0 0 0 4 0 25 3 0 13 0 0 0 20 32 19 0 0 0 0 0 15 21 9 28 50 0 39 0 0 
18 0 13 20 7 0 0 0 0 0 0 11 0 0 4 0 7 0 29 11 1 10 0 20 0 13 0 7 2 11 2 0 6 0 0 0 0 0 8 0 4 0 22 0 4 0 18 0 0 0 16 0 0 0 0 
0 0 0 16 0 0 0 17 0 0 0 9 0 15 0 3 1 0 0 0 23 21 0 14 14 0 0 6 6 0 0 20 0 0 0 0 0 33 10 0 9 0 0 7 0 0 0 0 16 0 29 0 14 0 0 
0 0 3 24 0 5 0 7 0 12 0 0 0 7 1 0 12 0 0 2 0 0 17 26 7 20 0 1 0 0 2 16 9 5 0 0 0 6 0 0 27 9 0 1 0 20 0 14 0 0 11 0 19 19 36 
22 15 1 13 0 23 0 0 0 0 0 10 0 34 0 0 0 0 0 3 27 0 0 0 11 19 0 0 0 0 0 32 0 30 19 0 0 25 0 12 14 0 48 26 19 0 0 0 0 0 0 9 8 10 1 
0 23 6 0 0 28 10 14 0 13 0 74 0 10 0 0 11 20 9 18 7 7 0 3 0 12 3 11 27 0 0 20 0 28 0 15 0 2 0 1 0 0 15 0 0 8 15 36 9 38 25 15 9 12 1 
0 11 0 0 0 0 0 15 0 0 0 7 11 0 0 0 0 0 0 0 29 22 0 0 0 0 5 0 40 0 29 7 0 26 0 0 0 9 0 36 0 20 0 70 0 0 0 13 3 0 30 21 0 23 9 
0 0 33 0 0 0 0 0 0 0 0 1 64 24 0 0 12 19 17 0 8 5 0 0 0 13 10 25 12 17 13 0 0 0 0 16 20 6 0 0 0 0 6 5 0 0 34 10 0 0 0 2 25 0 0 
0 10 0 0 26 0 6 0 29 0 12 11 0 44 10 37 21 81 16 0 20 16 15 6 10 0 23 4 0 6 17 14 0 0 0 0 0 44 0 0 0 0 5 0 0 0 0 46 1 8 26 34 37 3 0 
