55 31
0 0 29 4 12 5 27 1 0 35 0 0 46 7 35 0 0 8 0 13 9 0 9 0 0 8 22 10 10 16 0 61 53 20 0 26 27 10 26 0 0 13 30 15 22 16 0 0 6 0 0 19 20 0 0 
0 0 0 0 26 39 0 56 13 24 22 24 3 14 0 14 17 0 4 31 24 0 12 0 0 0 10 24 0 0 0 0 32 19 0 0 0 13 6 21 11 8 0 0 19 26 24 19 0 5 40 19 19 26 13 
0 5 0 0 48 12 6 0 0 0 17 53 24 0 0 5 33 0 0 0 6 22 0 11 0 0 24 12 9 2 0 0 43 0 0 0 13 26 0 7 7 0 0 46 1 9 0 31 0 33 0 0 0 0 0 
50 0 0 1 49 4 0 54 0 11 10 13 37 10 32 0 2 36 18 6 0 0 15 14 0 23 0 0 52 0 2 0 7 0 0 0 0 0 0 0 33 1 12 13 36 1 32 0 14 10 22 0 1 12 0 
0 7 0 10 10 10 24 0 0 0 15 3 23 8 9 0 0 49 15 0 0 3 0 4 0 15 2 5 13 0 3 0 0 28 0 7 17 0 0 0 9 10 41 30 18 0 0 29 0 19 0 0 0 21 37 
0 0 19 0 10 5 0 6 15 12 0 0 52 26 0 0 0 0 0 0 0 59 0 12 0 16 0 22 0 0 20 19 10 0 22 5 0 0 17 53 15 20 0 25 0 0 25 0 0 22 5 0 7 11 0 
22 9 0 0 4 0 0 44 0 0 10 5 47 23 0 8 0 0 0 6 0 13 2 0 4 5 21 0 5 14 6 0 0 0 0 26 6 18 0 0 0 0 0 5 6 20 0 0 0 6 35 8 0 21 19 
13 31 48 0 3 37 4 2 3 0 15 5 33 11 21 31 0 27 16 13 20 0 2 21 0 15 1 23 0 27 0 0 22 0 49 0 0 0 0 0 3 6 0 5 0 33 6 0 5 4 15 31 0 0 0 
22 51 0 0 0 0 0 27 12 0 0 3 38 33 39 0 0 0 28 3 12 14 21 0 0 0 0 0 3 0 0 0 0 0 0 0 0 9 0 0 3 0 0 0 4 0 19 18 0 0 47 0 54 38 0 
0 22 7 17 85 0 0 0 0 27 18 0 21 11 19 13 0 10 14 0 21 0 29 7 1 0 0 5 0 0 19 0 18 0 0 6 0 17 1 8 0 0 0 11 0 41 10 0 24 19 18 17 4 1 15 
0 0 45 0 65 0 0 0 11 0 2 0 0 44 37 0 9 23 8 4 0 11 29 50 1 0 1 20 18 0 20 0 0 0 0 4 0 0 0 0 16 15 7 0 0 12 0 74 0 0 0 55 39 2 3 
6 0 2 74 0 21 2 4 0 29 0 33 0 22 0 0 6 27 13 0 39 0 20 0 19 10 44 0 20 13 4 26 27 30 0 25 33 5 42 0 3 11 0 6 27 29 19 6 0 28 64 8 27 6 0 
52 2 45 0 3 8 0 17 25 0 3 5 37 0 0 0 29 16 11 0 0 15 0 6 0 0 19 20 1 46 6 0 0 25 0 34 15 0 15 6 5 0 0 9 23 11 0 18 0 11 0 0 58 36 8 
42 0 0 0 0 0 1 7 1 7 0 0 0 6 0 20 14 20 39 6 0 0 4 2 11 3 27 0 9 13 0 0 4 8 0 13 0 24 31 0 6 12 42 0 0 0 0 5 3 0 0 3 5 42 36 
0 19 1 43 0 32 0 4 32 14 0 6 0 14 20 0 0 16 10 31 36 0 0 17 0 2 0 19 1 26 16 6 0 2 32 65 6 13 0 0 10 4 23 0 0 11 0 0 11 25 12 5 31 0 0 
13 44 0 0 1 16 0 39 0 19 0 0 0 3 0 8 43 0 3 0 0 5 27 33 8 0 0 0 17 12 15 24 8 0 2 0 0 6 0 0 0 10 21 0 3 56 39 0 25 0 41 0 1 0 0 
37 57 12 32 6 0 48 25 52 1 38 13 22 0 5 0 0 12 29 17 1 19 19 0 9 4 5 6 0 0 0 0 13 9 22 24 0 60 13 0 25 22 8 1 0 42 0 29 38 0 34 22 45 11 0 
19 0 0 39 11 0 23 0 0 1 36 0 0 33 28 0 0 29 0 10 29 11 0 3 21 0 0 16 0 13 0 0 0 0 2 0 0 0 0 6 0 1 17 0 0 15 40 0 14 35 9 0 8 0 0 
0 26 1 13 3 0 48 9 71 3 0 36 0 3 0 1 14 2 16 22 7 0 0 6 0 16 0 38 0 0 28 4 2 0 52 0 23 0 9 0 2 72 34 0 3 0 7 45 0 18 23 0 18 31 6 
7 0 0 0 81 72 44 18 10 0 4 0 0 0 29 0 40 46 10 5 0 13 13 17 22 9 40 0 25 4 0 0 22 27 0 3 0 2 34 0 18 1 0 15 0 0 17 0 0 23 45 34 0 27 0 
0 0 14 0 0 0 0 14 0 7 0 12 0 13 4 0 14 10 0 0 25 17 0 7 0 0 0 7 0 17 0 6 4 0 7 0 15 10 0 0 0 0 0 11 0 25 17 15 0 0 0 11 6 0 0 
0 0 1 20 19 14 46 8 28 35 6 53 0 1 0 0 13 4 30 12 21 11 4 6 6 7 1 0 3 16 20 16 9 0 0 0 23 8 9 11 9 51 0 0 9 0 35 9 29 21 34 14 46 1 40 
0 0 0 0 20 17 0 8 4 5 0 0 0 0 0 7 7 0 4 0 15 31 18 7 0 0 0 28 17 0 0 0 0 5 16 15 0 0 17 0 12 0 0 0 22 6 0 0 0 22 23 0 21 10 0 
0 4 0 0 0 0 0 0 6 0 0 15 0 2 71 0 7 0 14 12 0 3 0 0 43 0 3 41 0 4 0 23 0 0 0 21 0 0 0 0 4 31 8 0 20 0 3 0 0 3 18 0 0 51 27 
18 0 0 0 26 0 17 62 8 15 15 18 15 28 0 22 0 0 38 10 47 0 0 22 7 0 0 28 13 32 5 7 0 0 0 8 16 29 0 0 16 28 21 0 40 0 28 0 0 42 19 17 0 0 0 
24 0 33 49 21 43 0 0 0 4 19 34 0 63 0 13 44 29 18 0 14 1 23 0 0 0 9 22 10 39 0 0 15 6 19 47 18 3 0 6 5 20 0 8 39 4 13 4 16 22 34 0 0 15 15 
38 0 0 35 0 0 0 2 5 0 0 24 0 0 0 0 0 3 0 0 3 16 8 5 0 0 0 3 0 0 5 31 0 30 0 13 20 3 0 0 0 0 23 24 9 0 0 16 0 2 0 10 9 0 4 
1 14 0 24 11 40 0 0 0 26 36 8 11 0 0 4 0 5 0 24 27 23 10 12 0 21 0 15 0 7 0 2 31 0 7 19 35 0 0 0 27 0 5 24 41 66 0 27 0 0 21 7 1 6 19 
3 3 44 8 8 41 8 48 0 4 0 65 0 0 2 0 8 20 0 0 20 11 27 23 0 7 0 12 0 0 0 13 7 28 0 14 0 0 5 42 24 17 1 8 22 0 67 0 0 2 17 19 20 29 45 
0 18 0 0 0 9 43 0 5 0 0 7 23 3 54 0 0 0 0 0 0 0 0 0 0 18 0 0 0 0 14 20 31 0 0 17 0 0 24 0 0 31 0 0 9 0 11 0 0 43 6 0 0 40 0 
35 22 0 43 0 49 0 8 17 10 0 0 0 38 0 0 28 0 0 7 0 0 1 22 0 32 19 20 4 19 16 0 29 0 19 21 12 10 0 0 0 32 50 24 15 29 16 9 0 0 0 80 20 19 16 
