55 31
22 23 0 0 0 26 47 0 5 14 0 27 7 5 25 0 0 28 0 25 0 0 0 0 23 65 2 9 31 0 22 26 0 0 16 4 2 0 0 20 0 0 0 15 31 0 0 0 3 4 14 35 6 5 12 
12 27 8 53 47 3 0 0 28 3 0 0 90 8 30 27 29 0 23 18 17 6 20 54 12 35 0 6 9 20 0 26 0 6 18 23 61 0 50 7 25 23 10 46 39 17 0 22 30 0 0 55 29 83 40 
0 26 0 94 0 19 0 0 0 11 0 0 0 5 0 29 0 0 13 0 65 1 25 18 34 0 2 17 0 0 0 0 0 7 0 14 0 0 0 3 0 18 0 0 37 0 11 0 37 13 0 0 0 0 51 
8 20 1 2 14 0 39 6 60 0 0 55 9 83 9 11 32 0 73 33 0 4 31 12 0 0 0 0 27 14 0 8 0 0 15 0 25 8 0 0 14 30 2 14 41 138 7 39 43 0 47 0 34 44 14 
21 26 15 0 8 0 48 0 35 4 19 39 13 3 10 14 16 0 19 0 0 19 34 12 0 18 14 0 0 29 1 0 28 7 0 0 0 19 6 5 15 16 13 43 3 0 5 0 0 1 0 30 0 4 30 
26 0 13 0 25 17 0 0 9 20 0 25 1 102 10 30 18 31 35 20 18 5 11 3 35 31 37 0 9 4 7 29 0 37 44 14 5 0 16 31 15 4 3 0 9 1 0 31 34 12 0 0 0 26 0 
47 70 0 5 0 33 0 0 0 0 0 8 19 23 1 21 31 0 0 24 0 16 0 0 22 0 0 8 14 0 0 14 0 0 1 34 0 36 21 24 13 41 10 0 0 0 0 41 0 7 0 5 0 19 14 
0 0 31 24 0 18 0 2 31 4 0 2 0 14 8 12 17 40 0 0 0 15 0 23 7 0 18 58 1 0 0 0 15 28 23 0 17 0 6 17 38 9 0 1 0 0 25 0 0 0 0 0 0 0 0 
0 0 0 36 3 62 26 9 0 10 0 34 11 0 21 11 25 14 0 0 18 19 0 15 0 0 0 18 14 24 4 1 26 18 4 0 18 0 3 58 19 4 0 38 0 0 21 3 5 0 0 13 0 5 0 
0 58 18 0 36 0 5 27 21 38 24 28 0 0 8 2 2 17 0 0 31 10 10 0 0 0 6 0 17 0 0 1 17 52 9 0 32 0 1 17 70 2 1 5 0 48 0 7 0 48 0 31 0 11 0 
0 5 0 7 15 60 40 12 32 4 15 22 0 4 27 35 12 34 26 27 0 18 0 0 16 1 0 17 12 0 21 16 0 3 23 0 39 6 12 16 22 20 1 0 38 0 60 33 3 0 0 61 0 0 9 
0 0 6 0 11 0 44 0 15 33 0 1 16 15 0 38 0 5 11 0 8 0 24 6 0 7 6 0 0 6 1 27 0 0 0 8 0 2 3 17 0 0 33 0 0 0 29 0 0 18 44 36 0 36 1 
16 0 6 0 0 0 12 0 0 0 20 0 0 0 5 55 16 30 26 4 0 0 0 8 0 0 0 0 35 13 22 0 0 0 24 11 6 6 0 19 24 1 7 9 15 0 6 30 12 0 11 34 0 0 12 
0 0 22 41 37 0 1 0 0 0 0 0 0 7 0 0 0 4 0 32 0 0 24 2 22 0 0 0 0 0 0 10 0 5 0 0 0 0 0 0 0 0 0 36 50 0 21 0 0 7 0 0 0 25 0 
45 0 16 0 3 0 11 73 11 1 34 20 28 9 0 0 6 53 4 0 33 14 5 10 0 0 12 2 9 25 12 0 3 0 9 3 1 13 12 16 28 12 9 33 10 56 19 0 51 0 14 2 0 33 47 
46 0 0 0 4 0 1 0 0 0 63 13 20 14 0 34 0 6 0 12 0 0 0 3 0 10 0 14 17 3 0 21 12 0 0 0 0 0 38 0 40 22 0 1 0 17 34 0 48 10 0 0 42 12 39 
0 8 0 0 57 40 0 0 0 0 0 15 23 18 0 5 0 0 0 8 28 8 0 19 24 0 5 0 7 0 0 5 0 25 36 23 0 6 0 35 7 37 14 1 0 0 0 17 33 0 2 8 17 5 0 
75 0 27 0 0 0 15 9 0 0 0 0 0 0 8 0 9 0 0 0 1 7 0 0 15 13 9 0 1 6 0 0 0 33 0 0 0 0 0 17 0 0 39 0 0 9 0 0 3 0 21 4 0 0 23 
17 0 8 0 0 6 28 0 0 45 0 0 17 10 1 3 21 17 0 0 7 7 0 7 0 18 20 0 22 15 0 0 0 31 0 0 1 20 0 5 7 0 0 0 0 0 7 0 0 0 22 0 16 17 110 
5 0 7 4 20 36 6 32 0 0 0 19 15 42 0 12 12 23 0 4 1 0 15 0 0 0 0 0 78 0 0 3 0 0 14 0 0 0 9 0 0 0 5 36 0 0 1 14 26 21 0 0 0 0 15 
26 0 0 0 0 4 8 0 13 44 39 11 3 35 0 13 0 0 0 8 0 11 0 0 0 0 41 0 32 10 27 14 0 0 4 9 19 0 0 6 10 16 0 19 14 17 18 6 0 79 0 0 39 5 0 
24 0 23 0 0 15 0 0 11 7 23 10 33 17 31 20 0 0 0 0 0 10 0 0 24 23 0 0 33 27 17 16 0 0 0 0 0 0 0 0 25 0 0 0 18 15 0 16 0 0 0 41 3 0 0 
0 0 13 0 0 10 7 2 3 4 27 40 7 10 0 0 0 16 0 3 0 23 0 0 0 0 0 19 20 0 43 12 0 0 0 0 0 27 21 0 4 0 21 22 0 0 0 0 0 0 0 61 0 0 0 
0 0 5 37 55 31 5 18 10 0 6 0 29 0 0 7 11 3 1 1 5 19 2 16 12 0 19 20 16 1 19 9 8 11 0 11 30 0 0 43 81 0 0 16 55 0 0 20 0 0 0 0 1 0 0 
0 8 6 0 0 19 12 2 46 0 0 0 0 23 23 32 11 0 17 0 5 0 22 3 29 28 3 0 0 0 24 5 0 0 0 8 0 0 0 0 1 1 0 0 17 0 16 32 0 0 0 7 1 81 70 
51 26 13 22 0 17 0 45 11 15 40 0 4 3 25 55 0 0 8 20 0 19 48 13 0 13 17 1 0 0 4 0 0 4 33 0 24 0 0 39 0 25 0 0 0 0 28 35 34 7 0 0 19 7 0 
0 0 23 19 36 44 33 2 34 20 25 12 1 1 17 16 12 10 23 29 18 0 19 17 7 43 32 9 3 0 14 35 0 24 0 25 9 12 0 33 49 26 36 19 40 0 19 22 29 44 0 0 0 21 0 
0 42 1 0 31 44 18 1 29 0 0 0 3 0 0 11 23 8 0 7 0 4 24 45 3 3 2 0 14 0 0 1 23 2 0 0 0 29 21 22 0 17 14 49 0 0 0 0 0 18 7 0 0 0 0 
69 0 5 0 12 0 3 30 14 0 0 0 0 0 36 0 41 12 46 0 21 0 31 13 0 0 2 21 2 14 0 23 0 24 0 0 13 30 0 65 21 29 9 0 0 19 46 12 5 7 4 0 0 5 0 
37 0 38 40 0 21 2 10 54 4 14 0 0 2 9 0 38 31 0 5 0 16 0 0 22 20 12 20 0 40 1 5 5 18 21 0 0 53 0 0 21 0 0 73 0 0 22 0 31 9 0 0 31 27 0 
30 26 30 0 11 6 6 0 59 0 5 6 6 12 29 19 10 0 0 7 31 0 8 11 45 4 5 0 33 0 30 16 51 0 23 0 0 0 0 9 28 22 0 9 6 0 10 0 16 0 35 31 9 53 0 
