55 31
20 25 50 1 91 3 0 17 18 26 0 0 18 0 0 25 0 22 34 0 0 0 0 0 17 0 25 13 0 0 25 0 0 47 7 0 0 25 0 27 17 13 0 4 0 0 0 47 7 0 0 49 4 0 65 
23 46 0 6 0 0 3 0 6 1 0 1 0 16 37 0 28 0 0 16 0 11 11 23 0 0 14 26 0 27 0 15 0 12 0 0 6 0 0 0 14 0 59 0 0 0 0 46 0 11 7 38 1 25 0 
16 0 6 13 69 0 11 41 44 53 22 8 0 0 34 24 50 9 39 0 0 0 0 0 5 0 24 0 13 6 0 1 27 0 0 4 0 21 16 0 46 23 22 41 28 0 28 10 2 0 24 13 17 70 38 
18 0 7 32 16 0 29 3 6 48 5 0 0 0 0 5 32 0 36 35 16 0 0 0 10 0 0 0 0 0 24 3 0 0 10 21 10 28 16 2 0 0 0 0 0 0 11 0 31 2 3 0 4 29 56 
19 56 0 0 0 0 3 10 29 8 3 0 1 21 23 18 0 15 18 29 12 0 0 2 0 0 0 26 36 0 4 0 21 1 69 0 0 10 4 15 64 0 14 4 26 0 0 4 0 0 0 2 0 2 12 
3 21 0 2 0 1 0 0 10 47 0 0 26 12 24 0 0 0 13 7 0 23 27 4 0 9 10 27 0 0 0 29 3 25 0 4 21 1 32 7 25 10 12 35 0 27 0 0 5 41 11 0 0 16 0 
44 0 51 22 4 0 24 3 0 28 48 5 0 49 8 35 0 0 4 9 0 54 19 41 18 17 0 17 20 17 3 2 0 15 21 25 3 77 15 8 0 28 5 0 0 62 27 7 76 49 38 20 0 0 0 
57 0 4 33 0 0 3 0 68 0 0 17 0 12 6 31 11 0 10 3 5 5 7 22 18 12 0 27 1 18 1 29 7 17 3 0 23 0 7 3 32 5 9 0 42 29 38 0 53 0 0 15 0 31 44 
6 30 42 47 46 21 1 23 0 35 0 0 4 38 29 17 0 0 27 27 4 53 29 33 0 0 0 18 16 0 56 30 19 0 0 9 18 9 3 4 0 38 23 42 23 47 0 0 0 0 124 9 0 8 15 
1 73 0 27 35 0 11 23 11 0 4 0 0 0 10 15 0 0 21 0 1 15 18 10 0 18 0 0 3 21 4 0 21 14 5 0 6 19 0 20 2 8 4 35 0 0 0 10 7 20 3 0 0 0 17 
1 43 39 0 0 0 0 9 17 0 10 2 0 0 6 0 0 0 0 24 0 13 2 0 44 0 0 0 21 0 1 14 0 9 11 0 39 4 0 3 0 8 0 20 43 15 0 0 41 21 55 12 31 22 0 
31 0 11 0 32 0 48 0 32 0 0 0 0 0 0 0 0 0 0 14 0 0 0 4 14 0 1 1 0 0 30 10 0 0 0 3 32 16 0 20 34 0 16 0 20 2 0 0 9 0 6 0 18 0 60 
8 0 2 3 37 29 11 0 28 6 0 22 4 0 0 0 25 23 18 0 8 3 19 6 7 15 0 0 15 1 13 11 2 3 31 12 63 0 0 31 23 35 0 0 3 0 20 0 39 2 4 42 0 14 0 
0 9 0 0 0 38 0 0 0 0 9 16 16 0 0 8 0 7 0 0 0 0 0 5 0 16 0 14 17 4 0 0 10 17 7 0 0 0 2 0 1 23 2 41 0 2 0 0 5 0 16 0 0 0 27 
33 45 5 2 0 2 86 16 0 31 12 39 25 0 10 24 0 0 32 0 34 0 0 16 1 13 16 20 0 0 14 0 0 33 7 3 11 29 15 54 0 0 0 0 7 0 42 41 0 0 11 2 0 25 34 
0 0 0 10 13 14 0 1 0 0 0 6 0 15 0 0 12 0 19 0 2 0 2 2 0 0 0 0 6 0 0 27 0 15 3 4 8 19 0 9 0 10 14 0 0 0 10 13 9 0 7 3 24 0 0 
7 19 10 24 0 14 0 1 0 0 32 0 16 0 0 0 24 0 4 1 20 11 0 0 0 0 0 32 0 15 0 10 0 21 0 8 15 8 7 13 18 0 11 1 13 1 5 0 0 37 0 14 13 3 0 
38 0 0 24 3 0 0 0 0 0 6 10 29 14 5 15 0 9 0 17 0 5 0 14 0 0 26 46 17 9 7 18 5 0 0 19 7 10 0 0 3 29 42 1 0 22 11 34 0 0 0 0 26 0 19 
65 46 0 0 0 30 45 40 3 0 0 0 0 47 0 6 16 0 21 2 17 8 0 10 0 25 21 0 0 5 30 0 12 21 3 42 26 15 0 27 4 8 3 0 9 0 6 18 16 0 37 48 22 0 0 
0 10 56 4 0 14 44 54 23 7 0 67 0 0 11 19 23 2 13 0 0 3 11 0 9 0 15 0 11 0 22 0 1 5 2 17 34 9 1 12 0 31 4 0 5 0 6 7 64 0 35 9 58 3 5 
20 21 14 0 0 20 5 41 0 37 31 0 0 1 7 0 0 7 18 0 8 0 28 0 0 0 10 40 20 19 8 10 4 0 0 0 21 5 36 5 8 31 10 0 5 0 33 0 41 0 0 15 10 0 0 
42 0 0 20 0 32 18 0 0 16 0 2 0 40 14 6 0 32 9 4 50 0 0 0 0 0 0 0 17 9 27 10 0 0 0 17 1 38 0 1 13 0 5 7 13 0 7 0 0 50 61 0 63 21 0 
0 0 14 0 47 0 0 0 0 0 4 8 17 31 1 29 27 0 0 0 13 36 8 0 11 0 0 0 25 14 7 2 0 4 12 0 0 0 0 0 0 3 9 0 26 15 33 5 0 0 0 89 22 2 1 
61 36 0 0 23 0 13 0 0 12 6 1 0 23 34 0 34 0 17 0 1 0 0 23 0 0 0 0 0 17 0 11 6 0 0 0 23 12 7 0 8 32 0 0 0 0 30 33 0 20 34 51 0 0 0 
10 2 0 0 32 28 0 31 2 22 14 30 0 6 6 42 38 37 13 0 18 1 22 0 0 0 19 0 14 0 0 0 25 12 0 0 11 0 22 0 36 5 7 0 5 53 30 0 0 0 0 0 9 1 35 
25 16 0 30 95 7 2 2 27 61 0 42 13 0 8 0 35 9 18 37 0 3 0 14 0 0 4 1 18 18 30 21 0 30 1 1 0 19 4 0 13 10 24 15 3 0 5 36 39 13 5 47 21 37 35 
0 21 61 15 20 0 23 0 36 0 4 12 0 17 0 0 0 0 15 0 0 0 0 0 0 0 0 0 0 9 31 0 37 0 0 0 25 0 0 0 5 10 0 0 50 13 0 0 3 1 24 20 4 26 20 
45 19 0 3 46 21 0 0 0 22 0 2 10 0 0 12 2 0 4 2 52 0 12 0 0 3 19 3 12 0 0 22 0 18 0 15 0 0 0 11 12 0 0 0 17 26 15 0 0 66 30 0 4 36 0 
15 2 47 1 22 0 0 0 39 3 0 0 7 8 23 15 0 0 4 0 32 6 10 0 26 0 0 0 16 0 23 0 0 0 0 0 0 23 0 18 4 0 0 0 0 15 15 26 46 0 25 0 32 0 4 
0 19 43 0 0 7 23 0 14 0 40 12 0 0 19 0 28 27 11 0 19 0 14 30 0 0 0 0 0 11 0 0 0 19 0 0 0 31 4 18 31 0 0 0 14 43 6 0 0 0 40 0 0 49 3 
0 2 16 17 4 21 0 0 24 6 0 6 3 53 0 0 0 0 20 0 6 0 10 0 0 0 1 0 20 26 0 0 31 0 0 0 0 0 0 9 0 0 0 17 0 0 7 15 55 0 0 36 0 2 7 
