55 31
0 40 39 12 0 0 22 0 10 1 0 29 10 0 0 0 0 85 0 0 0 0 0 0 30 32 17 0 3 0 0 0 0 0 0 0 0 34 0 0 18 40 10 0 0 18 29 22 0 0 0 26 35 0 0 
28 0 7 0 38 1 0 0 0 9 0 26 3 0 0 0 11 0 2 0 9 38 0 8 6 13 1 26 0 0 21 8 24 0 40 26 29 0 4 17 0 0 21 32 0 24 0 1 9 0 0 21 0 31 0 
0 0 17 0 25 0 0 3 0 0 3 0 20 0 0 3 0 13 10 0 0 27 0 17 41 0 0 0 0 25 0 0 20 0 0 0 0 0 0 0 17 40 0 36 0 2 0 16 0 0 0 0 4 7 0 
10 0 0 2 0 36 21 0 19 0 12 0 1 0 0 0 0 14 6 10 0 6 0 24 0 19 0 70 0 0 0 0 21 5 0 4 26 0 45 15 0 37 0 5 0 26 0 24 0 0 0 0 0 2 59 
39 0 0 0 0 74 49 24 18 0 34 0 26 9 0 5 0 15 0 20 0 0 9 5 5 25 16 0 46 1 0 0 0 16 34 23 0 31 24 43 14 0 0 4 16 0 0 14 0 0 16 44 2 48 58 
0 30 13 15 25 0 0 1 6 10 29 0 5 1 0 3 0 9 19 0 0 0 0 0 9 3 6 22 5 0 18 30 28 0 3 42 16 4 1 29 0 0 0 2 22 0 1 15 2 25 27 13 37 20 2 
20 11 0 0 0 0 30 0 0 0 0 0 0 0 0 0 44 10 6 0 0 7 0 0 0 0 0 0 11 8 0 6 12 21 0 15 0 2 10 0 0 6 23 0 0 58 47 6 0 10 27 0 24 0 53 
0 20 0 0 0 0 53 0 0 0 35 24 0 12 0 0 0 0 18 9 10 22 0 0 34 0 0 0 0 0 0 0 22 0 0 8 2 16 2 0 0 9 0 6 13 7 50 23 0 0 0 2 2 8 48 
0 39 8 0 7 0 0 0 3 0 6 0 10 36 0 0 0 0 8 7 31 0 0 27 0 17 14 0 8 20 0 16 0 18 15 0 4 0 6 0 0 0 41 22 11 1 0 21 15 13 17 0 0 0 15 
110 59 18 23 41 19 76 16 41 134 0 17 0 34 0 6 0 13 0 9 7 32 11 20 32 0 1 0 0 0 26 5 20 0 4 5 0 3 27 0 0 0 3 16 35 18 21 36 0 17 65 0 72 39 0 
0 27 10 0 12 0 0 0 10 40 38 0 10 0 0 4 15 0 0 0 9 4 0 0 2 0 0 0 15 0 0 9 0 0 19 0 0 0 0 9 9 32 18 7 0 12 0 72 16 0 0 0 0 0 0 
0 17 0 0 0 0 0 15 0 0 0 0 0 0 0 0 0 36 0 0 0 4 0 23 0 12 4 8 0 0 0 6 0 0 7 11 12 0 0 0 8 0 7 20 0 0 32 0 0 0 0 0 0 36 9 
38 49 53 10 0 29 33 0 0 11 35 9 10 0 3 0 17 22 23 0 2 9 32 0 0 7 0 4 0 4 25 0 0 19 29 0 3 0 0 25 23 0 0 0 11 43 0 0 3 0 36 0 0 37 32 
0 16 0 5 0 0 0 1 0 0 36 0 0 0 0 0 0 4 0 0 0 33 6 0 0 15 28 0 19 0 18 0 22 4 2 3 4 0 22 13 15 11 39 0 0 0 0 6 3 0 0 2 22 6 68 
46 0 49 17 16 41 44 6 0 0 6 0 5 5 0 15 3 38 23 0 15 0 0 0 12 22 0 0 0 0 27 0 0 4 19 11 4 8 23 6 34 3 0 8 4 17 87 4 0 6 0 17 28 0 0 
8 0 0 45 8 0 6 0 27 73 0 9 0 0 40 0 0 42 0 7 3 7 5 0 20 11 0 5 0 0 0 16 2 9 2 17 0 19 0 0 0 24 0 0 7 37 32 22 31 0 0 40 17 0 4 
4 9 21 0 0 7 0 0 5 0 11 0 50 11 0 29 0 29 0 6 10 11 5 0 0 10 10 26 0 7 57 13 11 0 50 3 18 8 0 12 1 14 5 0 16 4 0 11 13 10 16 33 0 0 42 
10 6 85 34 12 1 0 0 0 0 7 0 0 28 15 24 12 0 20 36 6 0 0 6 0 17 23 5 23 11 3 1 31 11 0 1 1 34 0 3 6 18 40 24 0 10 1 86 12 0 0 0 13 35 20 
55 0 28 0 18 31 0 5 0 35 3 0 23 27 0 9 0 9 0 0 4 0 8 9 0 0 0 25 0 0 20 9 12 22 30 0 31 4 0 0 45 32 0 0 0 0 0 21 0 49 10 9 24 0 7 
0 0 0 0 0 30 3 25 0 3 0 0 11 0 0 0 1 8 0 15 0 29 13 11 3 8 0 0 0 0 18 18 15 0 15 43 5 0 11 0 8 0 10 17 4 0 0 0 18 18 0 0 0 32 0 
0 59 9 0 0 5 0 0 4 34 13 0 4 6 0 0 5 0 9 3 0 0 0 0 0 0 40 57 23 7 0 0 0 0 0 4 0 27 0 6 0 2 2 31 4 34 10 5 0 22 30 23 0 0 0 
20 86 0 10 42 0 6 0 19 0 16 0 5 10 0 0 9 1 6 12 0 11 0 23 26 0 0 4 0 10 20 10 24 0 14 25 30 37 5 10 0 14 41 0 5 11 73 11 0 5 61 0 0 0 0 
0 0 23 1 0 0 17 0 12 9 9 0 21 15 0 0 24 0 8 37 24 0 0 0 43 59 0 10 18 8 0 4 5 25 0 17 0 3 9 0 33 0 12 0 6 0 0 0 0 13 0 27 0 0 0 
0 43 6 0 48 0 52 0 0 30 16 0 6 0 0 26 0 0 0 13 5 5 17 6 14 0 0 2 0 7 24 0 0 0 0 0 14 0 9 19 0 25 0 3 93 33 0 23 0 0 0 21 0 0 0 
0 2 4 18 27 24 0 20 1 49 37 35 6 0 0 0 0 28 1 0 0 0 30 0 0 17 8 41 0 0 0 16 2 17 1 26 54 23 0 12 0 29 0 0 34 7 0 0 0 41 42 6 5 0 18 
0 12 7 60 0 0 17 0 40 9 17 35 0 12 4 0 0 0 7 11 31 3 0 0 18 10 15 22 19 0 39 1 18 0 16 48 0 7 0 0 3 38 15 24 35 26 5 3 13 0 29 36 46 0 0 
20 3 34 10 15 16 0 50 0 14 0 0 13 0 0 0 0 39 1 31 0 0 30 14 0 13 22 0 0 22 30 0 0 0 18 0 53 0 8 0 0 0 35 7 12 0 0 4 38 1 5 29 24 0 4 
66 12 2 1 0 73 0 15 17 0 10 0 0 13 37 8 0 0 19 0 0 0 3 1 0 1 4 22 0 7 0 11 10 11 0 10 4 6 21 0 0 3 10 43 22 0 23 0 3 1 22 22 47 0 23 
36 3 18 0 48 0 0 0 0 13 19 0 0 10 5 12 0 5 0 0 0 15 0 7 0 64 40 0 0 46 9 0 14 3 0 23 55 13 38 1 0 26 12 9 8 6 17 33 19 23 0 1 112 0 29 
86 33 53 0 70 0 35 0 36 35 17 26 25 4 0 0 3 0 30 29 0 6 71 0 22 6 12 5 25 25 0 1 22 23 72 0 38 26 34 3 7 73 1 31 2 0 48 21 42 27 0 1 12 0 25 
27 0 0 0 14 30 18 0 0 3 42 27 3 3 34 0 22 24 14 9 26 0 0 0 10 5 0 0 0 0 5 15 0 0 20 0 11 26 68 0 0 65 0 11 0 0 43 9 3 25 1 40 0 25 0 
