55 31
0 0 31 0 106 0 0 3 0 0 12 0 24 0 24 0 5 0 15 27 0 29 0 0 10 0 34 0 0 10 0 6 0 43 25 16 70 0 19 0 0 5 0 27 40 0 0 0 18 0 39 33 0 0 0 
43 0 0 0 25 0 0 0 0 37 2 18 18 0 0 15 0 0 0 0 0 0 0 0 13 0 9 34 22 10 15 10 5 0 25 12 26 14 0 0 0 13 0 61 36 20 0 0 7 0 0 46 9 16 0 
30 7 0 0 0 0 30 0 14 1 13 0 39 0 12 0 0 0 0 0 10 6 0 0 20 0 11 0 0 13 30 4 20 20 5 0 24 0 0 17 0 0 0 22 13 0 0 0 0 0 0 60 20 0 0 
0 0 0 0 35 0 15 0 26 10 19 0 15 19 0 5 0 34 0 0 5 0 30 10 2 0 18 0 21 4 0 0 0 10 27 0 11 11 0 19 0 1 4 66 0 0 0 8 2 84 11 17 21 49 13 
49 59 0 0 0 22 5 2 41 17 4 9 30 0 0 37 20 12 42 0 0 10 4 60 0 0 9 0 1 0 2 28 11 2 0 3 0 14 6 0 0 5 71 0 31 44 0 0 21 8 0 0 63 0 7 
0 15 0 0 9 4 10 0 0 65 0 0 12 29 0 32 15 0 1 1 0 8 36 0 15 5 4 24 10 3 0 0 13 0 0 34 30 10 0 3 31 0 10 26 3 12 0 39 2 15 0 14 30 0 7 
0 7 20 9 20 17 0 19 69 37 5 8 4 13 0 13 2 11 0 0 0 9 1 7 38 13 15 0 4 0 23 13 15 54 0 24 0 0 0 0 0 39 12 7 0 40 40 23 2 2 0 0 0 20 0 
0 0 0 0 0 15 11 0 42 8 70 0 0 0 21 0 0 37 0 1 7 0 31 27 2 20 0 26 6 0 0 0 0 0 0 0 0 23 0 33 0 10 4 4 0 0 24 37 0 0 48 0 27 37 33 
0 12 39 0 0 13 0 5 9 0 0 9 15 58 0 26 2 33 0 6 19 0 11 10 12 17 2 0 2 6 14 17 5 14 21 0 18 0 18 15 0 88 0 11 15 0 16 0 3 16 0 0 0 10 49 
10 39 7 0 58 36 0 41 0 7 6 16 1 0 47 0 13 0 0 0 0 15 20 7 2 28 19 0 0 27 0 12 7 28 17 11 14 11 1 0 3 59 4 5 11 0 0 43 43 0 12 0 36 0 40 
43 12 0 0 0 10 0 0 0 9 0 10 3 0 0 2 0 0 38 0 28 42 0 18 9 25 0 0 1 11 0 0 0 0 31 1 18 12 0 16 13 16 12 31 26 0 0 0 28 12 6 30 19 0 32 
0 0 8 0 28 40 0 0 8 5 13 0 25 0 35 0 0 19 26 0 0 0 6 2 38 0 0 11 15 14 0 19 11 0 2 0 0 25 2 0 6 4 0 29 23 35 12 0 0 67 0 23 47 22 7 
42 74 0 2 0 20 56 0 0 24 3 12 27 7 0 16 0 7 38 29 3 0 7 22 23 16 15 0 20 5 17 22 44 24 33 0 66 0 27 33 0 12 0 0 22 0 46 8 33 1 0 16 56 49 0 
57 40 0 0 0 0 21 54 16 34 23 0 0 0 0 0 0 16 1 0 0 16 15 18 21 6 13 17 5 0 17 26 5 0 9 13 5 13 7 0 10 40 14 9 5 5 0 0 0 96 26 0 0 0 1 
8 3 0 14 1 0 11 22 22 0 0 0 0 27 0 0 0 3 9 0 34 5 1 5 0 10 28 19 20 23 0 0 31 16 7 24 4 0 0 11 54 17 0 0 27 0 16 7 32 0 7 1 14 2 69 
2 41 0 0 3 0 9 79 0 8 0 7 16 12 13 11 0 6 0 12 35 34 0 20 5 0 0 2 0 17 10 0 8 0 19 0 0 10 0 15 28 0 10 29 27 0 7 0 0 0 10 0 31 59 0 
0 0 0 0 0 0 12 0 4 18 43 2 0 16 0 0 0 20 8 0 1 20 11 0 4 17 0 0 10 12 0 12 10 0 3 0 21 3 20 2 1 20 10 0 6 0 21 0 0 0 38 0 0 44 0 
51 1 6 47 38 18 15 0 0 0 0 0 0 0 0 0 0 0 0 45 0 6 0 18 8 21 2 20 2 0 10 3 34 0 0 0 0 18 0 8 1 0 38 0 0 6 55 12 0 0 107 0 0 11 0 
0 0 14 28 7 0 11 0 0 9 68 14 3 0 7 6 14 2 0 24 18 20 0 1 17 0 0 0 0 4 0 34 13 5 8 12 36 0 28 11 0 17 0 3 0 5 10 37 0 0 0 34 0 1 7 
10 0 0 0 0 0 11 0 0 0 29 26 47 0 0 13 25 7 0 4 21 0 4 11 0 13 5 0 0 0 6 0 0 7 0 9 21 0 0 39 0 75 0 29 35 0 2 0 25 0 0 0 0 0 0 
0 0 20 0 42 10 0 6 0 47 0 0 4 21 0 10 0 0 0 0 4 0 8 20 7 0 0 21 4 0 8 3 3 0 0 14 0 0 3 11 4 3 0 47 11 0 24 25 21 9 0 27 18 0 0 
0 0 0 0 0 17 36 46 6 0 44 37 6 13 5 36 10 31 7 5 0 6 48 0 35 14 0 0 1 1 10 0 39 0 2 3 18 0 0 0 24 20 0 0 9 20 20 17 68 0 8 63 1 53 16 
0 20 0 0 0 34 130 1 4 29 23 8 0 43 15 0 25 9 0 6 0 0 3 0 35 0 17 10 0 0 3 0 0 32 28 3 34 0 29 1 9 47 29 3 17 0 0 0 0 0 0 21 13 0 48 
6 0 6 27 12 0 6 0 0 0 5 28 15 0 18 0 17 10 21 12 11 0 0 15 0 0 13 10 22 0 32 6 33 17 22 4 13 26 15 0 0 23 8 5 12 0 13 0 14 0 17 0 0 0 2 
0 0 0 24 0 9 9 5 0 0 22 15 10 0 9 0 20 27 9 0 0 0 0 0 0 0 0 15 21 0 6 0 0 0 0 0 8 0 8 0 4 10 0 0 0 0 1 0 24 11 0 13 0 0 11 
0 37 0 23 0 15 13 34 67 24 2 0 37 0 0 12 0 0 1 27 15 5 0 15 15 1 7 24 0 5 18 12 0 21 52 7 9 20 37 2 22 0 2 13 0 0 0 0 0 0 42 0 10 19 29 
0 12 20 0 15 0 25 0 30 10 9 0 0 36 37 11 0 36 6 12 0 0 24 3 6 0 4 26 13 21 0 25 0 0 0 0 10 0 48 0 0 0 20 0 23 0 32 0 0 41 0 25 0 85 0 
0 37 0 0 0 0 0 0 12 32 24 66 0 0 0 0 0 0 0 6 28 22 0 20 21 24 5 12 0 35 0 0 0 0 0 0 30 0 37 13 29 40 31 7 0 0 0 0 0 11 10 41 0 32 0 
31 0 39 0 0 39 0 0 0 23 0 0 23 0 0 0 5 2 0 10 0 0 9 0 0 23 0 0 23 12 22 30 2 0 3 54 34 0 10 0 0 16 0 13 39 0 0 0 0 0 15 21 64 0 0 
0 0 0 10 0 0 1 43 0 0 0 10 66 3 37 103 12 21 0 29 15 21 0 2 11 0 25 0 12 3 0 0 15 0 23 0 38 4 17 11 15 0 0 0 24 0 8 32 29 34 8 3 46 47 42 
0 0 6 0 5 0 36 47 6 0 29 34 0 0 0 0 20 16 7 12 5 0 15 29 0 0 0 0 24 5 17 17 2 12 14 0 5 0 0 32 0 0 0 27 25 0 16 18 0 27 0 0 3 0 0 
