55 31
0 0 0 0 31 0 0 33 14 0 2 9 0 25 19 0 49 0 0 0 9 23 27 0 0 0 0 6 0 0 20 0 0 6 0 40 21 0 0 22 5 14 15 0 79 48 0 0 0 42 0 0 29 0 0 
0 36 44 42 48 54 18 24 0 0 0 19 29 6 47 11 32 13 0 0 25 0 16 0 43 15 0 0 23 0 0 18 28 26 42 0 44 38 5 24 0 12 4 23 23 71 11 1 0 49 26 46 56 17 5 
49 73 43 0 0 0 20 0 0 36 0 0 0 7 4 32 1 7 22 0 3 0 0 25 53 0 0 16 12 23 0 13 0 0 0 21 19 0 18 0 1 28 0 29 0 15 25 42 1 72 49 19 0 15 0 
0 0 3 9 0 47 40 0 0 14 19 10 15 0 0 0 0 0 0 0 0 6 4 29 41 0 0 19 0 21 3 21 0 1 0 15 0 10 0 0 0 18 0 17 2 9 40 0 0 0 36 24 60 0 35 
35 0 10 21 0 6 26 0 29 0 39 42 31 0 0 0 47 0 6 0 0 20 0 0 18 0 0 0 0 0 0 0 4 12 18 22 0 8 0 17 0 0 31 27 20 12 7 0 38 38 0 0 25 35 0 
0 13 0 0 42 0 0 15 28 8 20 15 8 5 27 5 8 11 0 3 5 0 9 3 3 26 0 2 0 0 22 0 28 0 5 0 28 0 0 1 0 0 0 12 0 20 0 0 14 31 24 0 22 5 0 
0 0 24 27 0 37 0 20 20 0 0 0 0 6 0 0 15 0 0 27 16 0 26 0 8 17 0 20 20 0 46 0 0 3 0 0 0 0 0 5 35 0 0 0 19 43 0 0 26 0 31 12 2 0 15 
14 22 0 3 0 0 6 0 0 0 41 0 0 11 7 11 22 0 0 6 6 10 4 22 3 0 11 22 25 0 17 0 0 3 0 0 7 20 0 0 19 0 0 13 0 73 0 0 0 0 0 19 0 0 0 
14 24 0 32 19 0 0 35 0 0 0 30 22 35 1 22 34 3 0 0 6 0 5 0 16 43 16 7 7 21 12 0 0 26 7 21 32 25 31 23 10 23 19 0 0 0 0 7 36 23 0 0 0 0 0 
0 16 0 4 42 0 40 30 0 0 0 0 23 0 10 10 38 0 0 18 0 6 0 15 10 3 0 11 0 18 0 22 0 13 0 29 21 30 0 0 0 0 0 0 1 0 29 0 0 0 35 17 0 29 0 
17 28 4 0 0 21 84 0 0 7 19 5 6 5 9 0 6 0 7 0 0 0 3 9 19 19 21 0 0 20 0 0 0 44 26 18 18 12 25 0 5 2 0 17 12 2 0 4 1 23 17 0 5 60 20 
0 25 0 17 16 10 10 0 0 26 15 0 0 21 0 5 0 22 0 19 21 5 12 0 7 0 0 23 33 0 24 0 4 0 0 39 0 0 0 22 14 0 18 0 0 0 0 9 0 13 0 0 0 4 27 
10 0 0 25 12 8 0 2 45 40 0 0 27 0 0 29 0 0 0 6 22 0 0 10 7 0 0 0 33 14 0 23 0 10 13 0 21 1 0 27 12 21 7 0 0 0 0 13 0 45 0 2 15 66 0 
0 15 12 4 0 18 47 6 6 61 10 0 0 13 7 7 36 0 15 6 0 0 0 1 0 0 16 0 0 1 0 0 0 0 7 9 19 8 0 30 11 6 26 9 0 0 40 38 0 39 7 1 0 0 0 
40 69 4 0 49 0 101 2 14 1 37 0 4 9 0 0 33 7 36 0 0 0 5 31 6 0 0 0 7 1 15 0 31 27 0 29 1 15 28 38 40 14 4 0 0 0 4 5 0 74 0 29 46 3 0 
49 35 0 0 0 0 0 0 0 17 0 3 0 0 46 3 62 12 5 0 0 4 9 0 0 0 25 0 0 13 0 0 11 35 0 1 48 0 2 0 0 15 41 0 0 0 0 13 0 34 0 0 31 3 0 
8 0 0 0 0 0 26 34 8 0 19 43 0 10 1 1 32 0 0 10 0 5 0 10 23 0 0 0 4 0 0 0 1 0 0 0 30 0 0 0 0 46 10 0 20 5 0 0 26 0 1 0 0 7 6 
11 0 0 0 39 19 18 9 0 0 41 34 0 9 9 17 0 0 0 12 0 0 17 18 4 8 14 0 23 0 0 17 29 4 6 7 6 22 3 17 0 1 43 39 0 34 8 0 17 7 1 2 31 15 0 
0 0 0 0 0 0 0 38 0 0 0 21 35 3 0 0 0 0 6 0 22 18 0 0 16 0 1 0 1 0 0 0 0 7 0 0 24 10 17 0 26 8 34 11 0 53 0 1 3 16 0 20 5 0 0 
6 0 15 0 0 0 16 5 0 0 5 18 0 0 91 34 13 44 32 11 0 0 18 0 0 0 25 0 1 25 0 2 0 0 0 0 0 20 11 11 0 20 0 1 0 4 0 1 40 3 32 9 11 45 37 
0 0 20 21 0 37 40 0 6 4 0 18 0 27 0 0 26 0 24 3 0 5 0 2 21 25 0 11 0 0 20 0 0 1 15 6 0 0 38 0 65 12 9 16 0 0 13 0 15 9 25 13 29 12 0 
51 15 0 0 4 0 0 32 0 37 0 5 17 53 27 15 23 0 72 0 34 6 5 14 4 1 8 9 1 17 0 16 23 0 0 0 49 11 20 7 14 7 0 22 0 46 26 13 11 8 0 68 0 40 0 
76 1 0 30 3 8 18 3 69 2 40 37 0 39 0 0 8 0 31 9 16 0 0 23 0 0 16 19 35 0 0 0 7 0 0 5 0 29 10 18 0 0 0 33 2 0 5 0 48 31 8 46 5 0 0 
8 45 0 40 0 0 0 2 23 20 0 7 0 4 0 19 0 0 0 3 0 8 2 12 2 3 2 0 2 14 11 2 0 6 12 14 0 0 0 26 19 38 12 0 13 0 0 21 0 16 9 12 5 23 0 
8 0 103 0 12 0 2 30 8 17 39 4 0 0 5 0 0 0 20 0 0 0 24 5 35 8 0 25 0 0 0 0 0 12 0 2 11 15 0 37 11 0 1 37 19 0 5 0 46 29 0 2 0 0 30 
0 0 5 2 0 0 0 3 33 18 0 0 39 0 0 0 24 0 14 0 0 24 0 0 0 0 0 0 0 4 0 0 42 27 24 0 3 15 0 0 14 33 9 0 12 0 20 15 0 0 17 43 15 0 45 
44 24 57 0 0 0 35 0 64 24 15 5 0 4 0 0 5 1 5 0 11 5 2 9 24 0 10 24 0 6 0 13 10 0 0 0 16 42 14 0 0 59 22 2 21 5 9 0 3 0 5 13 11 51 10 
63 0 0 13 35 0 15 1 4 0 27 26 0 0 25 0 0 11 17 0 0 20 4 14 0 29 3 13 15 0 18 0 11 9 6 27 28 46 0 12 32 12 10 6 0 20 20 16 20 0 17 60 2 0 0 
16 11 75 3 40 3 0 0 0 27 0 0 11 0 0 19 1 0 3 0 0 29 0 0 0 2 27 2 0 0 20 0 30 0 19 0 20 0 0 0 28 28 0 0 58 0 27 0 0 0 49 9 0 0 0 
0 1 35 16 26 0 18 0 44 7 0 59 26 0 40 0 82 1 49 41 26 12 10 3 13 0 11 3 20 37 18 0 1 19 0 2 0 40 20 28 16 11 16 9 29 23 3 35 28 73 47 0 61 0 42 
0 14 0 0 0 0 26 25 18 0 24 0 3 0 0 14 12 0 37 6 44 0 5 1 27 14 42 0 0 20 0 17 39 0 15 14 0 8 20 11 0 28 11 24 24 27 0 0 8 31 17 0 0 27 0 
