55 31
0 6 8 0 21 0 102 0 0 4 0 0 30 4 19 0 0 28 0 14 18 0 0 13 12 0 0 0 0 0 20 23 0 35 17 0 22 25 0 22 34 0 0 0 11 33 0 0 0 0 44 37 0 0 27 
34 0 0 24 37 16 16 46 0 14 21 23 0 3 4 0 19 20 21 34 1 11 26 0 16 0 2 25 28 0 0 0 0 0 41 0 0 1 0 0 30 0 0 25 9 21 46 37 35 0 0 19 0 32 0 
1 1 0 0 39 27 2 0 0 20 0 18 20 5 2 0 6 0 19 5 9 21 1 0 8 0 0 14 0 2 7 27 16 0 45 0 0 7 2 0 30 0 10 0 0 6 0 0 0 0 14 0 10 8 0 
52 0 38 0 20 5 0 0 44 0 2 0 0 8 25 37 0 28 12 0 0 8 15 26 0 0 20 14 11 0 0 0 21 38 26 0 2 5 0 9 64 13 32 0 49 28 0 0 9 26 0 0 39 41 13 
2 0 22 0 0 0 0 7 29 0 0 0 2 18 34 0 5 0 0 5 0 0 34 0 7 0 0 0 0 6 12 18 11 11 5 0 0 25 0 12 12 0 0 0 14 2 0 26 18 58 0 10 12 0 6 
0 0 0 0 0 0 13 12 0 48 5 26 6 0 0 0 0 24 0 18 20 17 0 0 11 21 0 13 0 0 0 7 16 0 3 0 5 22 17 7 7 14 5 0 0 0 28 0 16 49 0 1 0 46 3 
0 3 0 23 3 0 0 0 20 0 1 0 9 1 2 0 30 0 38 1 12 0 0 17 3 3 0 3 24 12 36 3 0 10 0 4 0 6 0 0 10 16 0 0 0 4 0 2 32 21 0 0 0 0 17 
0 0 0 0 41 0 0 0 6 0 0 24 0 5 0 0 0 20 2 18 20 25 2 0 0 10 20 0 0 17 7 1 0 0 9 28 0 36 4 23 0 40 0 9 7 0 42 0 0 3 0 7 0 16 45 
23 0 6 30 19 45 45 42 0 8 75 0 0 0 0 11 0 0 0 18 22 0 17 20 9 0 37 0 23 7 0 31 10 56 0 20 0 4 12 6 2 4 3 20 0 0 0 21 0 21 21 70 19 0 16 
0 0 13 0 49 23 73 15 14 0 12 0 4 12 4 7 3 50 22 0 15 0 0 0 0 12 0 0 5 9 0 0 8 33 6 0 0 0 9 0 29 0 36 16 5 1 0 25 0 13 0 0 0 19 0 
17 49 8 0 32 32 0 38 32 1 2 29 38 33 27 39 4 20 18 8 16 0 18 6 9 9 4 27 21 6 24 2 22 16 18 0 3 51 0 0 44 4 17 0 4 42 61 33 7 14 19 4 20 0 42 
64 0 0 0 0 49 38 10 0 0 5 0 0 0 0 0 34 0 0 0 3 19 0 0 0 16 2 27 0 0 21 0 28 7 10 5 0 37 4 5 13 0 0 17 1 0 0 0 0 0 44 0 0 30 49 
36 14 39 0 4 0 0 18 0 0 0 43 11 14 0 0 4 21 0 58 0 0 0 0 29 18 13 0 0 0 6 30 16 3 8 26 53 8 7 0 26 58 1 24 9 0 15 35 16 4 0 0 0 41 48 
48 47 0 36 48 17 0 13 4 0 0 28 19 0 11 0 0 7 40 16 3 26 0 12 7 0 13 0 20 0 0 0 15 0 21 0 1 0 14 38 0 3 11 5 0 4 0 10 36 6 32 0 89 0 0 
40 0 0 0 35 0 48 3 0 29 0 31 5 32 0 9 0 12 0 15 38 19 0 0 32 0 19 0 0 25 19 10 0 13 0 0 36 28 0 19 0 7 31 0 0 13 13 0 0 0 0 0 0 27 18 
114 7 8 0 3 3 0 84 8 7 0 0 0 0 10 0 2 11 16 0 0 0 0 29 0 0 0 22 0 0 17 0 50 0 0 0 0 10 8 13 32 113 0 12 44 0 13 37 47 22 18 46 42 0 47 
48 0 27 0 35 23 37 1 6 35 0 0 6 0 0 19 0 0 0 0 0 0 0 0 0 0 0 0 14 39 25 0 8 10 0 0 0 5 10 48 7 7 14 38 35 0 0 0 48 11 0 0 0 0 13 
31 0 0 0 0 16 16 2 0 0 0 19 70 28 0 38 24 11 14 0 27 0 0 4 18 11 37 7 0 18 19 32 6 0 8 0 0 0 8 4 31 52 9 0 4 4 0 13 0 23 0 36 8 41 17 
10 0 30 5 37 16 19 0 5 0 4 0 22 39 20 0 0 27 0 0 51 0 15 24 0 0 23 31 6 11 0 10 24 27 15 13 0 0 0 9 0 37 7 0 10 0 0 23 1 23 45 0 71 7 21 
0 0 21 33 7 3 0 0 0 0 0 4 11 0 2 46 0 17 0 10 29 11 0 11 21 1 0 13 24 0 22 0 27 0 3 0 0 0 7 26 10 0 11 0 41 0 1 11 5 0 0 0 22 0 58 
5 15 0 8 0 13 20 0 14 2 16 6 0 0 0 15 13 22 34 6 0 0 14 0 27 1 1 0 4 0 8 0 16 0 4 0 0 8 17 13 0 9 0 0 45 0 0 0 10 0 0 36 34 0 1 
0 24 7 0 51 44 3 23 0 0 12 0 4 14 11 0 0 41 8 1 0 10 1 11 0 0 4 0 12 36 0 10 25 4 0 0 7 0 0 0 19 0 11 25 2 16 44 0 44 0 0 46 35 0 51 
0 0 0 0 0 6 0 0 0 15 0 0 6 0 0 1 7 0 0 20 0 3 0 1 0 0 20 7 0 0 0 0 0 0 2 3 0 0 0 4 19 11 0 5 0 23 5 0 0 0 0 22 0 0 0 
0 7 8 21 55 0 12 0 11 0 0 4 0 2 0 1 6 2 18 0 0 21 0 24 22 0 0 0 0 0 0 0 0 0 3 31 18 0 0 0 13 0 0 0 0 0 0 0 6 0 50 0 0 0 11 
0 1 3 0 53 55 6 31 20 0 0 0 15 0 24 8 11 0 0 28 7 5 0 45 18 10 2 33 16 7 21 0 0 26 12 12 14 0 0 19 0 12 11 15 10 4 22 12 0 19 0 1 88 0 15 
33 6 17 40 6 16 32 0 19 0 24 3 4 4 0 22 0 13 5 55 0 15 17 31 0 6 0 24 0 9 0 31 13 65 5 34 0 13 4 0 0 65 8 59 10 13 0 52 49 2 29 0 8 0 21 
22 0 3 0 39 0 4 54 1 18 14 13 12 41 0 0 21 32 0 9 0 0 0 0 20 0 2 18 0 0 2 12 0 0 13 14 0 37 9 0 45 2 0 10 0 0 42 13 43 0 0 38 9 0 0 
0 3 17 30 3 0 3 0 0 0 0 0 15 0 14 11 0 18 0 7 6 0 23 0 9 17 34 8 35 0 27 9 18 27 14 0 11 0 14 8 4 0 9 0 0 0 20 0 0 0 12 0 0 0 0 
46 36 0 0 1 9 28 35 0 0 0 3 15 0 47 56 11 28 14 0 0 0 2 0 0 18 6 0 19 1 0 0 1 0 26 20 0 0 0 0 0 6 0 4 0 28 33 46 2 19 0 0 0 0 39 
37 0 3 23 23 66 63 0 0 36 0 45 49 0 8 20 6 20 0 35 21 10 5 0 0 14 0 14 0 20 0 2 0 0 22 0 0 17 0 27 0 21 26 0 39 70 0 12 37 24 0 0 13 0 0 
0 0 17 1 20 2 3 10 20 0 0 2 0 0 38 0 0 3 0 5 35 19 2 0 0 5 48 13 20 22 14 5 0 64 15 23 18 0 5 42 61 7 12 0 10 0 10 26 2 22 0 2 31 0 6 
