55 31
71 35 61 41 2 0 5 0 0 11 0 63 20 13 86 30 3 27 3 51 11 8 22 16 0 8 0 0 43 0 36 0 0 0 0 0 11 0 14 13 0 3 0 4 94 0 7 44 13 115 1 0 19 23 14 
0 17 20 27 23 48 0 0 0 0 19 1 28 0 23 9 0 17 0 0 10 21 39 25 0 0 0 7 1 31 1 0 14 15 0 1 0 23 0 22 0 24 0 0 0 28 0 0 16 46 0 3 0 0 0 
0 19 32 0 42 35 0 18 25 37 37 34 10 4 0 24 25 28 20 12 23 0 0 0 22 20 0 0 0 15 24 21 24 45 21 1 22 0 39 14 13 16 0 0 64 33 53 54 0 0 5 2 21 11 0 
34 0 4 8 0 11 0 19 24 39 0 15 0 4 2 0 21 31 0 33 0 0 0 6 0 0 26 0 0 3 0 28 21 22 23 0 0 0 1 9 0 27 0 0 0 0 0 28 32 0 0 0 7 0 23 
8 32 2 0 0 14 22 26 2 0 2 94 0 0 21 0 23 17 12 0 34 19 10 5 2 10 26 0 5 0 4 21 10 45 11 0 11 32 4 10 19 0 74 23 22 0 0 47 0 0 0 3 14 16 0 
69 37 8 17 12 1 0 0 40 0 28 62 18 9 27 0 6 9 11 0 1 0 20 2 13 2 0 0 23 25 36 7 0 22 0 31 0 2 37 0 22 30 0 27 34 0 46 0 8 6 22 40 44 0 25 
0 15 1 6 0 1 30 0 5 27 0 0 18 9 11 23 6 0 21 15 14 20 16 16 14 32 10 0 8 19 29 0 0 32 6 1 73 18 27 69 0 5 2 0 20 0 12 17 5 10 0 0 19 15 23 
0 0 33 47 22 1 21 0 52 0 10 0 0 35 0 4 0 0 0 23 26 26 0 3 0 3 0 20 1 11 15 0 11 0 15 1 10 4 19 0 0 10 0 41 0 2 10 6 47 31 0 2 0 0 39 
0 13 0 41 0 0 0 0 62 0 15 10 39 0 0 82 32 0 0 5 0 5 7 28 0 0 0 7 13 19 0 0 0 0 0 14 0 29 27 16 16 59 0 0 84 0 22 0 33 13 0 70 0 0 8 
0 10 0 0 50 43 0 0 3 0 9 46 4 0 0 41 52 0 5 16 0 0 17 16 0 24 0 17 39 0 0 0 0 17 0 0 0 5 0 33 0 2 0 15 17 2 18 0 11 24 0 0 37 0 55 
22 15 4 19 78 0 0 55 0 20 0 16 0 0 9 4 27 1 67 3 0 0 3 20 0 2 12 16 21 6 0 19 42 0 16 0 2 0 3 0 3 34 17 1 4 8 0 3 0 31 40 5 0 0 50 
7 5 35 0 43 5 1 6 0 0 0 0 0 23 1 10 0 11 0 0 0 26 16 0 6 0 12 0 0 18 1 0 0 0 0 0 0 68 11 0 0 7 0 0 11 0 0 8 11 0 0 4 2 72 0 
7 0 9 12 13 11 1 47 2 0 0 41 0 3 9 29 5 13 0 37 12 30 11 0 18 0 7 0 6 20 27 0 0 29 0 0 12 0 0 0 19 5 17 1 0 1 0 7 0 32 17 0 41 34 47 
15 9 12 0 0 0 4 23 1 22 0 5 0 0 5 18 0 11 53 0 4 23 0 4 26 4 3 0 18 0 27 0 0 0 16 5 0 30 2 0 33 0 12 3 0 20 10 0 24 31 15 8 48 0 0 
53 13 12 0 56 70 0 8 4 5 0 5 12 0 24 0 2 13 40 0 10 10 21 0 24 8 0 10 0 36 0 2 0 2 5 35 0 32 12 29 68 0 0 16 1 21 0 0 7 0 1 15 11 0 20 
0 0 0 0 0 38 0 0 21 4 7 100 0 16 0 32 0 2 0 0 0 2 0 4 0 0 35 11 7 35 1 17 14 10 11 12 0 29 11 26 0 26 0 0 0 11 25 20 2 0 45 39 10 0 17 
11 0 0 38 0 33 0 38 0 0 41 30 42 0 7 27 0 8 10 0 0 17 0 13 0 0 0 0 0 0 0 0 0 28 0 0 13 23 4 9 0 38 0 0 0 66 31 8 37 0 0 25 0 36 51 
0 1 0 0 33 5 17 6 10 0 37 46 0 0 13 0 6 11 0 10 18 6 0 31 19 0 0 0 21 0 7 14 36 7 0 7 0 5 21 0 7 3 7 21 21 2 27 9 10 27 0 0 0 21 43 
0 17 0 0 0 3 0 0 38 0 0 16 0 5 15 8 20 32 11 11 0 10 0 3 0 8 0 0 0 29 0 20 0 4 14 13 17 4 5 0 0 0 17 15 0 0 0 0 17 32 7 68 12 0 0 
19 4 67 0 35 4 36 0 12 44 0 0 0 25 0 2 0 66 0 57 0 0 0 0 15 0 15 23 13 0 0 0 13 0 15 0 1 0 14 13 36 3 36 0 25 5 0 30 6 22 11 0 71 0 52 
0 23 0 52 0 0 0 18 0 0 47 37 0 1 8 1 0 3 10 20 0 0 0 8 31 14 9 2 0 0 19 0 4 0 0 0 4 0 31 6 6 33 2 0 0 3 43 0 12 0 0 0 17 16 0 
11 46 9 0 12 1 1 0 0 0 0 26 24 10 20 3 0 0 0 0 20 0 6 8 0 9 2 0 8 0 2 31 31 0 9 0 24 26 22 2 19 0 0 0 5 11 0 2 0 5 8 13 11 0 7 
33 0 0 33 8 23 0 8 3 0 0 10 22 11 0 6 0 26 0 13 28 0 25 37 0 18 0 0 0 4 42 0 15 20 0 31 36 13 0 2 0 11 19 9 5 0 7 0 17 0 0 0 4 0 0 
1 14 0 15 24 0 0 33 0 31 0 0 52 0 13 0 6 0 0 0 0 17 0 0 21 0 2 0 47 0 0 0 11 8 4 0 0 0 0 1 38 7 0 0 0 9 34 0 0 5 1 5 0 0 0 
0 16 14 30 12 0 0 0 0 0 0 0 0 0 18 11 28 23 18 20 20 19 0 26 0 0 0 0 0 0 5 0 23 30 0 0 65 11 0 50 16 0 0 0 28 14 6 0 11 31 0 0 32 0 0 
3 35 35 8 0 0 0 26 0 0 0 37 18 23 0 18 34 0 21 16 0 20 18 0 3 0 0 0 5 28 9 0 0 25 10 17 0 35 23 14 29 16 20 14 13 32 2 34 0 27 3 0 49 0 33 
0 26 0 4 4 15 24 0 0 0 0 0 31 10 13 34 0 27 0 5 15 0 1 66 4 0 22 12 0 0 24 0 0 0 0 0 13 0 0 0 6 0 0 42 4 0 0 0 1 0 27 0 25 0 11 
0 0 21 47 0 0 0 34 0 0 0 28 9 0 0 0 23 23 0 17 15 25 16 21 0 0 2 0 6 3 8 0 12 0 29 19 0 2 10 0 0 34 15 13 0 0 2 0 16 0 47 9 24 0 0 
28 25 0 0 7 0 0 0 0 0 0 28 0 12 37 15 0 9 0 3 0 18 0 13 0 0 8 0 13 3 16 0 9 0 17 0 0 0 24 43 5 11 0 14 0 0 0 0 0 7 0 17 7 0 15 
0 23 6 45 6 35 2 9 19 35 0 0 26 9 24 0 2 0 8 0 0 6 0 26 12 19 4 4 0 0 16 0 5 24 11 11 0 0 44 16 0 32 0 0 21 1 12 3 3 21 10 27 10 0 0 
0 0 9 0 0 0 0 22 0 4 0 0 45 17 1 9 0 22 1 6 13 6 0 0 0 9 0 6 16 22 5 27 0 37 0 0 18 0 0 22 0 23 0 0 0 0 28 0 0 0 0 0 4 38 27 
