55 31
12 0 0 0 25 0 19 1 26 8 0 21 0 6 0 24 0 7 0 7 17 28 0 6 18 0 12 17 5 25 0 0 21 30 21 22 7 26 18 0 4 0 0 7 41 0 0 3 0 3 0 2 0 0 0 
0 18 0 29 0 0 0 15 0 0 8 0 15 2 1 9 54 16 25 0 28 2 7 15 14 13 0 0 0 0 23 0 16 0 9 0 0 9 6 0 6 17 10 0 0 18 9 44 0 0 0 1 35 23 0 
39 10 0 3 13 26 32 0 27 5 30 15 37 35 1 24 29 16 0 0 6 0 23 0 0 0 0 0 0 8 17 44 0 16 27 15 0 4 0 25 10 0 0 0 0 29 21 0 7 37 15 0 13 0 0 
0 22 0 43 0 4 21 14 45 0 0 0 24 8 19 0 0 0 0 15 34 16 29 22 0 0 0 13 0 26 15 0 0 11 15 30 10 16 0 0 7 0 0 0 11 5 43 0 3 0 5 0 0 53 0 
0 0 27 18 0 35 0 32 0 0 0 12 0 0 23 0 7 23 14 16 15 13 12 0 3 6 0 0 0 27 0 13 0 19 1 31 0 0 0 0 35 11 0 0 0 42 31 0 0 42 18 0 8 18 0 
79 0 0 0 43 7 0 0 3 14 0 33 5 31 0 0 0 0 4 4 0 0 0 19 24 4 20 20 0 1 28 7 16 3 0 0 20 17 3 0 14 0 12 0 26 0 42 47 0 0 26 0 52 26 14 
29 49 44 7 0 35 4 0 3 45 28 40 11 0 40 34 11 18 17 7 0 11 0 23 0 3 14 0 0 29 0 0 8 2 0 13 7 0 11 0 88 0 40 0 0 0 35 28 34 34 52 18 0 17 87 
10 29 44 30 0 18 0 2 0 0 6 8 0 50 0 0 7 0 10 9 28 14 0 11 1 21 0 0 5 0 28 35 16 28 23 0 0 9 0 0 18 0 29 0 21 8 37 22 65 0 43 35 42 10 0 
0 0 0 42 0 0 7 0 19 8 0 0 0 18 62 9 0 18 9 0 19 24 0 0 5 15 22 0 22 17 12 18 11 37 3 11 0 0 6 55 15 0 3 11 0 21 1 62 21 0 0 0 2 0 61 
0 45 0 8 14 14 6 0 13 4 8 17 4 15 16 0 35 31 34 15 9 3 0 23 5 52 22 17 26 5 0 0 0 0 17 0 12 14 12 19 0 0 4 29 0 0 57 1 17 0 32 30 34 0 49 
61 0 0 2 23 11 0 0 20 0 40 0 39 34 0 20 0 35 16 0 5 1 9 19 4 5 1 1 7 0 0 0 0 0 22 11 4 0 2 0 20 20 1 38 0 0 15 23 2 0 40 12 33 0 49 
13 2 13 9 0 41 7 0 0 0 0 18 0 10 0 0 7 4 6 0 0 31 17 30 11 5 0 6 13 16 5 0 0 0 3 2 0 14 12 0 19 0 0 0 0 0 41 25 26 0 0 5 0 30 0 
17 0 0 0 0 5 0 51 18 0 0 0 33 10 9 0 0 0 0 0 3 0 14 23 8 0 0 2 0 10 7 0 8 0 1 11 20 24 0 0 0 0 4 0 0 35 1 0 43 0 0 3 0 30 16 
55 24 50 20 4 0 16 0 6 0 0 0 48 12 37 0 0 40 14 0 0 0 4 0 3 15 0 27 63 21 0 0 0 9 9 4 35 0 0 0 0 0 0 0 0 31 9 0 0 0 52 39 85 0 4 
38 9 0 0 4 0 7 0 4 50 4 0 0 0 0 19 0 27 0 25 0 0 0 18 0 0 5 0 0 20 0 13 0 0 7 0 0 12 35 30 12 44 7 0 52 9 0 0 0 0 5 0 0 63 53 
0 0 0 0 2 2 22 0 0 56 12 7 21 0 0 34 0 4 13 0 25 3 0 0 9 0 0 13 0 15 0 0 0 8 10 0 0 13 9 12 13 0 27 1 0 8 0 9 0 20 54 9 14 8 10 
52 0 0 0 44 14 0 7 0 0 6 22 3 0 0 32 0 0 0 0 0 10 13 15 7 15 16 0 13 11 0 0 0 33 9 0 6 0 56 0 15 3 6 0 9 0 6 11 43 1 0 0 21 11 8 
57 0 7 33 38 8 0 0 10 7 0 35 23 40 23 9 11 5 17 32 58 10 8 0 5 0 8 0 0 0 10 22 0 0 7 5 24 12 16 6 4 0 38 0 0 6 74 20 0 0 2 0 12 22 0 
0 0 0 22 39 11 0 0 0 0 38 0 0 0 0 0 11 18 0 0 0 9 6 0 0 0 0 9 0 0 35 0 16 0 0 13 5 0 0 0 0 11 0 65 3 10 4 0 59 4 0 0 0 0 12 
6 0 0 20 10 8 28 0 28 7 8 0 0 8 10 6 3 14 0 34 30 8 42 22 0 0 0 22 0 14 3 21 0 0 14 0 28 31 32 19 13 0 0 0 0 26 7 0 14 0 15 0 0 26 0 
10 0 0 9 13 0 4 0 0 20 0 7 2 6 0 0 0 22 7 3 12 0 11 0 0 0 14 0 0 0 14 0 22 0 0 14 1 0 9 24 0 0 0 0 14 2 10 9 0 4 0 11 0 1 15 
42 0 96 0 20 44 47 37 21 0 16 0 1 0 1 12 0 0 16 48 20 9 2 10 8 8 0 0 0 7 26 42 24 0 18 16 14 6 2 0 56 4 50 14 4 0 19 7 0 0 46 32 0 1 0 
0 0 16 13 11 0 0 10 13 18 11 0 9 21 10 11 0 37 44 12 2 6 11 6 51 22 8 35 9 0 32 0 16 8 15 35 34 16 5 17 21 0 0 0 0 8 4 26 29 32 14 5 0 1 30 
0 0 0 9 3 17 7 0 15 1 5 0 9 4 0 0 0 9 3 17 30 0 7 17 8 0 21 21 0 18 18 5 15 19 14 14 17 3 0 9 0 9 0 0 7 0 0 3 23 19 18 0 0 0 51 
41 10 0 22 30 43 17 0 0 0 0 13 0 0 23 8 0 21 0 0 0 0 0 9 0 54 1 4 4 0 0 0 10 16 30 21 0 8 1 0 8 7 0 27 2 0 8 6 68 24 4 0 0 0 70 
46 3 40 0 0 0 7 0 0 13 0 22 2 0 17 0 10 0 0 0 0 0 38 0 13 0 20 38 0 0 5 8 19 22 0 0 33 0 17 8 0 4 55 10 30 0 3 11 0 0 23 16 52 2 0 
44 0 0 27 26 0 0 0 11 0 21 0 0 33 0 10 8 8 5 21 0 0 6 4 8 10 13 0 0 0 53 0 8 0 7 0 4 55 0 7 9 0 4 3 44 11 19 3 40 4 13 0 0 0 0 
45 26 0 40 0 3 0 0 5 18 13 0 0 26 7 0 10 0 10 40 12 0 17 0 0 24 10 0 0 23 7 13 12 0 0 0 3 0 0 6 30 0 0 27 36 80 0 0 45 30 0 0 10 2 25 
13 4 34 0 0 0 0 0 1 79 19 19 0 34 0 0 0 0 0 7 0 47 25 6 0 0 0 4 18 0 0 10 52 0 0 17 13 0 12 6 0 0 0 0 2 50 27 0 0 60 4 42 0 34 38 
0 3 0 9 0 47 15 0 13 13 39 78 0 0 10 0 0 40 14 12 9 32 41 4 0 8 17 26 22 35 0 11 16 13 37 12 0 17 40 22 30 0 0 0 23 0 24 36 9 0 0 0 74 44 43 
0 45 0 33 0 3 76 41 62 6 5 0 39 0 22 5 0 3 0 0 26 31 0 5 1 9 14 0 0 0 8 9 43 0 17 19 0 0 0 0 20 0 39 0 25 12 43 0 43 17 0 3 17 0 0 
