55 31
52 27 16 47 0 2 0 23 9 32 26 13 0 4 23 30 27 66 0 14 0 17 8 2 11 18 12 0 42 0 0 0 0 0 30 11 26 18 7 30 23 4 13 24 37 0 13 30 0 35 15 5 52 0 0 
0 0 36 25 46 7 23 15 28 0 8 4 0 0 9 12 0 0 32 8 0 7 0 0 22 9 18 0 21 0 0 0 0 0 9 17 0 17 0 9 37 14 0 1 0 0 22 0 0 24 46 0 17 0 19 
15 1 1 46 0 0 45 35 16 40 0 6 6 2 0 23 60 18 28 23 38 29 0 33 7 29 5 11 27 0 14 13 19 0 11 7 20 0 18 8 0 20 4 24 23 0 5 43 1 81 0 51 22 19 72 
53 0 0 50 4 0 22 2 11 27 28 0 41 0 0 14 0 22 0 5 0 4 18 0 17 1 0 14 0 14 0 0 0 0 23 13 0 15 51 50 0 38 24 0 22 0 0 0 17 0 0 12 0 34 51 
11 0 40 0 24 0 27 43 0 0 3 4 0 6 0 5 0 25 8 37 4 0 18 0 14 0 0 0 24 0 17 0 0 25 34 22 0 12 0 1 18 66 77 0 14 25 0 29 0 49 103 9 0 1 0 
0 0 27 0 15 0 0 0 0 35 8 0 22 17 0 29 0 0 21 15 45 19 27 0 27 47 19 0 8 8 0 0 0 3 20 0 0 16 18 15 0 11 5 0 84 2 0 9 0 27 7 27 20 2 29 
0 28 0 2 0 0 0 0 4 1 11 3 0 6 0 0 11 0 36 45 4 18 0 0 0 0 5 0 0 16 0 2 0 0 13 0 0 0 0 16 19 0 19 32 25 0 39 0 0 0 0 31 0 0 36 
36 0 23 0 4 38 30 24 0 0 6 0 0 0 0 0 15 0 0 27 0 12 7 31 0 0 0 0 0 0 0 0 0 0 0 0 64 0 13 0 0 0 13 50 0 10 0 0 0 0 5 0 2 12 0 
0 0 0 21 36 0 16 0 0 54 0 3 0 16 29 22 5 10 17 6 0 0 0 17 0 0 0 2 4 4 0 9 0 16 0 26 0 9 4 17 45 19 8 23 15 0 18 0 0 15 0 0 14 15 51 
19 0 7 19 0 0 7 0 4 45 0 33 16 0 0 22 10 16 0 18 34 19 1 0 0 12 0 0 20 0 0 0 0 0 0 0 0 10 15 13 0 0 23 0 33 5 0 9 0 0 3 0 0 34 41 
0 91 7 0 0 17 14 0 20 7 0 0 0 6 0 16 28 16 0 18 0 29 0 0 0 0 0 16 0 0 5 0 0 31 20 0 7 0 6 46 0 0 8 23 5 6 12 3 0 0 29 0 11 1 53 
21 0 0 0 0 21 1 0 18 14 0 0 0 0 0 6 3 0 0 0 0 15 0 14 0 5 11 22 16 0 17 0 27 0 0 7 0 12 0 0 0 7 25 11 0 0 0 4 7 3 0 4 0 5 14 
19 0 3 0 20 0 30 38 20 0 0 4 0 0 0 0 14 33 0 40 0 11 0 0 20 28 0 17 0 8 8 1 0 0 0 0 0 0 0 23 21 0 13 0 17 38 0 4 0 41 13 0 0 25 0 
20 7 35 5 34 0 71 0 0 0 21 13 29 24 0 11 28 0 14 0 52 11 18 4 0 0 0 1 8 0 2 0 0 0 10 6 0 34 0 17 32 0 0 0 0 0 9 27 7 0 0 11 46 0 3 
32 0 0 14 35 71 11 14 0 40 26 0 0 69 0 28 17 5 0 0 0 26 28 0 13 0 10 11 0 13 10 0 48 0 12 0 13 0 3 35 0 0 22 77 0 0 33 0 3 27 10 0 0 0 11 
9 0 0 47 0 19 67 8 7 33 4 22 31 0 25 5 23 7 79 0 26 1 25 8 26 0 0 0 17 0 36 8 26 24 6 0 6 17 0 42 7 18 0 2 23 17 0 32 5 0 69 55 37 38 14 
0 0 17 6 0 0 0 0 0 0 19 0 0 0 0 0 0 48 0 7 0 5 0 0 5 0 0 7 8 0 0 0 0 12 7 0 19 0 0 0 14 0 9 0 0 0 0 15 0 0 0 24 0 5 0 
0 8 0 9 0 10 24 2 7 18 0 35 0 0 0 22 37 0 0 27 0 3 0 0 10 0 2 13 0 7 7 20 2 9 5 0 0 0 22 28 0 0 0 7 1 15 30 0 36 30 8 0 0 0 0 
0 7 26 0 42 0 45 0 0 30 0 3 0 0 0 12 25 8 10 0 41 25 0 16 24 0 11 10 34 0 0 0 0 0 0 7 25 5 2 21 0 0 13 11 21 0 9 9 6 43 30 0 0 0 11 
0 39 19 19 5 56 0 37 4 61 0 3 10 0 19 0 0 0 0 7 0 0 0 0 24 23 16 8 0 20 3 12 0 0 10 17 0 2 0 30 49 7 8 67 4 7 28 17 28 20 14 0 0 0 0 
0 7 19 47 10 0 0 0 5 0 0 22 0 0 1 13 38 1 35 20 0 0 0 0 22 9 23 0 0 5 0 0 0 0 9 0 0 1 35 20 29 0 30 6 0 27 0 0 24 24 9 0 0 0 39 
0 0 0 1 104 0 51 0 35 0 0 13 0 13 0 0 51 0 0 32 2 0 7 0 25 0 16 0 0 0 17 0 0 0 0 0 0 15 0 39 24 0 9 35 0 0 0 17 9 43 8 33 1 49 0 
22 0 105 0 14 0 3 0 46 22 24 0 10 24 9 20 34 9 15 2 0 0 0 6 25 19 7 0 22 18 10 0 30 31 47 19 17 9 34 9 4 2 2 0 0 49 41 11 44 23 2 6 0 81 19 
25 0 25 43 0 0 0 0 4 17 0 0 0 0 23 0 42 36 0 6 12 10 0 28 28 7 6 0 0 8 0 0 16 0 10 0 16 0 0 37 21 0 35 19 0 0 21 18 0 0 4 1 0 21 4 
0 38 14 0 0 5 70 13 13 17 5 9 0 0 5 0 0 0 23 0 6 34 0 17 13 18 32 6 16 8 7 21 0 27 0 47 0 0 5 15 17 9 0 16 0 0 37 10 41 0 0 0 23 0 0 
41 12 47 0 38 11 68 0 16 31 11 0 0 11 0 4 24 3 25 3 1 0 32 0 3 0 28 3 16 0 0 0 19 27 20 0 0 27 38 42 48 23 83 33 22 0 0 0 3 15 13 24 10 0 4 
0 1 11 16 0 0 8 12 37 37 14 0 43 0 0 77 8 23 55 69 0 19 0 0 0 25 0 0 5 25 0 0 0 12 23 13 0 3 0 0 0 14 26 0 0 46 20 52 0 30 30 0 76 24 10 
28 11 0 6 0 16 1 0 0 25 0 0 33 19 0 23 0 0 0 19 1 14 0 0 13 0 0 8 12 0 10 0 0 0 0 22 5 0 34 10 14 0 17 0 0 0 0 0 0 1 0 21 0 0 0 
0 4 0 8 0 0 41 0 2 40 3 8 0 28 18 0 5 0 31 8 0 38 0 9 10 11 0 0 0 0 17 0 9 0 25 0 17 0 17 15 9 54 21 4 35 0 0 39 0 2 0 33 0 0 15 
0 0 0 0 0 32 0 0 77 55 0 0 13 0 0 20 7 0 20 1 5 29 0 0 6 29 24 0 0 0 0 0 0 23 0 26 6 36 15 31 0 0 2 0 0 10 11 0 0 0 44 0 19 0 0 
13 0 31 0 0 39 5 13 18 0 27 31 0 13 0 23 19 0 36 12 2 14 2 0 0 0 8 0 0 4 15 16 50 0 79 0 5 27 0 7 25 1 39 0 25 20 0 0 9 0 0 0 15 0 52 
