55 31
0 0 10 45 0 0 21 6 0 11 12 0 10 0 31 26 0 15 16 0 0 0 0 0 15 28 0 0 4 26 5 13 21 0 0 17 5 15 23 5 0 0 32 19 2 0 7 12 0 35 0 0 17 30 0 
15 0 19 0 0 0 46 0 25 0 12 0 13 0 0 15 4 49 50 37 0 18 4 0 3 1 4 0 0 0 4 5 10 25 0 0 3 18 0 3 4 13 25 0 0 0 0 26 16 0 31 0 35 0 0 
9 41 45 40 8 0 0 17 29 4 15 0 12 50 0 8 27 0 20 0 0 0 18 7 37 15 0 18 0 0 15 5 8 0 16 0 0 29 1 1 18 8 26 40 0 0 0 45 0 2 16 9 0 0 0 
0 0 26 0 19 0 0 0 0 0 15 0 5 3 0 68 0 28 0 0 0 0 0 0 0 0 0 0 17 2 17 0 0 1 7 10 0 0 0 0 4 4 39 0 19 10 0 0 0 0 35 0 10 25 25 
26 0 0 0 21 0 0 0 0 7 0 2 36 3 30 2 31 0 36 25 0 0 51 26 29 0 48 15 0 21 24 24 26 1 12 0 8 0 0 7 9 0 40 0 30 0 8 5 14 0 11 0 2 2 19 
0 31 0 0 0 0 0 0 0 0 1 0 0 9 25 1 5 0 25 0 0 0 0 19 0 49 0 0 0 15 4 0 31 0 13 0 9 4 27 0 12 0 25 18 0 22 0 7 0 0 0 19 17 0 16 
31 0 0 42 1 0 0 40 0 7 33 1 43 38 26 0 5 0 4 0 7 0 29 21 20 0 0 1 0 6 0 46 8 0 0 0 0 25 10 0 25 28 0 0 20 80 13 0 6 22 0 44 31 0 0 
0 0 0 1 0 0 18 33 0 0 38 21 1 0 8 0 8 0 0 21 11 0 3 14 0 0 16 2 0 0 15 24 20 3 11 0 29 22 0 0 17 34 0 0 8 23 0 0 38 27 0 24 38 30 0 
26 14 26 18 1 21 6 0 44 40 0 3 4 4 29 8 7 4 0 34 10 0 0 5 9 16 3 33 11 17 12 0 0 0 0 0 0 0 0 4 0 12 28 26 0 0 0 45 40 47 0 0 29 26 0 
4 0 0 0 3 23 5 16 0 18 25 0 0 0 15 19 39 8 0 10 34 0 0 23 48 0 0 0 23 8 7 14 0 0 14 0 1 4 0 0 0 0 9 0 0 21 0 0 20 1 0 0 6 0 0 
0 25 48 0 27 0 0 6 30 13 0 6 23 18 34 18 7 15 16 6 5 5 14 5 0 17 0 0 22 11 32 16 0 3 7 26 0 0 0 0 0 26 17 34 7 7 11 17 15 14 97 0 0 25 40 
0 0 51 0 21 0 31 0 28 19 0 13 3 0 16 9 19 0 52 4 13 0 0 14 13 5 0 12 0 11 16 27 18 7 0 0 37 38 10 0 27 0 9 0 4 29 0 41 0 0 20 9 2 55 17 
0 0 0 35 44 7 0 0 59 6 0 5 0 0 11 33 13 6 0 0 26 21 0 22 0 11 19 1 9 45 8 4 12 0 0 0 8 17 10 3 0 11 21 0 42 25 12 17 67 0 42 0 6 24 8 
0 21 7 22 1 21 0 46 13 7 22 5 15 28 0 11 29 34 0 0 7 0 0 0 4 0 19 1 25 0 2 33 14 0 10 0 0 17 0 0 14 0 0 0 7 2 30 0 0 18 22 34 7 86 17 
0 0 14 0 21 0 11 0 0 0 0 7 0 9 0 13 0 10 0 26 0 33 0 0 1 9 0 10 0 24 0 0 2 2 4 0 0 4 16 0 0 0 0 10 0 0 25 0 8 0 0 0 10 34 0 
11 51 0 8 7 0 15 29 0 10 0 8 13 0 22 6 8 75 0 20 0 5 0 48 8 0 14 0 5 0 0 6 0 5 20 0 48 0 27 0 0 24 0 0 9 22 14 0 0 0 0 0 57 30 0 
18 7 0 45 25 0 15 35 0 0 0 23 6 3 41 34 44 19 24 37 4 0 0 0 13 6 0 16 24 7 9 4 2 15 1 0 0 0 14 0 0 0 89 11 25 0 0 43 55 35 35 1 28 25 12 
73 0 49 32 32 0 1 0 9 0 25 0 0 0 0 0 9 1 0 32 0 0 10 0 0 10 32 9 22 29 6 1 12 0 24 47 0 33 0 0 0 13 12 11 59 7 0 5 22 0 0 4 5 0 0 
1 16 30 0 5 0 0 0 8 5 9 0 0 0 0 0 0 2 32 0 1 0 0 2 0 0 8 0 3 11 6 28 31 0 25 12 0 0 0 0 0 0 0 9 1 1 6 16 0 31 0 21 0 0 11 
20 7 2 16 0 17 25 13 0 0 10 0 0 3 13 0 2 41 0 0 0 4 5 4 21 8 14 0 0 0 0 41 11 0 9 0 19 24 8 21 14 0 0 26 27 0 13 0 0 3 11 26 48 0 0 
0 0 17 0 9 25 29 0 0 17 24 42 3 0 1 11 9 0 1 0 29 31 0 29 11 3 0 39 0 0 39 21 0 4 0 17 9 14 12 0 1 9 28 10 11 24 0 14 29 30 21 30 4 45 31 
0 30 0 0 0 33 10 0 10 13 0 19 0 0 0 3 34 0 10 0 11 0 28 0 2 0 2 21 3 0 36 36 0 24 0 23 0 0 33 0 0 17 0 0 2 0 17 17 0 33 28 8 11 0 0 
46 0 13 0 6 0 0 16 0 0 0 28 12 12 5 0 37 0 0 4 8 7 1 0 0 0 19 11 0 35 19 0 15 8 22 0 23 25 17 4 0 25 0 4 48 1 27 35 0 0 0 3 12 5 3 
0 26 0 0 26 13 0 0 0 13 4 0 34 0 8 1 11 18 21 0 32 35 13 0 14 14 0 3 4 5 5 0 8 0 15 3 0 7 31 0 9 0 25 8 17 5 0 45 5 37 0 0 17 23 32 
2 10 0 56 2 0 0 0 42 6 9 18 0 18 10 9 5 13 0 0 0 0 9 0 18 2 0 0 0 18 13 17 0 19 0 0 30 0 0 0 13 0 0 10 7 20 0 0 0 38 42 19 15 33 0 
23 4 11 15 10 0 62 20 9 5 0 0 0 0 15 10 14 33 0 0 15 0 18 8 9 11 0 29 0 8 0 15 13 16 10 0 0 3 0 13 51 0 17 0 0 13 0 1 36 16 44 0 18 0 31 
22 0 0 0 27 39 0 20 34 0 0 8 48 24 0 41 1 0 13 8 4 3 0 0 0 7 0 0 33 0 19 35 10 0 0 0 17 0 0 0 12 29 0 28 49 0 0 16 0 0 50 23 0 0 29 
0 0 0 0 37 0 0 0 0 1 1 0 21 35 0 0 10 0 0 0 4 0 10 23 4 2 0 0 11 1 0 8 0 0 20 0 0 17 0 2 1 37 0 7 0 0 0 23 35 0 0 0 14 2 20 
3 38 29 36 13 4 0 35 1 24 0 3 48 4 1 45 7 3 9 3 7 7 22 8 30 0 0 10 47 28 0 10 21 29 32 34 2 28 12 0 4 0 22 21 0 30 0 9 0 29 12 0 4 54 43 
43 46 0 0 13 10 0 0 8 38 0 0 0 0 26 0 0 28 28 25 6 28 22 31 0 0 0 0 0 24 31 22 2 0 0 35 1 5 2 0 46 0 0 0 0 34 14 25 19 3 0 25 1 24 3 
0 5 29 44 0 0 5 0 0 0 0 0 0 28 2 36 0 19 0 0 5 10 0 26 0 27 6 0 7 16 0 30 0 0 0 10 13 12 20 0 0 0 4 9 0 8 0 43 10 0 36 20 29 0 0 
