55 31
0 0 14 0 78 0 26 0 0 26 7 25 50 36 33 0 0 25 34 0 6 5 4 28 0 0 25 3 23 12 0 31 26 0 17 0 0 0 26 0 8 1 30 0 0 14 0 34 17 36 0 0 80 27 77 
4 25 0 32 37 0 35 4 42 13 38 5 0 0 0 0 0 0 46 0 16 9 37 27 0 29 0 21 0 17 20 59 12 0 8 13 0 5 0 0 0 55 0 0 0 68 17 0 0 49 9 0 20 0 0 
9 16 0 6 68 21 13 0 32 9 18 27 6 18 12 0 10 1 0 0 17 24 0 8 8 13 57 0 18 0 0 14 0 23 0 0 19 2 29 5 32 0 32 16 0 0 0 53 0 0 0 47 0 0 29 
0 79 0 0 0 36 47 0 11 3 0 0 0 18 1 0 20 1 0 0 19 0 0 0 0 0 22 1 0 0 0 0 54 0 0 34 20 0 0 19 0 36 0 0 8 0 0 0 9 0 0 50 2 0 0 
0 53 17 0 26 0 0 2 38 0 0 10 0 0 8 12 0 0 11 17 3 7 21 24 26 17 32 12 4 7 1 0 20 0 0 8 2 17 2 22 0 0 0 13 0 1 30 24 1 0 0 0 0 29 45 
30 46 8 0 28 20 0 0 0 0 14 0 0 0 5 0 34 0 0 0 6 8 0 3 0 47 11 0 0 22 29 1 56 0 1 0 3 2 0 0 0 32 0 0 12 0 17 29 0 0 24 0 0 0 0 
59 0 43 42 44 27 29 2 0 56 0 17 0 0 37 23 4 0 0 1 42 9 46 2 4 21 2 21 21 0 9 0 15 27 0 21 0 5 23 19 0 0 0 0 6 3 23 0 90 14 28 0 0 6 2 
0 0 0 1 1 7 6 5 10 6 34 37 2 4 13 8 21 1 3 6 19 0 3 0 0 0 0 34 0 15 0 20 0 0 8 0 29 0 0 3 9 5 20 16 22 3 0 0 37 39 0 0 30 0 20 
0 5 0 13 37 1 42 31 0 4 0 0 3 0 13 1 5 1 0 7 0 12 0 5 12 19 19 0 0 14 0 5 10 0 0 0 26 0 31 3 0 32 0 15 18 4 11 18 69 0 0 0 9 5 36 
34 0 0 0 44 42 2 0 0 2 0 13 0 0 0 22 18 0 0 0 0 32 0 0 0 22 0 11 0 0 0 18 0 0 44 31 0 32 0 0 0 0 21 0 7 4 5 15 44 0 0 0 0 14 0 
0 49 39 51 0 0 28 0 0 0 0 9 22 0 3 8 24 0 0 0 0 0 0 24 8 0 30 0 0 26 0 0 0 0 8 21 4 0 0 0 11 56 0 0 3 4 0 33 0 0 49 0 0 0 51 
0 0 0 0 37 0 6 0 43 0 0 0 24 14 2 0 0 27 0 0 4 16 0 0 0 0 0 0 0 4 0 0 9 0 0 0 5 4 0 3 6 27 9 0 27 5 0 35 0 0 5 43 0 0 0 
28 37 0 25 0 10 0 0 0 33 39 0 2 0 6 0 26 37 0 11 26 0 0 0 0 3 8 0 53 0 43 0 23 5 7 0 0 9 37 0 35 0 0 5 27 0 26 0 18 0 0 41 9 0 37 
0 9 11 0 8 0 32 0 0 0 10 4 1 0 7 0 6 0 62 5 0 0 11 0 0 22 15 0 0 0 0 0 16 9 32 12 2 0 26 0 38 19 0 5 23 5 8 11 31 13 23 0 0 0 28 
55 35 28 11 0 0 11 0 11 6 0 1 0 0 0 0 0 0 0 22 18 32 0 0 0 0 0 0 0 0 0 10 8 0 0 0 51 0 0 0 0 33 42 21 0 1 45 0 0 0 0 0 5 0 0 
0 0 10 33 0 0 16 19 35 20 17 0 0 5 0 0 4 26 48 0 4 15 0 24 0 3 0 0 0 31 0 0 0 0 8 25 15 0 31 32 0 5 0 9 0 0 0 37 30 0 0 44 42 0 0 
4 0 22 0 11 29 26 46 6 0 0 11 19 0 0 0 1 0 8 38 0 0 45 13 0 36 0 0 10 2 0 23 0 0 40 17 47 25 32 0 0 0 0 0 7 4 0 0 5 30 0 29 17 46 0 
37 0 2 0 0 32 6 23 7 0 0 0 0 34 28 0 13 0 0 0 0 12 31 0 3 0 9 0 0 40 36 19 0 12 9 0 0 13 12 11 10 11 0 0 15 36 0 71 1 0 4 0 6 37 0 
8 0 4 3 37 0 0 46 0 0 0 0 29 14 0 8 13 0 12 2 0 0 10 10 0 3 0 22 0 2 0 0 15 0 13 0 0 0 0 0 1 64 2 11 8 0 14 6 0 0 37 7 45 24 0 
58 0 16 5 1 1 9 1 12 29 26 9 29 7 0 19 9 13 14 28 15 8 0 0 51 8 0 0 3 17 27 13 12 4 0 0 2 21 35 0 8 18 3 14 13 0 11 2 0 3 19 0 28 0 0 
11 4 0 28 48 3 47 6 17 18 0 83 20 9 1 37 13 20 2 14 6 27 14 18 8 23 0 32 2 21 6 15 39 5 0 1 4 14 36 3 18 14 20 52 14 40 35 0 47 41 37 2 68 32 10 
31 6 5 3 33 5 48 0 0 0 4 1 0 12 11 0 0 8 0 3 20 11 3 0 8 16 4 0 7 6 23 23 8 0 16 29 2 24 15 52 0 33 0 0 38 16 17 3 5 0 0 0 49 38 10 
0 45 0 11 0 0 16 8 0 0 8 0 0 27 42 7 0 0 0 8 0 17 0 0 40 0 0 8 24 0 0 19 25 9 0 13 0 17 18 15 27 14 3 2 10 7 45 10 2 22 19 14 2 0 13 
0 46 0 44 0 3 20 15 46 0 17 13 0 15 0 0 42 0 5 12 9 17 21 0 25 9 0 0 23 0 10 24 0 22 0 0 4 14 0 6 12 31 0 0 0 21 30 23 38 0 0 14 0 0 46 
11 192 14 7 3 0 0 39 30 33 7 20 0 89 11 0 0 25 24 14 0 14 19 0 17 5 30 0 10 21 21 16 6 0 19 0 1 12 0 38 38 22 4 58 7 16 0 56 27 36 7 55 28 0 2 
0 46 28 39 0 5 23 1 18 0 0 25 30 24 8 0 0 5 0 4 0 0 3 0 0 0 73 18 9 24 0 0 3 18 8 10 0 50 0 0 3 1 39 42 0 40 0 69 0 0 46 43 0 5 0 
43 37 51 25 0 42 13 19 6 26 35 0 8 11 7 0 0 0 3 12 1 30 0 16 0 0 16 3 0 38 3 6 0 0 5 28 6 8 0 0 15 39 0 0 10 11 0 42 0 0 0 51 42 0 2 
13 0 32 0 11 30 13 8 0 0 0 15 0 21 31 0 2 0 13 0 12 4 1 0 0 18 12 0 3 20 1 18 12 3 11 9 0 0 0 10 0 10 9 0 10 19 8 17 0 0 24 3 0 0 47 
17 0 3 0 28 26 0 56 0 0 0 6 0 0 6 2 26 19 22 0 9 0 1 28 0 23 24 0 0 11 23 0 0 0 0 0 0 0 0 0 14 0 0 24 20 2 0 23 0 0 15 0 7 0 0 
8 6 0 0 50 0 61 43 0 0 0 0 25 16 56 5 31 0 0 13 0 26 0 11 0 13 12 25 19 0 0 0 0 0 11 0 0 61 12 17 0 0 5 42 13 3 0 27 0 0 43 0 0 27 10 
13 17 0 0 69 0 27 32 0 27 36 0 14 26 0 6 0 0 29 0 6 7 0 0 0 12 33 1 2 20 70 43 11 16 0 0 5 2 9 0 0 25 13 5 25 14 0 46 4 23 6 0 28 1 45 
