55 31
21 20 0 11 0 29 2 0 0 6 28 41 4 30 38 36 70 52 0 0 0 5 24 0 0 19 0 36 13 0 33 0 2 28 23 21 0 20 0 0 25 38 19 15 18 0 41 12 18 0 15 10 90 0 0 
0 0 35 13 0 39 20 0 0 3 35 0 2 22 22 0 27 0 9 0 0 16 16 0 3 0 4 0 7 0 24 15 6 0 0 16 14 0 0 0 0 0 0 31 53 0 0 37 0 0 0 33 0 23 0 
0 0 0 2 33 21 2 46 46 25 0 13 0 0 0 46 0 0 0 0 0 0 0 15 10 20 19 27 0 0 2 0 30 0 25 0 0 0 19 0 0 0 9 1 0 0 8 59 0 7 21 2 0 0 81 
42 30 30 8 0 0 9 0 5 22 0 37 32 0 21 2 16 29 0 0 13 0 2 0 20 43 0 0 25 21 0 2 54 8 0 40 0 17 35 28 3 4 8 37 32 12 21 16 8 0 24 64 17 2 19 
22 0 0 39 8 0 44 4 0 3 0 2 22 0 0 0 32 0 0 17 0 0 18 22 3 0 19 4 0 0 10 7 0 14 43 18 12 0 7 5 7 0 19 0 7 17 0 21 69 5 0 0 64 0 14 
7 41 0 30 14 44 32 0 42 15 0 0 0 3 29 2 16 1 4 0 0 0 0 5 15 0 7 0 0 16 0 4 0 24 1 2 0 0 1 0 0 0 23 29 6 39 0 13 0 57 42 0 0 6 0 
2 14 7 0 40 54 36 0 5 11 0 39 17 5 0 27 0 0 33 0 40 19 13 0 3 20 19 20 17 1 32 0 15 0 0 39 0 7 0 28 19 21 52 0 49 19 0 0 0 46 2 32 0 0 0 
16 23 0 0 1 7 0 4 7 16 3 19 9 29 0 15 18 4 19 18 1 0 0 1 11 18 2 8 0 21 32 0 0 0 0 41 39 0 4 26 0 0 41 23 44 20 0 46 35 0 0 0 0 51 41 
6 24 0 39 63 13 0 71 0 13 36 8 0 0 0 0 10 5 0 25 7 21 33 0 19 0 0 7 24 1 0 12 73 0 30 33 25 9 10 34 5 0 29 0 0 0 59 0 0 27 12 6 19 0 0 
27 38 0 0 24 29 0 0 6 13 4 26 49 8 4 58 13 0 19 0 6 10 0 0 0 0 0 14 0 13 9 0 21 0 7 20 31 10 0 5 0 14 0 12 17 2 3 21 0 2 3 8 46 0 6 
0 43 43 0 0 0 40 17 0 7 37 0 5 34 17 25 0 0 9 0 0 0 2 2 0 31 10 0 17 9 0 33 0 0 0 10 10 9 0 0 25 0 7 0 0 56 34 23 0 0 0 0 22 7 28 
8 0 36 49 13 0 0 43 5 0 0 13 0 1 28 0 2 4 0 3 0 0 0 0 4 0 12 0 5 2 0 2 18 0 1 23 0 0 21 20 4 0 0 17 7 0 0 0 9 0 43 0 38 1 0 
7 0 0 0 8 0 62 0 0 35 0 25 19 11 14 0 0 6 27 9 25 0 0 26 5 9 33 0 1 14 0 8 0 0 0 0 16 3 12 29 12 0 0 0 0 23 14 21 23 3 33 12 26 18 11 
10 52 40 9 5 0 0 0 28 17 10 40 0 0 59 22 0 0 0 5 5 0 0 0 10 0 22 11 0 20 0 25 19 0 20 0 28 0 0 0 37 0 40 0 7 0 17 0 17 85 39 44 0 13 0 
0 25 0 0 0 17 0 0 8 7 0 17 0 0 5 0 1 0 23 10 0 0 17 10 21 1 25 18 20 20 1 0 8 0 0 0 43 0 0 8 7 27 0 0 0 18 17 0 3 9 3 15 0 0 15 
7 7 35 48 6 0 0 12 0 0 4 0 9 32 0 0 1 0 0 39 18 0 4 6 0 0 20 0 0 25 0 0 22 0 0 33 17 0 13 0 14 0 0 5 9 28 0 11 0 4 22 61 6 15 3 
3 0 0 3 0 0 0 0 0 0 7 0 7 0 0 14 12 7 0 33 0 10 0 29 0 0 0 3 12 0 3 21 2 0 7 0 0 0 0 0 4 0 0 0 4 4 0 2 3 0 0 9 25 9 13 
41 5 0 0 50 14 12 0 6 48 0 0 33 31 20 34 0 5 9 1 19 0 24 15 0 0 0 14 0 0 0 0 16 0 0 11 0 0 0 8 26 41 0 11 4 27 27 0 6 44 11 14 0 0 57 
0 27 42 8 0 0 17 0 16 3 27 0 3 36 36 15 42 0 0 3 0 7 0 6 35 0 20 36 7 0 0 0 0 0 22 29 35 27 5 0 1 0 4 24 42 14 34 24 50 29 36 10 0 0 0 
14 13 0 33 0 0 7 0 6 10 15 0 26 0 5 0 4 9 26 9 0 0 4 0 0 15 9 0 27 28 0 0 6 0 10 9 0 0 0 0 9 12 60 0 7 42 0 0 8 0 0 39 0 0 6 
22 74 0 47 54 0 3 6 0 15 0 0 11 4 11 20 0 25 11 16 0 6 18 0 8 0 0 0 0 26 0 19 0 0 3 9 13 0 2 22 22 0 0 7 19 0 8 10 0 4 8 0 30 0 0 
0 37 34 0 37 2 0 2 5 2 32 0 0 0 15 0 0 0 0 45 0 9 7 3 1 24 0 8 0 15 17 6 15 0 0 16 31 7 35 34 16 37 55 0 0 2 3 0 19 23 0 0 12 0 0 
13 0 0 15 13 0 54 12 0 14 0 16 0 33 17 0 5 0 53 0 0 0 0 0 0 0 0 22 0 15 0 13 14 0 7 8 0 13 44 1 0 7 0 0 11 10 32 1 0 10 0 27 0 0 0 
37 91 0 23 3 0 0 4 0 13 9 12 51 11 39 11 0 0 25 23 20 7 1 10 0 14 0 0 7 0 12 2 0 0 24 27 16 44 7 13 60 5 42 25 12 28 33 1 7 13 6 36 0 13 20 
75 55 0 4 3 0 48 0 30 31 48 13 33 0 0 0 15 27 0 31 12 5 13 9 17 0 44 11 12 6 0 1 0 13 12 8 0 0 0 0 43 0 0 21 70 22 14 25 0 109 16 3 4 0 46 
22 30 0 7 0 21 4 14 0 8 0 0 7 0 0 12 25 0 0 4 13 14 19 22 0 0 19 0 0 0 0 28 15 0 0 24 0 0 0 0 47 18 3 0 0 16 0 21 6 0 0 22 0 21 1 
0 0 0 51 0 0 1 11 0 25 7 7 22 21 0 9 0 6 11 24 19 31 0 19 9 3 0 0 0 0 27 0 0 0 60 0 0 0 0 14 0 0 19 24 33 0 12 2 14 0 0 3 31 0 0 
0 47 0 43 0 39 0 23 2 24 2 12 0 33 0 27 0 0 0 0 0 0 0 0 0 24 1 22 72 0 0 16 11 0 0 16 26 0 0 30 0 0 0 50 19 6 72 0 47 24 23 0 43 0 0 
0 0 0 17 30 19 25 2 0 69 22 19 0 6 0 0 0 0 23 12 34 12 12 2 24 0 0 0 0 0 0 0 0 29 28 8 0 7 0 0 0 0 33 17 9 0 0 6 63 29 10 9 0 9 0 
0 0 0 15 1 0 50 50 0 38 1 0 0 9 12 9 0 18 20 0 0 0 0 17 0 14 0 11 23 26 58 0 11 5 25 12 0 15 44 0 15 0 25 0 0 13 0 26 0 19 0 1 61 17 17 
0 2 0 2 0 0 18 0 0 37 18 42 0 30 77 0 5 18 15 0 0 0 0 0 0 0 0 0 0 20 1 7 32 34 0 18 2 0 0 0 0 7 0 12 0 0 0 6 0 23 2 0 0 0 0 
