55 31
0 87 0 32 3 70 0 12 13 0 0 17 0 19 0 0 0 0 21 31 0 0 0 32 0 0 0 25 35 8 0 0 0 0 2 66 32 10 3 19 0 14 0 0 39 0 0 0 0 36 31 0 25 0 0 
44 3 0 0 29 0 0 12 0 0 0 0 14 0 0 20 0 7 10 13 0 0 20 0 12 0 0 23 0 0 0 53 0 29 0 20 0 25 0 21 0 20 20 38 44 0 45 0 0 0 1 0 0 0 0 
0 0 7 0 0 0 51 0 0 0 8 4 27 1 25 36 5 23 47 32 7 0 28 19 6 0 0 20 3 16 28 25 2 0 2 7 16 0 20 28 15 5 8 44 0 1 6 41 37 18 6 32 12 38 14 
23 27 81 19 0 0 0 14 0 0 15 7 6 1 0 0 0 25 22 0 2 7 34 27 0 0 0 4 27 0 0 14 0 0 0 11 34 4 0 21 7 3 0 8 0 0 17 12 0 59 0 22 0 0 32 
0 0 4 0 45 45 26 0 4 0 0 0 22 41 0 0 0 0 0 15 0 0 0 0 0 5 0 0 8 23 0 0 3 1 28 0 8 22 20 2 25 2 8 0 10 0 23 1 11 59 54 29 0 0 0 
0 14 0 0 23 0 0 4 0 21 0 0 0 0 0 0 14 19 0 0 0 0 0 0 0 21 29 15 3 1 14 7 16 0 0 2 0 0 1 21 5 0 0 4 18 0 20 20 16 1 15 0 0 0 0 
0 0 0 11 66 0 2 3 2 0 0 49 0 6 18 24 0 0 10 0 17 25 32 15 28 0 16 25 6 1 28 0 0 29 26 22 0 0 15 9 36 2 0 22 1 0 33 1 0 42 0 16 2 0 19 
9 33 0 28 4 9 11 0 22 9 12 22 5 1 28 16 7 6 0 0 13 7 1 14 0 21 0 11 58 15 12 13 0 8 53 0 0 7 2 14 0 1 13 0 0 0 0 0 0 0 20 0 0 31 0 
0 22 33 13 0 0 0 0 22 0 0 29 0 0 19 0 34 7 27 26 0 21 0 0 7 8 0 0 0 32 0 7 18 15 11 32 1 15 28 6 20 25 27 0 0 32 0 0 6 3 75 0 12 24 0 
0 10 7 6 37 0 18 4 0 0 0 0 0 25 5 3 28 27 0 2 38 33 15 0 18 3 9 10 1 24 0 14 14 8 0 0 12 0 0 12 0 37 14 3 28 14 25 0 0 0 30 0 0 10 33 
34 53 35 12 2 20 0 26 32 8 29 19 0 17 48 0 0 0 0 0 3 7 0 10 0 0 0 23 0 0 26 0 30 0 22 15 23 33 0 6 39 0 28 0 0 6 1 37 41 0 0 0 0 0 53 
0 0 0 0 0 0 35 0 41 30 0 0 0 11 0 21 0 19 0 21 9 0 0 7 28 0 0 0 0 0 10 1 29 17 0 0 21 0 30 50 5 42 13 0 12 0 9 0 16 3 0 0 25 1 0 
34 18 0 0 0 26 4 47 7 14 34 2 28 20 0 17 16 0 3 2 19 0 0 0 3 2 11 4 22 14 3 25 19 1 0 3 13 0 0 10 13 15 1 0 37 0 3 3 38 9 8 0 0 4 0 
0 0 31 0 0 36 0 0 4 2 0 9 16 30 39 7 10 17 6 0 16 0 0 0 21 7 33 5 7 0 0 6 6 47 0 0 4 7 0 0 0 31 0 11 0 0 5 0 0 0 24 23 19 93 0 
0 0 0 5 4 0 48 0 0 0 12 0 0 37 0 0 0 0 15 15 12 0 5 0 20 2 0 0 0 0 0 6 12 9 0 0 0 0 0 0 27 0 0 0 11 0 0 11 0 0 0 0 0 0 48 
0 0 0 4 0 45 51 0 18 2 5 38 24 1 36 5 10 41 4 0 14 9 0 49 6 0 18 9 13 5 43 15 0 6 10 0 0 20 3 16 7 21 9 6 0 0 0 38 31 20 74 14 19 19 24 
0 0 16 0 0 0 0 4 0 0 0 0 0 1 30 0 0 0 6 14 0 0 0 1 4 0 3 1 1 0 0 0 19 22 0 14 0 0 5 0 9 13 0 3 0 0 14 0 0 9 7 0 0 43 0 
0 1 89 11 3 13 15 14 1 0 0 9 0 2 9 0 0 13 31 0 8 0 9 1 0 0 45 0 10 0 0 17 0 9 32 0 0 0 9 13 26 37 0 17 0 0 38 3 0 31 3 49 0 10 28 
48 48 52 2 0 28 21 0 0 86 9 0 38 8 0 0 0 21 0 0 13 1 5 4 0 0 6 17 18 30 0 0 22 23 0 3 25 1 16 0 3 0 6 34 35 10 14 0 47 14 28 13 52 17 58 
0 41 17 25 12 52 0 6 24 0 12 30 0 7 7 36 15 0 0 10 17 0 0 0 11 16 0 14 13 0 5 15 11 0 19 11 2 0 0 0 39 38 1 1 36 0 0 32 0 0 0 0 0 12 0 
0 20 0 53 0 12 35 18 0 93 28 18 0 19 17 18 3 34 4 15 20 31 0 7 7 25 6 22 8 5 0 31 14 50 9 7 31 7 2 13 2 95 2 35 10 0 37 0 0 21 11 36 77 1 68 
0 0 0 13 0 0 0 0 0 1 20 25 28 0 0 16 11 0 0 0 0 0 0 25 31 28 0 11 0 12 9 5 0 0 0 7 12 21 0 41 25 28 18 0 0 0 10 0 0 9 0 41 0 16 15 
22 0 0 58 10 6 0 30 1 5 29 1 10 5 0 0 34 32 0 0 29 1 9 7 12 0 7 20 0 29 1 35 15 0 18 0 2 0 18 0 37 10 11 0 0 0 0 40 0 0 0 0 21 16 0 
5 7 38 10 0 13 0 0 3 45 37 24 13 3 20 0 1 15 34 20 17 12 0 0 0 23 13 0 0 0 12 5 22 7 20 0 13 15 0 13 0 57 1 4 0 0 0 59 6 13 0 4 8 0 94 
6 26 3 27 1 10 6 23 5 59 6 0 7 20 19 23 0 0 0 10 6 1 1 0 17 20 0 10 0 0 22 4 32 15 33 19 0 0 0 30 13 19 6 0 0 0 0 7 53 0 0 36 38 0 10 
0 42 15 50 11 0 32 45 0 4 0 0 0 47 19 4 0 0 0 0 0 0 7 0 0 0 0 0 13 0 23 7 2 16 0 0 10 25 53 26 10 0 0 33 0 0 0 0 1 9 19 18 45 50 0 
0 0 8 23 0 16 38 0 2 36 8 24 4 23 12 0 17 5 23 33 23 0 9 1 0 21 12 0 11 37 0 6 10 0 25 41 7 36 29 21 6 54 0 7 0 0 0 12 19 36 0 0 56 0 0 
8 0 42 0 0 0 2 17 8 46 0 20 22 0 0 0 0 6 0 7 4 11 0 6 36 23 0 0 0 0 3 10 0 12 0 0 0 0 0 16 15 35 4 0 3 0 33 0 0 0 0 4 0 14 14 
6 42 0 0 0 81 0 12 0 0 36 0 25 0 0 0 0 1 0 21 33 0 0 0 15 0 0 0 4 10 9 6 14 17 29 13 15 22 1 8 0 6 17 14 0 0 36 0 0 0 0 46 0 33 22 
3 0 0 0 30 0 50 11 8 0 7 0 0 43 0 0 6 0 11 9 3 0 0 7 0 0 0 0 2 13 12 0 11 3 5 0 0 0 6 0 24 28 0 4 0 0 33 0 15 1 0 0 0 7 35 
43 103 0 20 0 13 1 1 22 39 36 10 0 6 13 0 24 6 0 36 0 0 12 9 0 0 15 9 16 0 33 24 0 0 0 5 8 0 0 13 1 35 10 49 51 0 95 0 0 28 22 0 10 0 24 
