55 31
0 15 9 50 27 0 0 0 8 64 0 0 0 0 0 0 0 3 0 15 3 0 0 0 19 0 26 11 0 3 22 3 0 0 10 24 16 6 65 30 9 3 0 8 3 28 15 45 2 0 13 10 91 66 0 
40 21 27 26 0 13 37 0 0 0 61 0 57 4 0 0 24 0 3 0 7 28 0 0 0 0 0 10 0 5 9 0 6 15 46 7 32 0 26 0 40 0 7 0 0 35 44 2 27 11 23 0 25 5 0 
12 0 1 45 0 44 24 5 0 0 4 13 24 8 30 24 25 0 0 21 0 6 46 10 5 37 0 0 3 0 11 8 0 5 19 14 33 0 0 0 15 35 50 0 8 7 0 0 0 13 0 0 0 41 0 
0 0 13 28 5 14 15 10 0 2 11 21 0 28 0 0 22 22 34 14 37 11 13 0 2 5 7 25 0 3 0 11 10 14 0 24 20 2 25 21 4 6 0 32 19 6 0 0 11 0 0 18 41 12 18 
0 24 0 24 28 0 0 0 4 0 22 1 0 0 35 0 0 0 25 0 2 0 0 0 22 6 0 20 0 4 0 0 37 0 0 37 10 0 0 0 0 0 0 0 15 41 22 0 0 39 0 15 0 0 0 
0 0 17 0 0 0 2 8 0 24 0 0 3 23 32 8 73 0 0 0 0 20 0 0 0 0 0 7 15 18 14 3 0 0 0 70 0 21 0 0 43 25 0 1 13 0 27 6 0 4 17 5 16 10 0 
22 43 25 0 3 31 0 6 32 3 0 0 11 1 0 0 25 32 0 0 2 0 19 11 13 2 0 19 14 1 1 30 45 4 17 0 0 17 15 7 32 25 5 0 13 5 14 0 19 1 8 27 0 39 0 
43 0 0 0 0 0 22 27 5 0 0 4 0 10 17 2 0 21 41 8 16 4 14 10 0 37 20 9 0 0 0 17 6 3 11 0 15 12 0 21 23 5 0 46 13 0 0 0 9 0 0 0 27 10 0 
61 0 8 44 0 29 0 0 12 26 6 31 6 0 17 10 34 30 3 16 13 32 16 0 10 0 19 1 9 0 4 0 2 12 19 1 0 8 16 0 0 0 15 3 44 28 25 44 13 4 0 0 3 37 45 
0 18 0 0 0 0 0 0 0 0 6 20 42 14 17 0 6 0 5 20 0 22 0 0 24 38 0 39 0 0 0 23 14 2 0 0 0 0 0 0 0 15 0 51 7 7 0 22 24 0 9 0 25 0 17 
0 0 16 0 0 71 0 0 0 0 0 0 13 0 2 0 0 2 6 2 0 18 0 0 7 17 0 16 0 0 22 8 0 0 0 0 0 0 36 0 17 19 0 0 0 2 16 0 0 12 0 0 3 0 49 
23 0 83 0 0 5 14 36 43 10 36 0 6 35 38 0 3 29 1 23 31 32 0 24 23 24 15 0 0 5 0 0 13 0 32 11 0 36 16 0 5 0 9 56 23 33 15 0 22 26 0 0 7 51 30 
0 0 0 0 0 0 0 0 5 0 17 0 21 0 10 0 0 25 0 0 18 0 0 13 0 0 0 1 0 0 0 0 0 16 0 0 0 0 0 0 1 36 25 0 0 37 0 0 0 0 0 0 0 0 0 
5 19 88 2 0 8 5 13 2 0 0 8 25 29 9 37 11 32 0 0 12 0 0 13 0 24 0 20 40 0 0 0 0 13 5 53 42 0 0 0 7 0 30 0 42 11 12 19 0 32 37 9 37 3 0 
13 0 0 0 0 12 77 0 0 22 32 0 22 0 0 0 30 17 0 0 0 10 0 13 27 25 0 4 0 0 1 6 0 0 22 0 28 21 0 0 0 14 38 0 0 0 30 0 33 4 44 38 46 0 0 
0 40 0 0 0 0 10 15 0 0 21 13 9 0 0 0 0 0 0 12 33 0 0 10 0 30 0 0 41 43 10 0 0 9 0 0 13 3 0 0 20 1 31 18 0 0 23 19 0 0 15 0 10 24 0 
6 0 110 14 39 12 33 12 0 0 36 8 26 8 33 2 0 33 0 15 18 5 0 0 10 0 0 31 0 0 0 10 42 15 28 5 48 0 7 0 0 58 1 26 42 0 63 0 9 37 0 5 10 26 5 
57 34 58 6 0 2 0 20 0 5 13 2 0 0 0 0 16 36 46 0 0 0 0 0 0 18 0 0 0 0 0 17 14 0 0 3 0 0 0 0 15 81 0 0 7 0 0 0 13 3 48 0 3 26 0 
28 46 12 15 0 0 31 40 0 20 0 0 6 0 21 12 0 3 6 0 27 0 31 9 0 14 18 0 0 0 6 31 0 11 8 20 29 45 8 24 34 0 0 0 102 45 6 0 15 4 15 28 20 25 0 
0 34 0 36 2 15 45 19 0 5 0 16 0 0 0 0 20 0 47 21 19 0 16 0 0 47 45 0 6 25 0 0 10 0 6 19 0 0 20 36 0 15 0 6 43 4 0 8 32 6 6 1 31 28 59 
0 0 0 0 24 0 79 0 0 19 0 12 0 39 9 1 5 11 0 12 1 9 25 0 9 0 0 12 2 0 0 0 0 0 0 22 0 0 0 5 0 4 18 9 17 4 0 25 0 5 0 0 7 17 0 
1 10 47 10 47 20 0 0 0 0 0 23 0 8 12 0 0 16 0 0 14 5 29 0 0 0 0 0 5 0 0 0 0 28 31 20 1 0 0 3 45 26 0 0 0 0 4 0 0 0 4 39 0 0 0 
15 16 40 33 0 0 0 34 0 3 0 0 3 12 19 0 29 8 0 0 0 0 0 23 6 39 0 0 17 17 56 0 13 0 0 0 0 7 0 38 9 38 20 16 0 42 1 3 18 16 4 0 22 0 5 
15 33 13 0 0 30 26 5 0 16 0 20 12 13 0 15 0 9 1 3 16 0 0 0 0 4 25 0 24 22 21 36 0 6 17 13 0 35 1 7 0 0 11 0 5 4 12 1 1 4 49 4 24 5 1 
34 0 48 0 0 46 1 0 0 11 0 19 41 33 8 35 0 0 13 15 6 7 0 0 10 1 0 41 0 0 5 19 1 3 18 20 0 0 13 2 19 0 0 0 39 0 0 0 0 0 3 0 2 56 50 
31 0 0 8 0 23 46 6 0 15 42 5 24 6 0 10 52 0 9 6 5 41 0 54 27 13 0 0 18 0 16 68 11 15 23 9 0 22 0 0 16 0 21 11 39 40 16 0 4 12 0 27 9 0 31 
3 15 37 4 19 0 24 11 0 32 35 26 9 23 10 12 39 8 0 0 79 7 24 4 16 0 0 0 0 0 0 18 0 24 0 5 20 3 15 32 20 6 40 0 6 7 36 0 0 24 82 22 18 33 0 
25 79 47 26 57 63 56 3 0 5 24 0 18 6 0 15 16 13 28 32 33 9 0 19 0 8 58 0 1 0 9 11 20 28 0 18 24 0 8 0 17 0 49 33 18 85 37 0 0 0 41 0 0 93 38 
0 24 0 24 34 13 0 0 0 4 0 0 0 0 0 0 0 24 13 10 0 40 13 0 0 0 0 0 0 16 19 6 0 7 0 19 15 6 34 0 7 33 0 0 0 28 0 0 27 19 0 0 0 0 0 
0 28 0 0 10 22 0 16 28 61 25 60 11 12 0 6 0 31 35 19 0 0 0 49 10 36 0 23 0 0 0 0 10 21 7 0 28 11 21 28 28 8 0 22 0 0 6 0 31 0 0 26 21 0 0 
0 33 81 14 0 2 0 21 0 13 0 44 0 0 17 0 0 8 0 13 1 6 0 2 0 0 0 1 7 0 8 1 6 15 72 0 3 19 0 9 0 21 0 0 10 0 7 0 1 0 0 30 0 0 43 
