55 31
12 15 16 13 56 22 10 29 0 0 77 40 12 9 2 27 20 25 5 35 24 0 9 0 23 0 7 49 5 0 4 0 17 3 40 15 33 33 22 2 0 11 0 8 36 37 0 20 3 16 11 26 88 5 44 
6 34 0 0 42 14 35 0 25 0 16 13 0 31 21 0 0 23 23 20 21 0 25 2 0 28 9 27 0 3 0 20 25 0 4 65 0 0 28 20 35 29 6 1 33 7 2 46 0 3 2 25 9 1 0 
0 0 51 0 0 0 36 0 34 1 16 16 0 0 34 13 0 0 11 7 22 4 12 0 14 0 0 3 27 2 33 18 1 0 5 0 8 18 0 43 10 10 38 0 32 0 32 18 18 17 0 0 41 0 0 
0 19 0 21 0 2 0 23 0 0 1 86 0 11 39 4 0 0 0 38 19 0 0 2 31 0 23 3 9 13 24 20 0 0 0 0 0 0 12 0 1 1 0 0 0 4 2 18 8 8 12 0 25 39 21 
4 23 16 45 0 0 15 41 13 0 2 4 0 0 0 0 0 0 0 0 1 13 0 0 0 27 0 13 26 3 11 0 0 15 0 0 0 0 0 0 23 0 0 59 0 2 0 36 60 0 0 0 32 0 0 
4 71 0 60 0 1 0 32 0 27 0 0 21 0 4 0 9 9 13 14 1 0 0 10 0 0 0 0 2 23 19 13 14 20 0 0 32 0 5 23 0 12 0 40 43 0 0 0 0 0 0 16 51 34 0 
0 42 0 0 33 27 0 23 0 27 35 0 0 0 0 0 22 0 4 17 0 22 4 0 0 30 1 0 6 0 0 0 0 32 1 18 17 24 21 25 26 4 37 75 15 25 7 0 21 3 41 0 9 0 21 
0 0 0 0 48 0 0 0 12 0 44 0 16 0 22 0 23 1 8 2 0 0 12 0 10 12 0 21 0 0 0 21 17 18 0 0 33 0 14 45 17 0 19 23 1 0 4 21 1 17 0 18 20 15 56 
27 0 0 0 35 21 11 5 9 8 0 33 7 1 1 0 29 17 0 0 0 0 0 14 0 0 27 15 4 21 0 31 0 28 11 50 0 0 9 30 0 0 7 12 19 29 15 9 0 0 15 40 4 32 0 
40 0 25 0 40 2 0 23 0 43 8 5 0 0 1 0 34 23 9 25 15 0 0 0 17 0 0 25 0 13 16 7 0 0 8 0 2 29 8 0 23 0 26 0 85 0 0 0 12 0 21 0 43 23 0 
19 32 26 0 30 0 24 0 10 0 0 0 0 0 1 0 0 14 0 0 0 0 0 12 29 0 0 0 26 0 9 9 1 32 30 0 0 1 8 25 0 16 0 0 1 4 0 0 0 0 7 0 1 29 18 
10 8 0 28 0 0 4 0 18 0 4 0 0 0 0 0 0 6 0 0 0 7 0 12 2 0 3 0 7 0 0 5 0 5 5 0 9 0 5 0 0 0 0 0 11 0 4 0 0 0 0 11 10 0 0 
0 49 0 0 95 0 29 0 11 0 41 3 17 0 3 4 10 0 0 26 0 0 0 1 0 0 26 0 0 7 0 12 0 0 18 0 0 13 8 0 34 0 39 7 31 0 4 3 0 0 2 41 41 11 44 
4 0 0 2 0 0 28 1 11 0 0 0 0 0 35 0 0 8 35 34 0 7 0 13 0 0 8 0 4 13 8 0 0 0 20 0 8 0 0 0 0 0 15 0 0 1 0 5 0 35 31 2 1 31 1 
55 0 58 0 20 34 0 8 0 0 50 19 0 0 18 35 0 38 9 35 7 1 0 21 20 0 0 40 11 0 28 0 40 0 14 16 0 0 3 52 0 0 27 21 7 23 6 0 5 48 6 123 12 53 1 
0 15 40 0 0 5 0 33 1 0 8 4 0 0 9 9 0 5 13 25 0 0 0 10 26 0 2 22 17 0 11 0 1 0 32 36 0 0 0 11 0 34 0 10 14 0 0 3 9 15 12 2 26 6 6 
0 30 0 7 0 28 47 1 0 8 0 23 0 0 0 2 14 15 0 1 14 8 0 0 0 57 0 48 0 1 0 0 1 28 68 0 28 0 14 16 2 10 5 0 0 7 19 14 0 0 0 0 17 96 29 
0 0 0 25 8 49 49 34 7 6 0 5 36 0 41 0 18 14 0 2 0 0 0 11 21 2 7 10 21 6 21 0 37 36 26 21 0 5 24 0 1 67 37 9 6 7 0 3 35 0 37 0 22 36 2 
6 1 34 0 5 54 1 33 0 34 18 25 24 5 0 0 0 16 0 0 0 3 0 0 7 13 3 12 0 0 16 0 22 16 12 0 17 0 13 13 39 106 0 0 0 8 60 0 0 0 0 80 21 0 6 
0 26 37 33 0 49 15 7 0 0 0 4 0 32 11 34 1 23 13 0 0 7 12 0 15 2 0 30 34 0 10 35 14 10 1 18 0 16 2 0 21 0 2 10 28 15 30 2 20 30 5 0 49 0 12 
0 0 56 0 0 5 0 4 12 2 0 0 6 11 0 0 0 1 0 7 26 48 0 0 11 15 10 1 0 4 10 9 0 0 0 0 0 3 10 0 0 4 45 1 1 0 32 23 18 0 8 0 18 32 6 
0 5 0 0 99 0 54 0 0 55 38 0 21 0 0 0 0 27 4 0 0 1 0 0 0 0 4 22 0 12 0 20 0 0 0 0 0 0 3 33 15 19 0 0 22 0 0 21 20 45 12 36 43 35 51 
13 0 45 28 0 0 0 20 0 0 13 44 0 13 0 54 0 40 7 0 56 0 0 7 5 7 0 0 0 29 0 8 13 0 31 32 16 0 17 13 22 2 0 2 0 16 26 22 0 10 39 11 6 54 9 
20 0 50 0 17 66 0 16 46 0 9 5 22 0 7 0 0 71 36 20 33 0 0 51 16 0 0 15 0 6 6 8 0 0 0 28 7 0 0 8 1 1 17 0 4 45 29 6 0 44 0 12 50 86 88 
0 0 18 0 1 19 0 6 11 0 25 6 0 38 33 9 0 7 0 38 33 0 0 14 20 0 0 10 0 0 5 19 0 0 0 39 1 0 26 0 4 0 28 0 22 16 0 4 0 0 1 35 0 0 9 
0 0 0 14 38 6 0 0 0 38 0 6 0 18 0 0 0 35 23 0 0 0 0 32 7 0 0 0 15 0 15 17 0 6 0 0 0 1 0 20 0 22 33 0 0 6 0 0 2 0 2 10 35 30 0 
0 0 4 0 2 0 0 41 25 0 0 0 3 0 28 61 25 58 24 0 0 7 5 8 6 0 37 0 47 13 0 0 0 0 0 0 0 0 0 16 0 16 39 28 1 17 0 2 65 0 0 0 23 0 0 
0 7 0 0 39 22 167 0 0 41 0 0 0 0 18 10 0 16 0 10 0 3 10 2 14 0 14 28 0 50 0 0 10 0 0 11 0 0 16 13 1 17 20 53 23 39 11 41 42 40 9 45 39 0 2 
23 4 15 44 7 27 0 73 7 51 0 6 5 37 0 0 22 28 0 13 37 13 0 3 25 27 0 15 20 17 26 37 3 14 0 17 0 16 0 0 13 68 17 10 33 66 4 53 22 27 12 32 12 18 13 
19 0 3 10 29 0 0 23 0 0 29 29 0 0 22 0 0 19 0 12 3 0 0 3 25 28 17 0 0 0 0 0 19 9 0 0 0 0 23 0 0 0 9 17 0 0 0 0 0 25 0 15 0 0 0 
16 17 0 0 34 0 32 47 0 41 19 0 38 0 5 0 21 4 13 27 12 4 6 0 55 18 2 23 2 19 28 0 32 17 0 19 20 24 44 0 0 14 0 29 20 51 34 19 0 0 62 3 12 35 44 
