55 31
0 2 8 45 7 14 0 26 0 4 20 28 23 0 0 0 0 16 0 0 0 0 2 9 14 7 0 15 9 10 6 17 0 6 49 23 15 0 3 0 5 14 13 0 4 0 27 0 0 50 40 0 15 0 0 
44 41 0 12 3 17 0 26 22 0 19 31 25 0 0 0 37 0 47 0 8 32 0 12 10 0 0 5 10 0 20 0 38 18 6 16 20 0 14 0 0 50 31 0 44 29 71 19 0 8 1 30 48 0 0 
116 37 0 46 0 13 0 43 0 7 0 0 41 0 8 0 0 20 28 0 24 31 4 10 0 0 48 2 104 2 39 2 6 22 0 0 8 0 0 12 0 41 30 23 0 9 0 9 27 79 0 12 0 41 0 
6 0 48 6 12 0 10 45 0 0 0 8 0 41 0 0 15 14 10 31 0 3 0 0 23 1 12 17 26 0 0 0 0 0 0 0 12 0 16 15 23 44 71 0 0 0 28 41 0 3 10 15 28 47 41 
0 0 20 0 3 0 0 0 3 31 41 0 0 0 12 67 0 0 0 0 16 47 0 0 0 0 3 0 15 0 0 20 0 24 26 0 0 0 13 0 29 8 0 17 25 0 31 26 57 0 0 2 10 51 0 
29 29 14 16 0 12 0 2 0 0 0 0 0 3 0 19 2 15 0 51 0 2 18 0 0 1 1 0 12 30 28 1 0 0 29 0 1 20 21 0 2 0 45 0 0 0 0 0 31 0 0 0 0 8 11 
0 19 41 46 0 0 42 3 38 33 50 0 4 0 0 26 33 15 13 0 3 12 0 0 0 23 30 6 33 6 3 46 25 16 8 15 10 0 6 23 20 28 34 14 0 0 43 0 57 69 0 26 0 37 0 
10 0 18 23 0 13 0 32 0 0 128 0 19 34 0 0 7 18 13 0 2 2 0 6 0 0 8 12 11 0 22 0 0 11 0 24 37 0 2 35 0 3 5 0 31 14 36 29 0 0 14 0 0 9 42 
0 0 39 30 1 0 21 14 17 18 0 0 5 11 18 0 0 0 19 21 0 3 4 7 15 39 0 7 0 38 0 27 35 0 0 19 7 3 14 0 29 16 1 0 9 13 0 11 21 0 0 5 0 15 86 
0 34 10 7 0 0 35 32 17 30 2 0 0 0 35 0 0 4 39 0 22 0 0 33 0 9 0 0 2 0 14 0 23 0 0 23 6 0 0 32 0 17 22 0 19 0 0 0 0 46 0 18 0 0 0 
0 67 0 0 0 5 0 0 3 0 13 11 13 0 8 0 4 0 0 16 4 0 6 0 13 37 0 3 1 0 0 7 0 2 0 28 17 7 0 5 10 6 0 0 10 0 0 0 0 0 0 0 0 0 7 
7 0 0 46 0 16 8 78 0 0 0 20 5 0 0 0 0 18 15 0 0 14 2 27 43 0 5 0 5 0 0 0 10 0 31 8 0 0 31 3 3 8 41 0 0 3 0 1 0 0 16 2 14 0 47 
5 8 12 46 10 0 11 31 0 8 16 16 0 0 0 2 0 2 12 0 0 11 39 1 15 0 7 0 0 27 2 0 3 12 15 13 0 0 2 29 0 6 0 0 8 11 24 11 30 7 0 0 23 0 0 
36 0 46 13 45 13 0 10 22 0 0 0 5 0 14 1 0 0 0 26 18 0 23 12 22 0 6 32 0 22 21 4 0 0 1 23 8 18 0 0 8 0 0 0 26 0 3 0 1 70 0 1 0 0 0 
0 0 39 22 0 35 0 0 0 8 4 0 5 14 0 2 0 7 15 9 0 11 15 0 9 11 21 2 30 15 0 0 0 0 10 16 36 0 17 11 0 65 0 2 10 35 7 59 15 13 28 31 34 7 0 
51 37 0 15 42 19 0 0 0 6 8 19 0 0 1 26 0 12 0 9 20 12 0 0 7 0 12 0 47 40 19 7 0 0 6 0 5 32 1 7 28 26 0 0 0 0 42 0 0 6 7 24 8 11 18 
6 0 0 0 30 0 0 0 0 0 72 0 5 0 5 8 30 13 0 11 0 0 6 24 0 6 0 0 0 18 0 0 0 0 13 4 10 41 0 0 7 0 0 6 0 13 27 40 12 37 30 22 15 0 11 
29 0 0 29 37 4 0 21 0 39 0 0 0 3 0 34 6 0 0 0 13 0 6 0 39 24 0 0 2 0 0 0 58 0 17 7 3 12 0 15 11 42 0 0 0 4 0 0 39 16 0 11 37 0 7 
7 0 0 0 6 20 0 0 34 5 28 0 0 0 1 12 0 0 9 20 18 11 0 2 0 24 12 1 1 9 0 0 30 3 0 0 0 1 9 11 0 0 4 1 3 0 0 14 11 22 40 19 0 0 0 
0 0 21 0 0 0 0 0 0 90 1 17 0 11 0 15 0 0 0 35 0 19 0 0 0 3 19 22 2 18 11 13 0 9 0 21 0 3 0 0 0 91 0 0 1 1 5 0 29 16 31 65 43 0 19 
14 73 43 18 0 0 27 29 0 7 3 33 13 0 1 15 7 9 0 0 45 11 0 31 6 15 2 20 0 6 3 0 71 35 0 0 0 0 4 0 0 12 6 42 4 43 0 19 0 0 0 0 32 0 31 
0 19 1 20 20 1 0 0 2 17 3 40 0 0 15 0 26 6 18 0 21 22 19 0 11 0 0 0 19 8 0 0 3 0 7 4 0 2 33 16 13 8 26 17 5 1 0 0 8 35 5 2 40 0 0 
0 0 0 0 3 10 0 15 1 43 0 0 0 5 0 0 0 42 0 33 0 0 5 15 26 17 50 0 6 0 5 0 0 4 17 0 34 3 4 4 0 8 3 0 19 0 21 4 18 0 33 0 104 27 0 
0 0 36 8 0 35 0 13 30 0 38 43 0 32 9 0 14 2 0 4 2 0 7 0 1 1 0 20 0 0 29 33 22 0 7 19 0 12 1 25 44 21 12 0 0 32 0 48 19 6 8 0 27 28 24 
0 0 52 0 0 2 24 27 29 5 24 0 38 0 0 8 5 12 3 0 18 30 0 13 12 1 21 19 1 12 5 0 12 12 0 25 14 8 24 18 2 5 8 0 10 0 19 0 38 29 43 1 0 0 68 
0 47 46 0 9 6 0 0 0 27 21 0 18 9 0 0 15 11 0 10 0 4 7 0 0 0 0 0 44 0 21 31 10 17 0 0 27 0 0 0 0 13 18 0 16 0 0 17 125 14 0 19 14 0 0 
0 53 0 5 0 49 0 42 60 30 0 15 25 0 7 0 23 0 58 0 0 26 0 0 0 18 15 53 10 0 0 0 0 24 0 0 0 0 30 0 10 34 0 4 0 0 28 69 1 22 6 1 0 31 102 
0 0 0 0 50 16 0 0 0 0 0 0 9 6 12 20 27 0 1 16 0 29 17 0 5 13 0 0 21 0 0 16 2 0 0 45 9 6 0 0 18 1 2 27 26 18 27 0 0 0 44 0 0 62 49 
0 18 24 16 10 0 0 18 2 22 20 85 0 45 0 11 5 29 16 9 0 12 20 19 9 29 34 14 14 0 21 4 0 66 0 4 25 6 25 0 0 0 39 7 0 0 68 0 9 0 0 10 13 1 29 
0 0 0 21 11 0 0 8 0 0 13 8 0 0 0 0 53 4 0 0 0 4 0 0 0 4 16 11 16 22 0 10 2 0 0 2 29 0 11 0 0 16 16 23 18 0 0 0 44 0 34 15 0 24 0 
0 15 48 23 0 0 0 9 0 0 32 30 0 22 0 0 0 0 0 12 0 2 0 2 0 15 0 0 15 16 20 41 0 0 8 0 0 0 0 0 15 29 65 4 0 0 0 0 0 28 30 0 0 0 0 
