55 31
63 22 0 0 0 19 0 1 0 21 0 0 17 13 27 2 10 2 0 23 32 0 29 0 0 23 68 24 0 12 28 0 14 6 42 0 0 37 0 0 0 15 14 0 0 18 1 0 0 0 0 17 50 19 24 
0 14 52 0 0 4 0 8 19 17 40 3 0 0 0 0 1 8 15 0 13 0 0 0 0 0 0 13 0 16 0 0 0 38 0 0 0 19 0 0 0 0 24 0 0 8 1 0 0 24 26 0 0 8 31 
20 0 4 0 0 14 13 0 12 3 29 0 21 2 12 0 0 15 0 7 12 0 2 21 1 1 0 0 0 14 17 19 7 14 0 0 0 0 0 29 14 17 0 15 0 0 6 17 0 0 26 0 0 24 3 
32 0 33 30 0 16 0 53 56 6 6 30 0 40 27 12 4 5 5 28 7 0 5 4 1 0 0 12 0 0 0 9 11 20 0 33 0 25 0 68 21 3 41 18 0 9 0 0 3 0 24 28 44 6 12 
0 49 0 8 12 51 0 11 44 41 9 52 4 34 37 8 0 0 11 0 0 0 31 0 3 0 0 3 24 2 13 14 19 0 0 1 0 0 0 0 0 0 0 25 0 0 41 34 18 0 8 56 45 30 43 
29 44 0 13 27 4 0 0 14 5 20 19 9 4 29 12 0 0 18 32 10 0 0 9 0 16 4 0 25 67 5 0 0 0 4 7 18 0 35 35 17 6 28 6 0 40 5 6 35 19 1 37 39 23 40 
17 19 81 82 37 27 6 28 8 25 30 30 10 41 2 34 7 0 7 23 24 26 5 24 0 7 7 23 0 21 0 0 22 23 34 28 9 15 0 11 0 67 0 0 15 0 23 0 45 20 31 42 31 8 2 
0 0 0 10 62 0 0 0 7 0 32 0 0 0 2 12 0 0 15 0 0 37 0 0 18 0 16 12 0 15 17 0 14 15 0 4 0 0 0 4 22 23 10 20 40 0 13 1 38 0 0 0 10 0 0 
23 0 18 0 5 0 0 2 42 2 23 33 0 0 0 0 7 0 24 0 27 19 0 0 0 12 0 0 24 0 26 20 0 23 16 31 16 0 13 0 19 0 0 35 0 21 41 0 16 0 7 0 27 2 0 
1 0 5 0 0 0 0 11 18 16 0 0 40 2 0 20 4 3 0 0 5 11 0 18 1 0 6 0 16 29 30 24 11 0 0 20 31 0 0 0 0 15 0 6 0 0 0 18 0 6 0 10 0 0 0 
37 30 0 21 12 0 2 45 0 1 15 0 3 34 28 24 9 0 0 3 11 21 19 0 37 0 26 12 2 14 13 8 0 0 0 42 0 0 0 0 16 7 14 0 9 0 0 13 15 14 3 0 10 15 32 
48 2 67 2 0 0 45 0 47 15 0 0 0 15 12 5 0 0 0 8 18 25 0 0 15 0 8 8 14 0 0 25 0 0 0 19 0 16 22 0 0 3 21 3 0 0 38 45 61 0 1 0 38 7 0 
34 0 0 0 0 0 0 9 0 0 41 0 0 15 28 33 18 1 0 24 39 34 0 0 0 0 37 0 0 27 12 9 19 13 0 0 7 2 6 29 6 1 7 0 6 0 0 7 39 29 13 47 50 24 6 
25 34 47 39 37 0 0 10 47 10 9 0 0 0 0 7 10 4 0 0 5 10 2 29 14 49 0 0 0 0 0 0 0 0 0 56 0 15 0 0 12 30 39 0 11 0 0 0 30 59 0 0 29 0 30 
0 0 17 50 0 0 0 0 39 10 26 0 0 11 34 6 0 2 0 14 0 11 0 17 22 9 0 0 0 5 0 14 3 0 6 0 16 7 8 0 17 33 2 2 0 6 5 0 14 0 0 7 26 42 0 
0 15 46 0 4 29 0 6 4 0 10 0 15 13 0 31 19 18 7 12 0 15 0 13 0 0 24 0 9 4 22 5 0 28 6 18 10 16 0 14 0 9 1 0 7 0 9 1 2 0 0 7 38 23 6 
13 0 0 0 12 0 0 0 33 7 9 7 0 8 0 7 17 0 18 9 0 5 0 20 3 0 17 0 0 0 0 0 17 15 10 5 13 3 0 1 0 0 9 3 9 0 0 0 0 17 7 2 0 11 0 
5 15 10 10 5 0 15 0 9 0 0 0 10 17 0 0 1 0 0 0 7 15 24 0 48 0 0 0 0 0 17 25 0 0 20 7 0 0 24 12 0 28 8 3 21 0 13 0 0 18 42 7 9 0 12 
2 30 44 5 0 1 0 15 11 0 0 14 1 5 44 1 0 6 7 7 17 11 3 9 33 31 54 12 0 0 0 0 15 9 0 0 0 30 0 12 0 0 42 43 19 0 18 0 0 24 32 35 4 0 28 
0 0 0 46 4 8 40 0 10 45 12 0 29 8 0 52 9 0 10 44 0 6 0 1 0 20 0 0 0 22 15 0 17 1 1 0 17 9 0 0 7 0 0 0 1 1 19 0 0 46 0 16 7 38 3 
45 0 0 0 0 1 33 0 5 48 0 6 0 0 0 21 0 2 0 19 31 0 0 53 8 4 0 32 0 14 0 9 34 0 14 0 2 10 1 30 6 0 3 3 3 0 0 5 0 31 43 51 15 0 5 
2 0 15 0 0 33 0 35 1 5 0 0 0 15 4 20 0 0 0 0 5 0 22 15 22 0 0 0 36 29 0 54 10 0 0 7 5 26 13 0 2 1 0 54 0 0 2 25 0 23 18 25 1 0 0 
45 71 18 0 24 0 0 17 5 8 0 3 5 30 19 7 12 0 16 54 0 19 0 0 0 14 7 0 7 40 47 18 30 0 33 7 0 12 7 9 10 0 29 0 5 26 4 21 18 12 43 2 64 0 24 
0 0 2 0 36 0 0 15 14 6 5 3 41 0 0 0 0 5 1 0 10 12 14 14 0 6 0 2 0 0 7 0 14 6 0 31 39 0 3 14 0 0 38 0 0 0 21 0 25 7 7 0 12 12 50 
0 0 12 25 16 0 0 0 0 32 18 14 0 31 23 20 9 26 0 0 30 0 0 16 0 6 25 24 23 14 20 0 0 5 15 27 0 0 0 16 0 1 0 0 20 24 0 0 5 32 9 55 0 0 0 
23 0 42 9 49 0 13 21 38 6 36 29 44 28 0 20 16 0 0 40 8 17 10 0 20 11 16 26 15 21 1 10 19 13 1 104 43 0 0 15 35 10 40 0 36 58 0 0 20 24 1 19 8 26 20 
40 32 48 0 5 0 0 0 9 5 0 6 0 0 11 21 4 16 0 49 11 0 13 0 0 0 6 0 27 0 5 0 6 0 4 0 12 18 0 13 33 0 0 0 21 0 0 0 0 20 80 0 22 24 0 
18 0 0 26 0 42 45 9 8 39 0 4 0 0 21 0 13 0 21 13 1 0 0 15 0 0 4 2 0 15 7 0 0 0 0 0 0 0 0 21 0 27 13 20 0 6 0 19 4 40 24 35 17 0 2 
60 0 19 0 41 0 37 29 8 27 0 0 0 56 3 0 0 3 23 25 0 21 0 33 1 0 8 0 28 0 0 27 0 33 18 12 42 12 23 0 0 0 23 76 22 0 0 29 20 41 26 0 72 23 0 
0 0 46 51 22 31 0 0 74 41 0 16 38 0 0 0 0 5 6 25 16 32 8 12 10 5 9 0 2 20 18 2 0 29 24 0 51 0 12 28 0 6 0 21 0 35 27 6 20 41 14 0 44 32 67 
0 46 0 0 0 0 0 0 0 0 0 0 20 0 24 16 1 0 0 0 0 25 0 0 5 0 12 0 0 0 0 0 0 17 4 0 7 0 18 0 0 0 0 0 0 0 37 46 0 7 0 10 0 4 3 
