55 31
0 49 0 0 0 38 45 0 24 43 0 0 10 17 2 10 0 0 0 6 0 23 6 26 0 23 13 18 27 48 0 13 0 0 0 0 0 14 7 11 9 13 30 67 13 11 0 0 0 2 1 13 74 0 0 
50 0 21 35 0 0 0 22 0 16 8 0 9 25 0 36 0 0 0 0 45 0 6 0 0 8 0 0 0 3 13 22 19 11 14 0 0 54 17 0 0 0 9 0 23 11 0 0 0 0 49 36 0 0 0 
1 31 13 54 18 0 4 0 0 0 9 9 15 19 16 13 0 0 25 9 4 33 18 0 0 4 23 0 7 0 0 0 50 0 1 8 0 19 0 0 25 41 0 60 0 0 0 0 5 0 0 12 0 2 33 
0 30 25 71 61 47 4 0 21 10 11 0 0 0 0 0 0 19 50 13 23 0 10 0 10 0 0 0 0 0 0 0 42 2 16 0 26 0 0 0 0 0 41 17 18 0 45 27 5 0 6 0 66 17 0 
0 25 4 0 5 39 13 0 3 27 41 12 0 36 101 9 6 0 28 25 0 0 0 0 3 3 14 8 9 0 0 0 26 0 0 0 60 5 8 7 16 0 3 0 12 3 76 21 48 71 0 3 8 3 14 
0 25 20 60 43 11 0 6 29 0 35 0 5 0 0 16 39 9 33 0 17 3 1 7 12 0 21 0 4 6 0 28 0 24 0 0 2 29 3 29 0 0 4 12 0 0 0 0 0 1 3 33 38 1 9 
0 16 3 0 86 3 0 0 1 22 4 1 7 8 1 10 0 0 0 0 0 0 13 25 9 6 5 0 0 13 5 2 0 18 11 0 5 0 16 32 4 0 38 0 11 0 1 1 25 0 0 12 48 5 21 
0 35 0 0 45 0 0 0 15 14 6 0 39 14 5 0 28 0 0 0 0 33 10 0 3 21 1 6 0 0 0 0 20 28 0 0 33 28 0 0 7 0 0 0 28 0 35 0 0 31 0 39 0 0 33 
0 23 4 0 2 0 0 13 0 0 21 0 0 0 13 0 32 0 0 0 5 0 14 0 0 17 16 23 0 0 14 0 0 21 20 0 14 3 0 6 0 0 10 0 0 6 0 0 28 0 3 0 15 0 27 
0 0 23 0 29 13 0 0 2 9 19 0 0 0 35 33 29 0 6 0 0 0 0 0 16 9 0 0 1 35 3 0 0 0 0 0 17 35 4 9 9 0 37 0 13 45 23 11 0 35 1 1 50 0 0 
0 29 15 0 1 0 7 0 5 26 21 0 41 23 1 17 0 0 0 0 3 12 0 1 0 0 0 0 0 7 1 24 17 32 16 0 32 9 0 0 1 0 0 3 3 14 21 0 17 0 3 0 31 0 0 
0 40 43 9 0 0 24 0 60 0 12 0 0 0 5 26 32 28 0 4 0 12 11 20 0 0 0 5 5 6 24 0 23 0 2 0 28 17 0 0 32 25 1 0 21 39 0 0 32 1 26 9 0 0 26 
0 38 0 45 47 5 0 9 0 0 35 8 10 53 0 36 0 0 35 0 0 0 17 7 54 35 2 0 0 11 0 21 20 10 10 0 2 7 0 41 5 4 6 0 11 67 0 0 57 0 0 42 28 17 29 
0 0 0 0 0 0 24 32 0 10 0 0 13 0 0 17 0 11 0 5 23 0 4 0 15 0 7 0 16 7 0 0 0 0 2 0 4 0 0 9 15 13 10 0 1 0 3 40 0 1 0 0 9 0 0 
0 27 0 25 50 16 7 45 11 0 0 4 12 1 0 5 8 0 0 11 0 15 32 0 27 0 0 0 52 28 0 0 9 0 0 0 0 0 0 0 7 9 9 10 0 0 0 0 0 1 5 23 68 0 91 
4 0 14 45 0 0 0 42 11 4 0 0 5 28 30 27 9 12 0 0 3 9 0 0 0 0 0 0 0 12 0 19 0 0 0 0 1 37 24 26 5 0 58 16 0 0 0 4 45 42 19 30 20 0 41 
89 0 0 15 13 11 0 0 7 0 8 0 0 66 27 5 0 0 1 16 3 0 18 0 10 0 0 0 7 0 0 0 0 12 0 22 15 4 0 0 18 1 29 0 0 0 0 0 48 0 0 0 0 16 0 
0 7 27 0 0 0 35 0 8 0 0 0 15 0 13 14 4 0 0 0 0 3 10 10 35 10 0 13 14 39 0 7 0 26 11 0 28 21 0 0 15 0 18 17 6 31 15 41 0 12 49 0 0 0 0 
20 0 35 6 39 0 0 0 0 6 0 4 0 56 1 32 9 31 7 28 14 3 0 0 6 23 10 0 5 15 0 8 20 0 0 22 10 16 6 0 0 0 0 54 0 0 4 26 31 0 0 6 3 16 2 
93 50 59 42 12 10 20 0 26 13 48 29 0 0 36 2 4 17 49 0 17 8 9 11 0 0 44 19 5 42 0 28 1 2 40 6 28 1 0 1 29 0 0 0 0 42 0 0 67 41 122 67 0 0 0 
0 9 9 15 0 0 41 17 5 15 0 0 5 0 27 0 0 0 9 0 0 0 5 0 8 0 19 0 0 0 0 33 19 15 0 0 0 0 7 16 0 27 0 0 0 14 0 33 0 0 0 0 0 0 0 
47 0 12 146 9 2 19 37 14 0 3 0 15 14 8 1 0 30 0 31 13 0 22 2 0 9 0 13 11 26 3 6 0 4 35 9 9 15 2 15 3 0 28 0 9 0 39 17 0 60 61 1 51 0 51 
0 69 21 3 7 34 3 0 14 0 34 33 28 0 39 0 0 0 0 0 21 0 2 10 10 3 20 9 0 0 14 0 22 31 1 16 26 0 0 35 28 1 7 52 12 0 16 22 10 0 8 22 0 0 53 
0 20 30 6 0 13 16 28 39 0 29 0 42 41 4 0 17 0 12 24 4 10 13 15 4 6 8 8 0 37 0 22 4 0 24 8 17 0 15 0 27 0 0 1 5 26 44 0 0 0 0 15 0 7 88 
51 27 0 0 19 0 37 0 52 0 0 0 0 21 21 2 19 2 0 9 17 0 21 4 12 5 11 4 24 25 23 5 0 0 3 0 12 11 24 18 15 0 2 40 24 6 0 0 0 0 0 10 0 0 23 
36 50 0 0 0 79 0 0 0 21 0 0 1 0 25 0 11 0 0 29 53 0 19 0 0 39 28 2 13 51 21 0 0 5 34 29 0 41 33 0 7 2 0 0 3 0 22 21 7 3 0 64 0 24 3 
4 18 0 21 9 3 38 32 23 1 24 28 13 28 0 7 38 22 0 4 0 0 22 4 15 20 19 0 14 5 0 0 0 11 21 0 0 0 0 18 14 0 18 19 29 23 0 39 0 0 0 0 0 0 54 
0 32 14 0 49 0 10 32 21 0 39 0 0 30 20 41 23 10 55 1 0 0 4 10 19 2 34 30 2 27 27 16 38 7 3 14 28 18 15 45 0 24 40 23 0 0 0 3 25 36 18 0 12 34 29 
1 0 25 18 0 0 22 0 0 0 0 0 28 0 11 9 20 0 24 18 26 46 20 0 10 15 0 0 10 0 0 0 6 11 20 0 20 49 0 0 15 0 43 0 0 6 2 8 24 28 0 6 13 1 0 
11 70 9 46 24 3 5 39 0 43 9 26 23 13 0 40 0 11 0 41 0 15 6 22 9 13 51 7 3 18 17 5 11 14 0 15 8 30 10 15 3 0 15 46 36 0 35 17 33 9 54 42 29 25 24 
4 0 12 31 0 16 0 17 0 18 0 11 23 18 5 0 28 24 0 5 25 0 9 6 17 22 0 3 5 29 0 4 0 2 0 33 9 34 11 21 6 0 0 0 19 0 21 60 5 10 0 8 0 0 31 
