55 31
8 41 0 0 4 0 17 0 49 37 0 0 0 6 0 13 0 0 22 22 2 0 0 0 13 26 30 0 32 11 0 0 18 0 26 0 5 0 16 0 11 17 67 0 0 32 0 0 0 0 0 16 17 45 45 
0 44 0 1 0 14 27 0 0 14 1 0 27 0 28 0 29 37 6 14 26 1 0 0 4 0 0 0 0 9 0 59 26 27 57 0 0 0 0 0 0 0 22 0 0 73 0 0 0 29 0 0 14 35 37 
20 3 14 17 5 0 2 32 4 3 4 0 0 17 8 39 13 19 10 3 20 0 5 0 27 5 61 13 0 6 14 0 20 30 0 21 6 0 11 13 4 26 0 0 0 0 0 0 16 0 0 64 5 8 48 
0 50 90 0 10 7 0 0 10 26 68 31 18 2 26 0 25 0 27 0 38 13 0 50 0 4 0 0 4 3 72 5 4 6 7 0 0 3 9 0 76 43 49 0 0 40 20 8 4 47 20 27 35 33 11 
1 62 20 0 8 0 0 0 15 6 26 56 0 0 14 30 5 15 0 0 19 0 29 23 0 0 13 18 14 0 0 0 0 31 6 0 0 36 0 1 19 0 0 0 7 0 7 0 1 0 0 57 0 7 10 
47 0 12 31 0 3 8 0 56 0 41 0 21 1 38 33 23 27 0 3 0 16 0 0 0 28 3 18 19 0 0 0 15 26 0 0 23 0 6 38 0 38 26 0 7 18 0 0 127 0 0 0 82 13 9 
0 0 0 68 11 0 0 32 49 0 19 8 27 0 23 0 13 0 0 0 11 9 0 0 8 0 0 0 0 0 27 34 18 13 30 24 0 14 14 32 0 0 0 0 0 0 0 10 0 12 0 0 0 42 0 
0 14 0 0 0 0 0 0 5 5 0 0 35 28 23 22 0 9 22 0 0 0 17 5 0 5 1 0 27 0 14 0 18 28 0 0 8 30 0 0 0 17 14 0 16 0 28 24 16 0 0 14 9 12 21 
8 3 19 17 20 7 16 31 31 6 4 0 42 0 5 12 0 15 0 20 12 17 2 0 2 21 0 0 0 0 0 40 24 0 20 0 0 28 26 44 6 0 0 0 29 0 0 18 10 0 0 13 0 0 42 
39 0 3 6 3 3 1 23 33 19 10 0 15 5 21 48 38 4 12 0 0 0 42 0 55 15 53 17 0 0 16 20 8 2 0 0 0 0 9 0 9 7 0 0 12 0 15 2 33 25 0 15 33 6 14 
20 63 7 0 24 31 3 0 0 0 0 17 0 4 0 0 28 0 3 14 1 0 17 0 0 11 18 0 39 11 25 1 0 7 0 0 23 0 0 14 3 0 26 0 10 12 0 0 3 48 8 3 3 8 0 
0 0 56 0 19 16 31 0 0 0 0 0 0 0 5 0 0 0 0 0 9 16 30 0 4 0 0 0 0 0 0 4 11 2 0 0 0 46 0 0 0 0 0 0 0 0 0 0 14 0 0 0 33 0 52 
2 0 1 38 0 62 15 36 0 0 8 0 21 0 11 51 17 0 6 10 12 0 0 0 0 20 21 0 22 0 0 0 5 15 16 21 8 17 18 0 25 38 10 36 21 0 0 3 0 0 41 0 0 9 0 
3 27 0 0 5 0 8 18 0 50 1 46 0 0 17 13 43 0 24 31 0 9 0 9 14 0 62 59 4 34 13 51 20 6 0 0 44 9 8 0 14 14 14 16 0 3 0 13 0 2 8 33 0 49 18 
0 14 0 26 0 0 33 47 59 13 0 48 0 45 0 62 31 0 22 7 3 1 0 0 8 0 14 19 0 19 0 0 11 0 12 0 21 22 0 0 43 5 45 0 0 0 0 49 0 41 0 0 0 57 7 
0 24 23 0 12 47 1 23 35 19 1 1 0 0 18 0 0 6 0 40 0 0 30 42 17 24 16 0 4 0 11 4 62 31 15 0 0 0 0 0 0 21 7 0 8 0 0 0 29 15 0 10 148 14 0 
37 36 31 88 8 35 0 0 9 0 17 0 0 0 0 11 11 9 0 0 5 0 0 28 17 4 0 17 19 26 0 0 8 12 8 1 15 21 11 0 0 0 8 0 39 7 0 19 0 0 12 43 17 50 0 
0 43 47 16 4 0 17 0 61 0 0 0 0 0 11 0 11 12 35 0 0 12 8 20 0 0 14 1 17 0 14 0 0 0 0 0 0 5 35 0 0 0 11 27 43 8 0 4 0 50 0 0 3 18 38 
43 7 39 0 14 6 0 0 20 10 0 2 45 0 4 17 0 21 10 0 4 0 0 15 9 0 17 0 15 5 0 0 17 5 15 0 36 0 3 0 0 5 0 0 0 11 0 0 36 0 0 0 0 59 7 
18 8 14 19 0 0 15 0 0 11 16 2 0 0 24 30 0 2 18 17 0 41 19 0 0 19 0 0 3 0 28 18 10 21 7 0 0 13 7 0 0 0 0 22 19 9 0 7 11 34 24 0 0 12 9 
0 0 26 0 12 8 58 0 19 5 2 0 0 40 42 0 0 0 55 0 0 0 16 0 0 0 0 60 2 7 0 0 11 27 4 11 0 0 10 5 0 0 0 0 2 0 19 0 0 8 0 44 24 6 0 
0 42 0 50 0 30 0 32 15 0 0 6 0 0 0 4 0 8 0 6 10 55 0 0 5 0 25 21 4 0 24 13 0 13 0 41 28 0 25 0 3 12 0 23 0 0 0 50 0 0 0 8 0 58 19 
20 29 32 0 14 3 0 1 18 2 4 17 10 0 10 0 21 0 0 1 27 9 0 0 12 0 5 17 0 20 40 0 0 0 0 14 22 21 0 4 0 3 6 4 3 0 3 27 0 3 0 0 0 0 0 
0 0 0 0 2 43 0 20 5 6 0 23 0 0 10 0 8 0 16 0 22 31 1 1 29 0 5 13 12 0 0 0 2 16 14 3 0 11 9 28 10 5 9 0 9 12 20 20 56 13 0 7 0 0 31 
0 12 7 0 33 16 0 7 1 66 52 4 12 0 27 62 38 37 26 29 2 7 28 23 30 0 5 0 0 0 0 26 1 7 6 0 22 28 14 20 28 2 1 33 35 0 38 4 38 34 0 36 0 23 23 
35 4 18 51 2 0 6 0 38 7 19 65 7 11 0 15 2 3 7 15 7 4 32 0 0 16 0 8 0 0 0 0 8 3 0 0 25 34 0 11 0 0 0 4 10 0 38 0 5 0 15 14 0 11 25 
18 40 0 53 0 0 0 0 0 0 0 0 9 0 33 0 1 0 16 0 0 0 0 18 1 0 0 3 0 0 21 0 21 0 48 0 0 0 14 0 0 17 17 0 0 0 0 77 21 0 7 33 0 8 3 
0 0 2 0 49 62 0 0 2 1 44 9 39 0 35 0 0 0 0 8 0 0 0 81 9 0 12 15 0 0 0 5 27 10 10 0 5 0 12 0 0 0 15 0 20 0 0 20 0 0 0 41 1 7 49 
62 71 50 12 44 0 0 0 37 36 0 16 47 2 29 21 1 30 8 0 4 10 1 32 2 0 4 0 18 0 0 0 26 0 0 0 56 36 0 39 38 2 12 3 42 0 21 32 43 31 3 28 0 0 31 
0 0 64 6 21 26 7 6 10 12 0 0 0 8 6 0 0 25 10 0 0 8 5 0 0 39 0 0 1 12 0 18 7 9 28 26 18 28 2 8 20 31 9 0 4 11 0 0 19 23 4 26 8 0 0 
0 0 9 1 29 0 37 17 27 8 2 23 0 2 45 0 34 0 9 35 7 2 0 5 0 0 50 0 23 18 5 29 0 5 43 12 0 0 4 0 17 0 0 20 21 38 0 0 25 29 34 13 27 0 19 
