55 31
7 13 50 0 0 0 0 7 50 0 63 31 0 0 0 0 0 27 11 17 0 18 16 9 0 19 7 0 0 0 0 30 0 7 0 0 35 0 0 23 0 40 0 0 28 0 14 20 0 0 0 20 39 0 0 
68 52 0 10 0 0 6 0 0 0 0 45 41 11 28 0 0 0 0 0 0 0 0 18 11 0 0 0 0 0 0 12 0 0 23 15 25 0 2 0 0 1 0 21 0 16 16 38 0 13 0 0 0 11 54 
26 4 14 0 42 4 0 0 0 0 0 0 27 21 24 0 31 0 0 0 0 3 0 37 7 0 0 0 0 0 0 0 0 13 0 13 14 11 4 0 17 15 0 20 12 0 50 31 11 0 0 0 38 0 0 
11 0 12 0 53 11 20 40 32 0 0 5 0 0 12 5 5 22 14 34 5 1 0 0 32 23 0 22 0 14 0 17 0 0 0 0 3 0 18 8 5 40 0 14 6 0 0 11 67 6 0 0 0 34 0 
0 0 26 20 1 0 0 0 0 6 0 0 9 0 46 0 37 0 0 12 0 13 4 20 16 0 4 0 18 5 26 18 10 9 8 0 24 0 2 8 0 20 11 7 0 7 32 5 0 35 2 15 16 45 0 
0 0 0 0 0 24 0 0 0 15 0 0 22 0 34 0 36 0 0 0 0 0 13 0 0 12 4 0 0 3 4 9 0 10 0 36 13 0 3 0 9 8 0 3 18 16 0 12 34 15 24 0 36 0 0 
35 0 0 45 0 30 0 0 0 16 0 0 47 5 17 0 0 8 5 10 0 0 19 0 0 33 4 26 3 0 3 22 0 0 0 30 13 25 5 9 0 19 0 11 4 0 5 0 35 0 0 7 0 75 0 
0 18 82 0 0 35 36 0 7 0 32 0 0 5 42 0 16 0 36 0 0 0 13 0 8 0 0 17 15 19 0 0 0 0 44 0 0 0 16 0 11 0 4 6 6 0 18 0 1 0 36 49 0 0 36 
3 0 23 48 4 0 11 0 4 0 11 0 0 0 6 17 0 31 10 28 6 17 15 8 22 23 27 17 0 20 0 27 24 0 5 13 23 12 14 2 5 2 6 7 0 28 0 0 66 17 23 0 23 0 33 
0 12 40 0 4 44 6 0 4 0 0 9 0 12 1 32 14 8 30 0 1 7 20 0 0 0 12 18 0 5 20 0 16 0 17 0 3 0 5 0 23 11 20 1 8 0 7 8 14 3 0 0 0 0 0 
0 0 0 0 0 0 5 0 7 11 0 0 23 40 5 38 3 23 5 0 8 0 6 0 3 14 18 3 43 3 1 9 0 34 4 25 6 16 12 19 4 0 8 10 1 17 7 7 0 31 17 3 0 62 22 
5 0 0 7 0 32 0 0 0 22 12 0 0 15 1 8 8 0 11 0 5 2 0 6 6 27 3 26 18 15 0 0 11 0 18 3 11 45 5 8 0 12 11 1 0 2 14 5 3 0 7 0 27 37 0 
9 0 0 0 0 51 0 0 6 17 5 31 26 10 6 0 0 0 0 0 4 0 31 7 13 9 45 22 0 0 0 17 0 10 17 0 2 0 26 0 7 8 31 12 0 3 23 6 22 4 24 0 4 35 2 
9 0 0 0 5 9 10 0 0 24 5 24 16 1 26 5 3 3 0 27 5 4 23 19 3 5 0 2 19 14 0 5 0 28 17 21 12 0 0 0 0 10 0 6 0 23 0 0 19 0 0 10 0 16 0 
47 14 36 0 47 4 0 28 9 0 7 2 32 0 31 0 15 9 26 45 0 0 0 1 0 0 3 15 0 23 5 0 0 0 20 33 32 11 11 0 6 0 5 5 43 31 3 53 3 30 0 0 1 37 42 
69 52 46 16 0 0 5 0 17 0 19 0 0 12 11 9 0 35 25 16 0 0 13 7 6 26 0 17 0 20 1 4 0 5 0 4 0 12 38 23 0 0 7 8 0 2 43 4 69 0 7 0 0 1 13 
5 28 3 0 37 0 0 2 0 2 16 11 0 33 71 38 0 59 10 0 0 13 17 0 3 9 6 17 38 3 7 0 4 13 26 14 5 0 16 11 12 37 4 10 44 0 13 17 10 2 0 17 14 1 40 
0 0 5 0 34 0 2 0 0 0 5 8 33 0 0 0 0 1 1 25 0 4 6 0 14 16 0 2 0 0 0 5 9 2 8 0 0 0 41 0 11 15 0 0 0 56 0 8 0 24 0 0 0 0 0 
0 2 4 0 10 4 0 0 0 0 0 0 0 30 20 0 0 0 3 25 7 7 0 10 0 0 2 15 8 2 0 18 8 10 25 10 1 0 3 2 10 5 0 0 51 0 0 0 0 0 0 0 0 0 27 
3 10 31 30 8 9 8 0 44 7 0 0 6 53 11 15 0 0 6 0 0 2 0 20 1 21 27 2 13 0 4 4 29 3 3 7 12 9 0 0 0 7 0 0 0 0 33 0 7 0 0 15 25 10 0 
22 0 0 0 0 3 19 0 0 0 5 9 27 0 8 1 11 4 7 22 10 3 13 0 2 42 28 14 0 0 0 17 32 28 19 14 13 11 0 44 7 46 0 6 5 0 9 37 12 75 16 0 13 10 3 
40 0 0 0 37 26 0 0 0 0 0 0 0 3 5 30 0 4 17 12 0 13 6 0 0 15 0 17 0 9 0 38 0 0 5 35 9 0 0 31 37 37 18 11 15 35 14 4 26 4 9 0 0 12 4 
51 10 56 50 50 0 26 0 42 17 0 22 19 21 1 1 0 4 17 22 0 4 0 0 2 0 0 3 7 5 21 19 26 0 0 5 0 0 0 26 0 24 2 13 2 11 18 0 6 0 97 51 0 42 1 
4 0 0 25 4 7 17 46 23 13 34 45 7 0 7 0 19 12 9 0 0 0 9 3 24 0 19 36 16 0 0 32 0 13 23 45 19 0 21 23 0 12 0 0 2 19 4 13 0 2 15 26 7 15 21 
14 47 0 0 26 0 0 0 5 58 0 48 23 0 0 9 0 15 0 7 0 11 0 0 0 0 22 17 20 18 0 3 0 0 11 18 22 0 0 0 36 9 0 0 0 36 0 0 47 37 0 0 24 0 92 
30 18 0 0 0 0 10 0 1 17 32 1 5 0 31 0 24 18 18 5 0 3 28 0 8 4 17 14 0 12 30 0 0 0 0 1 18 38 0 0 24 1 0 0 11 2 17 0 0 9 12 0 0 4 4 
62 44 33 0 0 0 8 0 1 0 0 1 0 0 37 0 24 0 10 3 0 0 20 0 18 17 18 0 0 4 9 0 15 8 25 21 5 6 38 0 33 18 20 11 22 2 19 40 20 48 0 0 18 0 0 
43 9 10 36 14 0 22 0 27 0 6 13 13 5 14 35 27 0 0 0 0 0 0 5 13 16 0 0 17 3 0 19 25 19 22 22 0 16 0 47 0 0 0 0 0 31 4 0 6 0 29 16 19 28 28 
33 38 21 36 21 21 0 0 0 0 0 25 3 0 0 26 0 0 0 7 20 0 10 21 12 24 43 0 17 15 0 0 0 8 0 0 3 0 21 36 12 0 0 0 15 24 0 0 28 0 3 0 37 0 0 
38 3 21 0 0 49 0 31 0 10 29 0 27 0 3 20 28 3 32 40 0 0 8 47 10 3 20 14 0 0 0 56 10 0 6 0 21 15 31 7 16 14 0 0 0 0 7 0 5 3 2 0 29 30 24 
30 26 0 33 27 11 4 0 0 34 0 6 5 15 29 0 0 37 12 0 10 0 15 18 0 5 0 5 7 15 0 0 0 15 0 35 33 0 14 0 15 0 0 26 4 8 23 0 0 0 0 11 53 7 37 
