55 31
0 44 20 0 12 14 0 18 0 0 0 0 0 12 1 8 16 13 27 2 18 1 16 25 0 0 12 29 27 18 19 14 6 0 0 0 34 0 30 0 35 0 15 5 47 33 27 6 26 15 8 4 0 22 130 
0 39 52 0 15 0 0 26 0 0 21 47 0 6 0 15 0 0 0 0 0 7 3 0 0 0 22 50 60 0 41 26 0 20 21 24 13 0 21 25 25 21 12 16 4 18 32 36 0 21 9 0 4 31 34 
3 0 4 34 0 0 0 0 69 0 11 18 12 0 11 0 0 0 4 15 10 13 49 25 0 0 4 15 0 8 4 10 19 0 0 0 5 29 7 0 6 11 12 0 0 0 0 0 0 0 20 23 11 1 0 
8 0 0 29 0 23 0 83 0 0 5 0 11 0 35 23 0 2 13 0 0 0 18 23 17 28 0 0 0 23 18 0 29 0 21 0 0 0 0 0 27 15 23 0 18 0 17 0 33 35 0 0 29 0 0 
2 23 28 12 7 13 10 0 16 18 10 1 10 40 0 38 4 11 38 0 4 18 9 29 9 0 0 0 26 2 95 17 9 0 4 32 0 0 8 18 0 0 5 13 22 61 9 4 27 37 0 0 39 7 1 
0 0 15 10 15 0 7 51 0 0 7 24 55 15 11 0 0 32 20 0 0 33 17 0 0 4 22 0 11 0 18 21 9 0 28 33 0 34 22 26 43 0 0 0 12 0 0 45 0 37 31 7 21 0 48 
25 14 45 0 11 0 16 0 18 2 43 0 12 0 41 0 0 15 5 18 0 3 2 2 17 13 2 9 26 1 21 60 0 33 0 0 0 0 10 0 0 17 0 0 0 0 0 25 11 15 50 37 14 21 54 
12 46 0 0 2 26 6 14 0 23 13 2 8 5 14 3 0 5 5 13 0 19 38 14 29 16 0 22 4 20 0 42 18 0 2 0 5 14 0 0 4 7 11 0 9 4 45 0 0 28 18 2 30 10 0 
14 39 17 16 0 0 0 87 0 2 39 0 0 24 2 0 0 0 0 9 20 2 15 23 8 0 0 16 16 0 4 1 9 0 34 0 19 32 1 17 59 1 1 0 16 9 39 11 5 42 30 14 0 30 5 
21 114 7 6 9 45 13 0 10 6 0 39 29 0 7 0 16 0 0 0 0 3 0 2 18 19 15 0 11 16 20 17 0 0 11 0 13 0 15 3 0 51 4 13 0 0 45 39 0 0 23 0 10 0 0 
6 46 7 27 0 0 0 72 37 7 23 1 49 0 23 0 0 5 0 0 0 0 33 0 12 29 0 10 0 15 0 3 10 23 3 0 0 0 0 53 7 27 19 0 9 19 16 53 0 37 0 47 0 20 19 
8 0 0 0 16 36 4 8 31 0 44 27 13 36 0 25 0 0 5 0 0 0 6 18 0 18 0 0 10 2 8 3 0 0 0 7 12 20 4 31 29 46 0 0 0 0 7 4 33 36 0 0 0 0 44 
8 0 0 14 6 15 65 47 23 9 0 15 0 0 0 33 15 14 2 0 5 0 6 0 14 23 12 3 0 0 14 42 26 0 3 11 0 24 1 0 0 0 0 18 0 8 0 41 33 0 24 0 0 0 40 
2 19 9 0 41 0 40 35 0 0 44 9 0 0 37 45 0 3 14 45 50 24 0 0 5 0 0 0 0 2 23 0 0 18 1 0 0 0 8 15 8 0 27 14 0 37 28 21 5 0 10 34 5 0 101 
24 21 0 1 0 29 27 1 41 58 0 0 0 10 0 7 0 0 6 0 0 0 0 5 22 11 0 10 22 0 0 0 7 19 30 3 24 10 13 31 4 29 33 0 0 0 5 1 12 0 38 10 0 0 0 
2 15 0 40 0 43 42 12 13 3 3 0 35 52 0 36 28 5 0 4 19 0 13 4 11 0 0 27 0 2 0 18 0 0 0 0 0 3 0 30 0 0 51 0 4 0 31 25 74 12 2 7 3 79 0 
53 48 0 0 16 0 0 13 50 0 0 0 4 0 11 11 2 2 0 0 0 7 12 0 2 7 0 9 0 0 0 0 0 15 0 31 0 0 0 0 0 0 15 0 11 0 0 46 15 0 14 0 0 62 46 
11 49 0 15 7 0 4 0 0 12 9 16 0 29 4 5 1 1 0 19 8 0 11 24 3 3 0 13 0 0 15 0 0 0 3 0 6 15 16 13 0 7 55 0 0 0 6 16 13 0 10 0 24 2 0 
0 2 0 48 0 15 0 39 14 42 0 0 0 7 19 0 2 0 0 0 29 0 14 0 15 0 0 0 0 0 3 0 0 19 0 0 29 10 0 9 0 15 0 0 0 5 7 10 39 0 1 48 0 29 18 
42 0 0 9 79 25 0 15 10 4 34 21 15 4 37 21 0 0 4 0 0 0 24 11 13 2 0 0 12 18 3 0 11 24 30 10 34 0 6 0 16 0 9 0 16 29 18 25 23 0 5 7 42 49 33 
4 2 35 33 0 24 44 0 0 0 71 0 24 26 1 36 43 13 16 0 32 11 4 1 4 20 0 17 2 8 39 3 0 9 20 0 24 8 0 47 0 7 0 0 19 5 45 3 1 0 39 36 46 20 0 
0 27 0 0 5 1 4 14 12 17 0 23 0 0 18 0 0 17 0 12 11 0 13 0 0 0 0 0 0 2 3 2 25 0 25 26 0 6 6 0 0 2 0 11 18 0 41 0 1 0 7 0 20 4 0 
0 0 0 17 36 7 0 8 41 18 0 2 7 2 12 34 12 7 1 31 26 0 3 0 25 3 0 15 18 13 0 0 5 6 0 0 0 10 3 23 19 26 25 15 0 25 0 0 0 57 0 42 0 0 0 
28 0 17 0 35 0 31 3 0 0 0 14 0 0 13 0 0 0 23 17 0 0 8 5 0 14 14 0 28 0 0 11 0 0 8 0 18 31 0 28 10 0 0 13 18 0 24 5 0 0 10 8 0 13 0 
4 0 0 0 0 0 0 0 0 0 31 14 0 0 3 30 22 0 0 18 0 0 4 13 0 18 0 16 18 15 0 0 0 2 1 0 0 4 22 0 0 4 0 0 0 41 0 24 0 0 0 0 18 0 5 
0 8 0 0 0 0 33 22 11 0 2 15 11 10 0 48 1 36 21 0 25 0 14 36 0 0 0 0 0 15 8 58 0 10 18 15 0 22 15 10 12 26 0 0 0 0 0 12 9 0 0 43 21 49 0 
0 0 0 4 1 41 27 5 5 0 0 0 7 6 8 10 1 0 0 4 24 32 71 4 0 25 24 0 0 0 6 58 3 31 6 19 0 0 0 54 4 0 7 0 46 0 0 7 25 0 0 0 9 51 19 
45 0 48 0 0 15 0 6 40 8 12 37 23 30 9 23 0 31 5 30 23 23 8 25 0 0 6 13 9 4 25 15 33 0 0 0 0 16 0 35 18 6 18 9 4 42 42 0 56 32 81 19 23 0 0 
24 120 0 15 0 2 0 0 0 0 0 32 0 38 0 0 0 0 15 28 31 0 1 22 48 22 0 0 7 26 0 0 0 17 12 38 0 0 0 0 23 0 41 37 0 24 1 17 0 25 17 28 0 0 3 
0 6 0 0 0 26 0 11 0 12 0 6 0 0 0 0 0 6 0 0 11 0 25 19 23 0 0 51 0 0 2 19 5 4 24 0 0 7 0 14 0 0 19 0 7 44 0 0 10 0 19 0 0 0 0 
59 10 0 41 11 12 0 26 36 25 0 28 4 18 18 26 20 24 21 64 18 0 13 1 0 0 0 0 37 0 25 18 12 17 20 0 27 0 5 44 4 24 37 50 112 42 27 0 15 0 43 0 27 0 6 
