55 31
0 12 0 0 20 0 0 0 30 4 0 2 32 0 0 0 0 8 0 0 22 0 0 0 20 0 10 0 17 6 12 31 5 14 0 48 10 24 7 0 28 5 14 0 0 17 13 26 0 0 0 0 35 0 0 
31 0 0 0 11 0 16 8 0 12 0 64 0 0 4 6 2 0 4 0 0 35 10 5 0 0 25 12 0 0 0 54 20 0 0 0 0 17 16 5 0 2 0 2 13 15 0 0 2 15 0 25 27 42 17 
0 0 27 0 0 13 0 40 44 0 12 13 0 0 0 0 12 0 32 0 2 0 0 0 14 0 0 9 20 6 0 1 5 0 0 6 8 0 0 0 22 0 29 21 0 13 0 40 6 0 16 0 44 0 0 
48 1 0 0 0 0 0 24 0 0 27 0 35 3 0 10 7 2 14 13 34 29 16 15 0 2 0 6 0 0 33 2 7 0 41 0 0 6 0 0 0 0 0 0 14 0 29 0 51 0 26 0 37 5 33 
0 51 0 9 1 0 11 14 0 0 8 0 5 23 6 23 15 11 2 0 37 12 25 10 0 0 23 17 2 0 0 24 21 15 0 15 15 0 0 5 0 2 35 8 8 0 0 0 0 0 4 0 0 52 19 
11 0 100 40 122 66 16 14 7 0 18 13 6 19 0 6 0 33 15 10 20 15 1 0 11 0 4 14 15 24 0 10 16 25 30 31 25 0 13 1 33 27 8 47 0 0 42 0 16 0 23 0 50 4 10 
0 79 0 0 2 18 39 23 2 10 0 0 10 0 0 10 43 0 0 14 13 0 0 23 14 0 1 18 4 11 0 18 21 1 3 20 7 0 0 5 8 23 35 0 38 11 19 50 12 21 0 0 18 1 0 
0 99 0 59 36 44 3 11 0 0 22 53 32 17 26 0 0 0 11 24 29 11 23 10 18 14 23 0 0 11 7 19 22 0 0 0 25 17 7 49 12 20 11 0 57 0 19 0 27 74 2 31 21 13 4 
0 51 0 19 3 3 33 45 0 0 6 53 1 23 0 8 25 2 27 25 0 31 0 4 41 0 12 11 0 3 22 0 0 10 0 8 27 34 17 65 4 0 0 84 0 35 0 0 0 0 0 0 123 0 0 
46 14 22 21 0 0 7 0 6 0 0 39 0 0 15 0 8 0 0 8 19 13 0 0 12 0 4 3 24 0 0 4 13 0 0 0 0 6 0 6 0 0 31 8 0 19 0 47 0 4 0 27 0 6 12 
0 44 44 37 0 0 0 0 0 0 0 27 42 0 0 46 6 0 0 0 0 0 0 0 0 0 1 18 0 9 0 14 16 22 16 0 0 8 11 0 31 0 15 1 0 17 16 1 0 0 35 0 0 0 74 
5 0 44 27 0 0 14 16 0 17 0 0 0 11 0 28 22 0 13 0 0 0 0 0 0 0 17 2 0 15 27 3 0 0 0 0 16 11 21 0 0 12 0 1 0 43 0 0 11 0 13 0 0 0 0 
42 22 3 0 11 4 4 3 23 37 6 0 0 0 6 30 29 0 31 0 18 0 0 9 0 0 29 0 24 0 12 7 0 7 0 11 0 0 20 21 1 0 50 24 0 6 48 30 0 0 8 11 15 9 2 
0 8 0 11 3 8 7 0 0 6 27 3 0 0 8 0 17 12 11 16 0 6 8 47 7 21 0 0 0 12 0 4 0 0 0 0 30 16 8 6 12 0 39 0 0 0 32 3 0 0 0 0 8 0 0 
3 0 0 0 0 0 26 0 0 5 11 0 0 7 72 10 15 0 0 0 0 11 0 15 0 7 14 0 7 8 9 0 11 19 51 0 0 14 1 5 54 0 14 29 13 0 0 0 3 0 0 17 0 0 12 
43 0 6 0 0 32 0 0 41 0 0 13 10 2 33 0 0 7 0 0 0 0 0 0 15 10 6 0 0 9 0 0 12 0 0 10 0 5 0 0 0 0 3 46 0 17 0 28 0 0 0 0 5 1 10 
20 0 1 0 0 9 23 41 3 1 2 0 0 12 30 10 21 3 0 14 17 0 0 5 0 12 7 25 24 0 0 0 6 0 0 28 9 5 22 0 13 0 3 0 29 20 0 5 5 27 0 3 7 21 3 
0 21 66 0 0 13 0 46 46 0 52 0 47 32 0 13 3 5 16 6 28 13 39 0 4 15 19 1 7 10 0 0 24 8 13 16 0 0 10 11 4 9 0 82 3 12 19 79 25 0 5 49 44 46 0 
0 0 2 41 5 0 0 36 2 15 0 24 10 28 26 0 3 0 0 0 0 2 10 1 0 0 0 4 19 11 0 14 0 11 2 50 2 6 25 0 39 12 0 48 27 0 37 13 9 0 24 0 18 0 8 
0 0 11 46 0 0 40 0 37 7 30 7 13 0 0 7 35 0 4 0 0 8 16 1 13 2 0 0 5 0 28 0 0 0 16 0 0 0 7 6 15 0 17 0 0 0 33 0 0 91 0 0 39 7 0 
33 0 0 0 6 65 7 0 3 1 15 18 0 0 11 0 18 34 13 0 6 0 0 6 12 3 41 1 0 7 12 0 7 20 0 15 7 18 18 0 15 30 0 0 0 20 10 0 4 44 8 32 39 0 0 
0 2 0 38 30 22 23 9 7 0 23 0 18 9 0 54 0 0 15 0 0 8 3 8 26 0 55 33 0 32 0 9 18 8 12 31 0 20 4 0 0 17 0 10 20 17 14 0 33 23 0 1 15 49 33 
0 0 0 0 0 0 0 0 11 43 7 0 3 29 1 27 38 7 39 0 4 17 0 0 9 4 8 0 0 7 55 19 5 0 21 0 20 21 0 0 0 0 0 28 14 0 26 29 24 18 0 43 0 0 45 
0 27 0 1 0 0 6 9 0 2 0 22 0 2 32 1 0 0 3 0 0 16 0 5 20 0 12 0 11 13 0 12 4 71 0 16 30 0 55 0 0 12 43 5 26 0 23 33 0 0 0 20 0 21 0 
83 15 53 0 37 51 4 18 10 17 13 1 0 19 22 20 15 0 24 4 5 9 12 12 0 18 10 0 16 23 0 23 23 7 0 63 58 12 7 23 69 28 0 0 25 4 6 0 0 13 7 65 5 0 0 
24 84 28 4 15 72 37 21 0 0 0 10 27 0 0 10 43 0 1 15 35 6 0 0 14 0 24 6 13 29 0 56 10 0 0 0 0 11 72 0 12 0 38 0 24 0 12 10 32 33 48 1 51 44 0 
0 5 0 0 33 0 4 20 35 0 3 14 27 0 18 0 46 23 0 0 0 4 5 6 17 0 0 0 0 8 0 0 42 0 4 17 0 0 7 27 0 24 0 0 0 0 14 2 0 2 0 0 0 0 50 
0 11 19 31 0 15 37 31 27 0 23 31 11 40 0 16 0 0 8 15 38 36 0 0 25 0 6 0 0 0 0 0 21 0 17 26 15 0 17 0 22 34 4 64 0 0 14 34 9 0 7 0 0 18 0 
33 0 0 24 17 9 0 0 0 0 23 23 2 2 8 0 0 0 0 0 56 37 5 33 0 0 0 36 0 0 0 8 39 31 35 28 4 0 0 0 0 20 0 2 9 0 0 2 0 0 0 0 16 0 0 
0 0 18 35 21 0 0 4 0 29 8 0 2 37 0 0 0 0 9 0 0 0 25 16 0 9 25 0 4 1 0 3 19 0 31 0 13 25 0 25 0 0 35 0 0 14 0 17 23 0 0 0 45 20 0 
47 0 25 7 0 28 0 55 27 37 57 6 0 9 59 0 39 0 0 12 21 0 0 20 0 0 24 22 0 0 49 0 0 3 16 20 0 57 8 8 44 0 0 9 0 9 52 84 0 31 21 0 0 0 8 
