55 31
0 22 0 0 0 23 35 31 9 41 1 0 45 8 11 0 3 29 24 15 27 0 20 16 19 52 4 21 4 12 4 0 35 31 0 14 1 23 29 13 32 39 0 17 4 4 105 25 23 36 18 24 0 7 29 
36 37 2 0 0 0 44 43 0 0 15 8 0 0 0 15 17 0 24 31 1 0 12 0 0 8 8 14 25 5 25 0 0 26 8 0 0 0 17 12 0 0 24 0 24 0 40 0 0 0 0 0 0 46 0 
22 0 0 23 33 16 0 0 4 0 0 0 4 0 0 28 22 0 20 3 0 10 5 0 6 0 23 8 0 1 19 0 16 24 0 3 7 0 0 0 22 0 0 0 0 0 5 0 26 10 0 0 0 4 0 
0 0 0 40 3 0 16 3 10 3 0 0 35 30 5 0 20 0 0 0 0 0 0 17 0 0 0 17 4 0 0 0 11 0 19 2 6 1 1 0 0 7 2 3 0 32 26 35 0 0 37 0 0 42 51 
51 0 51 0 23 0 0 2 2 23 12 0 0 36 0 0 0 0 12 0 22 0 3 22 6 47 27 14 21 0 24 0 22 0 4 0 19 0 14 9 0 0 0 0 21 2 0 9 22 76 0 33 23 51 22 
10 5 30 1 38 16 7 16 46 0 13 5 70 13 70 0 27 4 36 29 17 27 0 0 24 54 0 8 16 0 16 10 49 10 0 8 10 5 31 9 0 9 10 17 0 14 19 0 0 25 34 18 28 48 18 
29 0 6 34 19 0 10 0 5 21 35 13 15 36 6 0 5 0 24 8 15 0 0 0 9 12 24 13 7 49 0 0 2 21 0 27 4 31 0 3 0 27 39 19 14 35 0 0 0 0 11 20 15 5 52 
27 0 10 0 26 0 32 11 61 5 32 0 0 16 24 0 16 0 9 0 0 0 3 0 0 0 35 27 24 0 26 0 14 19 18 0 17 23 25 0 0 13 36 0 0 0 23 0 0 11 0 15 18 12 0 
18 0 0 1 27 0 0 38 84 0 28 19 6 17 0 0 6 15 32 0 0 0 8 0 1 10 0 5 0 15 13 11 12 0 0 12 19 21 4 0 15 12 32 20 0 37 2 23 0 0 0 15 46 20 46 
41 19 0 1 0 36 3 0 9 0 0 33 11 0 0 0 0 14 14 0 0 0 0 0 2 8 2 7 0 16 15 0 0 0 8 34 49 0 0 0 22 41 3 7 0 14 0 0 0 0 19 6 33 0 0 
12 0 20 21 0 9 0 0 0 0 22 0 12 0 7 0 0 18 0 0 32 0 0 9 21 15 13 0 0 12 0 0 10 0 5 24 0 0 4 0 0 6 0 0 0 0 0 37 0 0 0 0 22 0 0 
0 0 0 55 0 22 27 19 3 0 0 0 0 0 0 3 0 0 8 0 0 0 26 12 5 0 0 22 4 9 38 0 11 0 15 0 0 0 5 0 0 0 0 0 0 7 23 10 12 17 0 0 0 32 0 
53 0 27 3 0 15 49 0 0 11 3 11 3 3 0 7 0 17 21 12 15 7 31 12 0 20 9 12 5 5 26 0 21 0 0 26 0 0 0 6 12 4 49 37 0 22 11 0 0 9 0 6 0 45 0 
6 0 23 0 39 0 0 13 17 4 0 40 0 0 0 10 12 11 0 1 11 0 21 0 0 35 6 8 25 0 20 0 1 29 27 0 4 0 6 6 0 0 4 0 0 15 60 0 0 0 16 40 52 25 3 
17 57 16 0 13 5 40 0 6 42 16 31 0 7 32 19 7 5 1 14 0 0 6 7 10 0 0 35 0 6 28 6 14 0 5 0 7 0 1 31 57 0 26 11 1 28 5 5 10 48 0 13 0 0 18 
7 0 0 1 19 0 36 7 30 24 0 14 0 0 0 0 12 0 23 9 4 0 32 19 4 0 0 32 18 14 6 1 10 6 1 0 0 13 30 0 29 0 34 0 5 42 38 3 3 0 9 36 0 26 20 
0 0 34 25 14 0 35 11 1 32 0 3 15 0 9 37 0 0 11 1 11 0 0 16 2 0 0 7 25 0 8 1 0 0 9 0 41 14 10 19 0 67 0 2 0 0 4 14 0 11 30 0 30 0 14 
0 30 10 32 4 7 0 0 0 0 20 0 0 0 3 0 0 0 0 14 3 0 0 6 1 0 16 0 2 0 0 23 0 0 5 14 4 6 16 0 0 7 0 0 3 9 3 0 0 0 11 0 0 23 20 
7 47 0 0 1 1 0 27 37 0 5 0 22 0 26 31 42 0 29 33 0 23 0 9 13 10 0 11 0 25 5 0 16 0 0 24 14 10 3 42 7 12 23 21 0 0 32 33 47 29 57 43 0 0 22 
0 0 48 27 0 7 0 0 0 6 0 68 0 0 0 0 13 11 8 18 0 0 11 30 8 0 16 0 5 14 4 0 0 0 2 13 24 8 0 0 3 11 5 0 0 0 0 18 0 0 0 0 0 12 43 
42 26 1 1 0 0 7 10 32 0 0 6 0 22 0 31 6 0 2 39 24 0 6 5 0 28 6 34 0 1 15 1 0 6 27 18 38 0 0 31 10 10 27 20 2 2 90 9 1 29 0 1 5 15 0 
4 0 0 43 12 0 26 0 1 1 4 99 1 7 0 0 0 1 1 10 47 0 8 0 0 0 0 0 24 10 0 0 0 4 29 1 5 22 0 0 23 5 3 0 0 7 51 33 0 0 16 0 41 33 0 
29 0 49 9 0 0 18 0 3 0 4 40 31 0 25 48 0 0 20 17 4 0 4 11 33 0 0 21 6 101 0 0 27 15 30 21 28 17 18 31 7 11 0 16 10 0 12 0 0 5 0 107 24 33 22 
0 0 19 0 23 0 0 8 0 0 3 0 0 0 1 0 94 14 16 22 0 19 6 8 0 0 13 23 0 0 0 8 0 21 0 0 0 23 7 0 0 0 0 0 0 0 41 10 3 0 3 15 0 0 39 
38 0 0 0 12 0 6 0 0 45 18 37 9 17 0 0 12 11 29 9 0 14 0 33 0 7 5 12 18 3 14 0 0 7 11 0 6 0 0 0 22 0 0 0 0 0 0 0 40 0 0 0 2 13 116 
1 13 0 0 42 0 67 5 37 32 0 0 0 0 31 18 0 4 9 8 0 0 3 0 0 24 0 8 0 40 24 12 7 11 0 35 0 0 0 12 9 32 33 38 49 41 12 0 0 53 33 42 27 1 14 
42 19 0 0 7 23 6 59 19 0 35 28 21 1 2 18 14 0 36 27 14 0 26 0 17 0 0 23 4 20 11 3 3 7 11 31 0 0 0 0 8 0 32 0 0 57 11 0 64 11 39 29 0 23 0 
37 0 0 37 3 24 36 7 16 0 0 15 0 3 0 4 10 0 0 0 0 0 0 0 16 0 0 0 0 8 22 23 0 26 4 0 27 37 27 0 37 35 15 0 0 0 0 0 4 0 22 22 15 5 23 
65 0 0 0 0 0 17 0 0 33 0 5 0 29 14 0 0 20 0 27 0 7 0 0 6 0 0 22 7 0 0 3 1 0 3 0 0 20 0 2 6 25 4 23 0 0 0 44 26 39 0 51 41 1 0 
0 0 82 24 4 0 0 44 0 6 34 42 0 0 3 31 0 25 17 14 0 25 29 0 0 5 0 0 0 14 26 19 11 35 0 17 3 0 0 0 0 21 2 7 34 26 83 0 0 0 67 82 0 71 21 
0 0 20 0 29 0 0 19 0 15 5 18 0 37 12 7 17 0 0 30 17 14 40 38 7 0 12 8 5 0 34 0 10 54 10 25 0 4 14 12 10 0 0 0 57 15 23 53 0 0 29 2 84 2 0 
