55 31
38 24 41 0 0 36 0 7 0 28 17 13 0 21 9 5 0 31 0 6 24 15 0 56 6 0 0 14 0 34 0 7 0 4 12 3 0 0 3 6 15 8 2 41 43 6 5 15 28 0 0 24 25 23 0 
0 0 0 37 32 0 12 0 0 20 0 19 26 0 3 9 19 12 15 34 45 0 21 6 14 0 6 1 0 0 0 0 5 2 0 0 3 0 38 0 32 0 0 5 0 5 18 27 0 0 0 19 17 51 0 
65 20 6 41 0 26 0 31 30 8 17 2 0 21 0 3 32 10 4 0 0 0 0 35 58 9 0 30 0 0 27 0 24 6 12 0 0 21 15 19 21 38 42 24 10 5 9 0 27 0 0 0 14 17 0 
26 0 22 0 34 0 0 13 0 4 11 18 3 23 0 0 19 25 7 0 0 0 9 0 56 0 1 0 11 16 0 13 2 1 20 7 0 21 16 19 0 0 15 0 0 33 0 23 0 37 74 0 14 5 24 
11 2 38 71 8 0 119 0 2 0 48 11 2 0 0 24 25 0 1 22 0 5 20 0 0 0 10 14 37 22 17 18 3 19 0 0 7 0 0 33 12 0 15 41 0 1 12 24 45 24 0 0 46 0 48 
3 25 0 17 0 0 9 0 0 17 23 6 0 9 27 5 25 2 19 0 13 4 17 8 15 24 0 2 9 0 0 0 0 59 0 32 0 0 32 0 9 0 1 0 2 49 28 0 26 24 0 4 0 12 0 
9 7 0 13 22 0 33 0 69 0 7 7 2 0 21 8 3 0 11 5 2 0 21 0 23 0 5 10 11 0 0 13 0 66 0 19 0 0 19 27 24 6 9 21 0 1 20 0 0 11 42 25 10 13 15 
0 47 39 20 34 51 46 15 0 25 0 0 0 0 18 23 11 14 0 20 0 7 21 0 23 4 4 47 0 0 2 0 3 15 0 0 0 34 54 42 51 36 0 10 2 5 7 28 0 13 0 7 46 19 27 
0 48 12 15 7 0 0 0 0 0 0 12 2 11 0 32 24 0 26 0 0 0 0 12 24 9 0 11 0 0 0 0 0 26 25 12 0 0 0 2 24 0 0 0 26 8 0 32 0 0 0 0 0 13 11 
0 2 2 16 23 0 4 0 31 0 0 0 0 8 20 0 57 19 2 16 10 1 0 0 6 12 5 7 14 21 2 0 0 0 20 18 0 0 0 31 7 0 15 0 0 0 9 20 1 55 4 4 0 1 4 
40 31 0 3 0 27 41 26 0 0 0 42 36 17 28 29 0 20 31 0 0 6 0 0 0 0 47 0 19 20 38 26 40 26 0 8 20 23 0 16 0 0 33 0 2 8 50 22 11 54 84 39 22 39 0 
0 6 0 0 0 26 16 0 0 0 4 10 0 16 0 6 0 11 0 25 34 20 0 0 0 0 0 0 0 0 0 26 0 0 0 10 0 16 0 20 0 20 0 0 0 0 0 0 0 0 2 0 31 0 0 
0 0 50 0 49 0 12 0 0 13 0 0 0 0 27 38 0 8 16 8 71 1 20 0 0 0 2 1 7 5 0 0 18 0 45 15 0 0 8 16 0 0 0 0 15 21 3 2 0 0 0 36 83 43 0 
8 0 0 2 14 2 3 54 0 5 4 0 11 4 8 2 0 1 14 3 2 27 1 33 7 0 12 15 4 10 4 5 9 0 0 1 6 7 5 8 17 0 0 12 3 14 3 7 10 3 0 0 0 46 0 
0 16 0 19 47 11 2 16 3 0 0 5 0 0 14 8 32 32 0 0 0 7 0 48 0 4 25 11 9 20 0 0 0 13 0 15 13 0 0 25 9 15 0 18 4 14 0 4 39 10 0 20 0 1 0 
43 0 0 13 14 18 101 0 21 0 0 14 2 0 3 48 0 0 10 15 0 18 4 5 9 0 0 2 5 21 3 0 0 22 45 30 0 3 8 0 0 0 8 0 0 11 6 19 43 9 0 31 28 39 15 
16 0 0 49 7 0 8 4 5 0 0 0 0 0 8 19 11 0 0 19 3 0 0 3 9 4 0 7 0 13 5 19 1 19 35 5 13 19 18 41 0 0 6 0 33 5 6 0 0 12 1 0 68 9 0 
9 20 0 120 24 13 11 0 34 1 21 2 0 2 0 0 1 0 0 0 34 0 20 0 12 14 5 10 26 5 19 2 29 11 14 0 0 0 40 14 35 10 54 9 0 12 8 17 52 18 0 10 14 60 26 
0 0 0 4 46 0 24 16 6 8 0 0 35 9 19 28 20 8 9 0 0 0 0 0 0 4 0 0 0 2 24 0 20 19 0 0 0 3 6 0 22 2 28 19 19 0 14 66 8 0 4 0 37 24 0 
0 0 2 62 0 0 42 16 0 0 0 8 0 0 10 0 0 13 2 0 27 16 25 1 5 0 0 40 6 16 0 2 14 0 31 4 18 21 20 7 23 0 15 1 0 0 18 2 0 1 44 0 0 61 11 
47 57 12 6 0 5 3 0 0 3 16 19 21 33 0 0 19 0 0 0 0 0 0 10 9 0 0 0 10 0 0 0 0 0 0 0 0 0 7 0 0 2 12 31 0 1 12 52 0 12 0 0 0 0 12 
32 0 22 85 0 0 103 19 19 22 0 27 0 0 0 7 25 14 7 46 0 19 24 0 2 6 15 9 7 0 24 0 24 16 11 10 0 35 6 18 3 5 0 41 0 1 44 21 3 43 0 42 49 31 0 
36 2 18 31 20 31 35 22 0 15 0 6 22 2 6 20 0 6 6 0 16 0 6 14 14 0 15 0 11 0 0 27 0 22 31 25 33 32 0 3 20 35 0 0 0 11 11 0 26 35 0 8 0 0 5 
3 0 0 7 34 0 8 0 5 58 12 8 25 72 17 9 0 0 0 15 13 0 19 0 24 0 5 7 0 0 0 0 0 1 20 7 17 30 59 9 51 0 31 0 0 0 6 0 12 13 0 25 43 73 0 
0 16 44 30 0 0 8 0 0 35 19 0 0 0 8 0 9 0 0 0 0 0 0 20 43 0 0 0 11 0 0 0 25 0 16 0 0 0 9 0 0 9 0 0 35 9 44 0 1 7 26 0 0 50 9 
42 0 0 0 0 29 2 39 2 0 3 7 0 3 13 17 8 11 4 5 3 10 7 18 5 0 0 0 8 9 0 10 21 0 5 14 7 17 6 0 0 0 42 0 0 0 29 0 0 24 0 4 0 7 0 
23 4 0 7 3 0 22 5 40 0 45 12 7 28 0 9 0 0 0 7 0 0 0 12 0 18 68 0 11 26 23 0 14 0 0 0 0 13 9 20 0 0 0 12 38 4 1 14 46 0 0 5 0 26 0 
9 16 0 0 47 0 34 0 0 5 0 42 0 8 5 0 0 43 2 19 2 17 10 0 0 0 0 0 0 18 0 0 10 12 17 2 2 16 7 21 40 0 0 2 0 14 0 0 48 0 0 47 0 45 24 
26 29 0 13 0 8 73 0 0 12 0 26 0 3 23 24 0 39 0 18 23 0 0 2 24 17 0 21 11 12 0 0 0 17 0 0 0 42 0 11 11 40 0 59 0 0 0 24 28 0 0 11 47 0 0 
0 22 0 6 11 2 20 0 18 36 0 25 17 24 8 11 78 1 3 0 27 0 18 8 21 4 41 15 34 18 27 19 13 9 12 16 0 31 0 0 0 0 15 31 0 14 0 27 36 23 26 8 1 38 48 
0 11 0 0 0 0 17 0 0 0 0 28 0 0 5 23 26 28 0 3 19 2 0 20 0 8 15 9 10 0 0 0 31 0 0 17 28 18 12 21 24 8 0 0 0 19 7 43 0 29 0 0 0 3 0 
