55 31
33 5 28 49 0 0 27 0 65 60 0 0 0 0 0 0 25 17 0 0 20 30 25 3 0 0 26 22 13 22 0 0 28 0 17 1 33 0 0 0 0 13 0 34 0 0 3 0 15 8 0 59 0 53 0 
20 28 0 79 15 21 47 0 25 6 23 0 19 0 0 31 25 0 16 15 31 18 0 16 15 0 60 0 13 25 0 12 26 0 20 0 0 0 0 28 0 51 0 25 7 0 0 0 6 1 24 69 46 61 123 
24 0 0 35 0 4 28 17 0 17 15 0 0 21 21 0 15 15 0 11 8 0 17 0 2 21 25 19 0 14 26 6 15 7 45 0 0 0 35 32 16 0 6 28 25 5 19 4 6 0 3 17 0 0 15 
0 44 0 0 0 38 0 11 0 7 39 49 0 21 0 0 35 24 2 0 0 0 0 0 0 7 0 0 24 0 0 0 17 13 65 0 0 0 31 0 0 24 19 9 11 44 0 42 0 85 7 35 33 11 0 
47 27 25 23 0 8 21 0 40 27 12 10 22 0 14 16 0 24 27 17 2 26 0 33 3 5 20 34 5 0 3 6 23 10 22 26 4 4 0 3 19 0 0 0 0 34 0 47 16 0 4 10 0 2 4 
0 5 0 0 40 27 0 26 77 0 2 0 0 0 22 0 20 12 0 0 56 0 20 0 0 19 0 22 24 13 26 0 24 21 0 0 19 0 21 1 0 2 4 25 60 3 2 39 0 0 3 45 24 0 0 
1 59 111 0 0 21 48 0 0 17 0 0 47 18 35 37 1 1 7 11 0 7 0 18 6 7 2 0 0 13 21 0 22 0 6 0 17 0 3 0 0 3 30 41 12 40 12 50 1 0 0 28 65 7 4 
40 0 0 17 0 0 0 4 5 20 0 20 0 0 35 7 37 22 0 3 35 0 0 0 4 28 4 0 22 21 0 20 7 16 0 0 0 3 0 4 0 41 0 0 0 0 31 0 10 44 0 13 0 15 0 
20 0 0 0 0 0 21 0 0 18 17 0 13 5 18 0 0 0 4 0 17 0 0 0 0 0 0 56 0 0 0 0 4 0 0 0 0 12 6 0 0 0 22 0 6 0 0 0 7 8 0 0 0 0 0 
0 0 0 16 0 42 14 0 0 11 0 14 0 0 37 0 0 0 16 33 0 0 0 0 3 7 16 7 0 8 4 0 0 5 3 0 0 10 17 0 11 6 0 0 13 0 0 40 0 2 0 40 27 0 0 
0 0 0 20 30 14 0 41 0 0 41 20 30 22 43 20 17 4 0 33 0 0 0 18 6 0 0 0 64 18 19 9 4 11 28 23 0 0 3 16 12 11 31 7 0 13 4 0 35 32 0 37 11 0 19 
31 0 57 17 0 0 33 4 0 0 16 0 0 0 0 0 0 0 0 17 0 0 5 32 0 0 36 0 0 0 0 12 0 0 0 0 0 0 0 33 0 7 40 0 0 0 7 0 32 18 43 0 2 7 19 
0 0 9 5 0 15 0 0 5 0 18 13 0 18 14 0 8 3 0 0 5 0 2 0 12 17 0 0 15 1 0 1 0 0 28 7 0 0 28 9 15 0 0 15 0 0 0 12 33 0 25 5 14 0 0 
22 33 4 26 0 0 0 39 17 0 0 24 9 2 3 26 0 0 0 18 5 13 18 0 0 0 0 0 18 37 29 0 10 59 12 6 14 14 17 0 18 13 30 12 49 0 52 0 0 9 0 19 22 0 0 
1 0 49 18 33 5 10 0 0 0 0 10 10 49 18 0 0 0 0 0 0 41 0 0 8 0 21 2 0 0 0 0 26 0 10 23 0 0 25 0 0 0 0 12 20 33 42 0 35 14 12 49 0 0 0 
6 0 37 12 0 13 10 0 0 9 19 30 0 0 0 12 0 5 14 22 2 0 0 0 0 0 25 7 0 19 2 0 5 15 1 0 8 0 0 0 12 38 0 7 18 23 10 0 21 8 7 0 54 0 0 
29 0 0 50 0 41 0 0 26 9 0 27 22 0 16 5 1 0 10 19 23 0 8 19 6 0 24 4 16 15 25 15 3 46 48 14 0 46 34 2 0 0 10 0 0 0 28 0 14 13 24 0 1 0 0 
9 0 2 46 82 0 46 0 0 0 0 0 7 23 0 2 12 0 0 11 12 3 0 10 8 0 0 0 0 13 20 0 8 4 0 0 13 0 5 10 10 0 9 15 40 0 30 8 13 2 0 5 28 0 0 
16 17 0 14 0 18 21 0 32 10 0 0 2 0 2 0 22 14 12 21 9 0 5 11 0 0 0 33 9 0 0 0 0 10 9 0 0 0 13 28 11 4 2 16 0 4 0 0 11 0 0 1 10 9 11 
13 7 71 2 56 43 0 30 2 20 21 9 11 20 0 35 35 9 0 4 0 6 13 8 9 22 42 13 0 7 6 20 42 29 3 29 24 12 0 15 5 1 9 29 18 38 3 6 43 2 0 1 4 23 0 
5 79 1 35 4 37 53 22 43 4 0 0 10 7 13 9 19 12 3 0 0 37 26 0 0 0 0 12 1 31 22 0 28 6 0 3 0 22 39 0 11 7 37 6 23 24 0 0 53 15 34 43 0 23 0 
80 39 10 14 20 15 0 0 10 25 2 2 24 0 0 0 11 28 0 8 6 57 3 0 20 0 25 0 9 0 22 0 2 0 19 22 24 27 0 9 11 5 16 0 44 10 0 12 27 0 9 12 0 0 20 
0 0 0 0 10 0 2 0 21 11 4 0 30 0 0 8 0 0 0 13 18 24 0 0 15 29 4 0 6 25 6 22 22 0 30 0 0 1 0 9 0 11 30 22 40 0 0 0 10 6 49 0 8 0 4 
15 75 19 49 1 0 11 18 6 6 0 14 0 12 21 18 0 8 0 55 8 0 0 20 13 0 47 12 0 10 0 21 20 30 0 15 0 9 7 3 9 0 27 36 0 6 65 1 13 12 0 2 26 27 35 
0 0 29 0 15 0 37 0 43 6 40 0 6 10 0 0 0 0 0 25 12 8 3 15 27 0 0 0 13 0 5 4 3 2 1 3 32 15 14 0 17 4 0 0 0 7 0 15 0 41 0 74 15 0 0 
10 51 0 19 0 35 22 0 0 4 0 22 19 0 5 3 25 23 0 0 0 0 25 5 0 0 19 26 5 0 0 22 6 7 0 0 3 4 0 0 22 4 0 0 16 15 9 24 22 8 24 6 29 22 0 
0 6 11 39 0 59 33 0 2 0 48 0 0 0 21 14 5 12 0 4 21 19 8 22 0 0 12 0 27 17 10 0 18 52 9 0 0 10 21 0 8 0 39 38 0 12 0 0 14 6 0 0 0 0 4 
0 0 0 26 5 0 40 0 66 25 0 14 31 0 0 0 27 0 0 13 24 0 0 29 6 0 26 10 9 19 30 0 31 0 26 0 0 0 0 31 19 32 6 39 0 0 11 0 17 0 0 0 38 0 26 
5 0 28 17 50 28 1 0 0 3 0 9 0 0 22 0 0 27 8 0 12 0 0 0 0 0 0 0 0 13 26 0 40 15 70 0 3 6 4 0 9 27 10 6 8 16 28 0 38 10 0 0 27 0 50 
27 28 31 38 43 0 7 0 0 2 24 0 0 19 20 6 17 9 9 17 4 18 0 0 0 0 17 22 41 0 13 0 5 0 15 1 0 12 0 2 0 32 0 10 35 0 1 56 32 17 0 0 0 1 29 
0 57 38 142 0 49 29 0 0 6 9 67 6 13 27 30 12 0 0 0 0 7 1 40 0 10 0 12 0 24 0 0 0 0 0 0 0 0 0 0 10 18 0 32 21 44 14 44 2 0 0 48 0 68 34 
