55 31
0 25 43 0 20 17 0 16 38 0 9 13 28 0 39 0 0 30 29 2 0 0 25 1 0 0 8 9 23 7 8 48 27 11 0 27 33 8 15 0 25 6 0 6 3 51 0 23 0 25 0 8 40 39 8 
0 9 13 30 0 38 0 12 0 17 0 0 0 10 10 25 0 14 0 3 20 56 0 10 20 7 7 13 22 0 0 37 3 21 0 18 0 6 14 0 18 27 25 39 0 40 0 1 0 4 0 3 51 4 30 
0 0 0 2 11 41 0 20 0 0 0 0 10 0 0 0 0 0 0 0 0 0 23 16 0 0 25 0 15 29 11 17 0 0 0 13 0 0 5 10 18 21 0 15 2 6 39 19 0 0 0 0 0 19 0 
16 6 0 0 0 5 0 1 32 29 1 1 0 9 0 0 16 0 7 10 0 0 0 20 16 0 0 11 17 0 0 7 1 1 22 17 0 0 27 0 0 0 24 2 0 0 0 0 0 0 0 0 0 26 0 
43 0 0 2 0 0 0 35 18 44 0 0 0 3 0 0 1 12 0 3 0 13 17 11 0 3 0 0 0 18 23 0 20 0 17 6 0 0 60 15 2 6 0 43 15 20 16 2 41 0 0 8 0 93 0 
29 0 0 0 0 25 0 47 0 23 0 1 1 4 5 10 0 6 19 0 0 0 30 5 0 18 0 0 0 52 0 11 38 0 0 0 38 0 11 22 9 0 7 0 9 9 0 0 23 11 17 0 77 0 18 
0 0 0 3 0 4 28 9 0 25 43 15 0 15 11 8 4 0 19 22 9 10 16 24 0 16 16 11 0 11 0 0 0 0 6 0 26 0 2 0 31 0 5 35 0 38 0 14 2 31 23 0 2 0 47 
38 0 25 26 11 0 43 42 68 41 0 0 19 7 24 0 11 0 12 34 0 0 14 24 0 0 0 41 0 7 11 6 17 0 17 0 0 0 24 31 21 22 0 0 35 8 22 24 0 67 0 0 0 49 13 
0 2 20 20 39 57 14 18 11 5 21 0 0 7 0 4 15 2 8 7 15 31 7 6 18 0 8 7 0 5 20 25 0 19 0 0 5 7 0 0 16 23 1 10 40 6 7 0 4 0 10 4 9 0 22 
0 38 30 20 34 45 10 7 21 20 23 0 3 8 0 5 28 11 17 3 55 20 0 8 11 0 17 14 10 1 9 0 30 19 20 24 18 18 11 0 16 7 0 5 15 10 26 1 27 21 22 0 17 52 18 
51 36 19 75 46 4 0 32 0 0 0 0 0 1 0 0 0 0 0 0 28 9 11 0 27 41 10 0 17 26 0 9 1 11 0 0 10 0 9 0 0 0 17 36 0 17 0 0 28 3 44 78 49 22 0 
64 0 24 20 23 44 0 7 0 18 19 15 0 1 7 1 4 0 5 17 0 0 27 0 9 0 9 5 13 11 0 0 4 10 4 17 11 0 0 5 22 1 3 24 0 0 6 0 0 74 11 0 37 53 0 
74 0 2 43 0 24 46 0 49 19 0 0 28 7 0 7 33 0 0 11 0 13 0 0 11 6 37 11 19 22 30 0 6 12 16 0 0 4 6 8 10 0 17 6 5 12 41 18 1 31 62 2 98 41 46 
46 0 47 0 11 0 6 0 0 5 4 13 0 2 11 1 0 0 1 16 31 0 0 0 0 33 1 1 0 0 0 3 6 5 4 0 1 16 21 0 0 0 9 0 6 0 58 22 10 93 4 31 0 3 0 
7 0 0 0 13 0 0 4 10 1 0 3 18 9 2 27 37 5 2 0 0 3 31 2 0 2 12 12 0 0 0 0 0 1 0 0 23 15 37 0 9 26 0 0 23 0 6 0 10 0 1 1 4 30 0 
0 0 47 16 39 0 41 45 0 38 0 0 3 32 0 6 3 2 0 15 0 23 1 0 0 22 3 25 14 0 0 0 9 29 8 0 0 0 2 13 0 0 11 5 17 3 5 41 11 47 12 5 20 0 0 
84 0 8 0 0 0 6 5 0 27 20 0 44 0 0 0 0 8 0 0 0 0 0 34 10 25 0 13 2 0 18 0 0 0 2 50 18 0 15 0 25 0 19 9 1 0 0 0 0 0 38 15 0 0 0 
20 9 0 26 0 0 15 0 3 30 11 0 0 4 0 0 13 4 35 0 11 6 9 6 0 0 0 2 3 0 0 9 0 0 34 0 0 0 13 0 0 3 43 0 0 0 0 0 0 13 0 0 0 42 0 
13 0 0 10 13 5 0 0 21 17 12 1 1 22 9 10 0 0 2 6 34 6 12 10 0 10 14 0 10 21 11 17 6 0 12 0 6 0 14 11 7 0 0 17 0 0 51 2 0 12 0 5 4 41 34 
0 1 22 0 0 25 10 0 10 37 8 14 0 0 0 0 0 0 0 0 0 0 0 0 22 3 0 0 4 0 24 18 0 5 0 0 0 0 10 0 0 0 0 0 0 0 37 0 0 1 10 0 0 0 0 
0 8 32 44 66 0 0 0 0 9 7 0 7 0 14 3 0 18 45 0 12 0 0 9 13 0 3 3 34 7 0 0 1 0 9 18 2 13 12 0 29 14 0 20 2 0 4 30 0 1 102 19 0 1 20 
41 44 31 0 4 0 0 0 4 0 2 0 2 0 3 0 24 0 0 0 0 15 0 15 0 0 0 0 0 0 0 0 0 31 10 14 0 37 3 0 0 6 4 15 0 43 0 0 0 15 9 0 0 18 0 
63 23 0 47 0 14 17 91 25 8 0 0 0 13 13 0 1 0 10 0 13 18 27 17 20 0 0 27 0 0 0 26 2 13 0 7 24 30 44 16 1 0 7 9 43 1 0 0 0 27 57 0 20 0 2 
5 6 0 65 21 7 0 5 24 3 16 12 3 0 2 21 8 0 0 16 0 0 19 15 0 21 3 17 23 28 0 8 0 0 0 16 105 0 19 0 0 33 12 38 28 0 0 0 0 0 6 5 30 10 1 
21 7 53 0 0 0 23 1 62 56 0 0 0 18 35 0 28 51 32 13 33 20 0 30 0 0 0 8 1 21 34 0 6 16 21 0 0 16 0 0 0 0 15 0 28 0 37 15 0 76 31 14 20 4 4 
14 25 0 18 0 0 0 7 7 0 0 19 13 6 26 8 0 0 11 14 0 0 11 11 0 11 0 0 0 12 1 0 4 0 43 0 0 0 8 0 41 12 5 7 0 34 0 5 11 0 0 0 0 18 0 
5 0 0 42 0 15 0 24 23 13 0 0 0 0 1 15 38 6 9 0 37 0 0 17 0 0 0 0 0 0 25 0 0 0 0 0 18 2 22 0 0 0 7 20 0 29 17 0 39 17 42 48 0 0 38 
47 10 0 24 0 45 37 2 26 0 3 0 7 12 0 8 0 18 0 22 0 31 0 12 0 0 54 42 0 0 17 10 38 0 28 1 14 16 0 0 0 7 36 2 0 18 0 35 35 0 0 48 20 14 0 
5 1 16 17 0 9 0 0 9 0 11 9 13 35 9 0 28 0 0 7 7 5 0 0 0 0 28 1 0 12 24 0 0 19 14 21 1 2 0 0 34 27 64 0 0 0 0 0 29 42 24 0 32 0 0 
0 6 0 0 14 55 32 25 9 8 10 33 44 0 0 0 34 5 8 7 16 6 24 5 0 19 0 21 30 0 0 17 40 0 1 14 14 30 0 0 10 19 0 0 10 0 2 13 42 38 26 3 8 12 8 
0 10 0 15 0 5 0 35 0 3 58 42 1 33 0 19 9 30 27 47 0 60 0 27 8 0 0 0 15 7 33 30 37 5 2 27 3 0 0 12 0 31 33 15 0 0 22 0 25 3 20 0 20 36 7 
