55 31
0 52 0 8 20 35 0 0 31 0 6 19 28 0 13 0 18 0 0 2 0 0 0 17 1 0 20 0 9 0 0 11 20 7 18 0 30 0 5 31 55 3 0 0 16 7 0 0 17 5 0 46 59 2 0 
42 19 0 5 0 0 56 14 26 5 0 31 18 8 0 0 12 53 0 0 46 10 0 29 2 23 16 0 32 15 0 4 26 0 0 0 0 0 18 17 0 0 73 0 5 0 0 0 73 23 0 0 7 0 3 
19 0 67 0 3 40 0 37 28 18 48 34 27 39 0 33 23 0 14 21 22 1 0 0 20 11 19 14 62 0 0 31 0 0 0 0 6 19 25 28 0 5 22 41 0 62 0 0 0 28 0 0 39 43 0 
6 37 0 24 46 0 33 42 0 1 0 38 16 0 0 0 26 3 1 2 34 0 27 0 0 5 0 0 36 0 0 9 26 0 0 0 12 33 37 20 0 0 0 0 13 0 0 0 20 61 18 0 19 22 18 
0 12 0 12 0 22 0 1 4 25 1 0 0 0 0 14 22 0 0 4 36 0 0 22 0 17 0 0 1 4 14 0 29 25 0 12 0 22 35 0 0 0 1 1 38 0 21 0 16 0 0 11 0 0 28 
0 0 90 13 31 7 5 0 33 20 33 0 0 0 0 17 2 21 0 3 38 15 2 0 19 0 5 20 1 11 0 2 14 1 0 34 5 0 22 13 0 33 37 0 42 0 20 30 0 42 48 31 9 42 0 
0 0 0 16 0 19 38 3 10 47 0 0 1 0 33 0 4 9 0 31 12 0 0 17 24 1 9 0 0 28 6 8 0 0 5 0 16 3 0 0 11 33 14 26 80 4 19 33 0 10 0 64 22 11 0 
0 27 0 18 0 0 0 32 14 9 0 10 0 0 0 0 7 0 31 5 0 12 0 2 0 5 0 8 0 0 0 7 4 20 0 8 0 6 0 35 9 8 7 0 22 0 0 0 0 65 42 0 0 0 15 
0 15 38 19 0 0 0 24 0 47 17 27 13 14 0 0 2 0 6 4 8 0 19 20 0 12 0 20 8 17 0 24 0 0 16 0 19 0 23 0 38 0 0 0 0 7 10 15 1 0 41 0 18 0 0 
53 0 0 30 0 0 1 15 0 0 18 0 24 0 0 0 17 35 0 6 44 47 6 16 4 12 3 0 15 12 0 0 0 13 0 0 24 16 32 21 10 0 0 0 29 0 0 47 4 0 10 0 24 0 0 
14 0 18 18 0 3 31 20 3 0 36 8 0 0 10 2 29 0 4 9 2 18 9 9 10 0 31 9 19 24 0 0 12 0 6 0 8 27 0 0 0 15 42 0 0 32 0 0 3 0 11 17 0 24 0 
18 28 15 28 17 0 40 0 46 0 35 9 0 9 6 12 0 0 0 9 5 10 37 0 0 1 24 4 18 49 9 2 0 0 0 0 0 0 13 46 0 10 38 35 0 35 43 0 44 19 52 23 0 0 6 
20 0 0 24 16 81 60 0 84 5 2 0 34 5 5 39 13 17 5 0 62 0 24 12 13 39 17 0 0 0 0 0 0 16 11 1 16 6 16 0 59 12 0 23 7 0 66 42 0 0 0 0 99 68 29 
62 15 4 0 0 30 0 0 6 12 16 0 0 30 9 6 8 0 13 0 0 17 2 0 9 16 0 0 18 0 0 20 12 11 0 31 0 6 9 0 9 11 0 10 0 21 14 0 0 7 1 0 52 0 37 
0 0 0 6 21 27 0 81 0 0 6 8 0 9 24 25 0 14 0 0 0 0 0 0 20 21 22 4 0 17 0 4 27 0 19 0 0 0 24 0 9 16 33 7 0 15 0 0 22 1 4 0 6 46 11 
8 30 47 0 0 42 6 0 1 43 20 12 7 9 0 36 33 16 6 12 0 8 5 0 13 5 0 7 0 22 1 0 16 2 0 24 36 0 0 0 4 1 16 10 11 1 6 100 0 50 31 48 13 45 18 
28 7 16 0 13 3 0 5 4 20 11 2 0 2 3 42 5 0 6 1 0 0 26 0 7 23 6 14 0 15 4 0 10 0 34 14 8 15 0 11 0 44 16 0 16 0 0 0 56 9 11 36 0 0 12 
0 53 4 0 22 0 13 19 32 0 2 3 7 5 53 42 0 0 32 4 12 0 0 4 0 0 3 25 8 1 1 16 10 4 4 8 14 0 32 0 31 2 0 0 0 0 8 10 30 35 17 0 22 38 53 
0 42 3 32 0 0 46 22 10 27 4 35 42 11 43 36 0 0 0 0 34 18 19 0 18 0 13 25 6 22 0 0 18 0 0 29 22 0 1 25 26 5 0 38 1 0 9 0 0 0 4 12 0 0 124 
0 3 0 0 0 0 0 0 3 3 11 74 0 1 35 0 4 0 0 0 4 0 9 0 5 12 19 0 0 21 0 0 0 0 0 25 0 0 0 12 4 7 0 0 6 8 1 36 0 60 15 10 0 8 0 
0 0 0 2 6 2 45 0 4 27 8 67 37 0 0 0 0 0 0 18 25 28 0 8 11 33 0 0 8 0 0 0 0 0 0 0 27 4 0 28 0 26 0 5 0 29 0 0 16 10 27 51 0 0 7 
5 0 0 18 0 0 0 0 0 46 42 8 0 12 0 35 21 1 3 8 0 17 21 20 0 44 16 0 24 3 15 47 14 37 4 7 0 11 13 0 30 0 16 7 29 36 0 31 13 7 4 5 0 9 18 
16 6 4 0 9 33 37 0 0 16 0 0 4 16 0 2 20 0 0 11 0 18 0 0 0 16 25 2 0 6 0 0 0 17 0 1 10 0 37 18 0 0 10 8 7 0 40 7 0 0 0 0 18 0 1 
14 19 19 9 38 1 32 0 0 0 17 7 9 7 19 2 0 4 7 79 26 5 0 29 9 8 22 14 0 22 3 2 0 0 11 0 0 0 26 0 17 0 27 1 39 2 0 3 13 25 0 0 83 1 4 
15 24 28 86 13 19 0 0 0 3 0 38 58 23 12 23 0 36 29 16 28 6 0 18 15 31 4 2 14 0 4 17 3 19 16 13 44 17 36 0 0 11 1 4 2 0 4 29 0 6 47 0 40 59 17 
3 28 0 16 0 0 13 0 0 12 65 56 21 0 30 0 2 17 5 0 0 8 13 13 20 2 9 0 25 37 0 7 21 21 0 15 20 0 0 0 6 0 2 0 74 12 40 0 38 0 0 0 17 0 11 
0 0 0 0 23 3 0 0 0 17 0 1 0 0 0 0 0 0 40 0 16 0 15 0 0 0 22 31 0 5 0 10 18 0 20 0 16 32 6 0 0 0 0 0 17 0 0 16 0 18 18 41 0 0 0 
5 64 0 70 38 0 5 0 71 0 23 41 1 0 4 0 18 33 0 3 3 0 0 5 0 15 0 27 0 18 35 8 15 0 0 0 6 0 25 0 32 40 59 0 21 0 0 26 6 46 33 38 13 0 33 
87 42 3 0 6 0 0 5 118 0 31 0 0 0 19 4 6 36 18 4 12 0 0 39 0 6 9 0 13 28 29 1 6 19 0 0 17 16 5 25 16 33 0 42 46 9 32 47 11 23 0 31 22 0 5 
24 7 9 0 0 23 0 0 15 4 0 0 5 3 5 0 23 12 16 0 19 0 22 0 6 16 0 26 88 0 5 0 26 34 0 5 0 0 0 6 0 22 0 5 8 0 0 10 1 2 0 18 16 1 12 
57 52 0 0 0 35 15 20 30 0 15 12 0 25 0 0 0 0 5 15 0 23 0 26 0 25 10 21 9 7 0 0 0 0 4 0 16 0 13 2 60 16 0 0 44 0 0 0 21 71 0 0 0 53 1 
