55 31
0 16 20 0 0 37 12 0 5 22 16 64 3 5 0 26 20 0 16 41 14 0 17 0 0 16 0 0 0 0 39 8 0 0 19 30 17 7 0 0 0 0 0 24 10 0 35 0 0 0 0 0 36 52 0 
24 0 0 31 0 0 9 0 0 35 15 17 0 20 15 0 8 21 20 16 0 0 6 2 16 38 0 31 0 0 1 9 5 20 7 0 23 4 8 16 6 43 17 26 35 8 4 0 0 7 0 0 0 0 0 
23 1 0 52 5 9 48 0 1 20 0 41 0 8 25 0 27 13 17 4 24 49 0 48 21 11 13 0 16 0 7 0 9 28 16 32 13 19 0 28 19 22 18 0 58 21 0 0 8 28 20 0 76 0 53 
124 34 0 0 0 9 11 2 2 0 12 18 0 0 35 9 0 16 17 29 5 21 12 2 27 29 4 7 7 8 27 33 0 0 0 7 0 0 29 0 15 0 5 5 0 0 12 13 0 1 20 0 48 6 54 
0 66 70 54 20 22 47 0 7 7 6 0 0 0 1 12 0 17 0 0 0 0 20 20 30 0 2 0 2 23 24 0 28 0 24 0 26 2 0 25 0 0 57 22 9 0 0 0 0 11 10 0 98 0 98 
15 3 18 0 0 58 12 10 91 11 0 1 0 16 0 43 7 0 2 32 13 0 0 8 0 9 1 1 18 36 0 17 25 5 0 0 19 29 0 5 35 0 0 19 0 0 0 0 9 20 19 0 12 2 0 
25 22 15 40 8 0 0 0 32 46 0 0 5 0 38 0 22 0 23 5 19 15 34 4 17 0 18 17 14 12 4 0 0 35 0 5 0 17 23 2 20 22 14 40 8 0 0 0 16 0 4 0 30 22 38 
0 33 6 11 5 50 1 0 9 15 1 15 0 21 32 21 0 53 21 0 0 29 5 0 16 34 11 12 8 0 6 0 8 0 1 0 30 20 8 0 6 0 0 26 0 0 18 9 0 30 3 0 0 17 50 
0 12 26 0 0 20 0 33 0 24 1 35 0 0 26 0 15 0 0 30 15 0 0 0 1 8 0 0 17 0 0 9 0 24 0 11 0 0 0 0 7 0 0 0 11 18 35 2 0 7 13 0 27 10 0 
9 0 0 84 0 31 0 0 20 5 0 0 0 10 31 35 15 2 0 2 0 1 0 0 22 8 18 14 13 0 0 0 15 0 19 12 31 16 3 0 0 0 0 0 46 31 16 0 0 7 16 48 8 37 0 
26 0 0 21 16 46 8 17 9 29 10 7 0 0 0 0 10 9 11 10 27 18 0 40 39 0 10 17 19 6 0 2 28 0 28 8 3 10 46 52 0 0 18 8 8 0 23 10 9 0 0 17 61 0 0 
0 35 0 22 18 21 0 0 10 29 33 1 8 0 20 2 0 2 0 2 5 18 25 0 8 3 21 0 0 7 32 0 0 0 9 10 16 1 30 0 62 0 0 40 0 0 27 25 0 0 46 10 42 0 0 
5 39 24 0 12 28 0 0 0 5 0 12 0 0 0 0 0 11 32 0 2 0 0 0 27 0 22 0 26 9 0 0 31 21 10 0 14 0 3 0 7 0 2 28 5 0 0 0 0 0 14 35 34 0 6 
0 23 6 16 0 0 0 0 29 0 0 0 0 11 0 13 0 13 5 16 0 0 0 6 33 0 0 6 17 0 0 8 0 6 20 19 0 19 0 5 0 0 0 0 9 17 0 24 0 0 0 16 0 15 1 
52 0 0 0 0 0 0 0 35 53 48 1 16 30 3 16 36 0 14 0 15 7 0 0 9 23 17 0 7 19 0 0 0 9 4 0 0 11 32 29 29 0 0 65 4 4 3 7 33 4 0 0 43 0 11 
0 0 4 50 0 42 10 12 54 44 0 21 0 0 8 0 21 14 0 17 0 6 12 0 42 20 0 29 4 23 6 17 21 0 20 14 9 0 0 0 0 19 1 19 0 9 12 36 6 0 34 23 0 5 96 
0 10 23 45 30 35 2 42 63 3 0 13 14 0 1 15 0 8 30 35 22 0 15 4 9 25 11 1 17 0 3 14 0 0 0 12 0 15 2 13 38 1 42 37 3 2 0 5 0 56 37 46 8 0 1 
25 10 0 0 10 4 25 14 19 40 0 38 8 0 22 14 7 7 25 15 10 36 3 26 16 32 0 14 0 20 7 6 19 6 0 9 0 36 26 39 5 8 0 9 13 0 7 9 53 9 52 43 15 28 33 
8 0 48 0 0 5 34 44 1 1 12 53 17 0 25 5 14 5 3 15 20 32 4 5 26 4 0 0 28 9 0 0 28 18 2 0 12 0 0 79 16 0 17 25 38 2 0 11 31 26 78 37 46 22 6 
36 0 0 2 14 47 0 6 0 33 0 15 21 17 0 0 0 8 0 0 0 0 13 0 28 20 0 4 15 29 33 0 20 0 0 2 0 0 0 18 0 7 0 3 4 0 42 0 50 0 9 42 28 49 0 
46 8 20 36 35 19 0 0 0 37 0 0 10 18 0 0 0 41 0 10 0 7 9 0 36 0 12 0 7 8 0 28 8 0 0 0 0 0 10 71 8 29 56 6 8 0 9 0 24 0 7 34 0 5 8 
0 5 15 35 0 2 6 4 10 2 0 7 14 0 4 7 0 23 4 19 15 12 21 0 3 20 14 24 9 34 4 2 7 0 4 1 0 31 21 19 0 0 18 0 0 6 0 6 11 7 8 28 0 6 0 
0 18 67 0 37 0 13 0 50 85 4 0 0 35 2 0 3 21 0 18 24 0 4 0 0 0 21 0 15 0 0 20 5 35 0 0 9 5 11 30 0 35 0 4 24 41 0 0 16 12 0 0 1 0 0 
0 0 18 25 0 0 4 0 0 7 12 0 0 0 12 9 0 2 0 1 0 0 0 0 10 5 6 2 2 0 0 23 0 24 25 36 21 0 2 13 5 31 0 0 0 4 32 0 0 5 16 23 0 0 0 
51 0 20 0 0 2 0 0 24 18 0 11 0 0 17 0 32 55 7 0 0 0 26 0 16 0 0 0 24 0 13 38 0 11 22 0 4 0 1 0 22 3 0 1 1 0 23 0 9 0 33 51 10 0 2 
15 0 27 0 25 0 8 25 17 0 0 21 8 0 0 0 0 1 0 28 0 0 28 12 0 13 0 0 0 25 0 8 0 19 26 16 0 16 19 0 32 0 0 0 5 20 16 0 0 42 0 6 33 0 18 
10 0 34 43 0 24 31 0 24 3 22 68 10 0 3 10 0 9 0 0 24 0 0 20 9 8 0 24 26 0 26 0 22 0 25 0 0 18 8 15 0 0 0 28 41 18 43 0 37 0 0 15 0 0 17 
24 27 87 0 20 34 11 0 65 0 0 0 0 0 8 0 8 0 0 0 0 44 12 0 31 9 0 0 0 0 0 0 5 0 0 0 0 49 0 34 19 0 0 0 0 0 25 0 0 0 25 11 5 45 52 
0 21 6 0 0 0 0 0 0 9 0 0 0 9 0 0 14 0 21 23 0 21 20 0 0 17 0 1 47 8 0 0 0 11 5 12 0 0 4 0 0 40 17 12 17 0 0 0 0 4 23 0 25 20 8 
19 1 4 77 0 16 0 0 0 0 21 29 29 10 1 23 0 0 23 61 48 0 1 10 0 1 5 1 23 0 0 12 0 0 3 0 9 3 47 50 9 37 33 22 80 35 4 0 0 8 0 25 30 32 0 
0 0 0 0 0 19 0 0 0 0 0 4 50 0 18 27 0 32 6 5 0 0 6 17 23 7 0 1 0 15 20 0 7 12 12 7 19 0 0 0 0 0 3 0 18 0 0 2 21 32 0 0 5 0 0 
