55 31
29 30 0 32 3 20 32 6 0 0 5 26 16 2 24 5 0 22 0 18 42 12 0 0 0 17 33 0 28 3 29 7 6 1 25 57 19 2 19 26 15 28 26 22 39 14 23 6 0 4 0 13 0 25 72 
1 44 0 19 0 29 0 29 32 31 31 0 49 36 0 38 0 0 0 0 0 18 0 0 0 11 1 6 26 0 0 17 0 0 0 0 0 42 8 50 2 13 0 0 8 44 0 0 0 0 0 38 0 3 9 
0 0 0 0 0 17 0 10 0 0 0 15 2 5 0 0 0 0 6 0 0 36 9 0 18 0 17 34 11 24 0 14 26 19 13 0 17 0 0 0 0 0 0 0 0 0 0 0 0 25 26 30 19 31 0 
0 0 10 0 23 6 14 22 29 18 1 20 41 0 3 0 21 3 0 0 16 0 7 9 0 29 23 27 0 19 0 25 16 25 0 4 0 6 0 13 28 0 31 0 2 24 4 0 25 0 14 0 15 0 0 
20 0 0 0 19 47 0 0 0 12 0 13 0 17 0 0 37 0 2 0 7 21 13 19 0 0 0 18 0 16 43 0 0 0 0 8 36 0 0 5 0 0 26 1 1 34 9 0 19 3 0 0 53 12 0 
28 21 22 2 46 21 0 59 24 27 1 42 6 3 15 0 36 7 35 0 12 0 30 0 10 15 20 18 9 0 0 6 24 5 0 28 14 9 11 0 22 17 10 6 0 7 13 0 7 43 46 0 0 59 0 
13 12 0 2 33 0 10 4 36 0 19 0 0 15 6 0 6 0 30 0 0 22 13 9 17 0 35 35 0 27 20 0 5 0 11 2 12 44 2 17 34 0 1 18 0 5 2 0 0 45 13 27 0 4 0 
10 19 0 26 0 0 57 0 2 57 31 0 31 14 0 0 0 11 0 7 19 0 0 14 18 0 12 14 11 41 0 23 0 0 7 4 17 6 0 31 29 24 0 0 0 21 0 0 6 0 10 12 43 0 9 
46 0 2 8 0 15 2 0 7 14 2 15 0 8 21 0 16 0 30 19 3 16 0 65 0 0 21 0 6 8 9 6 18 3 2 0 3 0 12 1 0 12 0 43 39 36 27 0 16 0 0 2 0 0 0 
0 0 18 0 4 0 6 0 27 8 0 24 4 11 11 0 0 28 7 0 0 0 96 0 10 21 0 2 17 5 12 0 10 10 10 13 0 20 11 12 0 17 7 7 14 16 17 5 56 0 28 0 0 35 13 
41 0 38 18 0 7 21 4 4 1 0 7 0 27 16 0 19 0 11 11 21 0 2 32 0 0 0 52 0 28 11 0 0 0 0 11 12 11 34 10 31 44 15 0 8 0 26 0 18 26 20 2 11 0 0 
52 9 0 0 0 28 38 22 0 30 15 0 0 0 0 16 0 0 13 0 0 0 6 0 0 4 0 18 0 14 16 0 0 0 0 0 0 8 0 0 0 2 0 4 38 40 7 0 1 0 0 0 52 4 0 
11 0 0 20 32 0 0 4 2 30 28 0 4 0 0 2 5 16 2 33 4 12 0 47 6 0 0 6 22 0 0 0 5 4 13 18 32 0 12 30 7 11 7 20 6 10 7 0 10 7 0 0 62 25 0 
2 0 15 41 0 44 0 64 7 0 0 33 0 8 4 0 0 14 18 3 0 9 13 0 42 12 36 0 21 3 13 26 0 1 0 2 5 0 12 10 7 17 7 6 85 0 0 7 0 23 32 0 15 0 49 
10 0 0 22 29 0 0 10 9 0 0 8 1 0 0 0 0 15 0 0 9 1 9 0 12 22 13 0 10 6 0 3 0 0 8 8 0 0 0 0 4 0 0 0 0 0 42 14 11 0 0 18 12 0 3 
0 16 0 10 0 18 6 37 27 11 11 0 18 13 0 15 0 7 7 4 25 0 0 11 0 3 0 0 3 0 26 0 0 13 15 0 2 0 16 0 33 7 11 0 0 0 0 38 0 0 12 55 0 6 8 
13 0 7 32 0 14 40 0 46 8 2 0 0 0 1 1 0 2 9 15 0 11 0 0 10 8 0 0 0 0 16 0 0 0 0 32 0 10 8 3 14 9 19 0 0 0 47 1 0 0 9 0 0 0 30 
48 9 0 34 50 18 0 23 9 37 32 48 3 0 16 0 25 0 11 0 11 13 51 10 2 24 2 18 21 0 34 8 0 0 0 0 33 26 37 39 0 19 38 5 5 0 0 10 0 21 8 0 0 0 18 
25 0 0 1 0 5 12 0 2 10 0 5 0 0 0 0 0 0 0 29 4 1 0 11 4 9 0 0 7 16 0 21 0 0 0 49 0 0 0 13 0 5 3 0 12 0 0 0 29 0 0 0 0 0 18 
1 0 18 0 15 18 0 4 15 0 0 0 10 39 20 0 35 58 10 0 18 0 20 6 17 1 4 25 0 8 0 0 5 0 12 0 32 1 0 9 23 3 49 0 9 0 8 10 8 0 6 37 1 9 0 
70 0 0 19 0 10 0 0 0 3 0 0 0 0 0 0 3 0 3 0 0 0 16 0 0 0 0 19 0 0 0 9 0 0 0 6 0 0 33 10 0 15 5 9 0 0 0 5 0 7 0 0 0 0 73 
0 6 0 7 5 0 0 9 11 6 11 9 20 35 0 20 8 8 2 11 2 0 2 15 8 1 0 0 15 0 8 9 15 15 0 1 0 0 15 0 0 8 5 11 0 0 0 7 15 8 0 2 0 30 11 
55 0 0 0 0 0 0 0 2 19 58 8 0 0 0 23 0 0 1 15 10 2 0 8 4 11 26 0 0 29 0 20 5 0 17 3 0 35 26 4 0 31 0 7 0 8 0 0 10 7 7 0 0 0 0 
16 6 0 0 0 5 0 41 0 10 1 28 0 5 0 5 19 0 16 13 2 0 0 11 0 24 6 37 8 0 0 7 7 2 0 5 0 14 13 28 6 11 15 0 14 0 17 0 60 0 0 0 0 0 23 
27 13 37 0 0 2 44 12 2 6 37 0 0 16 24 0 19 0 0 3 0 12 4 0 0 1 0 6 0 17 20 0 0 0 2 0 17 0 22 42 0 1 4 0 19 0 3 109 0 0 17 0 0 0 32 
19 0 23 29 0 60 0 22 3 58 4 0 39 0 31 0 6 0 0 14 26 20 29 9 8 1 14 5 7 5 0 7 26 0 5 25 31 7 0 0 26 0 47 34 0 18 23 0 2 24 0 0 20 0 0 
3 9 0 2 50 0 0 14 0 1 19 0 0 45 9 0 0 0 69 20 33 7 20 19 15 7 45 0 24 33 25 0 0 29 11 11 6 22 11 17 19 36 12 3 41 0 21 23 23 26 0 0 4 40 26 
3 0 55 0 0 55 9 0 0 3 0 0 3 26 0 14 0 0 0 0 14 0 6 8 0 17 23 0 30 8 9 0 36 0 18 0 17 0 0 0 0 8 0 0 0 16 8 32 0 40 17 0 0 21 1 
0 29 0 5 0 45 0 0 0 0 22 17 0 13 0 0 22 0 28 13 33 0 0 5 22 22 0 18 6 4 56 15 4 0 0 10 11 49 33 6 2 33 0 0 28 2 6 0 43 3 26 2 0 35 17 
24 0 0 0 0 32 0 12 28 0 30 40 0 15 15 0 29 0 0 0 56 0 34 18 16 27 25 0 0 4 3 1 3 23 0 0 26 32 31 0 10 8 10 9 0 29 0 0 1 41 10 11 27 40 83 
17 58 0 2 40 1 0 9 46 0 5 61 23 27 0 0 20 24 0 4 31 10 30 8 0 21 42 29 11 4 0 3 21 0 18 16 0 16 0 0 41 3 14 15 52 1 7 3 0 41 57 31 81 34 0 
