55 31
0 18 58 31 0 0 0 0 0 0 0 0 1 0 23 8 0 18 0 33 0 0 25 7 1 0 24 6 0 0 19 28 21 0 0 7 0 0 13 0 8 0 0 0 0 0 11 21 0 0 0 0 0 0 0 
29 0 0 0 0 48 58 16 0 0 22 0 12 48 5 0 20 0 0 0 0 0 0 27 57 13 0 0 0 6 5 19 0 0 0 1 18 0 0 34 6 17 36 8 5 0 28 10 0 10 40 0 21 3 48 
35 0 8 52 15 27 14 24 46 43 8 49 0 65 2 62 18 0 22 28 1 0 23 26 8 40 0 4 25 25 3 43 43 22 14 57 3 18 19 0 7 9 73 2 0 46 8 18 8 18 6 10 27 38 34 
0 14 32 3 0 0 47 13 22 0 18 0 33 0 2 0 41 11 0 1 0 1 0 0 10 0 0 25 21 0 21 22 19 0 59 0 11 0 10 7 0 0 34 8 0 0 7 0 0 0 38 22 35 42 4 
0 13 0 35 0 5 18 0 45 0 54 11 40 0 1 0 0 0 16 0 9 44 0 0 29 10 0 0 0 1 2 0 0 19 40 0 11 0 14 0 0 0 0 0 0 42 0 4 0 0 0 30 68 16 0 
1 1 46 0 0 30 1 10 20 0 17 0 29 3 32 0 20 7 0 0 0 21 8 20 8 0 0 26 8 0 0 0 0 0 29 10 11 23 0 1 0 37 0 0 0 9 7 29 46 8 13 2 7 2 0 
0 47 44 0 40 3 11 5 4 1 3 0 0 12 70 3 1 38 4 24 3 30 19 0 24 21 7 29 0 27 11 0 13 11 0 0 35 0 7 0 0 1 18 0 0 31 0 5 17 0 13 34 81 48 7 
0 35 4 9 48 36 16 1 0 10 0 33 59 22 31 17 44 34 0 14 23 33 0 0 0 0 0 31 21 0 3 0 0 3 5 25 17 18 6 0 0 36 0 26 12 31 0 0 31 41 23 79 3 37 34 
0 14 0 52 0 35 0 18 5 0 23 21 25 0 0 14 13 3 15 0 16 20 0 11 21 8 27 22 9 0 0 0 14 15 6 0 0 3 2 0 0 0 0 0 7 19 0 0 0 0 1 0 4 32 0 
0 31 0 46 6 16 0 45 45 0 0 0 0 9 0 0 0 0 0 0 0 0 38 0 0 0 0 0 23 0 22 30 0 0 36 0 10 0 3 4 7 19 8 15 0 0 0 0 0 0 4 37 10 45 9 
0 2 4 0 0 24 10 19 0 0 0 0 90 0 0 21 30 30 0 0 2 2 16 2 0 13 0 0 0 22 0 2 21 18 0 9 18 16 7 22 0 0 0 7 0 9 43 0 20 37 0 0 0 32 60 
3 17 51 0 0 44 23 69 15 33 0 57 3 0 25 4 0 37 10 37 0 9 0 15 0 0 0 19 35 0 31 0 18 21 0 0 0 12 0 57 7 0 0 0 0 27 37 0 0 74 18 40 0 51 52 
0 0 0 0 0 0 1 0 1 0 76 10 0 0 17 0 3 0 0 0 12 8 12 16 2 6 14 0 0 10 0 9 37 21 60 0 3 26 16 4 0 0 0 0 0 0 0 6 0 33 40 19 53 0 16 
40 13 0 0 0 0 5 54 4 9 0 5 0 0 0 0 22 42 23 24 30 3 45 0 0 0 15 0 8 0 12 31 32 23 3 6 8 23 13 0 0 28 23 6 0 0 0 27 0 49 0 90 0 0 0 
55 0 0 13 12 37 0 20 0 0 4 24 33 9 0 8 0 9 22 2 3 2 19 6 13 5 0 3 5 19 0 3 35 2 1 24 0 19 0 39 2 27 44 0 33 19 0 0 0 0 11 0 0 0 13 
11 0 0 13 6 11 13 13 30 0 0 23 22 0 0 0 27 34 11 0 0 0 0 0 0 0 0 21 13 0 8 20 0 0 5 0 1 0 30 0 0 0 0 27 7 0 0 10 17 15 0 53 4 0 0 
0 0 0 8 0 0 0 46 5 44 42 13 0 30 46 0 5 33 0 0 18 3 13 0 10 0 27 3 18 0 10 1 0 7 7 3 0 0 0 12 0 0 0 8 0 2 0 0 35 15 33 0 4 63 0 
0 23 18 89 32 7 48 43 0 0 55 6 30 0 15 0 0 18 5 16 31 9 0 0 5 0 19 0 0 14 27 2 0 11 22 43 0 0 0 0 30 0 0 0 0 0 0 26 0 12 47 48 0 0 48 
0 0 0 0 0 26 0 42 0 0 0 0 0 0 11 0 35 0 7 0 12 0 0 31 0 20 0 0 0 0 7 0 12 4 5 30 0 0 9 0 0 3 0 10 8 0 34 3 0 42 10 30 11 0 22 
27 0 39 7 40 0 0 0 0 26 8 0 0 0 0 6 16 18 9 0 0 22 10 11 0 8 11 2 0 7 19 31 5 9 0 16 4 5 4 16 1 39 8 22 45 12 0 0 10 0 14 5 13 0 0 
0 44 25 10 0 30 26 0 10 0 3 0 0 21 8 0 0 2 7 25 0 0 46 29 15 0 0 41 9 0 0 12 0 0 24 19 0 36 13 8 34 50 0 18 19 0 30 29 0 0 11 70 23 22 0 
0 0 30 0 0 0 9 0 33 0 0 0 0 0 0 9 13 0 0 15 4 0 9 0 0 0 0 0 0 0 0 1 7 31 0 0 11 8 0 5 0 33 2 0 0 0 0 0 19 13 0 9 1 0 0 
0 26 1 4 0 0 25 2 0 0 0 0 0 20 4 0 0 0 36 37 14 32 14 4 0 1 6 26 0 0 0 0 4 0 3 0 11 3 0 0 0 1 0 2 0 23 0 0 0 3 0 18 19 32 56 
35 0 16 7 0 0 16 18 25 0 22 52 7 0 49 14 26 32 18 10 0 0 0 12 0 23 9 2 1 3 30 31 0 16 41 28 3 0 0 0 26 9 14 0 0 0 2 0 14 32 0 44 40 0 0 
0 0 38 15 0 5 0 11 65 4 4 0 22 2 13 0 0 0 0 0 4 27 0 0 16 18 0 0 7 0 15 23 0 0 30 0 15 42 0 0 15 20 0 38 0 13 0 5 0 0 0 12 0 0 46 
3 19 0 23 35 26 36 39 0 49 38 0 1 3 4 0 0 32 32 18 48 23 19 34 14 0 0 0 0 0 2 20 0 24 25 0 2 18 0 35 0 3 38 0 16 6 84 0 0 21 28 24 28 44 59 
26 0 21 7 12 2 24 18 0 44 26 0 0 26 12 4 13 0 0 20 9 9 0 15 33 24 0 27 0 0 40 7 0 3 5 0 0 25 0 18 0 18 0 0 0 0 15 0 3 0 40 33 0 97 15 
4 36 31 15 46 5 0 10 0 0 13 0 0 0 36 0 0 14 13 0 0 0 0 0 13 0 10 0 25 28 29 12 0 40 10 0 0 1 0 0 6 17 2 1 0 25 42 18 0 2 36 5 23 0 0 
0 0 28 19 5 18 13 64 11 31 102 15 18 4 0 21 0 0 26 45 0 20 0 9 0 10 39 0 27 19 0 17 0 0 22 0 0 0 0 0 29 22 38 63 0 0 3 29 23 3 0 41 77 34 30 
0 16 8 33 26 0 23 37 0 0 24 0 0 16 23 28 20 15 17 35 17 19 45 20 0 0 0 0 52 0 24 29 18 0 5 38 6 36 16 0 0 0 7 0 9 10 12 17 26 6 0 2 1 0 50 
8 42 0 4 74 5 0 46 8 16 0 0 8 28 64 5 1 15 0 19 36 5 1 22 14 16 27 6 0 3 0 0 37 30 30 31 0 16 50 0 33 30 0 27 46 10 7 0 23 0 0 0 0 35 0 
