55 31
0 5 22 3 4 49 2 18 0 0 0 0 38 49 22 31 0 0 0 6 25 9 0 0 5 0 7 11 9 21 11 23 0 0 27 0 4 9 42 29 13 0 0 0 27 0 0 19 0 0 38 7 13 7 72 
0 0 73 53 23 8 22 33 18 27 0 0 0 5 0 35 19 0 72 32 17 0 19 20 10 0 31 0 22 11 21 28 8 0 0 12 0 0 9 21 12 4 0 37 1 18 0 42 0 0 78 35 69 0 0 
13 28 58 0 44 0 0 16 0 0 0 43 4 12 0 40 3 0 3 0 7 3 0 0 3 0 0 7 0 7 0 0 0 0 0 13 4 0 2 39 4 0 0 0 0 3 0 0 44 0 21 0 37 0 9 
83 0 25 18 39 0 7 0 0 0 6 0 22 7 0 35 0 17 19 0 3 26 11 12 11 3 11 10 0 7 0 0 0 0 7 12 0 58 26 2 4 41 39 0 14 59 47 26 0 0 0 0 13 0 25 
0 40 90 8 4 4 74 27 54 39 0 35 12 6 0 1 1 10 17 12 15 32 14 15 0 7 13 0 13 16 0 0 3 4 34 3 45 0 0 8 0 11 36 0 7 1 1 0 84 0 8 30 0 119 0 
0 17 0 16 36 0 29 0 0 5 0 2 0 34 0 0 48 43 25 0 18 0 0 2 15 19 28 5 0 14 0 0 0 15 8 7 0 0 11 58 32 0 0 0 4 1 0 5 11 0 33 34 0 0 0 
0 162 9 36 1 36 0 4 29 0 19 15 0 46 17 0 6 84 33 25 0 18 0 0 1 0 1 5 34 15 6 34 35 5 5 17 6 3 19 5 0 6 0 6 10 44 45 22 76 6 21 0 0 32 37 
6 39 0 27 0 27 2 26 32 0 0 11 0 14 0 16 27 0 7 1 22 5 0 0 1 0 11 0 4 0 17 0 27 0 21 0 0 0 18 1 23 33 0 3 0 8 0 17 35 0 0 2 0 38 7 
6 29 6 0 6 21 19 39 0 9 4 0 7 33 0 22 38 0 41 9 13 0 11 19 0 11 6 0 9 48 54 9 18 11 4 0 0 25 0 0 15 0 20 0 0 0 71 13 0 0 72 0 0 17 48 
0 15 0 0 42 28 0 39 0 5 15 7 0 5 0 7 0 12 5 0 9 0 7 0 0 0 0 20 0 20 0 0 0 0 17 0 0 0 19 0 0 0 0 5 0 17 4 0 5 0 0 0 0 34 13 
13 28 38 0 9 39 4 3 2 4 15 20 3 0 0 22 0 6 0 0 0 8 0 8 0 0 2 2 0 31 13 0 0 0 16 0 10 14 0 0 12 0 0 41 47 0 0 5 39 2 14 2 7 17 0 
3 18 15 0 0 8 0 11 1 1 0 34 0 11 0 0 8 15 0 0 0 29 13 10 0 0 0 0 25 9 0 3 9 36 16 9 36 4 3 0 0 9 0 0 9 34 0 0 5 1 27 1 29 25 0 
0 1 9 20 0 13 2 0 10 25 8 0 32 5 18 8 21 0 8 6 5 5 16 14 0 0 2 4 0 0 0 3 0 18 22 0 0 35 0 1 0 9 0 6 32 0 0 31 0 6 10 0 0 0 38 
61 0 14 11 0 0 32 6 6 0 0 0 4 13 37 0 30 3 56 0 3 0 10 8 0 0 29 0 4 3 0 5 2 12 7 5 13 0 54 0 44 7 0 6 26 26 0 0 4 0 41 33 3 6 54 
15 0 12 35 35 0 19 42 5 49 12 12 1 39 27 0 0 23 7 2 14 23 19 0 16 21 4 0 0 2 22 20 8 21 9 0 0 60 28 0 34 4 39 0 0 19 0 10 11 2 10 0 0 3 38 
13 0 0 1 0 0 0 0 14 0 0 0 11 0 3 15 0 29 12 0 8 15 14 10 0 0 0 8 10 4 12 0 10 0 23 13 0 0 1 0 0 24 27 0 12 8 0 0 0 0 0 8 0 19 0 
0 0 0 83 0 0 8 0 2 9 0 9 0 40 0 0 0 8 9 13 0 0 0 17 0 3 0 0 0 12 22 0 0 22 0 0 0 0 0 0 0 0 0 14 0 0 0 0 44 0 12 0 36 40 43 
0 27 0 31 7 0 31 30 0 0 0 34 16 14 2 4 31 0 16 0 18 0 0 0 0 15 0 38 31 18 0 13 29 0 19 0 0 2 9 4 0 0 0 0 9 0 0 49 0 43 1 0 0 26 29 
51 1 7 4 0 0 0 13 31 0 30 4 103 0 18 30 0 0 48 0 12 18 7 31 28 0 5 0 0 7 0 37 21 6 14 9 8 0 7 10 0 0 12 16 24 30 0 0 2 15 38 25 37 44 18 
0 1 0 2 61 43 19 33 0 0 0 14 6 0 7 0 8 0 0 0 15 0 42 8 0 0 0 0 0 4 10 0 0 29 9 0 0 19 0 0 69 0 1 1 6 12 9 0 3 45 8 3 1 31 0 
42 0 27 34 36 52 0 8 16 0 16 0 11 13 33 0 26 17 13 0 13 0 0 11 10 40 3 0 13 15 6 0 0 26 10 8 0 57 0 0 36 16 46 36 1 4 9 0 23 0 21 83 3 2 0 
11 32 8 16 14 0 2 0 2 93 8 20 32 0 1 4 23 0 14 0 17 7 0 0 4 0 0 0 0 21 0 19 0 47 3 19 0 29 0 50 13 5 0 0 27 0 5 0 0 5 6 0 0 31 26 
0 0 37 1 0 4 0 0 36 11 28 0 13 0 42 14 0 1 16 0 0 0 0 15 0 0 0 1 0 0 24 17 4 8 17 23 5 0 29 24 0 4 40 0 36 0 0 27 42 0 9 0 0 6 9 
13 0 88 40 9 17 44 42 0 28 0 0 21 45 17 26 0 0 36 0 6 0 2 2 0 30 0 9 0 0 0 0 0 18 0 5 10 58 14 0 15 0 29 76 6 25 10 23 37 0 0 26 4 24 36 
0 15 27 54 17 11 43 3 0 0 20 0 6 16 0 14 25 0 0 0 7 31 0 16 4 0 0 7 12 8 20 21 29 0 23 0 0 4 0 0 5 0 30 9 7 0 2 0 0 53 10 3 21 40 16 
20 0 41 51 9 39 0 85 0 42 62 0 15 1 15 13 0 0 0 24 39 0 3 4 19 11 20 0 19 21 1 23 36 7 19 25 4 0 60 0 5 0 0 0 7 5 27 38 10 0 91 31 0 2 8 
52 23 3 6 20 32 0 1 0 11 0 0 6 0 0 1 21 16 21 0 0 0 3 10 23 0 21 9 0 6 27 0 0 26 17 0 26 35 0 0 0 37 0 0 1 17 2 15 22 3 0 51 48 25 0 
25 0 23 52 25 7 9 14 2 31 0 17 93 27 14 1 22 7 12 6 0 33 7 19 21 11 4 0 23 25 0 0 0 13 45 0 24 25 22 6 45 23 17 0 68 35 8 10 4 0 11 65 5 4 33 
6 6 0 30 0 35 28 21 13 0 23 0 30 0 0 0 37 0 0 17 0 13 20 15 0 0 0 0 21 0 7 0 0 53 9 23 17 16 27 1 35 0 14 0 0 22 25 0 0 0 7 0 0 20 19 
0 40 19 0 3 0 0 5 20 0 0 0 17 0 0 0 0 0 34 25 0 33 0 0 0 8 0 20 3 3 0 0 7 4 0 0 0 6 6 29 0 7 0 18 36 0 9 10 24 2 0 0 69 0 0 
43 31 3 0 43 0 0 0 34 0 29 0 4 0 18 3 10 5 25 11 0 0 0 9 0 13 0 0 18 4 23 18 38 18 6 0 0 0 0 0 0 0 24 68 36 0 0 38 0 64 18 0 5 0 22 
