55 31
1 0 27 0 23 15 19 0 40 16 12 40 26 18 28 0 0 0 10 22 11 0 31 3 0 14 9 0 1 14 0 26 20 19 24 47 6 25 8 15 0 1 24 3 29 0 0 3 0 0 12 40 34 31 72 
1 0 19 0 0 0 58 0 46 1 13 61 27 0 5 5 0 0 69 32 0 0 12 24 0 16 0 16 0 7 0 7 0 25 20 0 0 0 0 20 0 0 0 0 1 39 0 24 19 1 0 65 0 42 34 
33 8 88 9 80 46 0 34 0 0 0 22 0 0 0 22 0 0 0 23 0 20 0 0 0 3 0 2 0 0 0 0 18 0 0 0 0 0 1 1 19 34 0 0 6 25 0 0 48 1 15 46 0 0 44 
0 0 51 40 105 25 8 34 36 24 21 36 3 3 32 31 13 17 0 18 4 11 0 15 14 1 0 6 28 67 22 11 28 0 14 0 9 21 35 2 10 56 0 5 7 0 43 36 44 0 0 15 29 51 23 
0 0 25 0 0 33 1 11 8 0 0 42 12 0 3 9 2 3 0 0 21 0 1 13 0 2 0 16 11 0 22 23 0 0 0 4 0 0 32 1 9 34 0 0 3 25 0 0 0 44 0 0 0 42 0 
5 29 33 0 28 5 30 0 0 6 19 4 5 4 12 24 0 44 0 0 0 0 14 3 0 23 0 0 0 0 33 8 0 1 25 0 17 0 5 15 0 0 0 0 21 0 5 15 12 16 0 0 0 0 25 
0 0 0 93 0 67 23 16 6 0 6 8 0 0 0 0 0 19 0 0 8 0 19 11 0 30 0 14 26 0 20 0 14 0 8 16 11 24 18 0 5 0 0 26 0 6 0 0 0 46 30 0 0 28 45 
0 19 6 7 44 85 9 0 9 0 3 0 2 8 0 4 4 0 0 46 47 0 5 0 24 3 0 5 31 5 16 0 0 0 0 0 0 0 9 0 0 8 0 11 0 0 13 0 0 1 0 0 32 0 113 
0 21 6 0 20 0 2 0 21 35 0 35 3 12 0 9 0 6 0 18 0 0 18 16 9 6 0 0 5 0 7 0 0 7 12 0 0 18 12 0 0 13 0 0 69 1 35 19 0 0 5 6 19 0 2 
0 8 0 17 49 23 5 48 0 0 0 3 0 3 0 0 0 0 15 0 2 0 12 22 17 21 10 0 0 6 0 7 0 0 0 1 4 0 26 0 0 0 0 0 0 10 44 0 0 0 0 0 2 49 2 
4 26 0 0 0 2 56 0 3 0 0 0 0 22 10 1 0 7 11 8 0 0 0 20 10 51 14 0 12 21 0 0 10 31 5 22 30 0 47 0 4 0 0 0 19 0 12 8 23 0 0 10 1 0 8 
4 28 40 11 18 28 17 0 0 0 0 10 0 0 0 13 3 2 0 25 19 56 20 0 20 0 9 8 3 4 20 18 16 45 0 14 0 17 17 3 0 5 26 18 0 9 37 0 27 47 8 0 14 32 26 
0 0 0 0 0 4 6 28 22 0 17 51 51 8 0 9 0 24 0 16 0 12 14 28 0 0 0 0 5 0 41 11 22 0 22 20 2 13 0 0 0 0 61 26 0 13 34 0 4 0 52 13 36 0 8 
0 0 0 22 14 25 0 18 34 31 0 0 0 0 7 7 0 36 0 15 0 0 17 13 41 0 0 0 21 0 42 17 29 25 8 0 9 0 3 0 50 0 7 0 20 0 0 23 0 0 10 0 0 46 37 
0 3 0 20 9 53 5 43 14 0 30 13 39 0 14 0 36 0 0 0 8 3 15 19 0 19 0 0 29 11 41 0 32 0 6 0 11 9 22 0 35 25 15 4 14 0 0 7 1 21 62 36 0 0 26 
30 0 0 27 0 21 47 33 0 8 0 35 6 0 9 9 0 9 20 25 11 9 0 0 0 0 6 24 11 15 14 20 0 0 2 0 2 0 10 25 28 0 0 4 38 0 33 0 0 0 29 10 32 1 0 
0 0 14 0 0 5 17 0 0 1 0 0 6 0 0 0 38 0 0 1 0 0 14 3 18 13 0 13 1 18 14 0 0 12 0 7 0 0 8 6 28 0 0 0 0 18 0 45 19 8 0 0 1 1 33 
9 1 33 31 18 55 1 11 0 6 9 27 3 22 13 49 1 22 7 32 0 37 18 11 0 7 0 67 0 8 4 0 0 20 26 18 9 0 32 2 0 26 5 11 0 29 0 11 7 28 31 51 47 0 1 
0 0 28 28 0 0 4 35 17 0 26 22 3 7 9 12 28 15 0 0 23 0 0 0 0 17 0 0 2 14 0 16 34 22 10 0 0 0 0 4 0 0 21 14 0 0 0 1 0 33 3 0 24 22 0 
13 0 0 0 66 0 14 0 0 0 0 0 0 13 0 0 0 16 0 0 32 0 18 7 0 0 11 9 0 0 0 19 5 1 0 0 13 0 0 0 0 0 0 0 39 0 0 0 0 0 0 0 42 0 0 
0 53 7 37 0 9 38 2 33 7 0 3 38 15 0 3 22 0 5 0 16 5 21 0 39 4 19 9 20 13 11 8 4 2 33 8 3 24 7 15 52 41 41 9 0 9 18 14 18 34 32 27 42 16 48 
0 33 0 18 10 4 1 0 45 7 19 0 9 0 0 14 6 27 0 0 0 0 42 8 6 0 0 0 0 10 0 0 20 0 33 0 3 0 0 0 19 16 0 0 12 0 6 3 3 0 15 7 24 21 0 
64 0 0 0 0 72 52 16 8 1 0 1 17 0 0 25 37 0 0 0 2 13 6 0 14 8 2 21 17 7 0 0 11 0 26 19 0 31 5 0 31 0 12 0 0 0 6 0 0 17 1 10 52 85 19 
0 0 0 0 23 0 0 0 8 8 0 21 17 0 0 0 8 3 0 7 40 0 0 7 0 41 0 0 13 0 25 0 31 0 0 19 0 0 8 19 0 23 0 17 0 0 3 0 0 3 23 23 0 28 42 
0 35 8 71 36 20 17 0 2 0 15 22 6 39 50 24 0 0 15 0 1 16 16 20 26 0 5 0 21 15 6 16 4 0 0 0 27 0 0 36 45 12 2 0 0 17 0 4 37 0 38 0 0 40 0 
9 16 0 33 25 13 53 0 1 10 24 0 24 0 24 0 0 17 0 0 0 12 35 0 0 0 0 10 18 1 2 0 23 15 0 0 45 0 0 15 0 10 21 44 2 0 0 0 0 44 16 20 61 0 15 
0 25 0 0 26 24 13 17 53 17 0 0 0 6 0 25 0 23 17 13 6 29 0 0 0 10 42 0 2 12 6 11 2 0 0 19 0 18 0 11 0 12 34 0 21 0 0 9 0 0 4 0 3 0 0 
53 0 0 0 39 2 0 5 20 24 0 13 24 8 9 0 18 0 18 16 0 1 0 0 13 0 1 0 0 0 2 0 4 0 0 35 0 0 0 0 0 0 0 0 2 25 22 0 29 0 3 5 0 0 0 
67 28 12 1 38 1 31 40 39 33 0 4 93 25 19 0 0 8 0 12 1 48 15 31 12 21 4 52 6 2 0 21 4 21 17 23 31 12 13 0 36 5 33 31 52 17 5 7 47 0 30 0 0 0 54 
1 0 7 1 0 9 18 0 22 10 37 7 1 15 0 5 0 0 0 27 15 0 0 19 0 13 10 14 6 48 35 29 0 0 6 1 10 0 0 17 0 1 11 0 33 0 0 37 0 47 44 21 3 9 29 
35 3 30 29 15 2 55 0 9 0 0 0 6 17 0 12 30 4 15 0 20 0 0 0 0 9 0 2 0 42 20 5 0 0 7 3 0 61 3 0 0 0 0 0 5 7 30 12 0 5 60 0 59 0 23 
