55 31
70 16 0 30 0 22 0 0 0 0 0 3 16 0 41 22 2 11 9 0 7 21 9 11 0 56 0 0 9 9 10 4 0 0 29 21 0 9 6 23 10 27 0 0 0 0 9 0 53 0 19 26 63 45 38 
42 18 0 18 0 0 29 0 0 0 3 27 11 26 0 1 0 7 0 19 11 0 10 19 28 26 0 0 6 28 13 0 0 0 0 0 43 17 0 11 0 19 27 0 0 0 0 11 0 13 13 21 0 0 0 
0 0 0 0 18 0 16 1 6 0 0 0 0 0 33 0 0 0 6 11 0 16 12 0 17 0 27 8 17 8 0 6 0 15 10 17 16 27 0 21 18 17 7 0 0 24 0 22 0 34 13 20 16 9 0 
16 28 0 44 0 28 48 18 0 2 6 33 0 0 0 15 1 19 36 11 12 17 28 3 13 19 11 0 4 0 29 0 0 8 0 0 0 24 21 0 0 54 18 0 0 25 0 44 0 0 18 9 0 53 0 
0 0 0 11 20 1 37 11 2 0 8 7 0 7 13 3 59 14 15 9 5 0 12 0 1 4 0 30 9 4 5 5 11 0 39 6 0 34 0 8 1 49 36 11 0 18 10 0 0 21 9 9 0 0 38 
0 29 0 41 0 8 5 3 37 0 14 20 4 5 2 6 28 0 17 0 4 10 24 0 0 9 0 0 0 0 0 0 0 0 14 15 0 33 2 0 4 24 0 0 47 0 35 0 0 0 0 0 0 0 0 
5 17 13 0 11 5 20 4 6 10 1 0 0 0 0 29 0 13 20 26 10 0 20 0 0 0 6 0 7 0 13 8 1 3 0 0 18 0 0 8 33 0 22 0 0 2 4 2 28 0 0 18 0 0 34 
0 46 0 61 0 10 25 26 0 0 41 0 0 25 39 0 22 0 22 0 0 0 18 25 0 0 0 0 4 0 0 9 1 0 0 13 5 14 1 7 5 34 3 29 0 0 5 0 25 0 63 28 0 35 0 
43 21 0 8 6 45 0 1 29 6 0 0 0 0 35 7 2 0 2 72 22 19 13 4 54 0 0 0 19 0 22 6 0 0 0 8 0 0 0 4 0 0 1 34 0 0 0 0 78 35 3 6 10 0 30 
4 16 25 16 40 0 50 0 0 0 3 9 34 1 0 7 30 7 9 13 17 20 31 25 7 23 2 0 1 1 4 16 0 16 0 0 24 0 13 0 39 40 22 0 2 0 51 2 27 0 30 11 0 18 14 
27 0 0 0 0 48 64 19 37 44 0 0 0 17 0 14 0 22 5 0 31 7 0 21 0 3 4 9 1 9 3 0 9 0 0 7 0 0 0 22 0 0 11 2 15 21 9 21 48 29 4 0 0 15 48 
50 0 0 17 13 14 0 8 16 39 6 7 8 12 0 26 18 34 0 11 28 5 12 3 57 22 11 9 11 27 13 0 15 14 0 11 0 7 9 0 0 30 39 0 25 3 0 12 73 16 46 0 6 16 30 
0 0 26 20 0 0 5 3 0 0 0 0 3 31 17 0 15 1 6 0 28 0 13 0 28 22 22 12 26 3 6 34 29 0 3 26 0 17 0 12 0 5 11 0 31 0 18 22 24 0 0 47 0 18 23 
42 0 15 0 0 0 10 5 0 24 0 4 0 18 36 4 26 23 0 11 13 7 22 0 15 14 0 0 7 18 4 31 0 34 0 0 12 0 21 8 0 0 55 4 0 12 0 18 0 0 45 1 27 40 0 
0 0 14 0 6 0 31 0 8 0 18 21 0 3 28 22 0 0 4 0 0 31 0 0 9 0 16 0 0 9 0 23 29 9 0 0 0 9 9 14 0 0 30 2 0 2 0 0 6 0 0 6 0 0 0 
10 12 0 47 30 38 8 9 0 40 3 7 8 12 19 10 0 2 7 0 0 9 11 0 14 29 0 0 0 2 0 23 0 0 19 0 0 0 2 2 0 38 7 38 0 0 0 0 4 33 25 0 0 2 58 
0 16 40 0 9 0 13 10 0 0 0 0 16 30 1 12 0 0 7 0 0 18 12 27 13 18 0 12 15 0 0 2 0 11 0 0 0 0 4 18 0 0 28 33 0 0 0 0 6 3 11 4 0 0 0 
107 0 9 0 8 10 0 11 12 11 0 9 23 0 11 0 0 0 2 0 0 11 0 0 0 0 17 13 0 10 0 2 0 0 0 23 0 7 0 0 0 7 0 0 0 0 45 47 1 1 0 13 9 4 8 
9 0 48 40 0 57 0 21 14 38 15 46 0 0 0 1 37 0 5 0 0 17 15 0 16 0 2 0 0 5 6 24 0 0 0 0 0 7 16 0 0 0 3 40 0 0 1 38 0 44 56 0 1 0 43 
0 8 23 14 0 0 17 23 23 41 29 35 16 35 72 0 54 2 9 18 0 0 6 6 12 42 0 0 5 0 6 7 12 1 7 0 58 18 13 30 0 21 29 0 49 8 35 3 6 33 0 0 38 43 38 
37 42 0 32 0 16 0 40 0 17 0 0 21 20 0 0 0 9 36 19 17 46 0 5 0 9 14 29 25 0 0 0 0 34 15 39 19 42 4 0 19 0 0 18 23 0 0 8 13 0 44 9 0 33 0 
2 44 2 23 3 94 8 3 12 22 27 0 40 0 14 29 0 0 31 0 21 14 22 5 1 0 0 0 1 5 1 22 16 0 0 4 0 12 0 18 14 0 0 0 7 53 0 30 16 13 0 19 71 0 40 
22 0 0 0 0 22 41 0 0 0 0 0 0 0 0 22 0 0 36 3 0 0 0 25 10 0 0 8 0 0 4 0 11 0 3 3 0 1 0 0 0 0 0 0 14 0 0 44 19 0 0 10 0 1 0 
6 66 0 0 0 29 0 0 0 68 0 0 0 0 0 20 0 0 2 0 21 12 12 23 19 0 24 0 0 0 0 0 0 10 16 33 15 2 16 3 0 0 5 0 0 0 30 1 0 0 57 0 32 36 0 
23 0 0 0 3 23 0 2 3 4 21 39 6 3 0 11 6 21 0 0 0 16 0 13 0 0 20 0 15 0 5 0 22 0 0 0 23 22 9 0 0 25 3 0 0 4 35 4 0 0 26 2 31 17 0 
41 0 0 0 50 9 0 0 0 13 0 20 0 0 1 1 3 0 2 8 16 11 23 39 0 0 18 8 0 4 0 37 4 36 0 26 12 0 0 0 0 0 38 0 39 22 13 0 0 21 0 25 0 0 0 
13 12 0 27 0 36 0 19 4 0 0 0 7 12 5 0 0 0 4 1 0 0 14 20 0 0 0 0 10 0 5 0 0 0 8 0 0 3 9 9 0 1 0 2 0 42 0 5 0 44 0 5 0 0 16 
38 45 0 31 34 0 6 30 28 34 19 29 0 4 0 28 4 29 28 18 79 24 9 28 11 1 3 8 0 25 20 4 21 15 49 19 17 17 29 22 29 21 15 27 24 27 34 2 85 41 38 1 0 45 0 
0 0 3 27 21 31 10 0 0 0 27 50 25 43 1 0 4 0 9 0 0 44 70 19 27 19 5 3 23 0 24 5 0 0 55 16 3 45 0 6 0 35 27 10 26 14 0 0 0 0 1 16 30 38 33 
6 16 0 25 69 11 44 0 0 26 32 7 0 20 12 46 22 28 52 0 18 10 0 17 3 31 22 0 6 9 2 32 0 16 22 0 32 5 37 24 2 84 9 0 4 0 0 0 32 16 0 18 0 31 1 
52 25 0 0 0 17 18 0 33 0 0 63 6 15 15 0 0 0 0 8 22 12 19 0 7 18 16 30 0 0 40 0 9 36 0 0 0 0 0 28 0 0 8 0 0 0 40 17 37 0 50 8 20 0 0 
