55 31
76 10 4 7 0 0 6 0 46 0 2 19 0 9 19 0 4 10 8 0 26 0 30 46 28 0 0 21 8 17 7 0 0 17 5 0 36 20 21 20 11 0 8 18 14 0 0 13 0 43 0 51 0 0 15 
70 0 4 0 0 0 0 0 18 20 2 0 12 0 19 34 17 0 13 0 4 53 16 0 0 0 6 2 8 2 2 13 64 17 0 0 0 10 28 0 0 8 0 2 44 0 39 1 11 20 3 15 6 7 0 
59 15 11 21 0 7 9 0 0 31 38 28 0 29 0 15 22 6 9 30 14 0 19 1 2 0 24 36 0 27 6 0 0 3 7 0 0 0 0 0 38 11 65 0 0 16 5 58 0 30 2 41 26 0 0 
38 0 19 45 0 0 1 0 29 0 64 34 5 0 0 0 4 7 0 0 33 18 10 0 0 11 0 22 6 6 0 0 14 10 0 0 9 15 0 19 4 5 0 26 0 34 0 0 43 46 39 0 3 36 4 
0 0 16 0 49 30 5 0 0 44 19 0 6 4 0 2 0 0 0 0 0 0 2 0 0 0 0 25 0 19 0 22 0 14 13 17 5 24 0 0 23 0 24 0 0 0 44 4 10 0 4 19 8 93 0 
5 44 0 8 0 23 0 0 0 17 3 30 0 5 16 0 3 29 41 4 3 0 4 6 1 6 6 0 43 7 18 6 45 20 0 10 0 0 0 3 0 20 0 26 0 83 7 24 32 38 17 0 34 0 0 
34 48 0 0 0 0 0 12 0 0 0 6 0 0 12 12 13 0 3 9 0 0 0 0 10 0 0 0 16 49 0 0 0 0 33 18 0 3 11 0 28 0 8 1 0 0 0 12 15 20 30 0 2 18 0 
10 8 0 5 0 19 2 0 3 8 0 9 0 0 14 32 20 0 0 0 0 14 4 0 11 0 27 10 0 0 21 23 0 0 1 0 0 0 0 0 18 23 0 1 3 4 5 36 7 0 0 0 12 6 7 
0 12 0 20 0 7 2 0 0 0 0 26 10 0 0 14 0 0 0 0 0 32 7 20 1 5 0 23 0 17 16 0 7 14 1 0 0 26 0 21 0 10 35 4 2 0 16 15 3 0 0 0 0 77 27 
19 0 0 57 12 3 2 53 0 8 0 19 0 10 0 21 12 0 0 7 0 0 7 0 21 9 25 0 0 10 19 0 0 0 5 0 5 13 0 0 11 0 0 0 0 20 8 0 12 2 47 2 0 4 45 
48 11 0 0 23 1 19 4 32 0 42 4 28 0 0 20 0 10 0 29 0 15 0 0 0 26 0 40 9 15 0 3 0 12 0 14 15 0 0 16 0 41 0 0 18 12 0 0 0 17 0 54 24 28 0 
52 42 0 3 20 1 8 47 0 42 0 13 3 4 0 16 33 0 4 44 0 0 14 0 37 37 15 7 0 6 0 0 0 24 28 0 11 23 5 13 14 0 0 60 0 9 0 0 3 12 5 32 59 37 2 
0 0 76 0 0 0 27 0 3 11 12 18 9 12 0 13 0 0 0 5 0 2 0 13 0 42 0 17 0 7 6 29 0 31 29 0 0 3 17 29 3 34 0 0 11 3 10 1 11 0 0 0 0 0 36 
23 5 0 2 0 4 39 0 22 0 17 37 0 0 29 12 0 8 40 0 10 0 3 35 0 28 14 30 6 13 2 18 0 0 20 0 8 1 9 3 14 1 40 0 8 36 13 8 34 7 14 23 0 41 0 
0 0 0 0 0 0 0 0 0 24 0 2 0 18 0 0 9 7 15 0 16 0 16 0 0 8 9 7 15 0 22 0 0 24 0 0 16 18 16 0 0 5 0 4 0 0 4 4 21 0 8 13 37 0 0 
40 9 36 0 9 0 4 26 8 0 0 0 0 26 0 0 0 1 19 33 0 15 7 25 17 0 0 50 0 0 0 0 0 5 0 0 9 0 0 0 13 0 0 22 0 12 1 0 25 30 4 14 0 55 0 
0 0 32 48 18 25 0 3 13 30 42 26 5 0 48 4 21 0 0 27 0 13 54 0 0 0 2 16 14 10 36 16 12 11 46 0 0 34 16 0 4 15 20 7 31 0 32 0 63 39 1 84 0 27 0 
28 0 0 0 0 0 11 45 15 0 0 4 34 3 0 0 0 0 21 36 13 0 23 19 22 10 0 10 47 4 10 13 14 0 0 29 12 17 7 16 5 0 0 0 12 29 7 19 40 0 11 16 41 7 1 
0 41 17 42 3 0 47 15 0 17 24 16 0 53 12 0 0 0 0 15 13 6 11 3 0 0 0 0 11 0 3 9 4 0 24 38 9 4 10 9 0 0 5 18 31 104 0 58 1 0 0 5 0 47 0 
17 0 21 0 0 0 0 56 0 10 38 37 0 39 0 0 32 0 0 23 7 5 4 17 0 0 36 18 2 23 0 24 0 0 0 0 10 2 0 39 0 11 10 0 0 0 24 11 49 0 8 0 28 0 0 
23 56 49 0 0 0 0 0 16 72 28 0 9 0 7 0 30 8 0 33 0 0 8 0 24 0 0 0 36 29 0 0 0 0 0 0 13 20 28 0 0 0 0 0 0 0 37 0 0 34 0 49 11 0 38 
0 0 0 0 21 0 48 0 23 28 0 44 1 0 0 35 22 0 9 0 0 44 0 19 0 0 0 0 10 2 18 41 1 18 22 12 10 17 0 9 4 30 0 14 0 7 10 4 5 20 34 0 0 0 48 
16 92 100 44 0 0 42 40 0 48 9 4 6 0 9 0 15 20 6 0 11 10 22 60 25 22 25 16 33 0 0 0 0 14 10 0 0 0 11 6 39 30 0 5 11 25 10 145 42 38 0 0 57 0 4 
0 0 11 52 8 47 2 0 0 11 0 0 12 10 0 51 20 0 25 18 11 33 11 13 0 0 14 21 0 2 13 3 21 4 3 19 4 12 7 8 8 4 4 29 0 4 0 25 5 0 0 9 35 0 14 
0 0 0 0 17 3 0 0 0 4 0 0 0 14 0 1 0 5 0 17 3 15 4 4 4 0 9 38 0 0 6 0 0 0 0 14 38 0 0 0 0 1 1 0 0 13 0 0 0 0 8 24 0 0 0 
47 0 0 22 0 16 2 11 5 9 0 9 32 34 3 4 27 0 77 0 0 14 26 40 17 13 4 1 31 29 27 0 0 36 16 0 0 10 15 8 15 51 6 23 43 24 7 78 6 0 2 11 19 4 26 
0 0 0 35 4 0 36 0 0 0 0 0 0 0 0 20 0 5 0 17 0 25 8 23 0 11 24 0 12 5 0 0 0 0 0 0 0 0 35 16 12 0 37 1 0 0 10 0 10 0 0 0 0 0 4 
20 0 10 0 16 11 0 0 0 9 1 20 0 8 12 0 4 0 15 39 26 4 18 0 3 13 0 16 0 29 0 4 4 7 0 0 0 0 0 0 44 4 0 0 19 1 26 2 6 17 35 41 39 11 0 
25 0 24 0 35 0 0 0 18 7 22 1 22 30 13 11 24 26 0 33 0 0 0 23 24 23 0 0 24 15 66 15 10 0 22 0 12 0 0 4 27 6 4 31 0 6 22 6 32 0 0 0 33 0 29 
29 0 0 72 0 26 44 0 19 14 0 8 0 0 0 8 0 0 37 33 14 5 15 2 11 4 5 27 8 16 19 26 0 28 6 21 30 0 28 11 0 0 0 20 9 20 17 26 0 0 47 11 33 35 36 
0 0 0 23 66 0 2 37 31 11 3 37 26 16 14 11 0 8 36 20 22 22 31 23 21 8 0 29 0 40 29 20 92 18 7 1 0 65 10 7 23 57 0 10 0 3 8 29 11 19 0 28 40 15 18 
