55 31
22 0 52 7 0 0 32 14 44 0 0 0 26 38 13 14 34 0 0 3 0 23 3 15 0 0 6 19 0 0 27 0 26 6 14 13 13 45 32 0 0 0 0 0 44 0 0 0 25 1 58 20 2 0 0 
43 0 5 3 0 0 36 35 2 9 18 0 7 0 33 8 0 0 23 44 9 34 6 0 0 4 0 27 0 8 6 53 0 0 13 0 0 7 0 0 4 4 0 70 4 0 34 33 0 0 23 30 0 0 0 
0 43 0 0 0 41 45 15 1 3 15 0 0 0 0 17 14 24 0 12 14 29 29 0 0 0 16 0 7 1 0 0 0 14 0 26 2 22 0 0 0 20 0 0 43 0 54 13 27 43 9 27 0 0 0 
48 9 20 39 41 35 47 29 29 33 3 0 8 0 51 3 33 0 35 33 0 0 11 0 3 1 0 23 18 0 16 9 28 11 7 4 29 44 0 41 0 10 11 19 4 26 42 0 4 45 43 21 20 82 5 
49 13 0 75 47 5 111 19 7 24 8 27 37 5 9 0 15 27 12 16 20 0 6 18 9 21 35 2 17 4 17 17 41 9 20 31 28 6 27 0 0 0 28 5 24 37 28 10 27 4 6 1 2 0 18 
50 0 19 0 34 0 0 0 0 0 0 0 1 11 0 16 13 21 3 12 7 5 0 22 6 41 0 21 0 23 4 12 13 0 4 0 0 6 6 0 36 0 0 0 0 24 20 5 46 0 66 0 0 15 0 
18 22 0 8 7 11 0 0 0 40 43 11 14 6 0 2 0 5 29 0 9 52 13 12 0 7 20 0 0 28 0 10 0 27 0 0 0 16 0 0 18 9 21 0 18 0 21 43 0 30 0 0 19 28 0 
85 3 0 37 14 81 0 3 0 11 21 0 30 0 0 0 5 25 29 16 24 20 23 0 0 0 4 7 25 7 0 0 0 23 19 34 36 16 0 7 0 58 100 0 0 0 15 0 35 50 1 0 0 16 0 
0 0 0 33 4 53 0 10 22 0 2 0 19 0 0 2 4 6 29 18 5 7 17 0 0 3 0 0 0 14 0 19 12 15 23 6 31 4 0 0 0 30 1 9 0 12 5 43 9 0 0 9 0 0 0 
2 14 15 0 0 0 0 45 22 2 0 9 0 0 0 14 0 0 0 27 0 3 0 0 22 5 18 0 11 10 11 19 10 0 0 14 25 13 0 2 2 0 9 0 11 5 27 0 0 7 20 44 0 0 0 
49 20 0 51 24 0 33 3 5 19 13 26 0 39 16 0 0 6 2 0 0 3 13 25 0 0 18 0 7 0 0 0 0 0 0 36 0 0 0 33 26 20 3 34 0 0 32 5 0 101 0 0 49 1 0 
11 10 0 0 42 39 22 9 29 14 0 1 0 0 22 6 8 15 6 0 2 0 17 0 20 0 0 21 0 0 17 0 0 0 35 0 19 6 0 34 2 0 0 0 30 37 34 17 0 5 2 0 0 8 9 
17 88 23 0 17 0 6 29 0 0 7 51 16 0 0 34 22 1 2 0 2 0 0 11 0 25 25 6 0 22 0 0 6 21 0 0 29 8 43 3 0 5 1 34 0 0 2 0 0 40 11 0 0 0 43 
11 0 3 0 7 31 32 27 0 3 0 6 0 7 11 0 0 12 12 0 3 46 0 2 5 8 0 9 21 0 12 41 3 24 10 2 0 9 15 6 0 0 0 0 0 24 0 0 0 0 0 0 2 0 0 
0 10 30 5 9 0 0 51 0 0 11 0 0 0 0 22 0 0 0 0 3 3 0 0 0 0 16 12 0 6 14 23 52 27 13 6 0 0 0 12 0 7 0 0 33 38 0 0 4 0 0 0 0 0 34 
104 22 0 19 8 9 0 6 14 0 0 0 8 0 0 0 12 24 15 3 1 10 59 10 0 51 12 0 22 18 6 0 0 0 3 35 11 0 0 38 2 0 37 18 0 0 40 67 0 0 33 1 1 32 4 
0 0 0 12 0 0 10 0 0 38 8 0 0 0 0 0 0 0 0 15 9 2 27 0 0 0 0 22 0 10 9 14 0 9 16 0 0 5 7 4 14 15 4 3 35 0 7 0 0 28 6 0 34 0 0 
0 48 0 46 7 3 0 7 0 0 11 0 14 0 0 0 12 0 2 6 0 0 13 5 0 9 0 3 7 0 0 17 9 0 20 8 0 47 0 5 0 15 0 0 5 29 0 17 41 0 0 84 49 0 17 
36 40 18 11 6 12 14 0 0 5 15 8 9 6 0 0 11 0 0 11 16 8 0 0 11 7 29 6 0 3 0 0 32 15 19 7 23 0 0 0 24 45 18 14 11 0 5 1 4 0 0 29 20 0 0 
0 51 50 0 0 0 9 35 56 0 3 10 0 0 0 17 0 0 60 0 0 10 0 0 19 11 16 0 0 14 0 2 1 0 0 17 11 0 0 0 0 0 9 0 5 0 52 0 0 0 15 33 30 0 10 
21 0 0 17 0 11 81 14 0 10 9 64 14 30 2 0 19 57 13 26 0 35 6 0 13 0 0 12 0 12 0 11 6 0 16 8 0 13 27 0 1 0 16 0 0 4 15 30 37 39 0 0 22 12 0 
0 12 0 94 28 18 0 33 20 9 54 31 11 5 0 0 3 17 5 0 0 7 25 18 0 9 19 0 17 0 2 22 33 0 0 10 0 0 0 5 28 0 24 0 12 19 43 2 0 5 30 0 42 53 32 
22 1 0 37 0 28 3 0 0 6 0 0 19 17 16 14 21 0 0 0 6 3 8 5 14 0 0 0 9 0 3 16 0 25 0 0 1 10 14 0 37 0 1 1 0 0 0 2 0 0 6 0 0 0 18 
0 23 20 28 27 11 10 0 20 19 0 0 4 0 2 11 50 8 61 28 0 0 26 2 56 10 6 19 9 3 0 56 25 4 30 30 1 9 5 20 14 6 0 0 17 19 15 9 59 31 90 7 26 8 34 
28 11 0 42 0 9 20 34 0 31 8 0 30 11 41 0 0 4 33 4 0 3 0 0 0 0 0 0 0 11 0 5 0 0 0 0 0 52 6 5 44 29 0 0 39 42 2 49 7 0 20 32 0 0 0 
0 0 0 0 0 0 27 56 25 1 11 0 0 2 2 3 7 4 0 0 0 7 0 0 16 20 0 20 0 0 1 16 17 0 18 31 0 0 3 18 16 19 22 36 0 0 6 0 18 0 4 0 0 0 11 
45 17 0 0 49 0 22 31 28 15 0 7 11 0 18 0 13 14 17 24 0 0 6 23 0 16 0 21 0 4 4 6 12 0 19 0 8 0 32 0 2 0 13 0 2 4 40 0 19 20 1 0 0 0 0 
0 20 0 74 0 3 0 13 0 56 8 0 0 0 2 0 14 0 0 32 0 33 0 9 15 0 30 0 0 0 0 0 16 13 0 0 15 4 1 0 0 10 0 0 41 0 0 6 0 0 41 62 21 0 0 
0 23 0 12 12 0 4 34 0 21 13 0 17 0 0 17 19 16 0 12 24 25 17 23 8 7 18 27 0 0 0 3 10 14 9 12 16 11 23 22 0 59 7 4 34 15 0 0 0 0 0 0 23 27 0 
0 2 0 14 33 16 5 0 24 9 36 25 5 6 29 8 0 0 19 0 28 9 0 8 6 0 7 0 0 0 13 9 0 47 13 0 48 0 26 15 8 0 28 9 0 35 36 4 1 0 0 38 51 0 50 
0 0 0 6 22 3 16 0 59 3 0 0 0 0 0 0 0 0 26 0 0 0 15 0 1 8 12 0 17 11 16 0 17 0 0 0 0 13 7 0 1 28 4 0 27 52 1 1 1 4 13 47 0 0 0 
