55 31
7 14 0 0 10 0 1 5 30 0 25 45 0 0 34 0 0 0 0 22 0 0 24 0 10 24 0 10 0 19 19 0 1 0 12 33 0 0 0 0 1 1 10 3 0 0 19 2 14 2 0 0 2 18 0 
0 10 0 0 41 27 1 7 0 0 0 33 0 24 29 0 0 19 0 15 0 8 17 0 0 0 17 26 0 8 0 4 39 0 51 31 23 0 25 2 9 9 0 49 13 0 0 0 0 0 0 20 17 41 15 
0 0 29 0 0 0 23 2 0 3 24 0 7 4 20 0 19 25 0 18 0 14 0 23 8 14 8 0 0 0 0 0 2 21 10 9 20 0 0 0 5 8 25 0 0 0 24 1 0 0 27 0 0 0 9 
15 0 5 55 47 0 0 18 6 7 25 23 36 32 5 35 0 14 11 5 1 19 0 0 7 0 22 19 15 25 27 7 10 8 0 36 11 0 0 0 0 0 16 30 7 38 19 0 81 0 15 8 15 0 33 
0 39 45 6 38 15 0 35 0 0 13 0 0 0 16 1 24 9 0 0 27 4 20 0 0 0 6 0 0 0 0 0 0 0 0 0 0 0 0 0 15 0 55 0 0 0 48 44 24 0 0 0 0 0 0 
0 7 30 12 1 2 1 20 40 39 29 49 0 15 13 6 6 30 0 0 22 15 32 17 15 0 0 12 1 0 18 0 30 27 0 0 0 4 27 6 54 0 0 3 0 25 55 2 121 0 36 0 0 3 17 
28 0 0 14 14 15 0 32 30 32 0 25 29 21 0 10 0 0 3 0 0 0 0 0 0 2 28 19 12 18 0 13 0 0 21 26 0 3 30 52 4 70 10 4 13 0 7 0 21 0 0 0 0 0 0 
0 83 0 16 27 46 44 0 0 52 30 37 4 33 0 0 8 26 30 0 0 4 4 25 17 19 8 13 3 27 12 0 10 0 14 4 0 0 9 30 26 16 0 11 0 44 49 2 98 0 0 37 8 29 17 
3 0 16 35 0 11 0 37 6 12 10 89 0 13 0 33 25 0 0 0 0 19 0 0 0 0 11 14 18 14 0 0 18 9 14 24 42 30 0 0 8 24 0 0 0 2 18 0 9 38 1 0 0 1 44 
13 19 0 41 16 18 0 29 0 0 0 51 0 0 21 4 0 13 11 0 3 1 10 3 0 17 0 23 15 0 9 0 31 0 18 0 0 5 8 2 0 0 0 0 43 0 2 0 20 1 16 0 41 21 0 
0 27 23 56 17 61 46 31 8 36 6 7 6 27 14 9 15 16 13 27 4 10 0 35 9 0 12 13 14 37 7 0 30 19 9 24 34 0 16 1 26 8 0 24 22 14 21 7 10 44 48 0 44 64 0 
29 11 1 5 0 5 0 0 20 0 37 41 15 25 20 0 19 0 0 6 0 5 6 0 0 0 0 0 10 0 0 33 0 12 0 25 1 0 0 0 5 9 0 31 44 0 0 40 62 18 39 0 42 0 14 
39 12 54 0 3 34 0 25 5 6 0 35 1 26 0 7 0 3 4 15 0 21 0 11 13 0 15 0 12 8 3 8 28 2 14 30 15 21 17 62 12 30 0 2 0 0 0 0 0 0 0 0 12 13 0 
0 38 0 2 3 0 16 3 27 0 7 0 4 0 0 31 13 12 0 0 0 0 10 12 26 22 0 0 0 2 0 0 10 14 0 7 0 14 0 4 7 1 2 0 10 0 30 0 26 48 26 2 6 9 3 
0 0 15 28 2 0 9 20 48 36 7 19 41 0 0 33 0 22 0 0 0 15 0 20 17 23 0 10 0 0 0 0 0 12 23 4 12 0 0 0 0 0 0 2 0 41 0 0 68 4 42 0 0 0 42 
36 5 25 9 8 2 0 20 0 0 0 16 41 0 0 3 14 0 16 0 2 0 4 52 0 18 4 20 3 0 6 3 0 0 0 2 12 0 0 0 0 14 0 18 0 18 0 0 0 0 6 11 9 14 0 
0 85 0 5 49 16 0 0 0 10 0 29 7 0 1 25 0 0 13 25 14 0 0 6 27 6 0 1 24 0 0 11 1 8 14 0 0 0 0 0 21 13 10 42 49 9 0 2 0 0 35 27 0 6 9 
0 0 42 0 15 49 0 32 14 7 21 3 52 11 0 36 34 42 0 3 23 0 0 19 5 0 7 15 14 5 0 0 0 0 27 9 0 0 1 30 12 0 30 9 7 28 37 0 0 0 1 6 0 7 43 
0 0 0 0 0 0 9 0 0 0 10 13 0 0 0 10 0 0 35 0 34 6 6 28 0 0 36 8 1 0 12 0 0 0 16 8 0 31 0 0 0 0 33 16 0 4 0 2 42 0 8 32 17 42 34 
4 45 50 9 0 49 34 10 0 0 13 5 37 5 42 11 0 15 41 0 4 7 32 34 27 6 15 25 19 0 0 6 10 0 17 3 0 0 3 2 18 0 20 17 27 1 42 55 0 60 3 0 22 46 36 
0 2 17 24 36 5 0 15 0 77 28 1 10 33 17 0 5 3 0 35 0 23 9 0 18 0 0 40 14 14 0 0 11 0 21 0 0 0 0 6 52 5 0 12 6 41 0 40 4 9 26 0 0 0 47 
3 0 11 3 0 22 0 0 0 0 29 11 0 24 17 14 38 25 0 0 0 1 0 0 0 14 34 10 12 8 12 0 0 16 14 6 12 0 6 29 0 11 0 7 0 0 16 0 27 0 0 5 36 0 0 
2 13 0 12 8 0 0 0 26 19 39 55 8 0 0 0 23 0 6 0 0 53 0 0 6 4 0 0 0 2 0 0 5 4 26 0 0 31 22 1 0 0 0 0 0 0 0 0 0 0 38 1 0 23 77 
16 50 15 9 3 2 54 2 0 0 25 6 0 0 25 0 0 0 0 2 0 0 15 2 0 2 1 15 0 29 0 0 0 0 7 45 0 9 0 24 12 1 17 0 10 12 7 20 0 0 49 9 0 0 48 
23 15 22 6 0 17 0 0 0 0 8 11 0 6 23 11 29 0 25 6 0 2 46 14 11 23 10 10 16 5 9 4 0 0 16 2 23 44 12 30 5 20 0 25 0 19 4 0 4 25 43 0 0 0 0 
11 11 35 0 14 38 17 19 33 23 20 20 0 1 8 17 0 7 20 2 0 0 0 6 0 0 19 14 17 24 0 0 6 16 0 0 0 35 0 0 0 0 31 38 0 0 3 0 14 3 23 28 3 57 14 
0 26 0 3 50 0 38 1 0 0 0 2 0 23 0 0 0 45 0 0 11 7 11 0 0 17 25 0 3 0 0 19 0 17 0 0 85 0 32 6 0 5 3 37 13 16 0 30 0 0 0 0 0 7 27 
7 36 31 4 0 5 0 25 0 0 5 6 0 0 0 0 0 20 0 0 0 15 0 0 7 0 3 0 2 0 0 1 6 17 28 7 19 12 6 2 0 0 7 0 2 0 0 7 23 0 0 0 24 2 46 
13 0 32 0 7 9 0 5 0 4 3 0 0 21 22 0 0 0 19 28 34 8 23 22 20 14 22 5 7 8 26 16 0 0 14 1 1 52 0 14 0 0 15 23 0 22 1 11 0 0 0 0 18 0 45 
48 0 2 31 31 0 0 23 1 9 0 11 48 9 0 0 9 15 0 0 6 9 15 11 17 0 4 0 3 12 13 28 0 10 11 4 7 0 15 0 0 64 14 10 2 9 5 0 24 0 5 5 0 10 0 
0 0 36 115 25 0 0 33 3 7 13 0 0 0 117 13 7 14 16 14 0 17 0 0 9 17 0 8 0 28 15 0 7 0 10 14 0 15 19 4 59 33 2 29 4 28 0 18 31 14 0 0 15 0 91 
