55 31
0 0 2 0 19 2 0 52 0 0 3 0 26 16 6 37 0 28 2 0 0 0 14 24 0 0 0 1 0 5 12 0 0 2 0 0 0 0 0 0 0 0 27 0 0 0 0 49 0 20 0 0 0 0 0 
0 0 18 39 33 41 0 115 0 41 21 0 19 20 0 22 0 0 14 0 30 17 24 29 17 15 20 8 19 0 0 20 0 2 79 0 9 29 17 0 30 24 1 99 37 40 4 23 10 31 37 14 32 0 20 
42 11 27 0 46 8 45 0 0 0 0 0 14 17 0 47 22 0 18 1 1 0 16 1 13 19 14 0 0 27 17 0 0 0 16 17 0 25 38 0 26 7 42 3 0 0 8 19 18 34 46 34 32 0 0 
28 21 16 10 6 20 0 0 8 0 49 11 50 1 9 0 29 26 3 23 0 0 0 0 0 0 23 0 32 17 18 0 4 31 9 12 4 0 22 0 24 0 0 0 0 22 12 12 62 23 22 19 0 19 0 
25 0 0 0 0 36 35 43 22 0 0 0 30 0 0 0 0 57 0 31 0 5 14 30 7 0 5 0 5 1 0 23 0 0 1 16 0 20 0 0 12 66 30 8 11 0 21 0 1 20 16 0 5 36 0 
3 27 48 0 15 5 0 0 0 35 36 0 48 0 0 8 13 0 0 17 10 0 0 0 0 3 0 0 4 0 10 23 0 0 0 0 0 0 0 9 0 0 0 0 34 20 26 1 9 0 48 29 0 0 23 
0 14 18 39 0 0 0 12 35 0 9 8 21 12 10 17 21 0 0 11 0 0 5 0 0 12 4 0 16 0 9 0 39 0 10 0 18 0 0 0 39 12 39 45 19 11 19 36 0 0 0 0 0 12 40 
0 4 0 0 4 0 31 0 24 0 0 0 5 0 0 84 0 0 0 0 0 0 0 0 23 7 24 0 2 0 0 0 16 0 2 6 0 14 0 0 0 32 0 5 0 1 6 4 7 0 38 5 0 12 0 
0 0 7 25 8 0 0 4 0 0 25 15 71 23 34 18 22 18 0 13 0 13 9 0 0 0 0 0 25 20 0 0 7 17 0 18 0 0 11 0 27 26 30 0 0 0 25 7 14 0 7 0 0 12 14 
0 0 0 38 45 19 0 0 0 0 0 32 3 0 12 34 1 2 6 0 0 17 24 63 17 0 22 0 4 0 0 26 15 16 5 2 0 32 43 0 0 0 7 8 0 7 10 0 25 30 45 40 23 0 0 
0 0 1 16 50 43 33 0 0 17 0 16 4 0 0 32 12 1 31 29 12 0 5 11 0 15 0 5 21 0 0 6 17 9 0 5 0 6 7 0 11 0 4 9 0 19 0 0 43 12 0 0 0 0 50 
62 0 0 0 7 0 0 7 0 0 8 29 0 4 21 0 0 1 23 0 3 0 47 0 2 19 3 0 4 8 11 9 4 18 14 21 15 0 0 2 40 8 16 32 0 0 24 4 19 17 50 15 34 10 0 
47 26 0 41 4 15 16 3 0 76 4 0 29 10 4 0 11 8 16 28 39 11 3 1 10 9 0 26 5 0 0 9 24 17 0 0 20 0 0 15 4 13 0 8 10 0 40 75 24 15 1 48 8 7 46 
0 53 95 10 0 0 0 4 3 6 36 46 0 5 37 3 14 1 16 0 0 0 0 9 8 0 0 12 0 2 33 14 2 25 2 0 0 12 0 10 2 0 0 42 0 15 9 16 13 26 1 44 18 42 17 
26 0 6 0 3 0 0 5 0 0 3 0 17 0 2 4 21 5 0 0 34 14 5 0 0 0 26 0 4 23 40 0 6 0 5 22 11 21 0 0 0 0 7 5 0 0 26 7 5 16 20 0 0 11 24 
45 0 35 0 0 51 10 46 0 32 0 11 1 4 0 20 10 0 57 0 0 0 0 7 1 0 5 23 0 0 5 6 7 0 16 9 0 45 0 0 25 16 24 13 32 45 51 0 7 13 23 42 0 46 8 
0 0 47 4 45 12 6 0 3 1 88 10 11 0 12 1 13 12 3 0 2 37 25 0 2 0 17 10 0 11 0 0 0 7 0 10 34 37 12 0 2 0 0 26 13 7 0 25 27 45 28 0 0 0 30 
12 0 0 49 48 0 0 4 37 6 39 0 43 0 31 16 0 4 23 0 2 4 9 1 10 0 0 17 5 13 18 16 19 0 5 0 0 0 1 0 18 52 12 9 54 42 36 43 20 0 37 19 0 5 0 
23 8 0 0 0 26 41 0 0 0 0 0 23 15 20 2 13 14 0 0 16 0 0 46 0 0 20 25 0 0 0 23 16 9 29 14 16 4 9 0 0 0 0 11 8 3 0 10 4 0 2 0 0 0 0 
22 0 0 0 50 0 48 3 0 0 0 0 0 23 0 0 0 0 0 16 34 2 0 10 0 2 10 0 0 0 0 3 0 16 11 16 23 0 27 10 18 0 6 23 0 1 0 0 4 0 1 9 0 19 98 
0 0 4 0 43 18 9 0 11 0 0 0 48 0 20 11 38 0 0 14 0 22 0 13 0 0 0 18 0 8 13 0 22 0 25 16 13 0 0 0 21 0 10 78 9 6 0 47 0 9 2 0 1 0 80 
0 2 20 5 15 14 0 13 0 0 2 0 0 4 39 13 28 0 5 7 0 2 20 7 8 8 3 2 26 18 0 0 3 15 0 31 14 8 2 0 0 0 27 0 0 0 8 8 61 0 37 0 0 83 0 
17 0 0 0 0 0 4 0 0 0 27 0 17 28 16 0 22 17 61 40 89 0 4 2 0 2 17 31 6 0 0 0 24 0 22 16 1 30 11 11 17 0 10 0 25 0 4 0 4 11 35 20 4 33 57 
4 19 0 39 50 32 37 0 3 22 2 15 11 7 0 0 28 0 19 0 7 5 0 16 0 0 17 15 13 0 0 0 9 10 14 0 0 13 12 0 17 15 13 27 45 0 0 24 0 0 56 0 0 10 8 
0 37 20 42 42 27 6 5 0 0 8 7 14 42 0 58 8 3 0 0 8 0 10 1 21 14 30 0 0 0 38 0 18 11 24 4 30 1 23 14 0 6 23 42 22 0 73 22 84 5 16 0 29 0 41 
40 0 0 0 40 0 0 0 0 0 30 41 28 26 8 27 5 34 0 15 24 5 20 21 0 0 1 0 18 0 0 0 0 0 0 0 0 10 22 0 82 0 27 0 20 33 29 0 23 1 2 22 41 11 14 
4 43 0 0 1 41 4 4 4 3 34 82 5 0 9 0 0 12 18 33 31 3 0 0 11 13 30 10 13 11 0 8 0 14 0 28 27 19 1 1 6 1 16 24 102 18 0 21 12 14 26 33 0 38 26 
44 0 13 0 0 9 45 8 40 17 0 4 19 5 11 38 7 3 0 13 0 33 2 0 2 9 21 16 30 12 19 19 6 0 19 9 8 1 32 34 1 9 10 2 45 0 0 0 0 19 0 22 43 19 33 
0 1 61 0 0 0 0 0 5 9 0 0 0 0 4 14 0 13 49 18 10 30 0 21 0 8 19 19 15 6 10 0 9 3 11 9 0 18 20 6 14 0 0 2 1 14 3 22 20 30 0 40 0 0 27 
18 0 36 0 3 0 0 29 0 3 27 0 3 0 0 0 8 17 3 19 0 14 0 7 12 20 4 25 0 0 3 0 11 35 0 1 0 35 22 10 3 0 0 3 21 28 0 0 22 0 0 16 27 0 21 
31 0 1 38 0 11 0 2 0 0 14 0 24 38 7 5 11 0 0 31 2 3 0 6 1 19 19 0 0 13 16 0 0 18 0 0 10 0 0 0 0 5 0 17 5 20 15 6 0 62 90 11 0 0 35 
