55 31
42 0 0 0 40 36 59 31 25 0 13 24 35 54 0 3 0 0 0 22 25 9 0 0 30 0 0 0 0 0 5 0 0 25 29 4 3 5 3 0 21 22 42 5 0 7 18 0 33 0 0 0 0 7 48 
17 19 33 11 0 2 43 0 8 0 23 0 7 24 0 0 0 0 0 11 19 18 0 2 25 0 3 25 0 0 0 31 22 39 0 0 0 26 32 10 12 0 0 0 0 4 0 7 25 68 10 8 52 44 31 
38 15 35 0 18 2 4 17 11 0 17 0 2 0 18 41 0 0 0 11 6 33 0 13 0 0 0 3 0 19 15 0 0 0 24 0 13 35 52 0 0 38 4 0 7 0 5 0 17 14 49 0 0 1 41 
41 7 20 11 47 2 0 20 9 0 0 44 44 0 23 21 0 0 0 0 0 26 2 15 23 18 7 26 8 0 9 22 6 3 0 24 37 0 0 4 0 0 0 46 26 14 6 26 0 4 50 47 25 0 0 
0 32 90 16 14 0 6 20 0 0 19 10 16 0 45 0 0 0 0 5 0 0 8 0 3 0 15 21 33 0 0 0 0 12 0 25 7 0 0 15 15 15 0 12 16 0 10 18 4 0 16 40 46 17 0 
65 36 50 26 37 19 6 18 9 11 33 0 47 33 0 23 8 2 9 24 24 12 33 23 35 0 0 3 0 37 26 0 22 17 21 23 3 37 31 2 6 29 41 60 18 8 43 0 2 11 0 0 69 45 1 
24 0 5 0 0 0 1 0 12 0 4 11 0 0 0 0 8 0 35 0 3 24 12 0 22 0 0 7 17 0 0 0 0 1 13 0 0 0 4 0 32 0 4 4 0 0 1 29 0 2 0 0 11 0 9 
14 42 96 70 0 28 46 32 8 18 40 14 0 2 0 30 41 0 0 3 0 33 21 19 3 3 0 33 0 0 11 12 0 1 17 12 0 23 11 61 0 39 40 42 11 19 1 12 0 12 0 20 131 0 77 
0 8 13 20 12 35 0 0 17 21 40 0 37 0 0 15 0 0 9 0 0 15 0 0 23 3 20 30 0 0 0 6 11 13 0 2 19 13 0 0 14 0 30 0 17 7 0 7 0 31 8 0 48 0 7 
3 0 23 56 0 69 0 41 10 0 27 12 7 27 2 14 40 22 13 50 3 0 16 0 21 0 0 11 0 5 5 0 30 8 0 0 0 9 23 22 0 24 19 36 0 36 6 16 41 0 47 1 0 46 50 
2 58 3 2 67 2 0 42 0 0 0 0 6 8 0 10 0 0 35 0 8 12 0 0 0 3 0 0 0 0 0 4 9 0 16 0 0 1 0 38 0 8 11 4 0 0 0 29 0 34 2 0 2 3 50 
0 0 11 40 41 23 5 24 36 0 18 52 13 0 11 0 33 0 6 24 8 5 10 8 12 0 5 0 73 0 8 30 0 6 14 0 0 0 27 0 2 36 0 3 28 38 12 0 6 31 0 0 33 42 51 
10 10 0 0 17 6 0 0 0 0 12 0 14 11 0 11 2 2 0 2 4 0 0 20 16 12 0 13 0 14 0 1 0 17 17 0 0 4 0 0 13 0 0 12 0 0 0 0 1 0 17 14 0 0 0 
0 0 79 40 0 0 0 0 11 0 17 32 0 0 0 11 6 0 0 26 33 16 12 10 0 0 25 18 7 0 0 0 0 19 20 9 22 0 0 3 0 0 23 9 42 18 0 5 12 2 0 0 0 0 0 
10 11 0 2 3 2 47 0 0 9 4 0 33 35 12 5 0 0 0 16 4 0 0 0 0 0 0 13 25 0 2 27 0 0 0 0 0 9 29 0 0 2 0 0 0 32 7 0 16 7 0 8 0 33 3 
46 29 25 6 0 0 0 5 0 20 1 24 22 0 0 15 3 0 0 18 5 0 4 0 23 8 0 25 9 20 44 0 0 4 0 17 7 47 0 0 20 0 3 26 0 5 46 0 0 0 5 14 0 14 9 
42 0 12 13 0 23 0 0 30 0 8 30 8 7 0 6 13 23 2 0 18 29 0 0 0 0 0 0 23 0 0 0 0 13 0 8 15 0 0 3 23 32 29 0 0 0 0 0 5 25 42 15 0 32 0 
8 19 23 0 12 0 42 40 4 0 0 16 0 0 0 0 0 0 44 0 35 0 0 8 0 45 0 0 8 34 7 2 0 0 30 7 14 0 20 0 11 0 24 15 0 21 0 33 42 0 0 15 13 0 2 
0 49 40 0 65 6 0 7 32 16 0 25 37 0 33 0 8 0 13 15 6 8 13 0 2 1 14 18 7 39 0 11 0 3 8 0 0 35 2 0 48 34 0 12 0 34 0 38 25 3 59 0 0 8 50 
22 0 48 14 24 1 4 5 45 43 59 0 22 0 6 5 24 14 0 36 30 20 34 56 4 14 3 7 24 22 0 0 5 10 5 8 22 7 23 33 21 14 0 14 0 0 6 0 26 9 27 0 144 11 47 
0 0 80 0 70 11 0 17 0 0 4 9 11 30 0 41 6 0 30 3 2 1 6 3 0 13 0 0 0 0 9 12 6 22 7 33 15 21 49 9 7 0 0 33 0 0 31 0 0 0 17 6 0 15 36 
9 32 31 8 0 1 59 18 28 0 0 4 21 0 27 1 3 16 0 0 0 19 0 11 0 21 0 0 0 0 0 0 13 26 0 10 0 13 9 11 33 11 0 0 7 11 0 40 0 0 11 0 0 0 0 
30 0 22 0 41 0 12 43 24 7 31 18 8 36 0 24 0 0 2 29 17 0 18 0 0 0 15 0 0 18 35 0 24 0 0 0 0 0 0 29 26 10 38 0 1 38 0 40 34 36 0 0 0 0 1 
0 15 54 0 0 19 0 0 0 0 52 26 14 22 0 22 38 34 13 0 7 4 5 18 16 8 30 23 0 0 0 8 6 21 0 0 4 14 7 0 0 0 0 0 0 13 0 10 6 0 19 8 47 0 2 
54 0 15 34 4 2 0 21 0 0 10 0 6 0 30 0 17 15 0 5 0 31 0 11 0 0 0 0 6 14 0 0 0 1 3 0 30 8 6 19 13 0 67 0 36 0 17 0 0 0 0 0 31 24 54 
0 44 5 0 0 0 18 0 0 5 0 0 0 0 13 0 0 0 21 15 41 0 16 0 0 0 0 15 0 7 12 0 0 0 21 0 0 5 18 21 0 0 12 0 10 27 17 0 10 0 23 0 0 0 14 
0 0 0 20 0 0 4 0 95 0 17 0 0 53 12 0 0 3 12 17 0 0 5 11 7 12 12 17 15 0 0 16 7 0 28 0 13 16 0 0 15 5 4 0 17 19 9 55 0 6 0 38 0 0 30 
37 25 8 0 27 3 0 29 0 9 10 0 0 4 17 0 12 0 22 0 9 0 52 0 26 0 2 0 0 2 22 19 9 0 2 0 19 37 7 17 9 15 12 0 6 13 2 0 2 9 28 10 0 0 0 
0 14 12 2 31 0 0 0 0 0 0 38 2 0 32 27 35 0 22 13 1 32 4 18 26 0 20 0 17 0 1 15 0 12 0 31 0 16 30 1 16 11 46 0 3 21 58 7 34 61 15 13 0 5 7 
46 5 0 5 32 7 0 21 0 21 22 0 12 7 0 0 33 16 0 0 12 21 0 0 0 0 24 0 29 0 0 11 0 15 1 0 0 16 15 24 0 8 27 0 0 6 37 20 28 29 0 0 4 65 2 
4 40 30 4 0 0 5 2 18 24 17 0 23 7 32 19 11 17 7 16 0 61 0 18 0 0 18 14 9 0 12 0 14 25 1 0 0 5 9 6 31 58 32 30 0 0 43 0 11 24 0 16 19 5 0 
