55 31
0 39 10 19 0 0 17 0 0 3 0 0 15 1 23 27 28 30 33 0 33 7 19 0 11 3 0 0 12 0 7 21 12 0 21 0 24 3 0 5 39 0 13 0 0 33 44 27 0 12 13 6 21 0 0 
0 2 12 38 78 38 0 0 16 3 34 19 3 10 48 18 38 0 14 0 0 13 18 69 8 24 4 21 20 0 21 43 17 10 20 0 8 12 0 36 51 0 0 10 40 0 2 5 45 28 8 46 13 65 7 
16 0 21 0 0 0 0 32 25 17 13 0 0 17 32 41 69 44 2 6 0 17 9 7 5 0 10 0 0 5 32 9 25 25 0 0 19 25 18 25 0 0 0 36 27 0 0 0 11 23 0 0 36 0 0 
0 0 0 2 34 16 27 33 27 0 0 0 16 0 0 23 14 0 18 7 0 16 13 28 0 0 28 0 0 23 0 11 10 7 41 27 0 0 1 0 9 0 0 1 0 0 0 36 33 8 1 24 3 24 23 
0 31 0 0 9 0 24 0 26 43 0 21 28 10 0 14 0 13 25 0 6 18 11 14 0 0 21 0 0 14 6 11 54 35 26 7 0 14 32 0 38 0 7 22 0 8 26 20 1 0 0 38 39 0 0 
18 8 0 0 19 0 46 0 31 33 0 23 19 10 20 32 0 20 0 0 33 0 0 13 0 0 7 5 25 0 0 0 0 0 0 23 0 18 10 25 5 18 0 15 26 4 0 32 8 0 34 0 68 47 0 
0 5 4 13 0 0 79 33 0 2 14 32 0 0 32 4 68 11 0 0 18 13 0 14 10 0 0 0 0 0 6 0 3 0 12 8 15 7 0 22 35 2 0 38 0 36 21 24 7 0 43 0 0 0 0 
0 0 6 59 0 23 0 0 0 24 0 21 0 0 0 0 0 1 4 0 5 48 0 21 0 5 0 0 23 0 0 28 0 24 12 0 0 2 5 0 0 26 0 3 44 0 4 0 4 20 3 0 0 0 16 
40 70 7 13 2 0 0 24 110 6 0 0 8 0 0 6 13 0 33 39 12 22 13 18 4 0 0 8 39 19 0 24 24 0 9 3 0 14 30 12 16 22 0 4 14 26 0 17 20 21 0 49 7 104 3 
3 0 0 0 0 8 0 0 8 0 41 48 18 35 0 0 21 0 0 8 21 26 29 0 0 0 0 0 16 5 23 0 23 0 0 0 0 0 0 0 0 21 0 0 23 3 0 0 32 2 8 105 2 0 1 
0 42 0 0 39 27 9 45 5 4 18 0 0 0 37 13 10 5 0 0 0 21 23 0 0 9 0 13 18 23 8 4 3 0 10 0 0 0 0 0 15 0 21 34 19 0 44 15 5 0 18 24 22 0 2 
3 37 0 19 17 0 10 53 0 0 3 0 0 56 0 0 8 0 0 0 7 0 0 0 11 17 0 0 2 0 10 0 0 0 0 11 23 0 40 21 10 13 16 0 32 6 0 0 4 36 0 15 0 10 0 
3 0 6 29 5 46 24 0 8 0 0 0 14 9 5 11 0 15 26 6 5 0 0 0 0 0 12 23 12 0 0 0 12 9 16 0 0 0 3 0 11 3 0 6 0 39 0 0 0 22 47 0 15 48 0 
41 0 40 42 3 0 0 36 0 0 51 2 40 2 0 0 0 28 0 0 0 0 17 0 0 0 0 0 18 25 23 0 4 0 14 16 0 5 9 17 4 41 53 36 34 23 0 0 14 20 0 13 40 23 14 
0 0 50 0 13 49 0 39 0 0 14 18 28 19 0 0 33 15 0 0 0 13 0 0 0 0 0 0 0 23 28 1 30 20 0 25 8 0 0 0 9 4 0 11 14 33 39 45 18 42 0 0 17 0 47 
34 57 4 23 28 0 43 0 20 0 0 11 1 11 0 60 0 0 0 18 0 6 8 38 0 0 0 14 0 10 18 39 1 0 12 0 0 0 0 3 57 0 2 23 11 9 12 32 32 0 0 0 10 47 0 
0 0 5 0 0 2 0 0 0 7 37 9 2 11 2 0 13 21 2 0 12 0 13 0 6 16 0 0 0 47 21 38 0 0 0 0 0 14 21 5 0 14 9 12 0 5 0 37 0 12 16 12 0 3 14 
38 4 71 0 0 18 24 2 8 0 4 0 0 0 16 0 1 17 10 0 22 0 0 23 0 10 5 7 3 17 0 19 0 5 16 25 35 14 15 7 67 10 23 8 16 13 0 8 0 0 48 0 29 0 1 
58 51 0 0 10 2 18 0 18 42 29 0 0 0 0 0 19 1 8 34 8 38 14 0 18 0 0 27 15 10 8 1 10 5 0 17 7 3 7 10 1 15 9 2 0 0 6 0 0 6 0 32 81 15 11 
0 52 5 20 0 0 0 27 47 0 8 0 24 0 2 1 7 30 0 0 28 74 10 20 8 0 3 0 0 7 21 0 0 0 10 18 3 0 0 0 18 3 0 3 7 0 0 12 0 28 0 23 1 44 0 
24 0 41 26 3 0 15 53 8 0 0 0 12 16 11 6 10 31 11 23 0 40 27 4 21 25 5 4 0 0 0 5 17 0 10 0 15 33 1 1 21 0 42 107 37 0 4 0 0 28 14 7 9 49 0 
0 42 27 14 20 0 44 0 28 45 30 0 23 3 0 0 2 14 11 0 0 18 0 0 43 24 0 0 0 0 0 4 0 9 9 19 4 3 10 0 106 4 7 36 7 3 22 40 0 28 0 0 0 3 75 
28 47 0 0 36 35 10 44 8 0 0 43 0 4 0 0 10 0 12 0 0 38 4 10 0 0 37 0 30 10 14 10 0 0 0 15 8 22 9 18 85 0 0 0 6 2 12 0 25 0 13 44 0 0 52 
15 26 2 0 0 5 3 45 0 47 30 0 0 0 22 30 37 7 16 0 0 4 0 0 0 0 0 38 0 20 5 0 0 6 16 0 13 0 0 6 0 2 29 16 2 8 0 0 0 17 0 4 87 77 16 
0 0 0 9 15 0 7 6 41 0 27 13 10 3 1 0 17 0 13 1 29 0 0 0 0 0 0 6 0 2 6 13 20 22 0 0 20 27 0 16 3 0 0 0 8 1 0 5 23 51 0 0 7 13 0 
0 0 9 33 46 0 19 36 4 23 0 9 0 0 3 23 3 28 4 2 0 43 31 0 2 57 2 0 33 0 0 33 0 0 19 32 0 25 20 19 24 3 0 27 17 29 15 19 0 46 25 0 45 49 0 
18 13 0 0 45 0 0 4 0 0 0 0 22 35 0 15 26 0 24 0 0 0 11 12 19 0 0 4 0 0 12 0 31 0 37 16 0 0 14 0 0 12 12 29 6 5 7 23 35 31 4 21 14 22 0 
72 0 0 40 0 0 27 37 8 2 6 0 40 7 0 52 26 24 0 37 0 24 0 30 25 0 0 3 6 0 3 0 4 0 20 17 10 18 4 11 27 3 16 42 9 26 4 22 9 20 55 37 69 76 14 
33 0 65 0 89 0 0 36 4 26 1 11 16 0 18 0 41 25 43 0 15 54 0 14 5 2 0 6 17 13 16 10 50 33 0 13 0 0 0 22 3 11 7 34 44 33 0 29 0 60 0 21 0 0 9 
0 40 33 12 8 0 23 0 0 18 37 7 0 0 0 1 0 0 0 0 16 0 0 0 0 20 1 17 0 13 0 10 0 2 3 51 16 17 25 2 7 40 12 1 19 28 0 56 17 0 0 30 37 0 17 
0 0 0 19 0 0 0 10 9 36 40 24 0 0 22 0 17 0 0 12 11 7 28 15 27 0 0 1 20 0 6 11 5 18 3 28 28 12 0 5 0 0 6 3 0 18 0 0 0 16 78 18 0 0 0 
