55 31
24 0 52 4 0 0 0 5 0 0 22 16 0 4 33 0 0 65 0 0 0 27 0 0 0 0 0 3 0 10 0 18 0 13 29 0 0 0 0 14 22 2 1 2 27 0 45 24 4 20 0 24 0 0 52 
13 7 0 3 7 0 0 0 7 17 14 5 58 0 30 0 0 0 0 15 33 0 4 49 0 0 59 22 17 0 0 0 2 6 15 12 16 0 0 0 20 0 1 27 30 7 0 27 0 26 16 0 7 58 28 
5 4 27 0 0 5 18 0 0 25 0 40 0 0 0 14 25 17 11 0 6 0 0 14 18 19 0 27 0 2 0 11 0 0 10 0 25 14 20 16 5 25 19 27 21 5 10 0 0 0 0 11 37 0 27 
5 56 18 33 15 0 0 0 56 0 0 20 23 0 0 0 10 0 0 6 25 0 0 3 23 17 3 25 0 0 37 0 0 22 33 0 0 3 0 9 24 26 20 0 0 0 10 0 46 0 0 11 44 14 0 
0 0 13 9 14 0 0 0 38 23 0 17 9 0 25 0 0 3 0 0 26 32 25 0 29 15 0 0 28 15 19 0 3 15 0 0 0 30 0 11 41 0 0 0 22 0 12 23 31 19 13 0 0 0 0 
19 53 0 56 27 0 65 20 60 21 12 2 44 2 26 25 0 0 0 0 13 0 18 4 7 0 23 8 0 57 20 27 8 10 0 12 9 0 22 0 8 4 12 0 0 0 37 75 0 0 11 16 37 31 34 
48 3 5 0 63 14 0 0 5 32 0 0 0 0 0 0 0 32 0 0 0 22 6 0 12 29 0 29 19 19 23 19 5 5 0 0 17 12 9 19 46 14 1 35 0 0 0 9 48 1 9 43 0 34 0 
7 1 51 0 0 19 0 0 1 10 0 16 8 9 2 15 12 35 6 0 21 0 7 12 16 17 21 0 10 16 2 0 0 6 0 0 0 0 15 0 16 28 1 0 42 0 0 0 0 0 8 0 74 31 0 
24 78 9 40 0 18 8 9 49 0 0 9 0 13 0 25 0 0 18 0 1 0 0 21 4 5 19 10 28 0 5 18 0 0 0 20 67 4 0 0 0 0 18 19 5 0 10 0 40 0 0 44 0 0 18 
0 0 53 3 0 1 80 0 17 0 0 0 0 39 0 12 0 0 17 0 0 0 10 0 0 36 0 9 0 0 17 0 0 1 0 4 0 21 32 50 0 0 14 0 0 9 4 0 0 24 0 0 24 29 0 
39 0 0 59 8 1 0 4 8 61 26 25 5 9 0 0 6 1 1 0 0 8 25 0 21 0 0 6 20 0 1 1 0 5 0 12 1 16 0 0 19 70 16 0 2 0 3 0 0 21 0 10 0 0 54 
21 2 131 17 0 27 9 37 0 23 6 0 0 0 9 38 7 3 0 0 30 0 0 0 15 16 2 0 17 4 7 20 0 8 20 14 0 28 0 0 0 0 52 0 4 9 0 33 42 42 8 0 0 4 8 
4 0 55 80 0 37 45 0 22 0 1 40 8 0 5 4 27 0 0 2 0 15 18 16 0 30 11 0 6 4 0 0 1 1 0 9 35 8 0 36 0 0 20 3 9 8 24 0 11 33 47 97 6 51 10 
16 0 3 0 0 14 5 29 0 0 14 0 0 0 7 51 11 45 19 9 0 14 22 0 15 0 35 14 2 0 16 20 14 13 0 17 21 15 23 0 22 8 0 11 32 8 24 2 0 22 33 3 15 50 11 
52 0 24 5 28 0 0 0 4 7 0 33 9 35 0 0 0 18 0 9 0 6 32 0 2 0 7 0 0 12 0 4 28 20 0 4 9 0 9 4 27 11 5 0 0 0 0 4 10 4 39 13 59 0 0 
0 0 49 35 0 42 5 23 0 0 14 19 20 18 36 0 9 0 6 24 23 0 0 0 0 5 3 4 20 2 4 19 2 0 2 0 0 12 31 12 0 0 15 58 0 32 0 47 6 0 48 49 5 0 8 
18 43 1 14 0 24 8 0 8 9 6 0 20 0 0 7 0 0 3 0 0 10 4 0 11 0 26 0 3 16 0 0 0 3 0 0 14 0 9 0 10 0 0 0 43 0 0 9 0 0 12 3 6 0 0 
81 19 37 0 0 23 0 2 0 5 30 16 35 3 5 18 0 10 0 0 1 0 1 1 4 51 0 6 0 11 0 24 0 37 0 17 28 23 15 12 0 60 8 12 8 9 36 0 0 24 45 7 86 39 2 
31 9 30 0 14 12 13 1 32 13 0 11 3 7 8 9 16 0 12 4 0 12 21 18 13 0 26 10 0 0 20 9 16 42 0 2 0 0 12 0 32 8 0 11 0 31 0 14 14 12 0 0 0 0 0 
19 0 0 52 15 35 0 21 0 0 14 1 29 10 0 19 5 0 0 14 2 15 22 22 0 0 15 0 4 0 5 0 0 35 19 0 26 14 25 0 17 59 0 6 5 8 0 3 2 6 60 0 14 30 8 
7 0 0 2 0 62 25 46 67 0 9 8 19 0 32 0 19 3 15 13 12 6 26 0 0 18 8 7 0 19 0 98 0 0 10 19 3 0 30 6 0 10 0 0 0 1 28 0 16 35 0 0 21 55 0 
33 8 0 25 0 0 0 0 28 8 42 36 11 7 0 22 0 0 6 0 0 0 7 11 28 59 0 0 26 29 0 23 20 30 0 0 0 22 0 11 0 24 0 0 6 11 5 46 0 0 9 0 32 0 26 
9 0 15 6 39 37 23 36 32 4 50 5 1 0 0 9 7 0 0 0 0 0 0 0 27 15 0 30 0 4 0 0 17 0 27 12 9 0 0 0 21 0 14 37 0 0 0 0 21 0 0 27 16 0 10 
12 0 0 25 0 0 14 0 0 0 4 31 8 43 0 0 0 0 0 0 0 0 9 10 4 0 0 19 29 0 0 0 0 6 3 6 0 0 9 1 4 5 63 8 0 0 34 12 23 0 4 0 11 6 0 
75 19 0 8 11 13 0 7 14 14 0 0 0 0 0 11 0 35 15 40 19 15 0 3 0 17 0 0 0 17 5 0 0 6 0 8 1 9 34 63 5 3 14 26 39 3 10 24 0 16 0 19 50 1 13 
15 0 25 0 0 0 0 68 24 15 36 0 13 9 14 0 0 9 0 0 2 0 9 30 8 13 12 0 0 20 20 33 0 25 0 34 0 0 1 19 0 0 0 41 5 0 2 60 0 5 4 3 0 29 50 
35 15 1 0 25 26 0 0 31 0 9 0 5 15 24 15 36 63 37 1 4 0 0 0 41 9 16 0 15 0 19 2 2 0 0 10 21 16 21 32 20 13 5 2 22 6 12 0 24 21 0 0 12 4 28 
0 7 8 27 41 0 0 9 25 7 40 0 0 17 0 47 28 0 0 0 0 14 18 4 0 0 19 11 0 2 10 9 0 25 0 0 0 12 3 12 4 0 0 0 34 41 2 22 0 39 0 41 0 17 1 
23 0 39 8 2 74 15 0 25 10 7 10 9 7 0 26 25 8 0 6 39 1 5 11 2 0 10 36 0 1 25 7 16 0 0 11 0 16 6 38 13 30 0 31 0 9 11 46 0 5 2 0 32 10 62 
32 0 61 26 9 0 0 28 39 0 68 59 6 2 0 0 0 0 0 0 0 0 15 39 13 0 13 0 17 9 16 0 35 6 22 20 42 0 0 13 16 37 0 59 0 14 0 39 43 23 40 0 50 42 1 
25 0 32 0 0 44 0 8 20 1 1 0 0 29 10 11 11 2 0 0 5 0 14 24 20 0 2 0 6 12 1 0 0 0 32 0 29 47 26 34 23 0 18 3 0 0 0 24 15 20 2 0 18 0 23 
