55 31
16 0 0 0 49 0 27 35 0 28 7 21 9 0 30 33 69 0 20 16 32 18 31 12 0 6 12 27 5 4 0 13 0 8 0 3 10 53 29 29 0 0 13 27 9 5 23 0 0 46 0 0 58 81 3 
0 0 28 35 24 6 0 27 0 22 0 0 31 0 1 0 0 0 0 15 18 0 0 0 42 5 0 0 0 15 67 25 0 0 15 0 0 39 39 14 0 0 7 24 5 0 14 0 0 26 0 0 42 0 24 
17 0 49 30 0 7 41 0 8 36 6 0 7 0 0 0 0 23 39 17 0 0 0 14 13 8 0 26 22 0 0 25 15 0 0 10 0 14 0 0 21 21 11 25 7 26 0 26 28 38 33 45 0 15 3 
0 29 31 0 87 29 0 42 37 0 45 17 14 2 9 21 41 31 0 0 18 8 1 61 21 0 1 0 33 3 0 0 0 9 14 8 12 27 4 6 0 0 0 29 37 4 0 31 29 45 0 0 29 1 32 
48 4 37 21 9 12 40 21 8 0 0 26 29 15 0 0 19 19 18 0 18 5 40 9 14 2 20 11 15 1 23 7 35 0 34 10 0 17 18 0 25 24 17 11 2 0 29 0 26 0 0 28 46 8 3 
7 0 0 5 43 37 0 11 11 0 27 0 39 0 33 0 15 0 12 0 0 6 29 48 0 0 0 2 0 0 2 1 0 0 0 27 0 27 0 0 0 0 39 0 16 0 4 73 25 11 0 69 0 0 0 
0 38 0 17 58 14 0 0 0 0 19 1 3 0 19 5 0 0 5 0 17 20 0 5 0 0 0 0 0 45 5 12 28 0 0 14 6 0 2 6 11 0 33 0 0 18 0 43 0 0 0 22 6 0 0 
0 75 0 0 0 23 2 13 5 0 0 32 6 0 30 0 0 21 0 14 0 14 0 0 11 0 0 10 0 0 0 17 0 8 38 16 7 0 17 14 0 5 37 0 40 26 59 0 32 7 0 0 0 19 1 
0 5 0 0 3 4 0 56 0 16 18 27 0 21 6 7 0 29 8 8 0 0 0 0 20 0 19 23 18 0 0 33 0 0 1 0 0 23 20 24 0 42 18 24 44 1 27 3 0 7 0 10 21 5 18 
7 28 0 84 0 15 0 1 0 10 2 33 8 0 0 0 0 0 13 3 0 0 0 0 0 4 0 0 0 12 0 26 20 20 26 0 16 0 9 6 11 2 0 0 45 1 0 9 4 0 7 4 0 50 0 
17 1 1 40 1 0 16 32 36 0 0 0 3 2 0 2 0 0 19 1 60 22 16 0 24 0 1 1 16 0 11 0 0 12 8 0 0 19 0 35 6 41 7 17 14 1 15 0 0 13 0 11 0 0 34 
0 6 48 33 18 2 0 23 6 19 0 3 0 7 26 5 0 26 0 0 7 28 48 22 10 15 0 0 0 43 6 0 8 0 0 5 4 17 1 0 0 33 10 0 16 10 10 0 0 46 6 43 0 8 15 
3 0 0 8 0 0 5 0 0 0 10 12 26 0 14 5 0 0 19 7 20 8 23 0 0 0 34 0 4 9 24 0 5 0 7 10 0 16 7 2 0 7 0 0 7 0 0 0 13 18 0 7 23 42 24 
31 0 23 31 2 0 89 0 0 0 30 23 4 0 2 0 5 0 0 0 7 19 0 0 0 1 27 4 3 23 2 45 0 0 45 32 13 13 17 7 0 10 28 6 0 21 0 13 0 18 47 0 0 20 16 
7 0 0 12 21 0 36 34 0 0 16 0 4 4 16 0 35 0 0 25 23 0 0 0 0 24 0 0 8 4 4 5 20 0 0 0 0 0 1 0 0 18 0 48 6 0 37 0 0 0 0 40 24 10 9 
32 40 0 0 12 2 67 44 5 0 0 32 0 14 0 21 0 0 23 4 0 10 17 0 6 0 20 14 18 18 26 0 46 0 0 9 31 0 4 0 13 29 0 50 0 16 16 0 0 0 14 44 4 42 20 
26 2 38 7 0 24 47 31 0 0 0 10 8 0 14 0 3 0 16 26 4 0 7 35 5 8 9 3 0 39 3 3 0 23 4 0 5 29 30 3 38 5 0 1 28 18 0 16 15 3 6 0 0 11 0 
15 36 34 34 0 10 0 0 0 8 0 26 15 0 0 56 0 8 0 0 5 13 4 28 12 13 5 22 0 17 0 8 34 6 1 11 22 35 0 0 11 0 0 5 22 23 9 34 4 34 0 28 0 8 27 
2 19 2 0 1 5 44 0 0 8 0 0 0 4 0 0 0 0 0 0 0 0 14 0 0 25 0 0 0 0 0 0 0 4 0 6 0 1 10 1 0 0 0 10 0 0 4 14 0 0 57 0 0 2 0 
0 0 15 30 18 13 0 7 6 0 0 43 0 32 2 37 0 9 33 15 27 24 97 12 12 35 4 0 4 6 0 0 10 0 0 13 0 32 8 26 11 0 0 10 0 4 41 18 26 12 45 33 19 10 24 
0 0 0 18 12 39 43 0 35 0 4 21 31 0 0 0 12 0 4 3 26 10 20 7 0 0 8 0 5 16 21 0 13 17 4 0 0 5 26 0 0 0 24 2 0 0 26 0 0 43 0 9 0 7 0 
7 0 40 1 1 0 0 0 16 5 17 0 3 1 0 0 23 0 0 9 0 0 9 0 24 42 6 12 0 0 18 0 16 0 13 21 26 2 0 53 0 0 47 19 16 14 0 8 11 0 0 35 0 9 29 
12 0 0 20 0 37 0 0 0 0 0 8 7 0 2 0 2 0 0 14 0 30 0 0 21 0 0 9 0 0 0 16 0 0 0 9 0 4 13 0 0 3 7 2 27 25 4 3 0 0 6 28 0 14 0 
0 40 19 36 18 12 19 0 0 22 0 30 0 26 26 21 19 31 16 0 8 0 11 0 0 0 0 0 12 40 0 2 0 30 13 16 7 0 0 10 26 49 0 1 7 0 23 0 9 21 0 0 0 0 24 
3 128 0 56 4 35 0 0 0 18 13 0 37 0 31 0 0 12 36 0 0 0 18 0 18 24 0 3 0 6 0 7 0 29 0 6 0 0 5 8 27 5 2 49 0 13 0 6 0 66 47 2 0 1 81 
0 36 0 0 76 0 0 0 83 0 10 0 27 29 19 17 0 31 0 1 0 0 13 0 0 5 27 0 3 0 0 3 2 5 0 18 0 52 0 27 0 19 5 2 40 12 5 4 7 32 42 2 0 10 24 
24 18 83 7 5 0 30 61 0 19 20 0 26 0 12 22 0 0 6 24 0 16 0 14 43 20 14 0 18 15 0 25 0 0 1 0 4 10 0 7 0 42 2 12 10 27 19 0 0 0 26 93 0 8 5 
3 21 0 20 12 16 0 0 0 6 0 0 7 16 0 0 20 1 66 0 0 20 0 22 0 8 14 13 7 19 0 25 17 0 9 2 20 19 1 4 7 0 0 42 0 0 0 10 0 0 0 0 0 35 27 
40 0 0 4 43 0 0 6 21 20 43 9 2 0 0 0 0 17 34 0 22 4 16 0 0 1 27 20 19 21 1 21 0 16 18 16 16 16 55 12 106 37 20 52 0 18 16 9 39 19 0 40 42 17 0 
0 1 81 62 0 39 14 0 0 0 0 16 70 10 50 0 22 14 12 5 0 15 0 0 0 25 0 24 0 9 18 6 12 0 16 43 15 34 13 0 30 0 0 0 39 81 0 35 14 47 0 19 0 1 0 
0 0 24 11 9 0 32 0 0 53 0 34 43 0 39 8 20 0 19 10 2 4 14 36 0 6 42 5 0 10 16 0 50 0 0 0 20 10 29 0 13 16 0 34 18 1 5 0 28 18 12 28 0 80 0 
