55 31
7 0 41 4 0 38 0 20 0 4 12 0 31 0 0 0 0 3 27 0 10 0 0 29 0 28 0 0 0 0 0 0 0 0 0 15 28 0 12 0 0 0 20 18 25 27 17 11 0 30 15 26 4 0 42 
0 0 5 11 29 21 0 1 5 16 0 38 41 9 19 0 33 0 0 3 12 24 18 0 11 20 21 0 2 0 0 0 25 39 4 13 0 0 26 0 16 41 20 15 36 0 3 13 52 27 0 55 8 41 24 
15 0 14 0 37 0 27 36 0 9 29 17 0 0 0 14 0 0 0 10 0 22 29 0 0 3 3 0 2 22 28 0 0 2 0 0 0 0 10 0 12 0 0 47 0 60 3 0 3 18 0 26 0 22 32 
4 0 19 3 0 0 47 11 0 2 1 9 0 0 15 12 21 27 18 0 18 3 0 0 8 23 19 4 2 14 5 0 9 0 0 12 45 27 0 20 0 0 3 22 6 7 14 39 10 0 0 15 0 61 0 
13 0 0 53 4 48 4 0 58 2 4 12 25 3 0 15 0 0 23 54 5 16 0 16 0 0 6 13 5 0 22 9 1 2 2 3 31 107 12 23 0 23 7 8 0 26 14 13 0 7 23 7 10 34 49 
3 21 0 8 27 18 0 0 0 2 0 11 0 33 11 0 35 0 14 0 21 0 50 0 0 17 0 13 13 0 0 0 21 18 11 0 0 0 11 0 0 10 38 0 0 0 48 4 0 4 25 20 24 0 4 
4 0 36 62 2 0 26 16 0 0 0 0 31 6 0 18 2 8 1 9 22 7 2 16 25 8 22 9 5 0 7 5 26 6 0 16 5 1 8 17 0 3 0 5 7 0 21 17 44 12 34 27 0 12 31 
76 17 42 4 0 0 20 36 0 39 0 34 0 64 0 9 0 0 0 0 17 21 0 0 1 0 20 2 0 5 0 0 0 0 3 0 20 23 5 0 0 0 18 4 9 0 4 0 56 10 37 1 52 10 14 
74 28 0 1 38 25 16 7 5 0 0 13 29 19 0 32 0 6 6 34 0 0 34 12 11 16 3 12 24 8 52 13 12 8 19 0 0 15 1 9 0 5 18 3 7 9 28 0 48 19 0 0 23 13 13 
0 1 24 0 0 42 20 0 0 0 0 0 0 0 13 17 4 0 4 2 1 0 40 1 1 0 26 20 27 1 6 3 2 6 0 6 0 0 11 31 0 14 4 8 6 0 20 0 2 0 0 9 27 14 6 
11 0 7 20 0 0 38 2 19 2 0 7 38 0 0 3 0 12 19 0 0 25 0 63 1 0 0 0 0 43 0 0 0 0 11 0 0 0 0 0 0 9 13 0 59 2 25 0 14 4 38 0 0 0 0 
79 121 5 0 0 40 2 0 0 13 35 5 19 32 5 6 9 0 0 4 0 0 4 17 20 8 21 23 9 2 18 0 0 13 3 0 23 6 38 0 22 9 33 7 0 63 3 10 0 22 31 57 33 0 0 
0 0 0 27 0 33 8 0 4 15 12 0 18 6 0 5 0 0 0 0 0 0 0 0 19 0 0 9 0 0 49 3 0 0 0 11 0 7 39 0 0 13 0 22 10 0 16 0 0 0 0 0 0 0 11 
44 0 20 0 38 0 30 29 10 9 36 25 0 25 16 0 7 0 6 21 53 7 0 0 0 0 22 0 8 6 4 1 11 0 0 43 47 0 25 12 38 0 0 24 0 16 41 0 4 0 4 17 9 33 0 
0 13 8 0 38 0 0 40 0 30 0 0 16 0 5 26 11 0 0 0 15 14 8 21 14 0 1 1 0 14 1 5 13 4 3 1 0 0 4 30 16 21 65 0 20 2 16 38 17 0 8 0 4 0 0 
0 36 0 2 37 24 11 0 0 0 25 0 0 22 0 0 0 14 0 0 0 0 0 0 0 0 0 8 0 0 1 27 7 0 14 53 0 33 0 0 0 37 6 0 7 0 0 0 6 10 0 10 0 0 0 
0 0 40 0 6 0 0 0 0 12 0 43 42 7 15 8 2 6 0 0 11 0 0 6 10 2 0 13 11 0 4 11 7 2 0 0 22 0 0 0 0 0 0 1 0 31 13 4 0 3 9 13 0 0 56 
3 0 81 14 0 0 47 0 32 73 0 0 0 2 18 19 0 36 16 0 4 0 20 0 7 0 11 6 0 23 20 18 1 20 3 0 14 0 17 9 26 0 0 0 1 36 37 24 50 20 14 0 19 42 0 
29 0 14 33 0 37 27 0 0 0 54 0 0 25 35 3 14 0 0 23 1 0 0 0 19 4 0 3 11 25 8 6 21 15 1 4 17 3 58 9 0 11 15 7 41 24 32 0 29 0 31 0 34 16 40 
5 4 21 0 12 26 0 0 29 0 0 17 0 0 68 0 33 1 0 21 31 32 21 30 0 0 2 0 0 10 1 12 9 13 0 30 0 29 7 0 0 2 16 21 24 0 0 0 0 29 12 0 0 3 23 
9 0 0 49 25 0 8 52 0 19 22 0 0 13 13 0 0 0 11 0 7 0 6 26 0 6 18 0 10 5 0 8 22 3 8 4 20 5 0 4 11 25 47 0 18 0 0 0 19 8 1 4 15 0 12 
0 0 29 0 43 35 14 0 6 114 10 0 0 0 39 32 2 0 16 14 2 4 0 0 1 26 46 0 0 18 6 17 0 6 17 8 27 21 0 6 0 1 49 16 29 0 4 18 1 35 0 42 22 0 67 
25 7 23 0 0 8 0 16 0 0 32 0 17 6 0 0 0 11 24 9 16 0 0 0 14 15 0 0 20 0 0 0 2 0 0 0 0 2 13 26 0 1 6 0 32 20 0 18 29 16 3 0 9 7 42 
0 0 21 0 0 21 20 0 0 0 0 40 0 0 36 24 10 4 0 18 0 0 0 12 0 10 15 8 0 14 9 0 0 0 0 21 0 15 33 13 6 0 0 15 0 13 29 17 9 1 36 40 26 19 5 
5 17 0 34 28 15 0 4 0 0 6 1 37 0 21 28 1 8 0 0 11 0 5 0 0 0 19 5 13 22 0 0 11 1 23 21 9 34 9 0 0 13 0 0 0 25 0 11 33 45 6 22 0 22 0 
10 0 0 28 13 16 0 21 0 0 10 0 7 0 28 0 14 13 0 7 0 24 0 0 0 25 15 0 1 0 0 0 0 8 2 12 0 0 0 0 16 28 46 0 0 0 0 12 16 9 47 0 4 0 0 
6 0 12 8 0 0 15 31 41 0 13 0 0 0 5 51 37 0 0 0 5 0 6 24 5 6 6 0 0 6 0 0 14 5 0 0 0 7 49 0 0 4 23 25 0 16 3 0 5 34 0 43 0 7 20 
40 34 0 0 50 0 0 0 2 51 16 3 0 0 0 18 0 0 0 23 0 0 0 44 6 19 0 3 22 0 3 19 5 0 17 0 7 0 26 12 50 19 24 0 19 36 0 1 42 30 22 0 24 0 81 
17 21 12 0 0 25 8 0 39 14 0 51 0 37 1 4 0 0 0 0 30 0 21 0 0 0 9 4 0 3 21 20 22 0 0 18 0 0 5 0 0 0 0 43 16 36 6 39 16 0 38 26 0 18 0 
47 7 48 0 6 19 27 30 66 0 0 35 7 0 38 0 16 23 0 7 28 8 16 13 0 3 26 0 3 17 7 0 25 20 0 0 13 1 2 7 0 2 28 0 0 37 107 0 51 9 25 84 3 7 15 
4 0 0 0 45 8 35 0 2 29 0 29 30 34 10 13 0 36 29 2 0 0 21 4 7 13 10 0 19 2 28 33 0 29 9 29 0 44 22 20 0 0 18 0 0 26 70 34 1 54 0 0 0 21 1 
