55 31
0 0 21 14 29 0 38 0 32 3 54 27 0 30 0 0 26 19 30 0 0 0 0 0 0 0 0 0 20 22 14 21 42 11 13 0 14 0 16 0 32 0 9 14 0 0 0 0 68 19 3 15 0 0 0 
44 2 10 71 39 44 30 0 2 36 0 0 64 7 12 11 31 11 22 14 8 19 30 10 12 0 6 15 3 8 0 3 0 2 6 23 23 37 0 27 2 0 5 82 41 19 23 76 95 96 19 2 0 5 0 
1 40 0 2 0 13 12 0 41 25 22 19 0 12 37 0 0 0 33 24 0 0 23 1 34 25 20 21 0 6 0 0 5 56 0 18 60 0 37 33 0 0 0 24 2 0 35 0 0 58 22 0 17 0 0 
0 2 0 49 0 0 44 0 2 5 6 0 0 14 1 10 0 36 13 0 0 16 0 0 0 22 16 0 6 0 9 0 0 17 17 0 18 0 0 10 30 9 0 23 0 0 10 0 0 0 53 0 0 36 0 
44 0 0 0 25 0 0 0 25 0 16 42 0 0 0 0 0 0 21 0 19 9 0 0 24 0 21 0 0 0 15 22 0 35 0 25 15 13 0 0 0 23 0 15 26 0 0 0 3 0 4 15 27 64 0 
0 2 13 33 0 39 0 0 0 0 0 39 24 0 0 25 23 0 16 25 22 0 10 14 3 1 5 0 23 9 37 5 27 0 0 0 54 0 9 0 0 0 12 0 64 13 1 1 0 0 41 28 2 22 0 
35 6 92 0 0 15 0 6 16 20 0 0 0 27 1 31 11 0 0 16 0 19 0 23 0 1 23 6 12 14 1 6 2 6 1 5 0 37 0 28 0 2 0 0 0 17 44 47 0 8 13 14 2 0 52 
0 26 0 49 42 0 45 3 0 8 11 0 39 3 35 0 3 0 1 5 39 2 0 11 18 3 11 37 8 48 7 13 11 2 21 0 15 34 5 13 0 14 0 22 0 9 0 0 3 35 12 74 13 9 20 
8 0 57 5 4 0 32 22 0 18 28 0 9 43 20 25 6 0 7 20 12 12 27 14 0 0 8 8 0 22 0 13 14 4 20 0 12 9 0 30 9 0 2 34 20 0 95 7 28 30 6 22 0 0 0 
4 19 22 0 2 45 0 0 34 8 36 32 4 0 23 4 16 48 19 0 21 0 21 25 0 25 26 47 9 10 0 0 19 0 5 0 20 47 0 39 6 21 41 11 0 3 26 66 8 0 41 3 0 1 0 
0 0 0 0 0 0 4 34 34 0 17 0 0 39 16 8 0 0 0 17 24 0 17 12 0 6 4 0 11 22 19 9 0 11 18 0 13 18 16 14 16 0 71 0 8 11 26 0 0 4 0 0 29 0 0 
0 70 33 8 0 0 0 0 0 0 0 0 0 23 0 0 0 0 4 0 0 0 31 0 11 0 0 0 4 0 0 1 0 11 0 38 8 0 0 0 0 28 0 13 0 0 1 19 11 0 0 0 0 29 53 
19 12 22 2 0 0 37 9 31 8 5 43 2 10 1 9 10 27 0 19 47 27 0 0 39 6 0 4 0 47 0 4 11 24 0 19 0 0 0 41 0 0 0 7 24 0 0 0 38 22 26 36 0 24 43 
17 18 8 6 26 0 12 0 45 0 44 42 3 15 1 21 58 16 13 0 0 0 0 0 0 0 13 22 0 0 17 45 0 0 8 0 15 31 0 2 3 5 0 28 0 15 0 0 12 60 1 1 41 92 38 
10 0 22 0 0 22 0 10 15 10 0 0 33 2 0 2 5 0 1 4 4 5 0 0 13 0 0 26 26 0 11 0 20 12 0 0 9 4 20 0 1 0 0 24 0 0 0 0 0 18 42 0 0 0 0 
42 0 41 3 0 13 5 7 0 9 29 29 0 0 7 14 0 0 36 20 0 10 3 0 14 0 8 0 6 0 0 2 9 0 6 0 0 18 0 0 28 9 47 41 9 0 0 0 0 0 32 0 9 9 36 
68 7 36 16 0 18 0 3 10 0 37 3 0 7 0 0 0 26 23 0 4 17 0 30 6 8 12 7 0 8 0 0 32 10 7 0 28 0 35 0 0 0 22 29 8 0 5 21 0 39 10 5 0 9 0 
0 49 0 0 0 15 12 24 0 0 12 18 9 0 15 5 0 0 9 12 16 0 0 0 7 0 0 0 0 33 0 24 1 0 10 28 16 20 9 0 4 28 11 0 38 0 5 7 13 0 59 87 42 13 0 
33 44 50 3 0 0 6 0 0 56 9 0 0 40 0 32 0 0 9 0 0 0 0 0 12 2 0 0 0 40 0 33 6 30 0 33 12 27 25 0 0 0 8 14 0 44 22 32 48 0 17 0 0 22 45 
0 0 0 13 0 0 11 7 0 9 0 0 0 8 2 3 50 13 3 6 9 16 0 52 0 18 15 6 10 10 0 0 4 0 18 0 8 0 0 14 0 18 10 15 0 0 0 0 0 52 12 1 48 4 0 
0 0 20 0 0 0 20 0 0 49 13 1 0 0 19 31 19 0 8 0 0 0 0 0 0 0 7 2 8 0 0 9 0 17 26 6 0 28 12 0 2 12 2 6 0 15 4 20 12 0 15 25 1 12 0 
27 39 46 48 48 29 21 0 19 0 0 82 10 0 0 38 13 0 29 0 1 8 6 13 0 30 1 46 1 7 0 34 0 30 24 1 25 1 0 1 41 14 9 0 8 11 0 0 0 20 0 26 72 0 10 
2 43 4 39 13 58 6 0 8 11 0 0 0 21 2 7 0 13 0 17 18 1 42 20 6 6 26 15 0 43 25 0 20 0 21 2 0 0 33 10 18 0 45 9 43 0 20 7 6 0 21 0 20 2 32 
57 15 22 0 0 0 0 0 16 19 0 0 23 0 0 34 15 0 0 5 35 0 0 56 6 6 13 8 0 16 10 0 0 0 0 10 0 0 0 13 0 0 42 34 0 18 6 0 25 20 0 0 36 8 0 
0 40 34 27 0 0 0 10 7 0 16 0 0 0 0 34 0 7 0 0 29 2 0 0 7 0 0 16 0 2 44 0 0 0 0 8 34 0 0 0 7 0 0 21 0 0 34 7 24 5 22 0 9 7 0 
16 0 0 0 3 36 36 3 42 0 19 0 0 7 0 4 16 0 0 13 29 26 16 0 3 3 21 2 3 0 0 0 25 0 0 0 0 18 0 15 0 36 21 0 0 25 0 0 24 0 42 0 25 0 15 
0 53 46 0 2 26 0 37 0 20 19 4 42 0 16 0 0 0 9 0 4 2 0 0 8 12 15 4 0 9 3 11 9 27 3 23 3 13 5 0 0 20 34 17 35 0 6 12 46 18 36 4 0 0 68 
0 28 0 33 2 0 2 0 4 65 10 43 13 0 26 0 0 0 20 0 42 0 0 17 25 8 0 16 3 29 0 11 0 1 0 12 13 16 8 0 18 1 17 0 0 0 20 21 0 37 27 0 3 6 14 
25 37 0 16 5 2 0 26 0 9 30 0 19 1 0 4 23 7 5 20 26 20 0 0 44 12 16 0 0 0 0 0 0 26 0 8 0 0 0 14 0 8 1 0 20 0 30 0 23 39 27 0 23 0 0 
1 0 8 60 30 3 34 2 56 4 15 26 22 11 6 103 10 17 0 26 17 60 65 7 13 10 44 16 18 0 0 7 16 18 47 8 20 26 16 36 0 17 0 0 0 39 45 20 90 31 30 43 40 0 0 
22 0 35 0 41 0 59 14 1 34 3 23 4 14 0 17 0 9 0 33 0 29 0 0 0 4 20 0 3 0 19 15 0 0 0 0 0 35 0 0 0 37 20 4 0 0 0 7 0 9 29 41 27 40 12 
