55 31
0 4 0 0 2 0 0 2 81 17 0 3 25 0 0 0 0 37 5 0 13 0 15 44 7 16 20 15 5 0 0 27 0 0 1 17 0 25 0 16 36 0 92 0 0 22 0 0 0 0 0 0 57 10 0 
26 15 0 23 0 3 0 7 25 0 44 6 21 0 0 32 6 3 30 21 35 0 15 22 20 0 24 9 0 9 10 0 0 29 0 0 3 2 0 0 8 0 6 23 20 0 6 37 0 20 13 0 6 0 25 
24 20 0 8 59 11 24 16 0 15 0 3 0 0 5 0 11 26 18 0 0 0 0 16 27 17 13 0 7 23 0 2 14 0 1 25 26 0 3 0 21 0 0 18 30 0 0 12 0 0 14 8 0 0 0 
0 24 0 0 33 44 15 37 2 0 0 5 8 24 45 29 0 0 18 0 34 19 0 0 19 13 0 0 0 2 0 0 17 8 0 0 0 103 0 0 0 31 0 9 4 0 0 0 0 52 45 7 7 0 31 
0 4 27 26 13 4 0 0 45 15 0 23 0 0 13 20 0 13 0 0 36 0 0 0 29 0 22 19 0 28 0 0 21 9 0 53 9 5 16 0 26 0 17 2 9 5 11 34 22 0 26 22 7 4 0 
0 49 0 6 0 0 0 13 36 46 0 0 35 52 0 13 0 4 36 0 0 7 7 24 6 50 0 19 6 0 20 22 0 0 0 25 1 0 3 0 5 0 0 0 36 25 79 0 9 23 0 28 6 23 42 
2 0 0 27 0 0 17 0 0 3 0 21 23 18 0 9 7 0 34 24 0 22 0 17 0 8 0 12 0 0 7 6 20 0 0 24 22 7 9 20 0 15 0 18 4 0 2 0 2 0 9 24 54 0 3 
60 46 14 12 0 2 6 2 0 0 0 23 0 0 0 17 13 0 0 0 17 0 0 8 1 1 0 0 0 6 7 0 2 23 0 20 4 0 0 19 1 17 0 0 8 0 54 61 21 0 8 29 0 0 54 
0 11 0 33 15 5 9 7 46 0 11 0 34 22 33 0 0 0 0 0 16 0 8 18 14 0 41 26 0 15 0 14 21 0 1 23 16 9 0 36 22 2 34 0 26 14 31 0 24 0 0 24 8 21 25 
38 4 0 3 23 0 83 41 40 37 0 0 19 15 0 34 0 24 10 9 15 0 0 24 6 0 0 24 7 14 21 22 0 0 0 0 44 0 38 0 8 19 36 21 0 39 0 56 41 0 23 24 2 0 0 
0 46 19 0 10 8 0 11 0 26 0 0 2 22 0 0 14 22 20 30 0 13 0 10 9 0 38 15 43 9 0 0 9 11 0 26 9 0 0 22 13 2 1 16 1 2 1 12 0 30 0 0 24 62 0 
0 0 0 2 63 3 0 4 3 0 27 0 40 0 0 0 9 0 16 0 23 0 2 15 2 9 5 20 8 0 0 16 0 33 8 0 45 27 0 0 0 0 0 18 16 0 0 44 0 13 6 0 0 20 19 
24 0 23 61 5 0 0 9 12 18 12 0 44 0 0 5 59 0 0 10 19 11 0 21 24 17 0 0 5 0 0 0 11 0 9 0 0 16 0 34 0 33 0 31 5 29 41 10 0 8 34 0 13 21 15 
19 52 30 25 38 20 6 0 1 0 32 14 72 0 0 26 14 1 8 0 0 10 22 13 0 7 15 18 0 14 1 0 30 17 0 9 12 5 0 0 0 52 39 31 42 8 45 3 12 23 0 0 13 73 0 
0 0 13 21 0 0 31 0 25 45 27 63 25 34 11 0 0 0 0 25 15 0 34 0 0 5 19 24 6 4 0 19 0 25 0 54 0 0 36 27 0 0 5 9 14 34 1 40 28 0 0 0 45 6 45 
0 0 0 21 2 4 7 0 0 4 0 0 9 0 1 2 0 8 6 0 0 0 29 0 18 1 1 0 0 0 0 1 29 15 4 8 0 14 14 0 16 0 0 0 3 1 1 0 0 2 0 30 0 29 0 
0 52 27 68 0 0 2 5 19 20 34 0 0 0 0 22 1 0 6 11 2 0 15 30 6 19 2 0 6 59 3 1 15 13 6 28 0 8 37 12 0 4 4 0 34 6 2 5 33 0 5 24 7 18 17 
42 0 29 3 37 24 8 0 0 16 1 0 0 6 0 0 1 0 0 16 7 0 0 0 0 5 12 13 5 44 5 39 0 8 18 0 0 9 16 0 2 22 42 0 0 2 6 7 0 22 14 10 6 49 16 
0 0 15 63 3 0 11 13 18 0 0 47 0 13 0 13 0 8 13 22 2 15 0 0 11 0 9 6 20 18 0 2 0 6 0 7 9 9 21 0 29 0 1 1 0 0 6 0 5 0 78 14 0 0 8 
46 57 4 45 1 0 23 0 0 36 27 0 2 30 19 7 0 21 10 0 0 12 52 6 9 63 20 0 1 3 11 0 24 10 0 1 39 16 0 21 0 9 25 72 8 0 24 0 1 14 0 4 27 0 11 
0 0 20 6 28 8 0 17 43 0 0 0 39 0 35 0 1 1 16 32 12 0 41 33 36 19 3 4 6 12 0 15 4 0 26 1 0 0 16 0 0 11 20 54 12 0 44 0 0 43 0 40 7 0 0 
2 47 23 8 18 29 0 0 37 19 0 37 55 16 0 59 0 16 14 56 2 7 18 0 9 0 0 18 0 0 29 15 0 0 29 0 0 0 39 0 11 0 0 7 32 45 3 0 36 0 31 25 0 17 16 
33 92 49 5 0 0 57 26 13 0 9 0 17 5 0 0 0 0 0 0 0 23 0 0 0 0 51 0 16 0 31 0 0 33 0 27 0 30 0 0 0 0 0 0 2 0 0 5 38 17 0 49 0 0 28 
0 51 0 5 3 21 0 46 80 1 0 0 39 5 4 13 0 23 2 4 25 0 4 0 29 37 8 7 25 0 16 3 23 0 10 0 37 2 20 13 20 32 17 14 7 38 16 25 0 10 16 40 51 42 15 
0 48 0 21 16 31 0 0 2 24 57 0 0 18 6 1 0 0 25 31 5 2 0 17 0 15 0 0 0 0 2 18 14 5 0 12 31 5 3 0 40 40 5 7 0 35 0 0 16 18 50 0 0 12 0 
28 0 2 1 0 5 0 0 21 44 0 6 78 4 0 22 27 6 37 6 1 13 11 7 12 6 0 0 28 0 20 0 30 8 35 0 0 9 0 0 8 0 0 0 32 0 34 0 8 40 34 33 13 0 0 
0 26 46 20 0 0 28 36 11 0 0 9 0 0 24 25 0 23 0 0 3 9 31 3 2 18 1 18 6 9 29 25 0 0 0 0 17 0 4 39 0 0 22 41 23 20 19 0 23 0 2 19 0 53 25 
5 0 14 32 0 14 0 0 11 0 7 23 10 0 0 0 11 4 6 35 0 32 0 12 0 0 1 11 18 0 0 43 4 0 15 0 1 24 0 37 11 3 31 0 0 0 19 0 0 7 23 51 7 32 35 
9 57 0 0 77 13 0 2 0 0 0 5 20 20 10 0 0 0 30 35 0 24 11 8 4 12 0 14 0 0 32 19 0 9 0 24 27 4 0 6 0 13 0 9 3 26 16 0 38 0 0 41 0 23 53 
48 0 36 58 66 48 0 4 52 0 0 11 35 0 3 0 0 16 0 23 15 0 18 36 21 14 12 5 0 9 27 0 4 14 1 0 25 0 1 0 0 0 10 21 0 21 0 0 4 41 0 28 15 14 0 
30 5 1 12 55 5 22 7 0 18 0 18 1 11 14 0 16 30 0 4 1 2 9 0 9 39 0 12 3 0 32 39 0 47 0 49 32 26 4 0 25 21 29 10 17 12 33 0 0 0 23 4 0 26 30 
