55 31
23 44 16 0 29 5 61 0 15 6 54 2 0 0 0 12 0 0 17 66 0 21 17 31 1 25 23 0 0 0 0 0 0 29 0 27 0 26 14 0 0 0 19 33 22 0 4 14 15 12 34 0 13 8 35 
0 39 0 51 0 13 0 24 43 21 8 0 47 51 5 15 32 15 27 29 27 10 0 13 14 0 21 10 0 10 35 24 84 0 0 20 18 67 0 0 30 27 0 0 25 24 0 35 22 0 0 154 20 43 0 
31 87 8 18 10 0 0 0 7 25 9 43 21 28 2 67 0 0 22 57 24 18 2 0 0 0 1 24 26 15 1 0 0 2 47 0 21 25 0 32 22 40 6 30 14 45 51 45 18 15 9 36 0 24 46 
22 34 0 40 15 40 44 0 0 38 13 0 0 0 0 0 10 24 15 3 15 28 0 17 0 22 3 16 0 0 25 0 0 5 0 0 10 0 29 0 0 6 41 23 0 7 50 13 1 43 0 3 0 19 1 
2 20 0 22 0 20 22 28 0 16 10 3 0 0 11 22 25 0 35 0 19 0 0 0 8 20 15 0 0 9 0 0 0 12 22 49 0 25 17 0 7 40 0 6 18 0 0 2 34 0 0 0 0 54 20 
48 10 37 1 0 0 0 0 0 41 40 20 0 0 0 16 1 9 5 3 3 0 1 21 35 0 22 0 0 0 0 0 21 40 4 1 0 0 0 0 0 0 0 4 18 1 18 7 72 23 41 0 0 72 0 
0 0 36 0 68 64 100 23 0 22 34 8 0 7 26 0 31 0 20 18 34 31 22 0 20 6 8 50 9 3 8 11 36 0 0 0 15 0 8 8 0 0 11 34 52 1 8 28 20 10 2 7 32 48 144 
0 0 0 0 13 29 0 0 0 0 0 45 0 3 0 10 2 13 21 0 0 19 0 5 42 8 0 13 4 0 6 0 0 9 23 0 6 0 0 0 25 0 4 0 0 0 0 0 37 25 16 28 0 0 0 
0 41 0 17 28 0 5 20 0 2 0 0 0 9 7 13 0 0 4 5 4 36 4 0 1 12 17 0 4 4 11 0 0 0 14 0 0 9 0 0 11 0 47 10 15 0 0 0 10 0 0 0 0 18 47 
0 0 0 0 19 9 41 10 33 0 14 0 0 0 23 4 15 6 0 33 0 0 9 4 30 0 8 0 19 0 16 8 0 2 0 0 2 4 11 0 10 4 13 13 8 0 8 17 0 11 16 0 69 11 8 
1 3 0 2 0 0 28 11 0 29 31 50 16 17 0 9 61 0 4 26 10 15 15 0 9 0 0 5 25 17 2 10 0 20 34 7 15 0 11 0 4 12 0 12 26 33 5 7 20 0 0 0 0 0 36 
0 46 17 0 7 0 0 0 0 0 0 27 27 2 15 5 11 0 50 17 0 34 3 0 3 0 0 20 0 0 12 9 0 20 0 0 24 0 8 27 13 0 0 0 26 0 0 46 37 0 13 0 17 15 9 
0 11 0 0 0 10 0 0 1 26 27 0 10 0 0 7 0 27 29 28 8 3 2 0 14 0 0 2 0 0 4 0 0 15 0 0 4 22 8 10 0 0 0 0 49 5 0 13 34 0 5 7 0 0 0 
5 16 0 7 0 1 0 44 18 15 49 10 5 4 0 34 0 0 4 0 0 14 23 0 15 7 13 0 0 0 20 0 0 7 0 0 0 3 16 0 32 15 4 0 0 23 9 21 0 5 0 44 15 0 0 
0 24 44 0 38 0 5 6 0 8 0 4 2 8 0 14 42 0 0 0 0 0 0 0 30 0 12 0 0 6 15 0 3 0 21 14 15 3 0 0 0 0 33 11 4 29 57 8 8 0 0 7 0 0 21 
20 2 0 0 53 20 7 0 5 0 2 27 0 24 0 15 0 0 0 0 4 18 12 0 0 13 0 10 0 13 8 0 0 20 12 0 1 6 19 0 0 37 17 0 11 0 1 6 15 0 4 0 12 16 16 
0 0 0 6 0 0 0 0 0 2 0 0 0 0 0 0 0 0 0 0 2 13 32 0 0 8 0 0 20 0 0 0 0 12 0 0 8 0 6 3 18 15 0 0 6 0 2 0 14 0 0 0 30 0 0 
17 0 0 0 0 0 41 0 11 18 0 39 0 0 6 25 0 54 0 0 6 11 0 16 12 0 9 0 0 20 9 23 0 0 0 10 0 0 1 27 0 0 12 13 11 10 35 41 12 2 0 0 14 0 37 
5 33 27 0 9 1 0 0 0 19 38 21 33 2 12 6 1 8 5 0 11 0 4 0 0 0 31 0 29 42 10 0 20 0 47 30 31 0 0 0 0 1 0 9 4 33 24 0 38 0 0 0 68 0 8 
0 6 39 36 22 38 25 10 45 0 6 0 1 7 9 0 7 36 6 26 9 0 0 0 34 21 22 14 25 13 4 24 3 0 5 10 0 0 0 58 4 71 9 3 14 26 30 18 19 0 0 21 0 5 0 
27 0 19 6 28 23 0 0 4 19 0 18 36 10 0 3 0 0 11 3 41 9 1 0 0 16 4 27 13 25 0 19 0 17 0 9 32 17 13 8 29 10 5 0 35 0 0 6 19 0 10 44 11 0 17 
0 19 0 0 0 0 17 28 16 4 0 8 13 0 0 43 38 0 0 8 15 0 0 21 16 0 0 5 0 5 0 19 17 1 0 28 0 31 0 33 0 11 0 3 12 29 0 6 0 0 0 7 0 6 39 
12 12 16 0 6 10 22 0 0 18 10 7 0 27 0 7 0 0 9 0 0 0 0 15 29 1 0 18 22 0 10 0 18 17 4 0 0 13 10 0 0 0 0 0 40 0 0 0 43 0 5 0 16 29 0 
15 0 0 9 1 0 0 0 11 0 13 3 5 14 0 8 13 53 7 21 16 5 36 0 0 15 24 3 6 0 0 0 0 0 6 0 12 0 18 0 3 0 3 19 19 19 52 30 2 0 14 0 0 22 9 
7 20 0 0 0 24 0 7 15 17 1 2 1 1 1 28 15 17 28 55 0 32 10 0 5 8 31 0 0 47 6 0 15 9 12 0 0 31 0 13 3 18 16 15 0 0 0 0 18 0 0 0 33 32 46 
1 0 21 66 14 0 0 0 19 4 47 20 8 73 0 43 37 9 1 38 16 3 0 8 14 24 5 18 0 4 0 2 9 5 9 51 0 0 0 15 41 9 0 4 31 26 0 0 15 15 16 38 49 37 20 
0 0 0 72 0 33 22 65 0 30 1 1 0 24 30 26 0 23 0 25 0 0 46 11 11 0 9 19 45 12 6 4 5 0 23 17 22 1 33 30 5 25 25 0 22 0 0 3 20 42 18 0 17 0 0 
14 27 0 32 19 0 0 0 0 0 0 55 0 0 22 1 13 32 0 8 30 14 0 3 2 8 12 8 28 17 20 3 0 0 3 27 32 14 10 0 12 11 52 48 0 0 10 0 82 29 0 8 42 0 0 
26 6 0 18 0 21 0 2 59 41 4 27 0 0 37 46 8 32 13 5 2 33 30 27 40 2 23 31 0 5 0 0 0 41 5 38 15 0 14 0 27 31 13 19 30 21 14 0 39 79 6 2 24 0 16 
0 47 11 25 25 6 2 0 12 0 42 6 5 15 1 18 0 20 0 28 0 1 0 15 0 0 0 6 11 0 4 27 26 35 1 30 0 7 15 0 0 39 12 0 11 0 0 5 60 2 0 0 50 0 0 
28 38 0 11 54 24 24 40 0 20 9 0 6 0 23 0 9 0 8 33 1 2 16 23 0 0 14 6 0 18 6 4 0 17 10 0 28 0 16 38 4 0 1 1 10 12 0 40 0 18 0 22 33 0 0 
