55 31
63 51 0 8 45 0 0 0 0 12 25 47 8 18 4 31 0 14 0 0 5 28 22 14 0 0 0 0 13 0 0 14 10 0 18 0 16 14 0 36 10 13 0 0 22 20 0 120 1 9 39 62 67 43 86 
9 3 0 16 0 28 0 0 12 0 0 0 11 0 0 13 66 29 0 5 20 0 25 12 0 0 24 0 10 13 12 0 20 28 18 0 0 0 10 0 8 0 0 0 0 24 0 24 20 17 34 34 30 0 0 
16 0 19 1 8 38 51 46 0 7 0 56 5 0 0 2 17 0 0 28 36 25 0 14 0 18 13 7 0 14 0 23 0 0 8 24 34 20 13 33 9 23 0 41 6 39 2 0 7 6 0 4 32 57 57 
41 0 0 12 21 27 6 0 0 53 3 0 38 7 2 0 14 0 4 32 3 37 11 31 9 16 35 2 22 26 19 0 26 40 2 0 1 0 0 35 10 22 3 0 5 3 5 7 0 2 41 5 0 1 25 
33 25 49 0 0 35 0 35 49 11 0 0 3 1 24 15 0 0 31 5 11 0 0 22 30 8 44 0 0 14 0 21 0 41 0 14 3 0 24 34 4 0 1 0 25 30 0 0 0 52 49 43 50 4 0 
0 74 0 0 0 19 46 45 35 8 43 5 32 0 30 1 6 22 16 0 12 4 17 11 41 4 0 0 6 0 52 3 12 0 13 23 6 8 37 56 28 0 0 5 23 0 24 17 8 10 0 24 1 4 24 
0 52 0 21 0 20 23 0 27 0 0 0 18 24 20 0 0 8 0 6 22 0 17 0 26 17 18 0 0 23 0 1 0 0 32 11 0 1 0 27 0 2 17 2 5 18 0 0 4 15 0 24 0 22 0 
23 24 35 27 3 42 17 0 12 0 31 29 1 16 0 0 11 2 0 0 2 0 0 0 21 0 0 0 0 1 45 0 16 0 0 30 16 22 0 22 3 25 0 5 19 14 2 35 0 0 0 8 0 7 14 
89 8 58 0 0 0 15 7 0 0 0 0 0 1 0 41 4 1 8 20 2 15 31 0 0 9 22 0 19 27 17 24 0 0 0 0 5 37 15 35 0 0 0 13 26 2 10 9 17 10 43 21 0 46 0 
0 0 10 70 19 0 2 0 0 51 16 2 0 0 46 13 44 0 0 33 2 17 16 0 15 5 0 0 25 19 6 0 10 19 19 0 0 14 29 9 31 34 3 0 3 31 0 47 0 26 0 0 33 4 38 
9 0 0 0 3 0 7 43 37 0 0 17 10 47 0 5 0 0 0 32 0 18 0 1 0 0 0 0 0 0 0 0 2 13 0 3 0 0 0 25 7 0 0 6 0 37 4 31 0 0 51 0 39 4 4 
12 35 0 10 0 0 0 8 0 0 13 15 12 41 7 0 4 29 28 4 5 0 0 13 0 33 0 0 0 0 16 13 0 15 4 0 51 0 0 0 13 0 0 15 44 5 64 22 0 4 31 2 4 7 18 
11 32 0 36 0 0 0 8 0 36 0 0 0 15 0 8 34 0 10 0 28 4 0 0 0 5 0 27 25 7 4 3 17 26 13 1 0 0 0 0 30 19 8 46 1 44 33 16 20 26 0 23 0 0 0 
25 0 0 1 12 6 0 0 0 0 13 23 30 34 0 22 19 17 6 0 10 4 26 9 14 7 10 9 0 20 49 3 0 0 0 23 0 33 13 9 0 6 22 3 26 6 8 30 10 0 0 7 30 0 0 
6 0 31 0 1 28 47 12 14 20 4 14 0 0 21 1 0 0 0 8 11 15 0 2 18 2 0 0 0 1 0 2 70 33 0 0 13 0 0 0 4 1 7 1 0 11 2 12 5 17 5 0 6 1 11 
0 0 1 49 0 37 13 52 0 32 7 0 0 0 15 5 0 12 14 25 8 0 0 13 0 6 13 0 0 7 22 0 14 0 5 0 0 0 0 36 33 61 23 0 0 0 0 40 0 6 10 0 38 1 0 
0 8 3 30 16 34 0 0 7 8 4 0 4 38 2 41 29 14 30 10 0 13 5 10 7 3 0 0 16 14 0 16 2 33 13 0 5 27 0 26 0 7 11 0 9 71 0 34 7 34 0 7 0 0 3 
0 0 5 40 70 8 21 45 16 3 9 0 0 36 0 12 0 21 36 28 3 0 7 14 13 1 2 0 0 45 0 23 0 3 0 0 0 29 19 10 0 28 0 0 15 13 0 40 0 45 4 0 0 0 32 
0 0 30 8 62 39 66 0 43 16 0 0 0 18 5 0 30 5 0 20 0 0 0 17 7 23 13 0 10 0 0 10 57 0 18 3 10 16 10 0 37 11 0 0 39 0 38 0 8 0 0 90 4 3 48 
0 25 14 1 0 43 12 0 10 30 0 0 0 0 0 26 5 29 0 14 28 0 0 6 3 0 25 22 0 23 0 0 9 7 14 27 0 2 0 49 50 26 37 2 5 13 4 0 3 32 2 22 25 7 0 
12 93 15 8 0 3 14 16 43 0 0 66 23 25 23 32 0 6 0 22 14 17 10 22 27 6 3 0 0 5 33 7 17 4 9 11 16 0 28 25 1 52 12 9 8 20 8 48 47 34 20 46 10 0 16 
0 0 51 0 0 0 0 0 0 21 45 37 25 0 7 0 0 0 0 0 0 1 0 11 14 35 18 9 0 4 0 8 0 4 9 0 0 23 0 7 9 19 0 7 1 22 2 0 8 47 2 26 0 49 24 
32 10 28 0 39 1 13 40 2 0 42 0 0 15 2 0 0 14 9 13 16 1 0 0 0 22 26 9 24 4 30 7 0 3 0 0 3 0 10 0 0 4 0 0 0 5 0 18 0 49 0 0 4 0 44 
0 0 0 14 33 0 0 13 30 14 0 0 0 37 2 6 0 5 8 0 8 0 0 1 0 0 9 0 21 0 12 0 0 56 0 2 0 10 2 0 13 11 0 0 0 4 3 0 0 0 38 9 0 15 21 
0 0 0 18 19 0 0 20 2 41 2 0 0 0 0 6 0 10 0 0 0 27 0 25 15 0 21 13 0 20 23 10 0 0 0 11 12 0 17 14 0 0 0 0 11 0 8 21 0 0 0 0 0 0 0 
51 0 0 3 10 0 0 22 0 0 25 0 0 0 32 10 0 3 22 0 3 0 0 13 12 7 24 0 3 22 3 3 2 3 12 0 36 1 1 22 22 36 0 4 14 74 0 0 45 5 0 51 0 0 25 
35 0 22 4 0 20 40 5 4 9 0 57 5 0 0 36 0 18 0 22 0 2 22 0 22 2 23 0 28 19 18 0 0 0 0 2 0 0 13 12 23 42 12 7 15 18 18 1 32 0 24 91 28 49 54 
0 0 0 0 47 23 10 0 0 10 0 13 7 2 0 7 0 0 0 2 15 22 0 18 0 0 31 0 19 0 0 0 31 4 13 16 1 0 47 0 16 8 11 0 0 7 0 0 0 0 0 47 0 0 28 
38 25 0 11 31 0 50 0 41 0 4 0 0 12 0 0 0 15 51 1 0 50 1 17 10 2 0 0 0 0 13 28 15 0 0 75 10 1 75 0 4 0 0 6 6 1 16 0 30 38 30 1 0 16 0 
0 39 0 0 29 0 0 38 0 0 0 0 0 0 15 29 0 17 0 29 5 0 0 17 0 16 0 21 7 0 0 21 28 17 17 7 0 17 1 52 50 0 14 4 47 58 0 0 50 20 0 45 0 23 32 
20 33 0 21 22 26 28 7 0 0 11 0 25 0 96 16 18 13 0 28 0 20 4 26 20 0 26 9 25 0 0 0 0 0 8 15 16 25 0 0 48 20 0 41 0 0 11 30 23 26 11 41 38 2 0 
