56 32
39 0 0 0 0 0 0 5 0 0 26 15 11 11 28 0 0 29 0 0 1 16 18 27 0 3 15 8 16 0 7 11 0 0 0 0 26 3 4 54 0 1 41 13 0 0 3 0 0 0 37 0 30 0 4 11 
37 40 25 23 60 32 18 0 25 24 18 25 0 0 12 38 18 0 0 0 26 9 6 0 2 0 52 37 0 0 24 0 0 35 41 0 25 9 0 0 14 40 15 0 11 0 0 11 21 0 0 22 54 37 29 29 
0 38 0 0 0 0 54 45 0 0 44 14 3 0 0 20 0 0 0 0 0 0 0 0 0 17 0 11 0 31 22 10 21 0 0 27 0 0 14 45 0 25 0 11 9 0 0 0 0 0 3 0 23 2 72 0 
4 0 45 4 0 0 0 4 14 35 0 8 20 32 11 11 0 0 7 0 27 5 15 27 33 5 22 0 4 0 0 7 11 49 25 18 29 3 13 0 0 33 33 13 0 0 0 33 0 0 12 10 69 18 0 0 
0 52 50 0 0 3 0 10 0 0 14 34 0 12 19 13 0 0 0 23 16 0 0 20 0 8 16 20 0 0 8 0 0 31 0 3 23 0 3 32 0 19 16 10 2 45 0 20 0 0 14 27 50 52 0 22 
2 0 37 27 0 3 2 25 2 4 10 31 43 13 13 40 35 74 15 16 20 0 0 0 0 8 12 0 55 0 14 0 35 19 18 11 11 11 15 11 0 0 31 0 0 0 5 0 14 6 0 17 27 36 4 3 
21 0 19 0 0 0 0 0 0 0 24 0 0 17 8 63 25 4 5 27 17 19 28 0 41 8 0 28 6 0 0 2 15 8 6 11 6 0 0 0 0 0 0 0 26 21 48 1 0 0 0 0 10 0 39 28 
42 0 0 26 0 1 0 0 4 0 17 0 4 46 8 29 6 4 0 13 0 7 20 0 0 4 31 17 1 1 10 1 0 0 0 0 36 0 18 0 0 0 0 0 29 0 2 0 9 0 0 4 6 0 0 46 
31 46 2 0 46 21 2 16 0 12 4 37 0 0 5 3 44 0 3 8 28 11 6 14 3 30 36 11 24 6 0 29 10 2 16 35 5 14 0 0 29 15 0 6 26 25 40 25 16 6 30 0 38 19 3 0 
0 17 2 0 43 13 7 0 4 0 0 4 0 15 0 0 0 0 0 0 7 20 0 25 2 0 17 12 0 7 0 3 0 14 0 0 0 0 0 8 13 21 7 3 0 0 2 27 27 6 10 0 9 0 0 0 
0 94 56 0 30 0 0 0 0 0 35 0 0 0 13 7 40 18 0 0 11 9 18 0 0 0 4 13 0 5 0 0 0 30 0 5 0 0 8 47 18 62 0 10 0 78 16 4 9 0 0 4 0 7 49 9 
2 0 57 35 37 4 13 0 0 4 0 0 0 4 13 0 0 4 0 0 7 10 0 10 32 0 7 25 15 0 0 0 12 10 0 0 0 17 19 0 0 43 0 3 0 0 19 0 7 6 0 49 0 19 30 8 
57 0 25 38 0 32 0 0 0 0 0 42 0 0 10 31 30 4 32 28 5 0 46 13 26 11 0 13 7 0 7 11 4 0 35 17 12 27 0 0 0 77 0 4 33 45 0 39 0 0 26 8 0 0 29 0 
0 0 25 0 12 0 44 0 40 0 30 67 18 26 10 0 9 9 18 0 0 0 10 0 0 0 0 28 0 0 3 11 0 0 12 0 1 0 0 54 1 11 0 1 1 0 22 0 7 4 44 0 0 0 43 0 
3 1 58 43 4 3 28 1 21 0 0 29 6 58 19 7 18 14 0 9 2 6 3 0 8 16 3 14 9 18 0 0 0 47 18 0 17 8 15 0 29 49 0 35 31 0 78 5 0 0 14 0 7 17 20 9 
25 13 40 46 72 0 0 10 0 5 13 7 31 0 17 0 7 3 0 6 0 0 0 0 28 18 1 0 0 12 15 9 9 0 0 3 0 0 0 40 0 10 0 10 0 67 25 9 0 40 0 0 28 0 0 0 
37 0 3 25 9 47 33 0 11 0 8 13 23 31 7 12 22 0 0 1 1 16 0 0 0 15 12 0 0 23 0 15 0 8 0 1 24 16 11 7 0 12 0 31 0 8 10 17 5 34 0 4 86 65 18 0 
7 47 0 0 0 24 0 18 0 0 0 0 15 0 0 11 0 0 0 13 23 6 6 0 2 23 30 22 0 0 12 4 10 11 15 15 4 17 0 8 8 0 0 0 0 0 0 0 47 11 0 21 0 0 0 0 
0 0 18 29 0 3 0 0 5 0 65 5 1 25 13 0 0 7 0 0 39 0 1 0 14 12 22 14 1 15 0 0 10 15 7 18 0 27 17 0 8 33 0 28 0 0 0 17 19 0 15 39 1 2 0 0 
3 9 11 27 9 28 18 0 0 0 2 16 0 27 32 0 13 31 31 0 25 0 7 23 3 42 0 5 11 7 7 0 0 39 0 5 3 22 0 24 26 24 0 35 12 34 16 0 3 0 13 8 0 28 17 0 
0 0 2 29 2 0 0 66 0 12 0 0 0 21 0 14 23 0 0 13 17 0 0 3 21 21 13 7 0 5 0 17 0 6 39 0 0 4 3 0 0 4 37 2 33 0 2 0 14 8 0 44 0 52 0 7 
6 0 0 63 6 31 37 0 47 0 8 0 0 0 0 0 17 0 0 14 16 2 0 0 0 19 14 12 0 9 0 0 0 49 31 0 7 32 35 0 0 0 4 7 0 0 15 8 13 0 44 0 0 0 7 47 
41 21 45 10 40 1 8 8 0 0 42 44 5 14 0 20 1 8 15 0 0 0 21 5 8 0 6 0 0 0 23 0 0 0 0 0 32 8 32 0 14 2 3 2 0 5 20 45 50 0 0 0 5 17 8 0 
2 49 13 0 11 5 48 8 12 0 0 20 0 1 27 1 0 42 1 5 9 37 2 3 5 0 8 0 0 7 0 30 12 0 0 0 0 0 29 18 2 8 11 11 11 0 4 0 0 8 49 22 0 11 15 49 
6 0 3 0 0 18 0 16 28 0 6 0 0 1 0 16 2 0 35 24 0 0 0 10 0 16 7 0 0 13 0 7 0 25 9 0 1 0 0 0 0 0 13 25 0 0 1 0 0 0 0 0 27 8 0 37 
26 1 14 0 23 16 5 26 0 0 34 0 0 0 11 32 33 0 13 0 0 19 0 3 0 25 11 62 21 0 8 22 25 0 0 0 9 0 12 0 0 2 4 23 46 4 0 0 5 0 21 0 2 26 17 0 
5 54 46 0 1 0 5 0 5 14 0 14 0 0 14 0 19 14 0 0 30 0 15 39 0 0 0 5 27 14 1 1 0 10 0 0 1 1 51 0 0 29 20 14 3 0 18 47 58 0 37 0 0 0 12 32 
6 0 0 0 0 0 23 6 0 0 0 14 9 0 6 0 32 0 8 23 3 18 20 25 0 3 0 0 0 57 23 0 22 0 0 0 12 0 0 28 0 34 0 0 0 21 1 0 0 0 0 3 41 36 3 0 
0 28 68 0 21 10 25 12 0 0 4 21 0 22 28 13 0 0 0 0 0 4 1 0 5 1 0 28 2 39 2 25 21 20 0 0 12 30 5 37 0 0 13 10 0 24 0 0 0 3 14 22 0 0 2 41 
0 0 143 22 0 10 0 47 0 45 0 35 8 32 0 10 0 27 0 27 26 0 25 0 1 0 1 0 0 0 0 17 0 0 0 0 59 0 21 0 6 7 40 0 36 32 56 34 8 0 0 0 0 0 2 0 
24 17 24 0 15 0 53 4 0 0 14 26 11 0 0 15 14 8 5 45 0 9 22 38 29 20 10 0 8 16 0 0 0 14 0 11 8 0 31 0 25 7 0 40 0 0 0 0 0 26 21 11 80 19 6 0 
19 22 11 15 32 0 40 8 17 38 1 15 0 17 0 0 4 0 0 32 0 8 20 28 11 0 16 20 0 8 0 0 13 0 0 11 25 0 19 27 0 28 15 0 0 0 3 0 0 0 0 55 0 11 0 0 
