56 32
4 3 36 34 18 0 0 0 0 0 35 37 39 0 79 41 0 0 3 8 1 10 45 22 10 0 48 8 0 8 0 0 20 0 0 13 0 23 23 0 8 31 32 16 15 0 0 0 24 0 49 39 17 39 0 17 
3 3 25 0 37 0 0 14 0 0 0 14 26 7 17 39 0 36 1 17 19 0 13 0 0 11 0 0 0 12 0 18 0 2 2 0 36 15 23 0 0 39 1 1 0 0 0 0 0 0 0 27 4 0 63 0 
16 29 51 0 0 5 24 11 12 15 25 0 4 32 16 0 0 0 10 0 15 0 22 7 25 1 0 8 24 0 33 4 0 45 0 48 0 0 0 22 31 1 0 0 0 32 18 0 0 0 0 18 24 51 0 0 
2 0 0 0 0 0 9 14 9 16 7 15 4 5 20 4 27 10 24 4 0 21 0 0 0 0 0 12 18 0 0 0 0 18 11 0 0 21 0 25 31 3 0 0 0 0 0 0 0 0 0 0 0 0 0 0 
35 36 0 19 39 5 0 0 0 0 26 27 27 0 9 0 0 10 17 0 11 0 14 27 6 0 0 10 0 0 29 24 7 25 8 0 31 0 41 7 0 5 0 39 0 6 0 0 0 0 17 1 30 0 0 0 
0 51 1 20 54 15 0 0 0 67 30 38 8 31 13 0 23 32 26 1 20 12 51 0 24 6 50 35 20 16 7 59 22 3 0 0 0 22 11 21 1 27 16 29 59 41 50 1 81 1 19 42 11 43 0 0 
0 39 0 35 0 15 0 0 3 0 9 0 0 21 0 24 0 0 0 15 15 0 0 12 13 15 0 0 0 0 28 0 0 0 14 8 0 13 35 24 64 0 3 14 6 0 0 17 0 15 0 0 10 0 0 0 
29 3 36 0 30 0 0 48 0 0 0 35 0 0 0 0 6 34 0 14 10 0 0 50 25 13 63 0 17 29 1 0 20 0 61 0 15 22 40 17 0 0 0 0 2 0 25 0 0 25 0 6 1 0 30 36 
13 0 0 0 26 27 0 42 9 13 8 0 7 0 0 28 0 0 27 4 0 0 0 0 0 0 0 0 0 10 26 21 0 0 0 0 9 0 17 8 0 3 0 0 0 57 0 6 0 0 43 0 48 0 4 17 
0 13 0 22 1 41 0 0 38 0 45 39 0 11 11 0 0 12 0 39 0 17 0 0 20 18 20 12 13 17 14 17 1 4 0 29 38 0 0 14 0 13 3 0 3 35 17 2 0 9 29 48 47 0 8 36 
1 20 40 0 1 34 0 0 0 0 0 0 30 0 0 2 0 21 0 12 0 0 0 0 6 0 6 12 25 15 7 0 0 0 7 17 0 0 0 45 0 14 12 0 10 0 0 0 0 0 19 0 0 25 25 0 
0 50 12 0 18 3 4 0 0 13 4 0 0 0 0 0 0 7 0 18 24 0 0 0 0 0 0 11 0 25 17 0 5 0 0 34 0 5 15 1 19 3 0 0 0 0 0 13 0 15 2 0 20 0 0 0 
0 0 0 14 0 85 13 33 4 1 0 0 0 31 0 10 7 6 0 22 0 0 17 6 0 0 0 5 41 4 0 16 7 8 29 30 0 10 0 53 58 24 0 12 34 0 2 21 0 0 11 0 0 0 22 5 
0 15 0 0 48 47 0 0 0 57 0 25 0 0 0 0 23 46 0 0 0 0 13 0 10 0 0 8 0 2 0 0 21 17 0 4 25 15 6 14 2 0 0 0 0 0 0 8 0 0 0 0 110 80 6 23 
0 22 0 0 27 56 4 8 0 8 25 0 0 6 25 2 26 0 1 9 15 13 30 30 13 0 26 25 13 0 4 26 0 0 9 8 24 13 0 27 30 0 25 21 11 5 59 6 0 0 44 2 42 94 18 0 
0 0 4 0 7 0 0 40 1 5 9 30 3 26 0 0 0 42 0 17 20 0 0 28 0 9 0 0 1 28 0 0 0 0 16 0 11 0 0 27 0 0 1 0 0 26 0 18 0 32 0 28 0 0 8 19 
0 20 0 0 0 16 0 0 28 1 0 0 0 29 13 5 0 0 0 0 0 24 0 31 38 11 18 2 18 5 40 9 0 6 2 6 0 2 2 8 31 13 29 0 11 0 22 0 0 0 5 56 12 0 15 0 
1 14 34 0 27 21 28 0 5 0 7 23 0 48 10 0 34 0 12 0 0 8 16 21 0 9 0 5 0 11 7 53 0 0 25 0 1 0 0 3 9 0 10 0 20 1 17 13 12 9 70 0 0 0 18 23 
36 0 77 20 28 0 0 20 19 21 12 23 0 21 3 17 31 32 14 33 30 0 13 29 20 0 8 13 0 2 14 10 8 13 32 16 7 2 0 7 9 4 1 12 7 0 30 8 11 33 31 13 3 26 54 0 
17 0 20 45 2 0 4 0 0 9 0 7 0 8 24 20 7 0 19 0 14 3 8 2 0 0 23 0 0 0 8 0 11 0 0 0 0 0 24 0 0 0 0 28 38 2 0 7 45 0 10 0 19 0 0 12 
0 0 14 0 0 23 0 0 3 0 0 6 42 32 37 4 14 0 0 0 0 0 0 0 0 13 7 1 12 13 0 0 0 16 1 0 4 1 1 4 30 0 10 0 0 0 13 15 0 48 0 0 13 6 1 40 
1 0 0 0 86 5 0 0 47 0 5 9 0 3 26 5 6 3 0 8 5 0 0 2 16 0 1 18 0 3 6 0 0 0 8 0 14 1 0 29 0 34 0 0 0 8 22 0 0 45 19 0 0 7 0 0 
0 1 38 12 4 18 0 8 3 20 0 4 19 14 9 50 22 52 13 9 5 0 17 4 0 0 12 3 0 0 30 56 0 6 28 1 23 3 5 0 29 3 11 17 10 0 29 0 0 2 0 36 3 0 0 0 
0 53 7 0 4 29 4 0 32 0 0 18 37 36 29 6 1 13 0 0 27 0 0 8 3 0 34 6 0 29 18 19 0 42 0 0 13 0 40 0 0 2 0 0 0 0 58 27 22 61 0 0 3 7 0 93 
42 0 0 42 14 34 56 16 35 60 37 1 0 32 25 2 50 0 0 19 0 14 11 16 0 0 6 0 0 8 13 0 0 11 28 0 0 0 19 13 0 0 80 13 2 67 0 18 0 0 0 48 0 114 0 0 
54 53 0 0 0 0 0 0 36 1 20 18 40 35 0 0 0 0 0 11 4 49 0 0 0 0 18 23 8 0 3 2 0 22 39 11 0 0 25 5 12 0 12 22 38 0 11 0 59 0 23 0 37 53 12 53 
30 24 19 0 0 14 0 0 27 0 5 35 0 23 0 0 4 8 10 0 4 14 0 0 0 24 0 0 12 0 52 32 0 0 0 0 13 0 0 21 14 0 0 0 0 30 15 13 0 34 37 0 26 0 0 0 
0 0 0 25 0 2 0 19 9 6 16 25 0 43 7 24 8 0 10 0 4 13 31 0 4 33 23 0 0 7 0 8 3 4 6 8 37 0 14 0 15 0 16 0 0 0 0 0 0 41 0 0 39 31 1 48 
0 41 29 4 36 20 0 29 37 43 1 0 0 4 54 38 9 19 5 20 7 13 17 0 26 9 0 10 0 7 14 29 25 0 9 2 0 2 13 22 0 28 3 0 11 6 0 0 5 0 12 27 43 38 4 0 
28 0 0 0 5 34 0 25 0 42 0 11 5 0 0 0 2 25 25 0 0 6 0 22 24 8 21 26 0 0 0 0 0 27 4 0 18 22 6 22 0 2 0 0 0 40 37 3 11 0 19 33 46 5 16 0 
15 28 32 6 24 7 0 56 11 1 5 16 36 0 32 50 9 6 0 0 0 10 0 17 22 19 22 0 26 13 28 0 5 0 10 0 0 0 0 17 30 0 0 31 4 0 14 21 2 25 0 24 0 0 47 0 
43 54 4 22 34 17 4 43 0 0 16 0 29 28 8 0 26 3 12 11 28 5 17 7 0 25 0 10 10 12 46 17 0 0 27 25 0 21 19 0 15 12 23 0 45 8 0 0 28 5 25 0 15 34 3 11 
