56 32
22 2 26 26 0 3 0 0 87 30 49 0 9 0 0 0 0 25 14 0 0 9 12 0 0 28 17 3 26 40 6 0 0 0 0 0 0 7 10 30 7 0 14 4 36 37 0 37 0 0 17 0 44 16 15 40 
79 17 8 41 22 35 58 5 0 30 24 0 33 0 7 0 29 26 0 0 33 0 0 17 0 13 48 0 22 16 5 19 0 6 18 0 15 0 13 7 39 4 32 0 54 34 3 13 0 0 36 13 67 86 18 0 
10 55 10 0 52 25 2 3 6 1 0 27 0 0 37 27 3 27 0 30 23 0 0 0 0 18 0 37 0 0 0 0 2 0 11 16 4 9 24 0 4 30 27 0 0 0 21 0 10 0 0 19 0 46 25 22 
40 100 27 0 0 3 12 0 46 45 9 10 13 37 0 24 10 0 39 0 21 19 2 20 2 32 3 16 12 17 0 0 21 0 1 0 0 2 0 3 41 0 0 25 25 0 0 0 47 2 0 2 0 5 96 46 
22 2 55 0 0 43 25 0 0 7 28 1 0 17 0 0 16 0 0 10 12 24 13 0 4 0 9 0 24 6 17 0 39 0 1 2 0 8 0 0 5 0 0 42 12 14 97 0 45 0 0 0 24 5 0 56 
0 24 1 40 0 17 45 0 1 28 0 31 2 25 11 2 26 0 0 40 0 0 17 0 25 75 0 4 0 0 0 0 12 9 21 0 28 25 0 1 14 0 35 30 12 34 27 0 0 0 13 45 0 3 12 0 
0 0 1 0 14 0 15 37 0 0 0 0 42 30 14 39 0 0 14 24 33 0 0 0 0 0 15 0 14 22 13 1 1 0 14 0 9 12 0 4 1 2 6 11 47 0 0 0 0 12 23 22 0 6 13 2 
23 0 0 47 0 0 1 18 0 0 2 9 78 0 0 0 0 20 0 5 0 20 24 0 26 11 2 0 36 17 0 31 0 19 5 24 11 34 4 0 8 24 30 16 11 11 4 2 3 23 0 0 17 22 2 0 
56 0 103 0 0 0 48 31 8 0 0 34 42 40 7 37 17 0 0 47 0 0 0 0 25 33 2 0 0 0 0 12 0 18 4 0 0 0 0 39 16 17 0 0 0 9 2 13 0 12 0 49 14 30 41 42 
0 47 0 54 0 0 7 0 2 0 8 39 14 12 7 3 47 1 56 0 9 0 0 0 0 49 16 4 26 9 0 0 0 0 4 0 0 34 0 0 0 0 0 0 18 0 0 0 0 0 14 0 16 43 26 37 
103 36 4 11 0 5 42 82 0 0 0 9 0 13 23 26 0 32 3 16 24 37 37 20 23 22 4 0 25 15 0 0 19 0 7 23 7 23 5 21 8 2 6 26 35 24 45 24 42 0 0 41 45 12 26 15 
0 32 8 0 44 14 0 0 0 0 0 0 0 0 0 0 32 0 0 0 10 0 11 6 0 0 0 7 0 6 13 0 9 32 5 0 12 20 4 19 10 9 12 0 0 0 4 0 26 45 0 0 10 0 0 0 
9 11 2 11 4 31 6 7 24 0 0 9 12 13 5 26 10 0 0 20 0 12 30 11 0 2 7 23 9 0 0 0 0 15 14 25 37 17 25 14 0 25 0 36 37 37 13 0 17 0 15 0 49 25 14 0 
3 19 3 0 33 0 40 2 0 0 0 42 36 0 0 54 4 0 25 4 19 0 0 4 0 15 11 0 0 0 0 2 7 3 3 24 0 15 0 0 2 13 34 0 40 0 2 22 36 7 0 0 0 0 13 13 
0 0 35 0 17 29 11 0 0 0 12 10 0 9 0 0 0 11 0 10 11 83 12 0 0 2 0 16 0 24 15 29 11 0 0 0 9 0 10 11 0 2 0 0 0 0 10 0 27 0 40 13 14 23 4 18 
8 45 0 18 0 0 79 10 3 0 13 10 0 0 0 20 13 0 0 5 2 8 7 7 0 10 0 17 0 2 0 0 0 0 1 0 7 0 0 0 51 0 12 10 0 0 40 0 0 7 0 0 16 6 48 28 
3 0 43 50 26 8 0 58 33 0 0 0 14 8 0 0 12 10 26 14 0 0 20 0 0 15 24 0 0 0 2 2 12 8 0 0 19 0 0 15 0 25 0 0 26 0 0 0 0 0 47 44 0 0 26 53 
90 52 0 11 0 1 55 0 0 36 9 8 3 14 22 20 5 24 0 4 0 15 11 0 18 19 24 9 0 2 0 31 52 0 12 14 7 3 23 11 0 24 0 11 34 36 11 0 6 9 41 0 0 69 28 0 
1 1 0 0 36 0 67 2 0 13 0 19 0 6 0 0 0 0 16 13 45 0 4 25 8 32 11 0 3 38 19 2 14 0 7 0 6 33 9 13 2 0 0 18 0 0 1 36 28 0 0 22 9 0 37 49 
0 60 0 0 40 3 18 21 0 6 32 47 33 8 0 6 0 0 0 1 0 0 0 0 9 0 0 0 33 1 12 0 0 0 0 0 0 0 26 0 0 0 44 0 40 0 2 0 0 0 0 0 0 0 103 0 
36 18 6 60 34 0 0 40 0 0 18 1 0 37 0 14 16 0 18 59 0 0 25 0 31 0 13 23 0 16 0 0 2 36 18 0 31 12 0 1 7 0 37 0 5 7 16 65 29 34 10 0 19 36 9 6 
10 0 0 0 42 39 17 78 3 0 45 17 0 7 3 0 6 6 21 14 23 7 10 46 5 38 28 0 0 4 0 20 18 14 0 10 15 14 0 0 0 9 28 23 39 0 24 5 23 0 0 100 29 0 75 0 
22 0 18 0 11 26 44 0 10 5 4 0 0 8 0 11 0 29 0 7 0 0 0 0 18 0 21 0 0 0 0 21 0 0 0 0 27 1 13 0 12 0 22 0 0 0 50 0 0 0 44 0 10 0 0 0 
3 11 0 14 0 0 21 0 37 0 19 51 0 13 21 2 23 21 5 7 0 11 0 28 5 0 7 0 0 5 5 1 19 0 0 21 0 0 11 0 0 0 12 0 2 115 5 0 18 0 0 0 3 47 0 40 
20 0 1 3 4 0 5 6 15 36 3 26 11 10 17 1 0 9 0 16 0 4 0 1 0 0 3 0 13 0 13 22 0 0 18 0 11 0 7 0 11 0 0 0 1 36 11 0 0 0 0 11 0 0 0 22 
0 9 0 0 4 14 35 0 0 6 28 28 11 5 0 0 17 0 0 0 1 1 0 0 0 16 0 10 0 4 0 0 21 4 21 21 30 27 0 0 0 17 0 17 5 2 0 0 0 0 0 1 17 22 0 21 
14 5 0 0 0 0 0 0 9 0 24 0 34 0 4 0 0 31 0 11 0 0 0 44 2 0 22 0 0 0 0 0 0 0 0 3 0 0 3 0 7 0 0 0 0 0 11 7 56 0 25 0 0 23 45 12 
12 60 8 49 0 5 0 55 0 28 5 11 33 0 0 0 11 22 17 12 0 20 9 11 0 0 12 0 0 0 0 0 0 19 33 17 0 43 40 7 0 0 32 41 1 11 5 0 0 0 44 12 49 0 25 27 
1 3 0 0 6 27 1 0 47 7 64 38 11 4 0 18 3 18 0 0 109 49 11 0 5 2 0 15 21 0 5 4 12 2 3 25 0 15 9 42 2 0 54 27 8 0 0 4 38 29 0 0 14 54 6 35 
21 21 0 0 0 0 16 0 0 0 0 19 10 41 0 27 6 2 11 0 14 0 18 22 36 0 9 27 0 3 0 0 15 0 12 0 12 0 0 0 0 2 27 2 0 0 23 81 2 0 49 0 0 0 41 0 
1 48 0 0 0 0 37 48 44 4 0 0 0 107 0 0 13 0 0 0 15 0 0 24 37 0 0 0 13 1 0 2 0 0 20 9 0 0 0 0 0 13 0 67 9 16 0 16 0 25 1 7 45 0 9 0 
0 0 17 36 29 22 0 41 37 50 1 18 20 23 0 35 31 1 17 17 0 0 0 8 0 24 0 23 13 30 0 38 20 33 31 24 0 20 0 0 0 24 4 19 3 0 27 3 43 0 111 0 43 9 27 0 
