56 32
16 0 0 39 0 39 11 16 0 33 22 56 34 0 33 0 0 0 0 0 0 0 0 0 1 1 0 23 0 0 0 20 0 10 18 0 0 25 31 0 18 25 76 0 0 0 41 61 0 0 23 20 16 24 47 3 
0 1 62 0 9 4 26 55 69 14 0 21 29 42 13 37 0 0 28 0 0 0 18 8 13 11 13 3 0 21 29 35 3 4 30 33 62 37 6 47 22 20 11 24 22 0 28 0 3 18 3 53 14 0 9 79 
17 7 11 0 0 6 11 0 10 25 0 6 12 14 26 27 16 23 0 20 0 0 17 3 0 2 12 0 7 2 22 0 0 6 0 13 28 14 42 0 17 9 1 10 0 0 0 39 0 21 0 0 38 0 19 1 
0 0 0 31 0 44 3 56 0 0 0 32 2 0 0 33 1 0 1 9 0 25 0 0 0 0 0 20 0 40 0 0 38 1 0 20 0 11 0 26 4 0 0 68 0 0 0 0 22 44 0 0 0 0 9 19 
0 0 17 0 8 0 0 0 28 0 9 0 30 15 10 8 50 0 34 29 12 0 15 26 25 7 3 18 16 13 23 14 7 1 0 26 22 0 15 7 0 0 29 17 22 9 41 0 4 0 0 16 34 14 15 0 
0 0 0 0 0 0 0 0 51 5 7 0 23 0 4 0 0 0 0 25 0 0 0 17 42 0 36 0 7 0 24 21 16 0 34 0 14 0 0 0 31 0 0 0 0 0 0 28 16 0 0 43 0 5 28 0 
0 0 0 33 0 24 7 0 28 35 0 33 0 7 0 0 0 4 0 0 0 27 12 0 0 0 0 3 0 30 0 0 8 0 38 0 21 17 0 5 12 0 0 6 68 1 0 5 0 0 5 13 15 2 17 26 
0 39 10 5 33 0 0 0 43 44 0 28 4 9 0 1 0 0 32 29 16 0 0 6 0 0 0 4 9 4 0 15 0 0 1 0 28 0 0 22 35 0 0 0 0 1 0 0 0 0 32 17 0 44 0 0 
20 19 0 0 44 80 0 0 19 0 18 0 5 0 17 0 8 0 0 14 33 30 12 0 0 2 0 22 3 9 4 27 12 14 35 19 0 0 0 7 30 0 0 7 24 0 1 0 9 17 0 31 1 7 73 0 
0 0 1 0 5 0 64 20 0 0 31 19 0 0 2 0 2 0 14 19 23 0 0 0 14 0 0 22 0 3 29 2 31 14 13 7 0 7 18 6 38 15 0 0 0 0 0 27 2 0 0 19 0 0 22 49 
1 44 28 1 41 15 0 1 25 39 9 0 18 3 18 0 30 27 0 32 9 0 0 9 0 0 34 3 0 9 24 4 2 19 0 26 10 25 7 0 2 12 0 0 14 42 43 9 0 16 0 9 6 0 12 11 
0 48 29 1 44 0 8 0 0 11 0 0 31 0 2 0 2 18 47 0 29 8 0 7 0 0 0 0 17 0 0 0 3 4 11 17 18 17 32 0 51 36 15 31 0 15 0 29 12 30 0 11 5 46 34 10 
0 0 27 5 1 0 0 25 56 46 0 0 9 18 0 24 9 0 0 0 24 0 0 0 22 0 9 0 0 33 22 50 0 60 0 2 6 17 0 39 0 17 0 22 0 0 0 20 0 18 5 6 5 1 43 19 
0 10 0 0 17 4 27 7 45 0 0 0 6 29 15 24 32 23 1 27 0 0 0 0 7 22 0 0 0 0 0 0 10 1 9 9 8 0 6 24 8 7 16 5 12 37 0 41 40 0 9 10 0 0 0 0 
6 4 11 11 0 0 9 39 1 15 56 3 23 11 33 0 1 34 2 26 37 0 2 0 0 0 1 0 0 0 0 0 5 5 0 23 12 0 0 25 0 0 1 6 0 4 43 4 40 0 7 16 33 0 44 0 
0 0 4 0 54 0 2 0 0 7 0 15 0 0 37 20 0 0 0 0 0 0 33 0 0 27 15 5 13 21 0 9 19 15 0 28 14 0 9 0 0 19 6 0 2 0 7 0 44 0 15 41 27 4 0 0 
54 43 11 47 0 7 0 6 18 0 21 0 0 15 10 0 22 0 4 13 0 0 0 0 9 0 26 0 9 0 0 15 25 9 0 6 23 7 38 6 2 4 10 30 28 6 30 0 1 0 62 16 17 0 3 0 
0 0 10 0 13 5 1 0 32 15 0 14 10 13 41 10 16 57 0 0 9 0 13 0 14 14 0 8 0 0 0 12 20 0 14 8 8 1 17 0 0 24 0 12 8 0 0 0 2 0 33 0 5 4 0 88 
0 0 9 86 0 0 0 0 0 3 36 6 11 0 0 0 0 7 7 0 7 0 0 31 3 2 0 0 0 0 21 14 23 0 3 0 4 9 0 35 32 0 3 5 0 4 0 0 16 0 0 20 8 50 31 0 
0 0 8 0 34 0 13 18 43 29 0 19 0 0 9 0 0 22 0 0 12 7 69 0 13 12 24 0 27 9 0 25 7 12 28 0 14 13 39 9 0 0 0 0 22 36 15 15 20 4 4 39 35 0 7 0 
27 51 28 0 0 30 0 10 13 10 2 26 0 0 0 0 0 0 16 5 0 30 9 0 0 0 0 2 29 1 28 9 12 0 5 38 0 15 0 7 0 0 0 0 9 0 13 0 11 49 2 0 47 0 0 0 
7 16 12 3 0 0 36 10 0 0 0 60 22 11 0 51 12 0 0 14 0 0 0 0 17 0 10 16 0 0 32 28 4 0 5 0 10 13 0 0 31 0 23 24 0 0 12 40 0 0 0 45 0 25 62 0 
22 49 6 1 0 2 2 25 33 41 4 25 0 0 0 7 5 0 29 14 5 38 0 4 0 3 0 2 0 4 0 15 13 4 13 0 30 4 0 0 0 34 0 0 43 0 37 36 0 14 9 0 17 1 33 3 
140 58 12 70 0 33 0 0 5 0 0 13 0 0 0 3 0 0 0 10 15 0 6 0 5 6 28 4 6 13 0 0 0 6 19 33 7 24 16 0 37 41 0 38 0 0 0 0 13 23 13 15 49 42 43 0 
0 0 33 3 0 2 22 44 8 7 42 28 27 4 2 0 1 0 7 7 0 13 10 0 19 0 20 0 0 23 0 0 0 0 18 10 23 2 12 33 0 0 4 0 7 0 1 0 0 0 0 20 56 0 1 23 
0 0 0 0 3 19 28 0 58 6 0 0 17 0 32 0 7 25 0 21 12 0 17 34 0 0 15 0 23 17 0 0 35 6 46 0 9 25 0 3 0 9 19 0 0 26 0 11 0 0 5 23 0 0 46 8 
0 13 0 0 0 0 0 0 0 48 0 4 8 0 55 0 0 25 0 0 17 17 0 13 25 8 0 0 0 12 0 7 15 0 9 0 35 8 17 12 6 8 25 14 0 0 32 26 7 12 26 3 0 44 0 0 
85 3 43 0 39 0 23 38 45 11 10 0 6 3 18 0 4 5 0 20 20 0 20 28 31 23 0 0 0 17 0 14 30 0 4 0 21 0 0 4 6 5 0 0 0 52 37 7 0 0 0 12 0 2 38 84 
5 34 0 0 37 66 32 0 5 26 23 45 5 0 0 38 13 0 17 20 36 0 0 29 8 15 0 1 57 37 19 12 0 22 10 1 0 21 65 3 15 33 13 5 0 0 28 0 33 44 7 5 17 12 0 73 
0 0 24 0 29 0 0 37 25 8 4 0 0 0 4 1 0 26 0 13 0 0 9 0 17 20 47 0 0 1 5 9 0 25 12 2 6 19 0 40 0 0 0 28 0 0 21 0 0 28 0 0 0 18 1 1 
0 9 19 0 17 0 47 0 0 19 16 11 0 19 0 7 7 0 0 80 2 52 44 3 0 0 0 0 0 0 9 0 2 1 11 31 0 0 0 0 25 0 0 22 74 0 0 0 26 0 0 62 0 0 0 0 
5 0 0 0 0 0 42 0 0 49 0 0 31 30 0 40 35 26 7 10 25 0 32 11 22 5 0 0 0 0 17 9 28 4 26 4 13 0 0 12 0 0 9 4 0 0 0 17 42 0 0 16 0 38 99 39 
