56 32
0 27 52 50 2 21 0 0 0 0 23 0 40 0 0 29 59 18 20 0 22 0 0 57 15 8 0 0 27 0 18 0 0 32 14 34 14 0 0 18 0 7 5 9 14 41 0 0 0 34 0 28 17 79 66 5 
54 0 0 0 0 59 57 89 26 0 3 73 24 27 38 8 0 28 18 13 0 0 0 25 51 0 0 3 13 76 4 0 75 0 22 16 22 2 0 0 67 19 19 5 68 5 0 30 0 1 43 0 11 33 37 64 
0 20 21 28 47 0 0 0 0 42 34 34 58 14 23 1 9 8 0 40 0 38 0 0 25 8 23 14 26 3 0 1 0 0 34 20 0 3 10 20 0 0 27 0 33 4 34 2 3 76 0 5 16 41 0 13 
0 0 0 0 9 0 0 0 51 5 8 7 0 62 6 0 16 38 0 21 16 20 5 19 0 0 0 26 0 14 23 1 0 13 27 3 2 0 0 30 0 0 2 0 0 5 21 0 0 4 0 11 0 22 23 92 
41 0 0 34 0 39 15 25 43 34 6 0 34 1 0 45 0 0 0 24 33 3 0 0 9 39 19 0 0 0 20 1 11 12 4 1 33 11 15 14 0 49 8 45 39 19 34 2 0 6 25 24 32 15 0 0 
0 8 0 2 0 0 4 0 0 8 12 0 15 0 11 33 0 6 14 43 0 0 1 6 2 1 21 9 1 39 0 8 10 6 13 1 0 0 14 16 10 0 25 18 0 4 0 4 64 0 0 0 14 12 0 2 
19 0 2 5 5 0 37 0 13 0 0 30 0 0 0 39 14 0 0 25 0 0 1 0 21 0 0 16 28 24 0 19 0 18 34 16 0 8 0 20 0 0 20 17 0 7 0 0 1 43 0 0 31 1 0 55 
0 35 0 62 7 12 21 11 18 3 1 29 16 21 33 0 0 28 22 0 24 10 19 22 20 0 18 0 24 14 2 0 0 16 0 0 38 8 2 0 17 18 0 0 52 34 29 40 42 30 47 18 30 0 0 0 
4 0 44 0 0 0 0 0 42 0 35 0 0 0 12 1 0 1 14 2 0 2 0 0 0 3 0 8 0 0 0 0 0 7 21 0 0 8 0 0 0 8 0 0 0 2 56 2 0 4 82 0 0 0 0 0 
58 20 10 24 20 6 1 11 0 0 15 5 45 38 0 5 3 7 22 11 58 9 33 0 20 10 14 1 0 9 0 0 0 9 0 28 1 2 0 22 22 6 0 43 4 3 0 65 9 44 23 38 40 18 0 68 
20 19 2 27 17 0 0 0 0 0 6 115 3 0 9 18 0 0 1 29 20 19 30 0 0 15 0 0 9 0 24 1 0 17 0 0 29 18 0 0 29 7 42 11 3 2 0 3 7 0 0 32 30 42 0 44 
0 0 0 0 56 0 0 4 0 0 0 41 39 0 0 22 9 0 0 0 0 22 0 0 0 0 35 10 0 49 0 0 0 0 0 0 0 10 0 0 6 0 8 37 40 34 26 1 20 3 13 0 0 0 42 0 
4 84 0 0 0 3 19 3 0 23 10 44 19 16 25 0 29 0 0 40 9 0 6 18 17 6 21 0 6 4 0 25 19 0 27 16 24 0 27 67 0 9 11 0 0 5 0 11 47 4 5 32 0 34 0 27 
0 38 0 11 0 0 8 0 18 0 27 0 0 0 10 11 61 0 37 0 0 0 31 0 9 0 18 0 0 1 16 24 16 16 1 0 0 0 3 44 0 3 0 0 28 0 0 0 38 34 0 0 0 31 0 61 
0 0 38 0 0 10 13 0 13 34 0 13 8 0 18 0 0 8 27 9 13 4 0 0 7 12 0 0 25 0 18 0 18 16 29 0 14 3 0 0 54 0 0 27 16 36 49 7 46 21 4 3 0 0 31 0 
29 0 0 12 0 11 0 8 36 2 5 0 36 0 0 0 8 0 4 9 0 15 28 0 20 0 5 0 9 27 0 15 7 11 18 39 22 26 0 7 19 3 3 12 10 0 24 0 0 15 0 12 62 0 19 56 
11 0 0 8 0 2 6 22 0 0 19 27 20 27 30 21 0 0 9 0 22 0 6 20 3 19 7 3 0 0 14 35 0 26 0 27 8 22 2 0 55 0 22 20 27 0 0 0 0 37 0 2 37 0 0 43 
1 36 0 0 0 51 53 0 0 8 12 0 0 0 0 0 0 0 9 0 0 0 0 11 0 0 0 6 0 7 7 0 0 7 59 0 7 57 11 4 11 0 0 0 3 5 41 9 0 2 53 14 0 0 0 0 
9 40 7 12 0 47 7 22 30 2 4 24 0 24 0 4 12 24 35 0 0 54 5 0 10 16 23 0 14 38 5 2 0 24 23 5 1 18 26 23 24 40 1 0 14 0 0 0 18 0 0 0 51 19 28 34 
0 10 0 20 0 0 2 0 13 30 14 36 28 1 8 11 16 0 15 5 0 3 0 0 3 0 0 0 0 0 16 0 6 6 6 3 0 0 0 24 0 0 7 3 0 0 0 54 0 6 38 0 19 0 0 0 
0 8 86 3 12 0 0 0 0 8 0 3 38 0 0 4 22 0 62 0 3 25 0 5 0 22 0 0 0 5 0 0 19 0 21 0 2 0 34 8 0 0 0 18 3 0 37 0 0 0 38 0 50 22 2 37 
24 0 0 0 0 41 54 0 20 0 3 5 39 0 1 57 5 0 16 0 0 0 8 0 24 1 0 0 42 17 0 0 0 0 0 0 6 0 13 0 9 26 5 8 0 0 48 0 0 0 22 52 46 0 0 20 
0 17 33 16 24 37 32 0 48 4 19 24 13 19 0 0 0 0 17 45 22 0 9 0 6 1 28 21 20 37 0 4 0 8 0 119 11 0 12 0 0 0 0 3 0 3 8 6 15 20 0 78 26 6 0 0 
0 79 0 3 23 0 0 0 0 0 44 82 18 0 12 3 0 26 26 23 0 0 10 0 2 15 17 0 34 16 0 20 0 0 13 7 0 0 2 0 54 0 0 59 0 26 8 18 0 4 32 14 5 1 29 0 
0 0 0 24 0 0 7 0 45 1 2 11 0 0 23 15 3 15 0 6 2 0 0 12 27 19 0 20 6 0 2 8 13 3 19 5 0 0 7 0 0 0 0 0 0 7 16 15 2 3 0 77 0 19 1 0 
0 0 0 6 0 0 0 6 0 0 0 0 25 0 0 0 22 0 0 20 0 19 10 0 0 4 0 0 28 3 0 19 1 3 0 6 0 0 24 0 12 13 7 24 0 3 0 18 0 29 0 18 0 0 38 0 
0 0 19 0 22 0 23 36 2 4 0 44 14 10 24 25 60 0 5 0 0 0 18 0 0 0 11 0 5 6 0 0 25 6 0 0 0 0 5 19 24 0 27 33 7 43 2 0 2 13 0 0 0 42 12 39 
31 0 13 0 0 0 0 0 13 0 20 43 17 0 0 8 0 0 19 0 0 0 21 11 1 0 29 0 17 54 0 52 15 17 11 0 0 19 0 2 4 0 0 33 5 0 4 0 0 38 0 3 0 24 1 30 
97 0 0 18 0 0 0 16 4 1 0 3 1 57 7 0 0 0 29 13 0 13 0 16 22 0 0 0 22 23 11 0 24 3 0 0 3 0 10 3 8 0 21 0 0 0 0 18 0 36 0 3 0 53 0 0 
49 12 0 0 44 12 61 4 43 0 43 10 14 0 0 24 13 40 20 35 14 10 0 9 3 1 0 20 14 10 34 16 27 16 21 9 28 15 19 2 0 0 95 0 6 0 0 33 72 49 44 43 61 126 60 9 
10 0 47 3 0 0 3 0 0 0 29 0 18 0 18 40 0 32 7 21 0 0 0 0 51 1 12 0 6 3 14 0 34 16 15 0 0 5 0 0 2 1 0 0 0 0 0 0 0 109 7 24 24 0 0 0 
0 23 0 69 0 10 0 22 30 22 32 0 0 0 0 0 0 8 5 0 0 0 0 0 23 0 0 18 18 5 12 10 8 6 29 22 0 0 17 0 0 0 32 0 0 0 14 0 4 0 12 23 4 2 0 0 
