56 32
24 42 0 0 0 0 0 0 5 54 40 19 0 24 0 0 64 6 0 0 0 0 8 0 25 0 0 11 0 1 20 7 0 17 18 15 2 17 7 3 0 0 26 49 21 0 1 0 0 0 50 35 22 0 6 46 
12 0 60 18 42 0 0 0 22 13 0 0 12 17 18 0 4 51 26 0 33 29 25 23 0 23 4 17 0 0 16 14 2 13 0 0 21 23 0 60 0 11 4 4 2 28 26 24 45 29 0 35 0 3 0 0 
0 0 0 0 0 0 0 58 37 9 10 35 13 0 28 0 0 0 0 9 2 0 32 0 0 0 0 0 16 0 0 0 0 28 29 0 0 0 32 31 0 0 0 5 33 0 45 20 34 0 0 0 6 15 19 0 
14 0 0 49 28 7 0 0 0 0 4 0 22 12 36 0 2 0 4 8 36 36 0 18 0 0 8 0 22 0 0 35 40 0 22 21 0 32 7 0 25 0 0 0 21 0 2 0 0 0 25 0 34 0 0 10 
1 0 0 31 1 20 3 9 28 0 0 22 10 9 18 30 29 0 0 0 1 1 32 3 0 0 1 0 0 0 0 0 50 13 0 13 46 0 0 6 0 0 2 3 1 15 31 0 0 37 2 20 0 30 11 10 
0 0 0 0 24 3 18 0 0 1 0 0 0 2 25 2 1 26 0 0 13 12 9 0 22 16 27 16 12 0 0 0 2 0 2 29 0 0 22 6 0 0 33 0 0 0 24 13 0 0 0 0 0 0 37 0 
21 11 0 44 0 2 38 19 0 13 1 0 5 42 39 18 26 16 14 25 0 0 17 8 0 0 6 13 20 0 27 21 4 25 0 17 8 12 4 40 17 10 38 0 38 20 43 0 20 4 2 28 41 35 4 42 
0 2 34 54 0 0 30 6 0 1 0 0 0 39 26 0 4 0 12 15 6 0 7 0 0 0 0 0 29 7 0 0 3 0 7 5 65 5 0 7 35 38 5 5 15 27 0 0 0 0 15 0 27 2 14 27 
94 37 0 35 0 3 0 44 0 4 6 0 38 22 0 20 30 13 0 0 0 0 8 0 0 0 0 0 4 17 0 0 27 0 0 55 8 0 9 0 19 6 0 0 5 0 47 11 18 0 88 44 0 0 0 23 
11 2 7 38 5 20 15 26 35 13 0 44 0 0 0 10 0 0 22 0 26 8 0 3 0 22 4 3 21 0 0 0 0 22 0 0 14 0 0 0 0 15 8 37 15 0 0 7 0 0 14 8 0 10 0 42 
18 0 15 10 0 39 0 30 0 0 0 0 24 0 7 15 0 2 1 0 5 24 0 12 0 27 21 0 13 0 0 4 0 0 2 9 15 0 1 0 0 34 0 2 12 0 0 4 7 0 0 7 16 4 0 19 
53 0 0 9 28 98 0 0 0 0 43 7 5 0 0 12 4 36 0 8 8 0 0 0 0 7 0 0 4 0 2 27 7 0 0 0 10 9 0 0 6 0 11 4 0 0 27 20 43 9 0 0 0 60 0 0 
0 12 0 39 0 67 41 15 43 6 48 3 6 0 0 0 0 0 15 0 0 0 0 0 6 0 13 0 0 0 0 0 27 3 2 3 3 0 3 36 0 0 36 6 36 0 4 40 10 0 3 0 0 0 0 7 
9 0 0 0 0 26 0 12 32 0 0 1 0 51 0 20 0 0 0 5 32 0 0 0 0 26 0 9 0 0 13 0 12 0 0 33 14 0 0 0 0 22 0 0 0 22 62 6 13 0 0 19 38 7 34 23 
0 0 0 9 11 0 0 42 0 0 0 0 1 38 0 14 0 0 35 0 1 12 6 14 27 0 15 2 28 12 0 4 0 0 3 9 4 24 0 7 1 11 0 0 18 0 5 0 20 42 14 44 12 49 0 0 
0 0 18 57 7 0 35 15 0 9 13 18 0 8 27 9 1 0 0 10 23 0 0 0 14 12 0 0 0 2 23 0 3 20 5 0 0 14 23 9 1 5 0 9 0 36 14 17 0 46 8 0 0 11 0 19 
40 15 19 0 2 21 0 22 12 55 0 0 0 7 0 22 2 0 0 10 3 7 0 14 8 0 18 0 16 35 21 0 0 9 0 7 0 8 0 10 0 0 23 0 9 0 7 0 0 12 0 0 0 28 0 0 
9 25 0 0 0 0 21 0 46 0 0 0 7 8 0 39 7 70 0 8 0 1 26 23 3 22 11 5 16 5 16 9 9 1 0 6 13 0 0 8 5 21 8 0 0 0 0 45 1 21 0 17 3 0 4 10 
17 39 25 0 45 0 0 0 20 6 0 4 0 17 8 0 0 19 0 8 7 22 8 15 0 0 4 20 11 0 18 3 3 6 16 18 8 20 25 28 39 8 16 13 10 23 0 26 24 11 0 12 12 0 0 0 
44 0 0 12 4 0 1 6 6 0 0 9 8 0 42 8 0 0 0 0 0 22 11 12 0 0 0 0 22 0 0 0 0 0 0 0 9 26 18 2 12 0 0 61 16 0 0 21 0 0 0 0 38 0 0 17 
28 12 0 0 0 0 9 0 37 0 0 5 0 0 14 0 0 0 0 0 5 19 0 0 6 23 0 4 18 0 0 0 23 6 6 0 11 0 0 0 3 0 11 0 6 37 16 7 23 9 0 11 2 2 1 18 
0 0 34 0 32 0 3 43 2 14 0 10 57 19 5 0 14 13 3 0 5 10 0 7 0 6 5 16 15 0 17 0 0 0 18 0 46 23 0 0 8 0 0 0 14 0 3 22 36 34 43 49 0 0 0 0 
15 54 0 0 28 40 48 9 0 40 8 47 0 0 0 0 0 0 8 0 0 19 0 5 25 0 0 0 19 0 7 0 28 10 0 0 27 0 8 0 0 0 20 6 35 47 1 8 37 11 15 0 22 52 45 0 
0 51 15 0 0 19 27 4 15 27 11 31 32 7 4 7 0 15 51 0 20 3 0 5 11 2 0 8 0 18 22 0 23 27 0 0 11 2 0 0 0 0 5 5 32 9 20 38 47 0 18 33 0 0 0 46 
26 0 36 14 0 13 24 0 0 1 0 0 0 5 29 0 0 0 2 0 0 0 0 29 6 2 0 22 3 0 24 24 0 0 0 0 20 0 60 0 8 0 0 13 0 4 0 0 0 0 0 0 12 0 7 0 
0 53 15 20 7 1 7 17 18 0 19 10 6 0 32 0 0 26 0 0 28 0 5 0 25 0 30 0 0 15 0 5 6 0 0 8 39 13 0 0 0 4 7 39 0 38 36 0 54 0 19 0 3 0 35 0 
64 50 20 45 25 0 0 0 0 0 0 53 0 14 0 5 0 1 0 23 18 5 0 0 2 8 21 37 0 0 0 16 1 14 0 0 6 0 2 15 0 8 29 0 6 20 0 0 46 0 26 101 26 0 11 0 
50 10 0 25 17 15 14 32 0 1 0 0 0 0 36 22 0 1 23 5 6 11 53 0 6 20 26 9 25 0 10 9 0 12 2 11 11 0 22 0 16 4 22 21 0 51 22 0 2 0 0 10 0 0 26 0 
72 45 0 24 0 55 0 0 29 27 24 28 0 31 47 12 21 35 24 19 4 27 0 42 33 9 24 9 20 21 17 25 0 0 11 9 7 7 2 1 22 23 26 7 10 27 14 5 0 0 1 0 16 0 0 34 
27 49 0 1 59 20 21 44 0 0 1 0 41 28 0 20 0 0 18 28 35 0 16 0 0 0 17 0 0 4 0 0 0 0 0 20 32 1 0 0 0 4 25 0 0 0 0 47 2 20 0 44 15 19 1 6 
11 10 38 15 19 0 0 4 0 0 23 42 0 22 0 0 0 13 0 0 7 7 0 8 4 0 2 12 5 0 14 0 0 51 0 0 22 4 0 13 51 7 29 0 0 17 0 4 0 13 3 44 0 65 0 0 
0 36 45 0 0 41 28 39 15 37 10 13 0 0 9 8 0 0 33 23 22 2 17 3 0 0 53 0 0 9 10 21 15 3 1 0 4 0 0 15 4 19 9 17 21 44 39 45 0 0 14 75 0 0 1 0 
