56 32
0 5 39 9 4 0 0 0 1 31 0 0 0 7 0 0 0 0 0 31 11 0 0 12 11 0 0 0 0 9 0 25 0 0 0 18 0 10 0 0 0 39 13 0 22 2 16 12 3 0 0 0 0 0 0 6 
0 20 0 32 79 25 34 0 5 0 9 0 0 9 27 14 0 28 49 0 11 0 28 0 7 11 0 21 38 20 25 19 7 29 5 50 17 0 0 11 66 0 17 0 1 27 2 11 0 65 0 0 0 35 7 0 
0 20 25 0 18 27 0 0 19 0 83 0 11 29 9 0 0 0 0 0 0 10 10 7 0 30 0 32 0 0 0 10 20 0 7 0 0 2 0 0 0 0 0 31 29 0 27 0 26 17 63 3 0 43 0 30 
55 37 15 6 0 0 0 0 0 56 28 28 0 0 33 17 10 3 0 7 11 10 11 15 10 5 10 4 0 26 0 0 38 13 9 6 19 0 35 14 8 6 0 7 0 5 40 0 38 0 5 0 0 6 0 50 
33 0 28 0 3 8 48 3 0 0 28 0 0 0 0 0 0 1 38 19 18 19 0 5 0 0 0 0 29 0 0 0 22 13 12 0 28 1 48 0 31 4 26 25 8 0 0 0 9 47 5 2 44 0 31 0 
0 35 28 0 0 39 0 0 0 0 36 8 0 0 23 38 0 52 0 7 22 0 16 0 0 0 0 28 0 0 0 29 0 0 27 10 35 23 0 23 0 0 0 0 17 0 1 19 4 32 0 1 32 13 0 0 
0 0 0 0 0 0 8 23 0 29 18 65 13 0 13 0 28 17 0 21 24 0 17 25 12 22 0 30 0 26 48 0 55 0 14 0 0 0 4 0 0 0 20 32 63 0 0 0 25 17 0 4 0 0 0 19 
0 0 5 0 13 14 48 77 0 20 19 7 29 27 0 0 11 9 0 32 18 0 5 0 0 6 0 32 3 39 0 23 9 13 10 0 11 32 12 14 60 9 8 20 8 7 0 17 0 0 17 43 23 8 0 0 
12 0 0 0 30 30 42 9 23 0 2 9 32 9 15 4 39 1 0 61 3 17 0 43 0 10 6 4 17 19 4 14 17 0 35 31 26 8 0 0 33 29 5 20 0 19 7 28 29 33 0 25 0 0 0 0 
46 9 15 9 0 41 11 0 0 14 39 6 18 0 35 21 7 17 25 0 18 33 15 6 12 0 22 1 0 8 5 4 20 0 0 9 5 0 29 0 5 4 7 0 23 25 23 0 27 73 10 0 0 0 0 0 
35 47 32 92 47 0 0 0 0 5 4 0 23 9 26 0 4 0 21 21 18 8 8 0 0 0 17 0 11 2 2 0 0 20 40 21 17 36 19 0 0 7 9 15 41 31 0 24 22 0 0 41 16 0 0 0 
0 0 2 52 0 0 4 0 0 5 0 0 4 0 27 7 0 4 0 0 0 0 6 15 0 0 7 1 1 0 0 0 0 14 0 0 0 0 13 0 14 0 10 0 10 0 6 24 19 0 1 0 0 2 16 54 
34 0 24 0 43 32 4 0 0 9 0 11 35 0 0 7 28 9 0 14 2 9 0 23 6 0 31 7 20 14 45 9 56 0 8 6 0 6 0 6 0 12 9 3 6 2 17 105 14 0 1 0 8 23 35 53 
0 0 0 0 22 0 0 0 11 0 0 3 37 0 13 26 0 60 0 13 0 0 0 0 0 15 22 1 0 18 0 0 0 0 22 26 0 0 0 0 0 25 26 0 0 10 18 5 14 1 2 0 38 6 0 0 
0 13 0 128 0 0 8 0 0 0 13 25 4 0 13 11 3 17 21 0 0 0 0 0 6 0 23 14 24 0 2 20 0 0 11 5 0 0 20 9 10 1 0 0 16 57 0 0 14 0 0 0 7 24 51 0 
0 17 30 34 0 10 0 0 8 0 31 43 14 42 37 0 14 4 28 0 0 35 19 0 0 9 0 0 14 1 0 30 32 0 3 7 18 6 29 0 0 26 11 3 8 0 12 9 2 0 23 4 5 0 43 42 
0 16 0 9 16 0 13 0 0 17 32 0 6 12 0 0 9 0 12 64 1 19 0 11 0 8 23 0 13 0 3 0 0 4 0 13 8 0 49 20 5 17 26 6 8 0 16 1 0 0 31 0 14 11 0 0 
23 0 0 0 11 0 17 0 0 45 0 27 30 9 53 6 29 0 32 39 0 7 19 3 43 6 0 0 17 11 8 0 0 8 0 0 14 0 33 0 4 55 25 8 3 46 0 5 0 9 2 3 1 0 48 31 
0 0 39 1 5 3 6 0 3 74 0 0 25 2 8 21 0 0 33 0 23 47 6 15 9 10 23 0 4 4 0 7 0 24 14 0 10 25 0 13 3 66 6 0 0 0 25 0 0 0 0 30 0 26 17 0 
0 0 1 7 10 10 0 0 0 0 41 0 0 0 19 3 0 0 0 0 0 0 23 0 0 24 0 0 0 7 0 0 1 26 10 12 13 1 8 12 0 0 0 0 7 0 0 12 0 7 28 48 0 4 18 0 
38 0 0 0 23 43 34 0 0 12 26 25 8 0 0 9 0 0 0 15 0 15 11 0 0 12 0 21 26 14 0 0 17 0 24 0 26 0 36 8 0 0 0 38 8 6 17 0 33 0 0 0 0 0 13 0 
31 136 26 0 20 11 9 0 23 24 31 0 5 5 0 2 26 11 0 17 1 31 1 2 0 1 0 0 20 32 7 85 0 14 1 0 20 54 0 0 36 40 21 10 0 35 25 4 0 0 0 11 0 0 0 0 
0 37 4 0 0 0 39 0 0 0 0 47 63 0 0 0 14 0 0 2 9 0 0 13 0 19 0 21 12 6 7 0 12 21 0 0 0 0 2 0 0 0 10 6 64 23 13 0 20 0 39 0 7 42 0 0 
55 0 0 0 19 0 5 0 37 27 0 2 13 8 0 17 0 17 7 10 12 5 14 23 0 13 0 0 0 6 10 14 13 0 34 0 0 8 17 19 0 0 0 35 0 1 0 7 0 3 41 0 16 4 0 8 
46 22 0 3 0 0 0 0 40 0 0 0 2 13 56 31 0 0 0 1 26 0 6 22 25 0 10 0 0 0 0 7 0 13 0 0 43 0 2 1 20 0 0 0 11 0 16 2 45 25 0 0 0 4 0 0 
0 0 0 9 0 12 2 0 0 0 40 0 5 9 0 11 27 5 15 0 25 0 16 36 8 0 11 1 24 3 0 1 21 7 0 0 0 32 14 0 14 35 0 42 0 7 28 15 2 0 0 62 15 0 44 0 
1 0 0 12 14 24 0 26 0 5 21 0 26 0 15 3 11 0 0 13 39 0 17 0 0 13 5 6 4 15 0 12 0 26 0 23 26 33 17 0 0 0 4 0 5 25 0 7 23 3 0 47 0 0 8 19 
8 16 67 33 38 23 40 2 13 0 0 4 0 2 16 28 0 11 24 36 29 5 30 12 7 0 26 23 0 1 41 26 19 10 0 0 0 27 52 0 37 4 56 27 0 0 11 32 59 29 15 20 0 9 15 9 
54 6 0 9 11 0 0 46 32 0 0 20 6 23 63 63 0 0 0 6 18 9 0 8 11 0 0 0 0 0 16 7 7 0 0 20 0 17 5 0 25 0 0 0 11 0 0 39 0 17 0 13 0 80 94 11 
2 1 7 39 10 0 4 10 13 27 34 18 10 0 12 0 35 43 0 21 0 16 14 2 0 6 0 0 28 42 0 9 0 0 10 25 40 16 0 0 21 15 39 0 34 0 38 1 6 13 15 35 35 0 0 0 
47 12 0 0 0 50 0 0 0 26 0 0 18 0 0 0 0 0 0 0 44 0 0 6 0 0 0 0 4 6 11 0 31 29 5 24 5 7 14 5 14 5 36 23 0 0 0 47 19 7 0 0 14 0 0 50 
4 0 94 0 31 50 0 0 45 2 28 42 30 9 0 31 0 54 2 39 8 0 4 0 1 18 0 3 0 19 18 1 0 0 0 23 0 70 28 21 0 4 13 35 13 0 6 36 75 36 48 0 43 16 37 45 
