56 32
40 13 62 0 18 0 11 0 0 28 41 26 0 1 21 0 25 17 19 10 0 1 53 34 7 0 21 0 0 10 0 10 0 0 43 18 0 0 19 0 40 0 0 0 18 28 33 0 17 0 0 0 0 51 0 0 
4 50 9 52 4 44 12 29 10 29 0 27 28 12 0 15 0 0 0 6 0 5 0 0 0 6 19 2 0 6 3 17 0 0 0 23 46 52 17 34 52 0 0 0 0 56 18 0 17 6 0 25 22 18 0 63 
0 0 6 0 47 0 3 10 4 0 0 26 0 6 0 8 9 13 9 0 0 0 0 0 0 0 15 7 5 25 28 12 9 1 20 0 0 0 34 11 35 15 0 17 27 13 13 0 8 4 16 0 0 0 0 0 
48 0 35 35 0 20 27 20 0 0 0 14 0 0 0 53 32 0 9 25 9 0 19 15 0 0 18 63 17 9 19 4 21 0 0 27 14 15 35 0 16 0 28 0 36 31 0 29 33 0 0 19 0 0 0 21 
0 0 0 0 0 38 0 0 10 29 0 14 0 0 0 1 6 0 10 24 0 0 0 16 0 19 0 0 0 3 0 0 4 0 16 0 14 21 29 16 0 0 0 83 0 36 2 0 0 0 30 0 0 0 0 14 
29 26 0 0 0 0 3 16 11 0 24 0 38 5 9 6 0 7 0 0 16 14 0 14 3 0 0 12 7 61 10 8 0 6 0 47 2 1 20 18 25 0 13 0 0 19 8 0 0 0 39 0 3 30 39 54 
0 0 101 27 0 0 0 45 6 14 29 6 9 42 6 28 30 0 0 18 20 9 35 14 9 6 0 25 0 14 15 0 22 0 0 0 29 1 14 0 0 0 0 28 8 51 32 0 81 0 26 71 37 12 38 33 
21 5 7 0 23 0 17 9 0 4 32 0 23 14 0 30 9 0 3 0 0 21 7 6 0 0 0 0 0 2 0 0 19 24 0 0 12 0 0 0 0 0 0 11 0 24 0 0 0 6 0 41 0 0 13 0 
0 0 80 6 0 0 0 0 24 0 0 0 27 0 12 0 0 0 0 14 12 2 2 17 0 0 0 0 0 2 11 0 28 0 0 0 16 0 7 64 7 16 0 5 7 11 3 44 0 16 0 6 27 4 8 0 
0 0 9 0 0 0 36 0 0 29 0 33 0 0 6 0 37 0 74 1 6 17 0 10 0 16 0 14 31 7 0 0 0 3 9 0 24 34 31 0 3 19 0 0 33 0 0 0 41 0 32 5 0 72 0 17 
0 35 28 0 3 3 9 10 4 0 0 1 10 0 25 4 16 32 15 0 5 4 8 0 0 10 0 0 17 19 1 0 23 0 13 14 56 13 0 35 9 0 3 0 0 14 1 0 0 60 3 0 0 0 0 23 
39 33 8 31 0 0 25 0 0 4 8 0 9 0 0 10 0 0 1 0 0 0 0 0 0 8 18 0 10 13 1 0 9 3 15 35 3 13 0 38 0 0 0 34 11 1 9 0 0 0 0 3 0 0 0 0 
0 12 0 0 2 0 23 15 0 41 1 6 0 15 0 19 20 0 8 0 0 34 34 25 1 0 0 0 11 12 0 22 0 32 9 0 0 39 12 0 0 45 0 14 0 0 0 19 0 28 0 0 52 0 4 37 
11 2 8 0 53 0 19 2 13 17 13 46 11 4 39 0 12 0 7 0 13 1 25 0 10 15 13 19 1 21 7 23 13 22 0 37 22 12 25 9 0 14 0 14 2 2 32 0 38 11 25 20 1 0 33 0 
17 0 0 81 49 13 16 14 2 83 7 4 41 0 4 45 22 11 0 0 0 14 7 0 21 0 0 4 25 0 0 13 0 0 0 7 0 0 3 0 0 0 3 0 12 21 37 0 0 10 12 4 0 8 0 49 
4 3 28 26 32 0 20 27 14 38 0 0 0 0 40 0 38 0 37 0 0 13 0 2 15 25 18 25 0 23 13 1 28 2 18 8 50 0 0 0 13 5 2 7 33 0 18 23 0 18 25 0 0 3 24 20 
2 11 0 10 44 14 0 0 13 38 0 0 11 0 0 0 0 0 0 18 0 0 0 0 0 13 0 0 0 3 11 0 7 0 0 0 0 18 17 0 38 10 0 0 0 12 6 24 0 0 0 0 0 0 0 17 
0 12 0 0 0 0 0 24 9 45 12 30 0 0 0 0 36 20 0 0 0 0 0 3 28 0 9 0 3 0 0 4 9 0 0 0 13 0 12 0 0 0 0 0 11 7 35 0 29 7 0 0 1 0 57 2 
11 0 63 21 7 25 11 12 0 10 4 26 0 0 24 0 0 11 8 42 0 0 0 15 6 46 0 0 0 15 10 12 21 8 0 0 10 0 0 25 2 8 41 11 8 0 14 1 11 11 28 3 13 40 22 33 
36 0 18 48 0 10 0 0 25 0 8 80 0 11 53 25 19 0 16 0 4 0 1 5 28 29 24 0 0 4 5 8 5 25 0 19 72 19 15 0 33 0 0 17 0 17 26 0 37 1 47 73 11 23 0 0 
0 0 47 10 4 0 23 0 36 0 0 13 10 0 3 0 10 0 42 30 12 0 28 15 8 17 0 0 11 51 0 0 0 0 6 4 11 0 0 34 16 0 28 25 13 0 27 0 0 17 26 29 15 0 1 4 
0 36 0 41 25 7 20 11 42 0 30 0 10 52 0 4 0 10 6 0 3 0 26 4 4 0 35 0 42 12 0 0 0 0 3 0 0 50 33 10 50 0 0 0 39 11 8 30 8 0 36 36 0 6 26 0 
0 0 0 33 0 0 0 0 0 13 0 8 26 0 3 0 34 27 0 4 0 4 0 5 0 0 0 0 0 4 11 0 0 2 19 0 35 0 26 0 11 0 0 25 27 0 0 17 0 0 34 0 0 0 24 0 
18 0 28 0 4 20 10 0 0 26 0 0 0 25 0 9 0 6 10 0 5 0 0 0 31 47 2 0 0 1 16 5 0 0 13 67 3 4 42 18 15 15 0 0 5 0 0 17 13 5 6 2 18 0 17 49 
6 0 0 0 0 48 4 0 0 3 45 0 0 0 0 21 0 0 23 0 0 0 0 14 23 28 5 0 0 31 0 14 8 3 4 24 0 0 0 0 10 0 7 5 3 2 5 18 0 7 4 41 0 20 0 4 
0 15 34 36 2 0 0 37 0 0 0 7 0 9 0 26 0 0 6 18 32 0 0 18 1 0 1 0 20 3 11 28 0 0 27 1 49 4 20 23 9 26 0 9 4 0 0 0 4 6 0 0 28 10 0 20 
7 0 49 8 10 33 0 24 12 8 30 0 45 0 0 23 31 0 19 1 0 4 14 25 29 0 72 15 11 4 25 17 20 0 8 4 10 0 42 29 44 13 34 0 33 0 0 8 56 16 0 66 17 0 28 0 
0 50 34 0 4 33 0 0 2 0 18 7 0 15 0 14 0 0 18 10 9 14 17 21 0 0 13 0 4 12 13 25 12 0 0 14 34 0 0 63 0 14 0 35 21 0 0 0 28 3 2 22 0 0 2 10 
0 11 33 0 38 0 27 0 5 31 34 6 36 25 21 0 12 0 30 24 8 2 0 2 0 12 1 25 0 6 0 47 6 0 21 61 32 62 22 16 26 48 23 0 34 19 20 55 18 20 0 6 0 0 54 36 
67 12 19 28 16 0 27 11 40 0 12 40 0 30 34 0 0 0 21 0 0 0 29 0 0 0 14 0 0 0 0 50 0 24 0 0 23 8 20 5 7 0 42 5 11 0 1 4 8 19 6 95 3 22 4 6 
0 42 24 30 23 48 27 0 3 12 12 0 19 1 28 19 23 33 0 23 0 16 0 0 35 8 0 0 0 5 28 11 0 28 30 0 20 18 16 11 0 8 15 15 0 11 2 14 0 21 0 24 18 0 29 22 
0 19 23 0 0 0 20 46 0 0 0 44 0 12 0 11 0 14 37 0 0 4 0 19 0 0 4 0 10 11 0 0 16 24 29 6 21 20 0 0 0 8 35 0 4 0 14 0 0 8 0 7 0 46 0 81 
