56 32
39 25 36 12 26 65 38 0 16 56 18 0 0 0 0 45 25 0 0 0 29 14 17 28 0 0 18 7 30 12 18 0 0 0 11 39 0 0 36 0 5 38 0 29 14 30 0 0 67 0 0 2 0 45 0 19 
4 84 0 0 0 0 5 15 0 0 14 0 38 0 0 0 29 0 0 0 22 11 0 9 0 0 0 35 7 0 0 21 0 21 7 0 0 0 0 0 8 0 0 20 20 1 34 23 8 0 0 7 7 0 0 1 
0 0 0 9 0 10 0 15 24 0 0 0 5 0 0 13 25 0 1 0 0 0 0 0 0 56 33 0 0 0 0 0 0 0 0 0 0 0 5 0 0 33 16 4 0 0 0 56 0 6 42 0 27 0 0 0 
0 50 31 80 11 111 0 10 0 38 0 6 28 12 0 1 0 0 4 0 13 24 0 26 26 0 25 14 41 0 0 0 19 39 0 32 11 9 25 42 0 39 0 15 6 22 16 7 12 0 23 35 13 3 0 2 
0 100 0 0 33 20 0 34 1 0 35 10 0 11 0 14 0 5 31 0 10 0 21 0 0 0 0 7 0 48 16 1 0 0 24 0 0 0 20 5 0 40 35 14 0 35 0 0 0 40 0 1 28 0 0 0 
4 3 0 14 30 0 54 0 45 27 21 22 4 0 2 6 0 0 28 0 17 19 0 0 16 0 10 18 0 5 7 1 17 0 38 16 27 0 0 14 20 0 2 0 40 0 28 0 0 0 0 1 0 44 0 0 
10 3 18 38 0 22 0 0 0 35 0 0 2 15 32 7 14 0 0 19 0 0 4 29 6 2 17 24 15 25 0 0 6 5 0 0 33 17 21 14 0 38 13 34 4 7 32 14 12 25 14 0 22 5 25 29 
10 11 0 0 0 0 46 0 0 26 19 52 5 0 5 0 17 31 5 1 0 0 13 5 48 21 13 4 0 0 17 0 4 32 9 0 0 28 0 122 0 0 20 37 32 23 58 0 7 0 26 22 13 0 1 34 
0 60 37 42 9 3 0 0 0 20 75 0 2 2 13 0 27 0 24 25 15 7 14 5 9 7 25 34 8 20 0 0 0 24 0 12 43 0 20 66 17 14 45 24 53 23 0 3 0 10 34 9 0 3 41 0 
0 3 4 18 2 0 53 4 0 25 39 35 9 0 5 0 10 35 12 17 22 43 5 16 0 9 13 0 0 25 9 0 11 17 18 7 1 7 0 2 0 23 16 21 29 8 0 27 0 0 25 6 0 12 25 0 
15 0 68 19 67 0 14 0 18 1 2 16 0 35 0 12 2 13 2 0 0 0 0 9 4 21 16 0 0 21 7 0 0 0 0 32 0 0 0 0 0 0 0 2 3 24 20 0 5 0 42 6 9 51 51 0 
55 5 0 43 39 13 0 0 0 15 14 1 0 11 0 0 34 12 0 13 0 8 0 20 16 0 2 0 0 29 0 22 32 5 4 0 4 0 0 13 0 25 0 32 0 0 0 0 0 6 0 3 0 0 3 53 
0 9 34 17 0 0 39 1 37 7 16 0 0 0 0 40 5 8 0 9 18 0 23 0 21 3 16 0 0 12 0 0 16 23 0 0 4 6 19 14 32 19 0 0 0 0 0 11 2 0 15 0 46 0 10 40 
17 0 27 0 32 0 0 0 0 27 12 18 15 10 0 31 3 0 0 16 0 0 6 10 3 0 0 10 6 18 0 0 0 6 0 33 5 9 0 0 0 0 4 12 0 26 9 0 33 0 0 0 0 0 15 1 
0 25 11 0 40 16 9 17 18 0 0 0 38 7 5 0 0 0 13 0 1 7 0 7 33 33 22 7 0 0 3 8 0 5 0 10 23 13 0 27 0 4 12 0 26 0 21 0 0 0 51 0 0 0 0 0 
4 0 0 0 0 30 0 27 12 0 14 0 0 3 0 64 3 0 0 0 11 5 0 4 10 22 0 7 0 11 8 11 6 0 40 30 0 0 0 0 24 0 0 6 7 0 0 13 12 0 0 0 0 0 39 0 
119 70 2 0 0 0 1 0 35 0 0 0 0 0 7 0 5 0 2 0 0 0 21 0 15 0 12 27 0 22 0 0 10 0 0 0 14 4 45 0 0 3 0 35 44 0 0 2 0 6 8 0 28 1 0 1 
0 48 0 1 8 0 0 28 15 26 7 0 14 0 34 0 0 35 0 0 11 0 4 4 10 3 14 0 17 6 5 0 0 0 20 0 11 11 0 22 0 0 0 0 0 5 0 30 1 42 4 0 0 47 0 9 
0 17 0 0 0 0 42 0 9 22 21 0 0 0 25 31 0 0 3 5 0 0 31 26 17 1 6 12 22 8 12 52 6 0 0 0 0 3 9 25 3 17 30 12 17 3 0 11 35 8 0 0 3 9 32 14 
63 18 6 0 22 7 46 27 2 2 7 0 7 15 23 0 39 15 0 0 9 0 0 14 8 17 50 25 0 19 18 9 18 15 24 13 0 16 4 38 0 3 1 16 61 34 22 39 5 0 34 24 54 0 0 2 
20 0 0 0 0 0 11 0 0 0 0 0 0 0 0 0 16 0 0 0 4 0 0 6 1 10 0 0 0 8 0 6 36 27 13 7 0 7 0 5 13 0 11 27 38 0 0 13 0 0 0 0 7 15 11 3 
0 14 0 0 0 17 3 45 0 0 10 2 24 34 0 1 27 5 0 9 0 8 1 3 4 1 1 17 16 0 17 0 0 10 17 3 16 0 0 0 0 13 0 33 41 0 0 0 0 0 0 0 42 0 0 19 
44 0 26 0 0 0 0 41 0 13 0 0 0 28 40 69 0 0 11 0 22 0 0 3 0 7 39 0 7 6 0 23 7 20 0 0 0 11 0 2 0 14 0 0 66 10 15 0 41 6 0 0 0 20 78 30 
12 0 0 42 0 0 15 0 0 0 0 14 0 0 7 30 0 15 4 13 22 0 0 0 6 5 23 22 10 2 0 0 0 12 11 25 0 15 52 14 5 0 0 23 0 33 0 2 0 31 0 0 34 0 0 3 
0 11 89 8 20 13 5 23 0 0 7 0 3 0 11 3 21 46 1 18 0 19 8 0 0 0 16 2 41 3 0 2 0 20 0 3 2 0 0 0 2 39 0 15 8 10 0 45 6 0 5 0 27 0 75 0 
21 49 29 0 0 6 0 25 17 25 0 17 3 0 59 2 0 0 17 0 0 12 13 0 26 16 12 26 0 0 22 17 25 39 4 9 1 3 0 0 0 35 9 0 46 7 0 0 56 40 23 33 0 65 0 22 
12 12 4 0 2 0 22 19 0 6 21 15 29 0 0 13 1 5 0 13 0 0 0 9 0 20 9 0 0 0 22 29 0 2 19 0 34 2 0 21 2 29 0 0 11 20 0 49 48 7 0 16 8 0 53 0 
81 23 19 0 22 45 93 0 3 5 45 31 0 0 5 24 1 28 0 33 0 8 6 0 22 12 9 0 0 25 0 27 0 12 8 13 1 1 22 27 19 3 34 0 38 28 2 0 46 0 9 0 33 0 0 4 
0 0 28 0 7 38 3 25 0 11 0 3 15 0 0 49 16 15 0 0 0 4 0 24 1 7 0 4 0 30 0 3 26 22 23 0 22 0 26 13 0 0 0 32 0 0 25 37 24 8 3 17 4 0 15 3 
1 1 0 0 0 0 19 0 2 11 0 22 42 0 14 41 1 0 0 0 0 6 0 30 17 0 0 0 27 28 10 0 14 10 0 0 0 3 10 1 1 0 0 0 0 0 0 0 0 0 5 0 0 0 21 0 
99 23 26 0 12 0 45 0 12 0 18 3 0 0 3 11 12 51 0 7 0 22 0 26 66 12 0 0 2 0 0 0 0 23 0 11 0 12 0 27 10 0 25 26 0 23 20 13 30 26 0 66 0 0 54 0 
8 16 2 0 23 0 57 0 16 0 10 0 35 9 14 21 0 2 0 20 30 44 0 0 15 0 20 0 0 27 11 5 0 0 0 5 35 0 32 8 47 11 33 0 13 0 0 0 27 1 31 0 51 0 0 0 
