56 32
0 0 35 6 6 10 19 0 41 0 25 31 35 8 1 7 20 0 12 0 4 0 27 21 20 27 9 0 2 27 11 76 0 27 10 0 63 36 0 22 63 0 15 4 10 2 1 18 24 61 0 15 5 20 0 19 
0 35 0 1 0 0 17 28 33 0 0 0 35 12 0 2 0 30 0 7 0 0 0 25 0 0 0 0 0 0 0 1 49 0 0 0 17 2 0 5 27 40 6 0 0 0 7 65 25 10 0 0 37 47 0 0 
0 8 0 27 30 0 23 0 0 22 35 2 43 0 0 0 6 46 0 21 0 0 6 6 0 0 2 0 17 0 51 23 13 0 3 8 19 6 0 16 49 0 0 32 0 30 26 30 14 0 26 0 7 0 60 1 
0 3 52 0 52 0 3 0 0 7 43 2 21 18 27 0 1 19 0 15 28 0 28 0 31 19 0 7 0 0 0 31 0 54 0 9 0 13 20 7 16 14 3 31 27 0 0 34 17 14 17 35 0 0 66 0 
76 0 0 0 21 0 0 20 73 4 34 0 0 0 32 0 0 0 36 0 16 28 22 0 15 25 4 0 46 0 3 22 0 5 15 0 0 0 0 12 1 7 2 0 43 0 6 12 30 26 7 0 0 53 36 0 
0 0 0 46 0 0 0 0 44 28 4 14 0 40 4 25 0 2 22 0 0 0 0 0 0 0 11 14 0 0 0 0 0 0 0 0 12 28 2 0 0 15 9 0 12 0 0 8 0 0 0 9 44 40 0 17 
16 49 0 47 6 0 85 0 9 0 0 11 0 15 0 10 0 0 0 19 0 30 4 0 0 0 0 13 16 6 0 0 0 6 20 1 0 15 4 18 0 0 6 0 21 0 0 40 0 6 89 30 4 0 25 0 
15 7 0 0 0 47 1 0 0 47 25 41 24 60 20 41 0 22 10 43 1 0 23 0 17 0 4 1 20 2 21 35 0 0 7 55 7 7 23 26 21 10 17 0 0 13 31 0 17 0 0 20 127 0 0 0 
0 0 16 43 27 11 0 0 0 46 6 34 0 3 0 39 0 5 3 22 0 4 5 0 0 0 8 0 0 0 0 28 0 13 0 0 23 6 0 20 0 13 0 1 1 34 13 0 0 0 21 0 0 0 39 46 
0 13 3 0 40 0 2 0 5 0 0 15 40 39 13 0 0 0 1 0 0 0 11 0 0 0 13 0 0 0 0 10 0 13 0 10 11 0 18 13 0 15 38 4 3 0 0 2 0 0 5 0 85 0 21 6 
0 0 16 0 14 43 38 0 0 54 32 0 0 9 0 0 6 0 19 10 18 1 0 0 0 14 7 0 0 0 0 0 0 0 16 8 19 15 5 7 12 0 3 0 47 18 7 0 43 0 0 0 4 9 0 8 
19 47 0 0 3 6 0 0 0 13 22 4 11 17 0 7 20 4 0 21 17 8 0 0 20 20 0 13 9 8 7 0 0 0 25 0 0 0 0 0 21 38 0 0 0 0 0 0 47 29 26 0 20 0 0 0 
0 4 20 0 0 35 0 0 12 0 0 0 0 0 0 0 0 1 0 19 13 0 0 0 12 0 18 9 0 8 0 13 0 23 0 7 15 12 29 31 18 1 47 13 0 0 1 6 0 0 0 14 47 0 17 0 
57 4 33 0 9 13 11 6 6 31 10 22 25 1 0 12 2 1 14 0 16 31 0 0 0 21 16 18 14 11 0 2 0 13 0 18 12 25 8 3 31 0 32 0 2 19 48 1 0 0 0 51 15 0 0 16 
34 35 0 39 3 0 0 5 0 27 1 20 0 24 0 65 39 0 7 0 29 20 0 0 0 0 0 0 10 10 0 10 0 13 6 17 8 0 0 10 6 3 0 40 0 0 30 0 0 0 37 0 0 0 13 40 
4 0 51 10 0 0 68 4 12 18 0 26 0 4 0 4 0 0 0 24 0 25 11 15 23 0 4 0 0 5 19 0 0 0 16 0 0 0 15 0 0 12 0 28 1 6 3 15 1 10 0 15 0 176 0 6 
40 29 0 31 28 0 0 0 0 22 0 5 35 30 12 24 5 0 0 37 0 0 6 17 0 0 17 0 20 2 0 12 12 0 33 0 2 4 15 21 14 22 14 20 4 0 0 81 51 0 0 0 46 1 0 0 
0 59 43 0 0 22 0 0 0 0 14 13 11 0 2 0 2 20 7 0 5 0 17 14 6 4 0 0 8 0 0 19 0 0 0 0 19 15 0 3 0 16 17 1 12 41 0 0 0 14 19 0 0 0 6 0 
0 25 44 0 15 26 0 38 7 0 32 50 15 21 29 8 0 7 7 19 0 0 9 0 19 28 16 15 0 0 17 5 0 7 24 0 5 47 0 0 0 34 31 30 1 21 8 21 4 0 10 0 32 28 36 36 
29 85 0 0 27 23 35 13 31 9 5 0 7 0 0 0 10 0 37 6 0 0 0 19 23 6 0 9 24 0 16 17 5 7 0 44 45 0 0 30 0 11 19 0 0 39 45 0 0 0 0 0 10 0 0 37 
0 55 4 30 5 26 0 7 12 0 43 0 0 54 6 0 0 13 36 5 7 0 14 28 19 8 48 26 14 0 0 4 25 45 0 27 8 0 21 49 0 3 11 22 1 13 13 10 16 23 2 15 39 3 36 16 
0 58 0 9 33 0 16 15 0 0 0 0 26 0 8 0 0 0 12 0 11 6 56 29 24 7 0 0 21 0 12 14 7 0 0 0 12 0 13 0 3 55 38 0 4 0 18 0 24 0 0 0 11 31 9 0 
31 29 0 0 0 0 0 0 0 0 24 47 0 0 0 19 30 5 30 14 3 61 45 0 0 0 0 0 0 10 32 5 0 9 25 0 38 27 4 4 6 0 2 32 47 23 30 0 27 0 0 0 25 0 0 54 
3 21 0 1 1 10 23 0 8 12 4 14 0 0 4 6 4 2 3 0 0 0 0 21 0 0 0 0 0 0 0 3 2 0 1 0 0 0 13 0 0 2 0 0 0 2 0 2 0 0 0 0 0 0 2 0 
0 5 47 18 0 0 16 15 5 7 23 1 0 43 0 10 7 0 0 0 28 18 20 0 0 14 14 18 8 0 0 4 5 0 0 0 23 0 12 18 32 23 11 9 4 14 0 0 11 0 8 0 1 0 4 31 
10 49 20 0 92 26 0 8 36 0 32 52 0 52 8 3 22 2 30 0 34 0 4 14 1 0 0 9 14 25 24 9 27 40 12 26 25 28 0 7 0 0 32 0 0 31 44 0 15 0 50 16 0 0 24 72 
34 9 14 20 12 55 16 1 14 39 0 38 22 2 0 0 0 30 3 0 10 13 13 0 21 8 2 0 19 0 16 12 0 0 18 0 0 4 19 4 0 0 17 12 0 0 0 48 0 0 20 14 44 1 0 0 
125 0 0 1 0 0 0 0 0 0 22 9 14 24 49 19 3 10 29 15 11 19 47 27 0 27 14 6 25 27 0 16 4 24 32 0 2 0 18 21 19 0 0 81 21 0 14 0 0 5 21 0 2 0 22 0 
0 0 0 32 45 1 1 0 33 25 0 0 0 0 0 10 34 14 9 43 21 6 0 0 0 17 17 0 0 0 0 0 0 8 55 0 6 34 5 0 20 6 3 5 24 26 0 5 0 1 61 0 10 8 13 26 
42 0 0 26 2 23 2 52 0 0 19 28 31 32 0 0 18 0 21 28 0 29 0 0 0 0 13 0 3 29 25 24 0 0 16 15 0 0 0 6 0 2 34 8 0 32 17 28 0 0 52 30 24 0 17 9 
96 39 16 14 0 0 8 0 72 33 0 14 0 0 19 16 0 9 0 0 16 0 0 14 12 0 9 0 0 0 22 0 29 3 1 16 1 33 36 3 66 7 57 0 8 0 26 11 4 0 15 0 0 53 52 40 
64 28 1 0 29 28 48 0 0 0 0 12 24 6 11 25 10 0 0 15 0 16 0 2 0 20 36 0 0 29 0 0 15 1 0 69 27 0 19 0 19 20 0 29 0 0 21 15 0 0 0 0 20 16 73 0 
