56 32
0 0 0 0 0 0 0 0 0 0 0 8 0 0 0 0 0 0 28 37 16 3 19 0 0 5 0 0 0 0 6 21 1 0 14 0 10 0 11 5 0 0 53 12 17 0 0 0 1 0 0 0 0 13 0 7 
1 0 5 16 61 0 0 5 37 41 0 0 0 16 4 27 12 13 31 3 0 3 0 0 8 0 26 17 0 12 30 0 1 27 21 0 0 33 0 0 25 32 63 0 36 51 50 0 0 9 0 0 0 21 23 0 
22 0 0 9 0 5 0 0 0 9 22 27 24 0 0 22 37 0 0 0 0 4 0 0 4 25 0 27 11 0 25 0 0 0 39 26 0 0 0 0 29 0 10 0 2 0 0 0 26 0 0 0 0 0 27 0 
0 0 9 0 0 1 0 25 29 12 0 0 0 11 0 5 32 9 24 0 15 9 0 0 5 0 38 21 0 0 0 0 35 0 14 0 23 0 0 13 16 0 12 4 8 0 3 0 5 0 2 0 26 0 27 0 
27 0 46 19 51 14 17 25 33 38 0 15 68 0 6 1 37 6 1 0 10 49 16 12 0 23 15 0 0 0 0 0 9 0 22 15 3 12 16 13 1 86 0 0 20 0 0 5 55 0 9 39 0 8 0 9 
0 0 23 0 45 0 4 0 0 31 29 0 26 42 10 3 24 0 14 11 5 14 0 0 3 8 0 13 0 0 23 0 0 0 8 17 2 0 28 0 32 16 0 0 0 0 6 0 0 39 32 0 6 16 23 42 
46 1 6 0 12 0 0 26 41 1 17 10 13 15 0 0 12 10 23 0 6 44 7 13 5 4 53 14 0 4 7 0 11 26 21 7 10 8 0 4 8 9 38 22 20 0 46 0 0 56 23 12 26 0 18 0 
0 9 63 44 0 2 0 0 10 0 29 9 0 14 28 14 0 37 0 0 9 2 24 28 0 24 9 27 6 15 10 0 18 0 0 0 3 3 35 29 10 19 28 26 14 13 18 9 52 2 28 28 10 0 6 0 
4 26 0 0 46 4 2 22 3 4 0 36 0 50 62 78 4 0 21 0 1 7 0 0 0 0 0 32 0 1 0 16 0 0 0 0 0 0 15 21 21 0 17 0 0 33 0 47 0 0 105 19 0 15 0 40 
68 51 0 0 0 21 49 5 0 0 0 44 3 0 0 39 0 9 0 8 0 19 2 49 19 0 6 35 0 6 0 27 6 12 9 28 12 0 35 11 9 0 0 16 8 45 1 0 0 0 17 0 37 0 34 109 
27 32 21 51 42 0 0 55 0 18 0 51 0 45 24 0 38 5 31 4 14 6 9 12 3 11 43 5 0 14 0 14 0 0 0 11 35 0 30 38 12 0 0 7 6 22 0 0 12 16 43 1 63 34 44 42 
39 14 1 19 33 20 17 3 27 9 25 5 11 1 0 0 0 5 3 0 0 0 0 5 0 11 9 0 5 25 8 15 22 19 9 0 30 81 7 0 0 0 0 35 0 6 7 47 4 0 0 13 4 0 25 0 
44 0 0 0 38 0 0 39 0 118 0 0 0 9 0 0 6 0 0 0 0 34 3 0 22 16 1 1 0 0 0 0 0 0 41 0 6 0 0 0 3 0 36 15 11 0 36 13 0 0 0 0 0 3 45 80 
36 0 14 0 0 0 26 43 0 5 25 0 38 0 0 0 15 0 0 0 53 2 0 17 0 0 5 14 3 29 0 33 41 0 6 9 36 2 12 0 0 0 22 16 11 6 34 15 14 10 33 31 0 3 16 5 
0 18 0 6 0 7 17 0 0 8 0 44 3 2 0 15 20 13 22 2 0 13 3 26 13 0 11 0 7 0 15 0 0 20 1 7 0 3 0 2 8 0 0 0 33 0 5 14 30 16 27 5 0 12 5 0 
0 37 12 1 4 34 0 0 8 0 61 9 1 18 20 5 16 5 4 7 7 22 4 0 0 0 18 42 0 0 0 14 13 0 9 18 0 51 37 6 21 12 15 22 18 35 41 0 0 0 23 41 0 4 0 15 
0 12 13 15 28 0 34 47 0 0 7 5 19 0 0 0 0 10 26 49 0 41 0 19 11 0 44 5 0 0 9 28 6 0 0 14 0 0 4 23 25 0 0 6 55 0 11 9 0 0 0 47 10 0 28 0 
0 0 0 0 0 26 1 1 46 0 0 0 0 16 28 0 15 5 0 5 34 0 6 21 0 8 0 7 0 0 0 26 1 7 13 0 0 0 0 0 12 13 11 11 9 0 0 33 0 0 42 0 11 0 23 0 
32 0 0 14 0 48 0 9 0 6 2 8 2 0 0 3 0 8 2 15 5 29 21 30 24 13 0 10 22 16 0 9 32 0 0 0 6 16 0 17 29 11 0 12 0 0 17 10 17 0 23 0 54 18 0 27 
0 15 0 49 39 14 0 0 0 65 11 0 0 0 0 0 27 12 0 66 0 0 56 0 0 17 16 0 0 0 27 24 23 0 3 13 28 3 0 5 12 36 9 65 0 0 8 0 0 0 0 90 12 0 4 57 
41 0 0 0 0 5 40 0 0 0 5 0 0 3 24 0 0 0 0 6 35 0 0 0 0 0 0 0 6 0 11 0 4 0 5 0 11 6 9 0 0 42 0 6 0 0 40 0 0 0 0 10 7 0 0 35 
0 0 12 51 56 27 0 43 0 0 0 0 0 11 8 0 0 0 1 0 1 9 0 0 0 0 0 0 0 0 3 10 18 8 13 0 23 0 10 0 0 7 0 0 9 0 0 0 5 33 35 0 0 25 104 0 
0 0 0 8 42 2 10 21 0 9 18 0 7 0 5 13 33 0 9 25 0 54 4 19 0 7 5 12 3 0 14 0 14 6 21 0 0 14 0 43 0 16 1 7 2 0 28 26 0 0 0 0 0 12 0 0 
49 44 14 0 0 3 0 0 11 15 17 0 51 0 0 29 33 9 8 0 0 0 12 0 2 0 19 0 0 13 28 0 0 0 0 0 0 19 0 12 0 0 0 8 13 44 0 35 0 54 0 17 0 0 12 0 
0 6 5 0 36 9 63 52 0 0 24 14 21 0 12 54 13 5 27 0 28 0 0 0 0 24 25 37 6 7 3 14 0 9 16 0 0 7 0 45 35 1 2 54 32 35 0 0 22 43 34 0 45 0 2 0 
0 14 0 37 2 56 0 0 0 48 0 0 5 0 20 9 21 4 24 14 0 0 0 8 0 0 0 0 0 11 0 23 0 7 28 0 6 2 6 0 11 0 46 3 0 7 6 0 0 0 41 0 19 0 32 0 
0 0 62 0 7 32 43 14 0 28 20 3 4 16 30 16 0 1 0 8 0 19 20 0 7 0 21 20 6 16 20 51 0 16 0 0 0 28 0 12 25 0 0 0 109 0 24 63 21 59 0 0 8 13 49 46 
0 12 32 0 22 6 29 2 3 14 0 4 28 0 7 3 9 0 33 14 0 29 0 13 11 2 3 2 0 17 18 30 0 22 51 17 1 1 0 18 21 8 1 1 14 76 2 24 0 45 6 18 7 17 46 7 
34 0 0 0 5 0 34 13 0 17 78 21 0 35 0 0 0 0 28 3 13 26 0 0 15 16 0 21 17 19 50 0 26 33 34 26 0 13 0 0 0 2 9 35 0 39 36 8 35 38 0 0 21 0 52 0 
0 0 0 11 53 20 63 19 9 34 0 28 0 0 4 34 35 4 32 13 23 10 0 0 0 55 40 7 25 4 7 0 33 0 0 7 0 5 0 13 21 16 31 0 28 29 42 0 37 32 7 0 4 0 0 27 
0 0 0 0 0 0 0 19 0 0 40 0 0 0 0 29 0 0 3 10 2 26 2 20 0 6 19 6 0 0 0 27 23 19 0 0 21 1 22 12 9 0 0 12 29 0 0 0 0 7 0 12 0 4 32 0 
39 0 16 0 0 0 0 0 64 0 0 0 0 23 12 0 31 0 8 9 7 25 25 2 0 9 10 0 0 31 0 30 0 0 0 0 34 17 17 32 29 0 0 0 0 31 0 25 3 41 0 0 0 32 17 12 
