56 32
3 18 2 2 0 46 1 51 2 7 0 5 0 45 0 0 25 0 6 18 4 7 0 13 0 0 0 26 26 0 0 0 0 14 21 27 1 24 0 7 29 34 23 0 11 17 7 18 0 33 14 46 0 63 0 0 
0 20 3 4 64 0 1 0 29 0 0 6 0 12 20 0 0 0 7 29 17 0 0 27 13 0 8 0 0 55 9 0 0 0 3 0 0 29 0 0 0 8 50 0 0 0 0 0 19 0 20 0 0 0 0 28 
0 1 0 29 0 18 0 16 27 0 17 28 16 0 2 15 13 57 9 22 54 1 14 6 16 20 6 15 0 24 32 23 0 0 16 10 0 6 0 0 29 36 12 3 0 11 0 0 39 9 21 0 12 0 25 29 
2 32 0 0 30 4 5 39 34 12 18 0 46 0 33 10 11 33 6 20 14 0 5 3 0 18 2 16 3 30 12 0 0 7 69 2 7 81 31 17 0 18 4 3 0 0 10 10 0 0 0 0 0 19 0 0 
2 0 1 0 8 0 44 29 6 0 0 0 31 2 0 7 0 51 0 12 18 6 32 6 0 10 0 15 0 6 2 1 1 0 0 26 29 24 18 0 0 21 0 0 32 0 14 0 0 0 44 0 10 34 32 0 
4 23 53 24 21 0 0 13 57 10 13 0 29 0 0 21 0 0 21 0 4 3 0 17 19 51 25 8 0 28 0 9 20 26 26 59 34 22 0 6 9 29 0 50 0 6 0 17 0 2 7 0 3 28 46 29 
16 7 45 0 24 25 29 0 0 0 0 0 3 41 3 0 0 20 46 0 19 0 0 0 11 10 5 0 0 0 28 8 0 0 16 38 35 14 21 0 12 15 8 0 0 0 12 0 0 0 16 0 74 23 78 6 
17 0 0 45 0 0 14 3 12 0 6 10 36 0 16 0 1 18 0 9 0 7 47 0 0 10 2 22 0 0 1 0 5 0 0 2 0 18 0 1 21 0 0 47 0 0 9 29 36 32 11 0 0 0 0 33 
16 0 50 78 37 11 32 5 20 76 6 33 0 13 33 3 47 2 0 39 13 2 0 27 20 26 43 19 45 34 37 5 0 19 23 28 6 7 0 0 24 37 33 13 0 0 11 72 30 0 36 0 33 44 0 0 
43 0 0 0 0 0 6 6 9 5 0 10 0 10 0 9 4 3 4 0 0 0 0 0 0 10 46 0 1 0 24 0 0 0 5 1 0 0 0 18 14 12 0 0 9 0 0 20 14 11 0 18 0 0 0 0 
0 1 0 14 3 0 0 30 8 0 21 51 0 0 0 0 5 39 0 5 0 0 0 12 0 0 24 0 0 0 0 0 0 17 0 15 0 20 33 6 0 4 28 24 0 3 0 10 0 0 47 0 14 0 20 0 
0 0 0 47 0 0 20 19 0 7 44 0 0 13 6 0 0 35 9 0 34 0 6 1 0 0 2 9 0 2 0 34 0 7 13 0 0 0 10 0 12 0 0 0 0 6 0 19 38 13 37 0 0 50 44 42 
0 7 7 16 0 12 39 24 3 0 41 0 0 42 0 26 26 12 0 12 0 0 3 8 0 0 4 12 27 3 0 36 16 6 28 0 0 0 0 0 0 9 0 27 7 0 15 0 12 0 30 0 1 43 46 75 
0 38 47 0 32 0 0 0 47 100 4 10 0 12 0 9 23 0 0 4 7 10 0 13 0 0 0 31 0 16 0 0 3 0 2 13 39 28 0 68 0 0 12 10 0 0 0 32 0 12 0 6 1 0 9 41 
0 25 0 19 0 1 36 14 2 0 1 8 25 0 13 0 15 0 13 17 2 13 0 1 0 41 2 5 16 0 0 28 5 13 0 8 0 0 0 13 14 35 41 0 0 26 12 0 0 0 0 26 52 41 44 30 
0 0 2 18 72 0 0 40 10 16 0 0 41 0 0 12 47 0 30 0 1 15 34 0 6 9 0 0 16 25 0 28 8 0 0 5 0 33 0 12 4 12 0 0 7 5 5 6 0 0 5 46 0 10 38 0 
1 28 0 32 0 4 0 14 69 24 0 0 3 13 3 8 8 0 0 0 23 0 0 13 5 24 0 0 0 0 9 0 21 20 0 22 25 0 0 11 0 5 1 25 0 0 1 39 11 0 11 0 0 18 11 7 
0 0 0 92 20 0 0 0 17 0 9 0 27 0 14 0 15 0 10 4 0 14 19 41 32 3 9 0 5 15 20 16 0 0 7 9 12 14 20 5 37 0 14 8 10 20 43 0 30 19 2 5 2 0 11 0 
3 0 37 9 38 0 0 7 0 15 0 0 0 17 0 0 0 10 12 18 10 5 0 26 10 8 0 3 0 0 45 0 0 1 0 1 0 9 9 37 0 0 37 1 0 3 3 18 4 25 6 3 0 2 2 17 
0 19 23 0 0 0 0 6 32 7 0 10 3 19 3 25 0 30 30 0 0 28 0 0 0 0 0 1 21 20 0 4 0 0 27 18 4 13 0 0 59 0 11 3 7 0 17 44 0 8 11 0 0 34 0 16 
28 38 0 12 0 0 0 0 0 0 39 6 21 34 0 49 0 0 0 0 0 21 0 19 24 0 0 0 31 0 19 0 0 27 0 10 0 2 16 0 0 0 26 0 0 5 0 3 49 1 5 0 24 0 46 0 
0 0 15 0 43 13 0 0 48 21 18 0 3 28 0 28 8 0 15 0 19 0 6 0 0 0 0 3 20 3 0 5 0 0 15 0 35 24 15 10 0 30 13 76 42 0 71 51 39 0 7 3 6 0 0 15 
25 0 40 142 31 46 15 17 0 10 20 0 0 0 19 9 3 7 0 18 31 37 13 0 15 1 23 0 0 0 23 0 0 0 0 40 7 41 16 15 0 0 40 8 8 3 0 0 3 0 31 49 17 0 42 0 
36 14 29 41 4 0 0 8 0 31 10 0 0 0 13 8 21 0 0 0 17 16 0 0 0 20 2 3 0 7 12 29 7 0 5 0 0 17 6 0 16 0 31 29 35 31 9 0 39 0 16 19 0 0 0 20 
0 17 26 5 0 8 20 0 45 0 9 0 0 34 0 0 8 30 16 22 0 0 7 0 10 30 25 26 24 12 0 17 0 9 34 18 0 0 7 0 32 10 1 2 2 0 0 15 4 5 0 22 21 3 0 42 
4 0 0 17 30 0 13 0 28 19 18 0 0 0 0 0 8 0 0 0 29 0 14 0 0 16 25 0 19 24 19 14 0 0 0 7 0 0 0 2 0 0 34 0 0 3 5 16 0 35 2 0 0 0 0 27 
0 21 0 46 0 4 48 35 0 5 2 2 17 0 0 0 35 0 14 13 8 0 0 43 8 4 0 59 33 0 0 5 0 2 0 2 3 0 3 0 7 36 16 4 0 0 10 4 0 46 23 17 34 0 0 0 
25 0 0 1 12 32 0 6 15 1 0 0 27 30 13 3 0 24 85 0 15 3 13 0 0 25 1 19 0 3 27 66 0 15 0 27 0 4 0 8 1 14 1 30 3 0 20 22 6 2 42 0 10 51 14 0 
12 8 0 0 0 0 0 25 0 15 17 0 64 71 0 0 6 0 0 0 0 0 0 37 20 0 0 5 0 0 0 0 25 0 0 0 18 0 0 25 0 0 0 0 31 0 2 21 0 15 12 4 39 0 0 5 
7 26 0 0 0 49 30 7 0 0 12 0 0 10 0 0 23 23 0 22 14 15 0 0 13 0 5 46 0 0 20 0 0 0 0 0 48 0 0 4 29 0 0 24 0 0 0 50 0 0 0 0 0 56 49 28 
0 12 0 87 46 0 49 17 41 52 41 71 39 0 24 48 5 0 0 29 28 15 12 18 0 4 0 0 0 1 0 16 0 0 30 8 0 39 37 21 11 25 39 0 8 19 2 36 45 2 41 41 10 45 17 5 
0 0 32 57 44 0 0 31 0 1 2 31 0 0 0 0 31 27 5 0 23 14 0 14 0 0 22 0 10 26 0 0 0 40 11 0 0 0 0 0 0 30 14 15 7 0 0 14 24 0 0 18 0 0 0 41 
