56 32
0 0 4 25 2 0 6 15 28 7 0 0 0 0 1 30 5 0 0 13 16 5 0 0 5 9 0 0 0 2 12 0 39 0 0 20 16 11 0 0 0 0 0 0 0 37 0 0 0 0 0 0 0 0 18 0 
51 26 0 0 0 0 0 33 83 0 0 21 8 0 20 26 28 0 2 25 22 0 0 25 0 0 0 0 27 0 0 0 0 49 1 0 8 14 0 0 1 0 0 0 9 2 0 19 0 14 0 51 17 0 0 47 
0 0 3 51 44 27 78 0 17 12 44 23 15 4 0 36 8 14 32 0 2 16 61 4 8 0 24 46 17 2 0 10 31 9 24 14 0 9 13 12 27 10 62 52 0 0 0 25 0 0 17 19 1 1 154 10 
0 0 79 3 0 0 0 0 0 28 27 0 0 25 12 0 0 0 0 36 0 56 5 0 0 6 0 0 18 2 0 6 0 0 0 0 0 0 12 0 0 20 0 0 0 24 27 0 0 5 0 36 0 44 0 8 
40 0 8 0 0 50 0 36 29 2 44 3 42 0 5 2 9 30 0 28 0 17 0 18 0 14 21 32 25 20 20 7 9 17 16 12 5 51 37 1 12 22 11 0 0 12 15 27 39 13 6 22 55 0 42 8 
8 0 4 10 12 20 12 31 0 4 30 33 0 37 14 0 0 0 36 0 7 0 10 30 2 0 6 0 0 25 21 24 51 0 0 5 12 4 12 17 5 70 12 0 57 60 33 0 41 17 22 20 14 31 14 23 
24 0 0 44 0 7 6 0 0 30 2 10 13 10 1 32 24 21 0 0 0 0 0 11 9 0 0 17 0 27 32 31 2 17 0 23 7 34 0 0 0 18 9 73 11 30 0 7 0 18 0 94 40 10 3 27 
24 0 0 42 0 2 0 42 7 7 1 17 0 0 0 4 0 0 3 0 35 23 0 12 0 19 13 0 0 0 0 0 9 1 6 0 0 5 14 0 3 0 1 19 13 42 0 52 10 0 0 5 0 0 0 35 
0 81 18 0 0 15 0 40 28 9 8 15 0 0 8 6 0 3 5 3 52 29 19 18 18 8 0 2 14 0 0 40 9 8 8 0 37 0 37 0 6 15 12 44 28 37 0 0 0 11 32 31 0 25 12 13 
0 0 11 0 0 0 0 13 0 0 25 19 3 3 0 0 39 2 0 17 0 0 0 23 3 20 15 25 0 5 0 0 22 0 5 0 9 0 0 0 0 6 0 4 0 0 31 9 12 0 0 0 0 0 5 39 
20 0 30 0 38 0 0 14 33 0 0 10 0 0 0 9 0 97 21 0 17 17 53 3 7 13 0 4 0 0 0 6 48 19 0 10 6 8 0 9 0 52 52 12 0 38 12 30 12 0 19 4 0 16 50 46 
41 23 0 13 37 0 64 48 10 9 6 38 0 77 0 0 0 18 43 12 6 34 19 0 54 0 0 0 0 0 0 7 0 7 13 0 0 17 0 2 0 3 29 6 3 0 33 0 41 77 3 5 0 0 0 44 
52 0 9 13 19 24 0 29 42 35 0 0 0 0 7 0 16 0 4 65 1 19 29 19 3 5 5 7 41 34 1 0 53 6 12 33 9 14 0 4 0 16 0 28 78 4 10 8 3 0 42 9 61 34 22 0 
47 1 0 12 0 5 3 28 45 7 8 36 0 2 0 6 0 28 23 3 1 28 0 27 22 16 0 3 17 7 18 0 21 2 42 21 12 8 3 0 31 23 33 0 0 50 19 29 0 28 43 11 3 40 0 42 
1 0 1 103 9 56 0 24 1 0 0 26 5 0 18 0 0 20 0 0 0 14 0 0 0 0 11 24 0 16 1 0 43 0 7 7 0 31 4 0 5 4 4 6 0 16 39 0 0 44 0 9 0 0 51 7 
47 39 0 3 8 0 0 8 0 0 20 0 0 10 30 17 35 0 7 11 14 0 15 0 0 7 0 13 6 9 11 19 36 10 0 0 0 14 0 0 41 1 11 18 6 0 13 0 0 21 25 43 0 0 59 11 
0 6 0 51 11 0 0 9 8 26 33 0 0 21 4 0 2 7 4 0 1 2 18 19 0 12 0 33 4 8 20 7 0 0 24 25 0 5 0 0 22 7 11 8 0 0 7 10 14 0 0 0 3 0 51 24 
0 17 0 10 49 0 12 5 9 0 26 0 0 0 25 13 11 78 0 0 19 20 0 0 0 5 0 0 0 0 2 2 11 4 0 0 0 16 14 25 16 9 0 33 0 0 0 0 0 0 0 0 35 49 0 0 
55 10 31 0 42 0 0 29 46 28 0 8 0 53 0 36 14 9 13 15 3 17 0 14 0 10 9 20 14 30 11 16 16 22 5 0 69 38 0 9 14 10 7 1 0 0 33 11 30 8 0 13 52 0 28 0 
0 18 0 0 52 6 0 14 5 13 0 12 0 14 7 0 11 0 0 0 41 25 0 51 7 0 6 18 17 0 0 11 20 0 0 0 0 33 0 0 4 0 36 31 10 0 15 31 0 0 0 6 14 0 0 54 
0 4 0 0 0 31 0 38 0 1 17 10 0 0 0 4 4 8 0 9 0 21 0 0 25 0 5 10 0 3 0 7 15 19 0 20 0 1 5 0 35 4 35 0 0 38 0 0 0 25 36 7 0 0 7 4 
0 0 0 7 0 89 0 0 3 0 31 13 0 0 0 0 0 38 0 0 0 9 5 20 0 12 0 15 11 0 0 0 0 22 7 24 9 0 0 0 0 0 0 0 0 17 0 42 38 44 0 0 46 0 0 54 
0 7 0 0 0 61 32 10 0 32 40 42 0 0 24 21 1 35 0 0 18 0 0 0 0 0 15 0 21 21 3 26 0 19 0 0 0 0 9 21 31 2 0 2 0 1 10 50 0 28 21 34 0 0 34 0 
13 11 24 21 23 14 3 28 1 49 4 0 0 12 17 7 18 21 0 0 0 5 21 0 25 0 16 2 0 33 0 11 0 0 10 5 0 0 0 6 0 57 0 33 14 1 7 37 0 0 21 9 0 27 32 0 
38 0 24 21 0 43 0 16 8 35 18 15 0 31 9 4 0 0 0 0 24 0 5 0 20 6 6 10 0 0 5 6 27 14 26 5 15 0 4 0 0 0 9 16 65 1 3 0 0 3 0 5 0 0 0 0 
0 0 7 30 0 0 23 6 2 4 24 15 0 0 7 14 0 44 0 8 0 13 23 20 16 10 0 0 0 9 0 0 4 9 36 16 0 0 5 2 0 21 7 40 0 13 0 0 0 54 0 3 23 12 3 0 
0 50 1 0 36 19 3 27 30 0 46 0 7 0 0 4 0 17 0 18 16 0 17 18 0 18 1 9 20 0 0 0 0 0 18 0 3 4 5 20 32 0 24 23 4 21 5 10 0 0 22 27 33 16 0 13 
0 0 24 52 0 0 0 0 2 0 14 10 1 0 0 0 0 5 0 8 10 3 0 13 0 0 16 9 0 0 10 10 12 13 1 0 13 0 25 0 0 3 19 0 17 0 0 0 0 0 22 0 0 0 0 0 
0 10 1 13 0 24 0 61 0 37 0 15 6 16 0 1 0 22 0 0 0 0 26 21 0 0 0 3 0 12 0 0 0 0 0 0 24 30 0 38 0 0 8 20 0 9 60 20 41 0 0 0 0 20 18 16 
25 15 0 0 27 0 12 36 0 0 27 5 0 0 0 42 50 0 0 0 27 4 1 0 3 23 0 16 17 1 0 5 0 18 0 0 12 8 0 2 27 2 0 61 0 2 30 0 23 2 1 8 0 0 0 0 
0 0 28 0 0 0 36 4 0 26 0 0 41 0 0 30 33 0 0 4 0 21 0 0 5 28 0 28 0 25 0 0 3 9 1 3 0 0 6 16 0 8 10 28 23 0 0 0 20 48 0 0 0 13 0 16 
2 27 0 0 0 0 0 69 45 28 38 40 6 0 39 0 0 0 29 0 29 28 0 0 0 3 11 0 30 0 0 13 7 0 0 8 0 13 14 2 0 7 0 5 32 38 3 0 8 66 0 27 0 45 9 11 
