56 32
11 0 6 5 17 16 0 82 0 18 43 40 0 0 2 42 2 25 0 33 21 33 30 47 27 44 11 78 12 14 0 9 0 0 10 16 13 2 27 39 12 30 0 0 21 72 0 43 42 3 3 39 2 89 0 58 
0 53 16 0 78 16 35 36 0 74 0 0 31 5 0 32 0 10 16 0 0 0 14 0 0 0 46 51 25 0 36 0 20 26 0 0 14 16 38 27 0 0 3 28 0 2 0 21 27 0 44 3 25 55 59 0 
0 0 0 45 0 0 11 44 15 54 0 21 30 29 0 0 0 3 52 30 0 0 0 2 4 0 7 4 23 75 39 25 20 40 6 16 0 12 0 0 7 4 16 0 0 12 16 1 29 0 0 51 45 0 0 0 
55 10 32 31 94 0 12 0 0 0 0 10 22 0 7 25 10 4 40 16 3 9 0 26 24 0 27 0 21 0 0 16 0 29 61 1 2 12 0 13 32 21 26 0 19 0 0 27 0 9 46 7 7 0 38 35 
8 0 39 0 0 0 3 0 0 0 0 0 0 0 10 18 0 24 0 0 0 38 0 0 7 15 26 0 0 12 0 42 1 25 25 4 0 0 0 0 0 48 0 0 2 0 42 0 5 0 0 0 23 0 0 0 
3 31 0 2 7 11 0 0 44 1 15 7 0 24 40 5 37 6 21 18 10 22 0 13 0 28 0 0 27 0 31 0 6 0 0 19 19 28 0 22 26 8 11 0 0 35 0 3 7 9 9 34 34 65 0 8 
0 33 0 2 0 0 49 0 6 33 21 0 14 6 6 5 7 0 10 5 0 0 15 0 0 0 0 10 0 0 0 0 0 6 33 0 0 4 0 0 0 5 0 0 5 0 0 0 10 0 41 7 0 0 0 32 
90 8 0 22 0 0 40 0 26 34 0 22 0 0 23 37 0 71 24 19 9 0 19 0 2 22 41 0 0 0 19 0 0 0 30 26 0 38 14 5 40 6 0 0 10 44 40 10 22 0 50 2 5 50 37 0 
0 0 8 2 0 0 34 5 6 24 0 36 1 7 27 0 0 5 1 54 32 22 0 2 10 0 3 36 0 47 19 0 0 18 6 0 11 0 19 0 9 14 3 23 0 28 0 39 0 10 21 21 0 12 28 23 
37 32 0 37 48 0 0 26 58 22 8 0 3 8 19 14 0 16 36 12 0 6 0 25 17 0 11 2 0 1 21 21 0 29 0 21 6 3 0 12 37 0 6 0 0 0 0 20 17 0 15 72 41 0 0 47 
0 0 13 44 0 28 17 41 0 0 19 35 25 0 47 14 0 4 24 18 23 0 23 4 0 14 6 10 21 0 7 21 11 18 0 17 0 20 0 9 0 4 19 19 30 23 0 73 38 21 13 18 89 9 0 0 
34 0 3 0 0 42 0 0 0 0 0 0 0 25 21 0 0 6 0 4 0 0 0 47 15 0 23 2 0 15 15 12 0 7 0 0 0 2 25 0 0 0 9 5 0 9 0 42 0 35 0 9 0 2 28 19 
8 24 16 0 3 0 10 24 0 14 0 9 0 0 5 47 4 0 0 0 0 0 0 32 6 0 8 0 0 0 3 8 21 3 8 0 0 0 0 0 0 27 5 29 0 1 17 0 24 15 0 0 7 0 0 12 
55 0 0 3 26 0 2 20 18 0 7 43 12 0 0 0 0 0 0 28 49 0 13 4 21 0 0 3 25 0 16 4 18 5 0 66 1 25 0 16 17 36 9 0 41 0 2 68 20 0 18 0 0 11 24 84 
86 5 0 0 37 12 0 0 0 12 42 0 0 54 0 0 0 4 0 5 0 0 0 7 0 17 0 8 0 0 18 0 0 0 0 18 12 9 0 35 0 10 0 30 0 45 0 0 0 5 0 26 42 1 0 0 
26 38 0 0 0 29 10 12 14 0 10 0 0 0 11 0 25 11 13 4 13 0 11 9 0 0 33 16 8 22 21 13 9 13 29 0 0 0 9 16 23 0 15 23 7 0 5 31 32 0 0 31 0 25 0 11 
29 13 30 76 0 0 15 0 39 0 37 6 0 0 19 11 5 35 15 25 25 19 20 8 0 0 3 11 0 27 12 0 0 19 31 0 4 0 0 41 13 0 11 14 0 6 0 76 42 4 0 48 57 0 0 0 
51 22 37 43 30 13 31 0 0 7 0 0 0 6 8 0 0 0 16 56 0 0 8 15 9 1 1 13 0 0 10 0 0 13 0 0 0 47 0 0 0 0 5 14 0 0 45 13 13 0 0 98 0 0 10 62 
6 0 0 2 0 0 0 0 13 0 0 0 0 0 0 0 6 0 0 0 0 21 13 10 16 0 0 0 26 7 10 0 0 15 0 0 1 9 16 0 10 3 0 14 0 0 16 0 0 10 24 0 0 3 26 18 
21 11 0 41 18 40 0 0 37 34 0 10 3 0 0 10 0 0 4 86 5 39 24 0 10 30 0 0 0 0 2 0 0 0 0 13 0 22 0 18 16 0 33 18 0 121 0 10 0 0 0 42 103 0 6 0 
29 0 0 84 35 18 81 0 0 26 0 0 14 71 3 0 32 20 6 12 0 0 0 12 14 0 24 19 0 29 0 0 0 0 17 0 0 0 0 29 41 26 37 0 31 6 21 7 6 42 22 0 10 0 47 0 
0 0 0 28 0 43 17 0 0 1 11 0 0 1 16 30 15 21 21 0 0 11 14 9 1 26 14 26 0 0 16 13 0 0 0 0 0 0 0 0 16 36 0 0 17 14 17 1 0 0 0 5 0 0 0 0 
0 0 0 0 36 0 18 9 42 62 0 0 0 0 5 0 0 25 0 45 14 0 3 17 0 2 18 2 12 24 0 0 20 13 19 20 19 0 9 3 22 9 35 12 35 7 0 8 0 17 9 0 9 15 26 52 
19 11 40 4 41 0 10 0 0 45 0 0 25 2 0 26 10 0 0 19 0 0 0 0 20 26 0 17 27 27 8 18 0 6 0 26 0 14 5 24 2 23 7 0 17 0 4 15 3 12 16 38 0 0 1 18 
6 0 0 50 0 46 0 0 8 5 63 0 25 0 0 43 22 0 14 7 1 0 0 17 18 0 14 16 18 26 0 0 0 5 8 19 17 25 26 0 35 18 12 19 2 0 30 6 10 11 0 55 0 73 36 57 
0 11 0 0 0 0 0 0 0 0 10 1 11 0 6 36 0 18 8 9 27 0 7 7 0 0 8 0 0 15 7 21 0 0 0 0 0 0 0 0 0 0 29 9 30 0 0 44 4 7 0 38 0 2 12 0 
12 24 0 28 0 0 0 0 37 14 0 14 30 0 33 4 0 0 46 0 11 0 33 13 56 24 0 0 0 0 19 21 5 3 0 20 11 17 0 39 0 0 16 25 2 16 0 0 3 0 0 27 0 16 0 10 
0 0 29 30 29 16 5 61 5 7 21 8 0 9 3 0 14 1 13 8 0 41 0 11 41 0 0 0 0 16 17 55 0 19 10 14 0 0 26 0 0 0 0 46 37 16 0 0 0 19 0 2 23 17 10 24 
53 0 41 0 0 9 18 18 0 0 62 0 7 1 31 33 22 12 8 20 5 6 0 0 18 18 0 18 0 27 30 0 18 0 0 0 0 26 0 0 4 25 0 19 0 18 0 29 15 39 7 51 29 13 6 1 
0 11 40 0 0 0 47 22 0 0 39 12 0 24 1 17 28 0 0 0 0 37 14 0 0 0 0 0 0 49 10 8 0 0 25 15 0 15 0 0 0 0 40 0 28 0 0 29 31 18 15 0 0 47 0 0 
0 0 7 0 27 0 24 19 20 45 0 0 0 0 4 0 15 7 32 8 4 31 30 0 11 21 46 19 22 13 0 31 0 13 17 0 0 0 0 15 0 12 0 16 0 0 2 38 0 41 9 0 6 22 25 0 
0 0 0 9 25 27 0 0 18 0 0 0 32 0 0 0 0 0 0 5 15 16 13 0 19 63 2 9 2 25 23 36 45 0 7 15 7 16 40 0 0 27 7 44 22 0 0 31 31 24 0 0 3 14 0 0 
