56 32
0 0 17 0 0 21 25 38 26 0 0 19 5 6 0 0 0 7 0 16 0 12 21 0 2 0 22 10 7 16 16 74 0 28 36 22 19 14 0 0 0 0 0 27 1 40 3 0 25 0 0 0 0 0 0 0 
8 0 39 40 36 5 34 0 2 42 16 13 22 0 26 1 48 0 9 0 26 0 10 2 69 15 19 9 0 15 5 5 10 0 0 0 13 11 15 8 14 0 0 0 0 0 0 7 5 22 34 22 15 40 51 39 
0 36 39 3 0 47 0 0 5 6 0 1 0 0 0 0 43 38 26 58 11 13 28 16 20 0 0 0 15 26 7 0 0 38 1 1 15 18 0 16 29 0 0 0 26 12 0 0 45 0 0 35 47 34 0 26 
4 43 13 14 18 3 30 0 21 1 9 1 1 0 26 0 2 11 27 0 8 0 4 4 14 0 18 0 0 0 12 0 0 0 0 0 30 16 22 0 54 0 12 12 25 27 37 35 20 26 7 0 0 16 0 0 
47 12 0 19 30 0 0 22 49 0 22 0 19 21 0 0 25 7 32 18 1 17 0 0 7 12 0 0 0 10 0 21 3 4 0 3 0 32 13 7 0 18 24 0 9 14 3 3 44 0 23 47 0 18 16 0 
0 6 0 0 0 0 0 1 0 48 1 59 74 42 10 8 5 0 0 0 12 13 12 22 24 0 0 23 9 17 25 11 12 0 34 0 11 9 0 14 0 7 12 13 23 0 0 45 24 2 39 18 11 0 45 35 
5 8 0 70 4 37 0 3 43 5 73 26 31 6 5 15 7 38 7 0 33 3 0 0 1 11 5 26 5 22 67 5 0 42 0 6 1 48 0 14 7 0 5 19 67 24 30 0 12 0 11 39 15 59 0 23 
22 0 38 19 0 32 33 0 0 4 24 90 28 19 0 8 0 29 1 3 5 17 19 10 0 24 0 16 26 0 0 9 8 17 17 1 23 19 17 33 39 4 0 28 0 6 22 61 0 17 17 33 50 0 0 0 
0 1 0 0 0 0 0 0 0 46 0 10 50 15 0 1 1 0 6 31 0 40 0 6 0 0 0 0 16 1 5 8 0 0 29 1 0 19 0 0 28 0 0 0 10 0 2 12 22 0 60 0 43 20 0 6 
2 19 34 0 27 0 0 0 7 23 21 0 35 0 0 0 5 0 0 0 0 11 0 11 8 15 10 18 0 7 9 27 23 0 0 0 27 0 26 0 0 0 0 0 20 18 0 35 0 11 0 0 0 15 10 0 
0 0 3 0 0 37 0 0 37 22 0 0 3 0 0 16 0 16 18 0 4 6 21 0 0 0 0 0 0 0 17 45 18 0 0 0 0 0 0 5 7 0 43 9 2 37 10 0 0 3 0 0 0 0 0 0 
58 2 22 9 0 35 0 0 0 31 12 1 10 0 39 0 0 0 0 25 20 17 1 0 22 22 0 0 0 0 19 1 6 0 20 15 0 0 8 0 35 0 0 4 74 2 0 4 0 18 0 0 0 0 20 41 
0 0 47 30 25 26 0 43 2 28 11 0 8 28 24 0 0 0 0 14 5 8 18 15 18 10 11 31 0 37 0 0 0 1 0 6 0 5 17 2 17 5 0 0 17 0 0 0 0 63 43 8 39 0 0 0 
49 16 1 63 40 50 35 0 2 0 19 6 51 1 0 16 56 14 0 10 6 0 0 27 0 8 10 26 0 9 5 23 0 46 0 17 25 47 7 0 0 0 6 1 23 15 0 2 0 49 27 3 36 26 35 45 
0 10 0 20 5 18 13 0 21 5 10 35 8 4 37 0 0 12 43 18 10 20 0 20 27 0 0 0 3 22 0 26 0 0 0 10 6 19 0 11 22 6 0 1 3 13 94 0 4 0 4 10 7 0 0 9 
34 15 14 52 30 1 0 0 25 13 9 0 8 0 0 0 42 0 15 7 0 39 13 28 12 0 0 0 0 0 1 12 11 25 48 0 12 0 10 14 0 6 0 27 0 11 32 8 10 0 16 2 0 0 0 66 
30 0 45 48 50 0 15 0 6 0 14 0 0 0 0 36 0 0 17 0 32 17 23 4 0 0 0 0 7 0 54 12 1 12 0 8 0 0 0 0 0 2 1 0 8 36 0 55 0 0 0 84 46 19 48 0 
0 0 0 8 11 48 35 1 31 7 11 41 0 0 0 0 7 0 0 0 32 0 0 0 8 13 8 0 8 0 19 7 0 0 0 0 0 0 0 0 32 13 6 37 9 21 0 5 0 35 45 0 10 0 0 0 
22 0 0 39 50 18 20 87 0 4 0 0 0 26 0 2 11 4 0 15 28 12 40 7 24 0 0 16 15 8 26 20 0 0 0 15 0 35 15 0 33 2 59 11 0 0 39 23 1 0 30 45 15 0 2 0 
0 8 0 0 6 0 3 92 26 24 26 14 0 0 0 5 8 47 4 0 22 2 19 0 15 14 0 20 0 22 0 0 0 9 0 13 4 0 0 62 8 0 8 17 5 35 4 38 21 9 0 44 45 0 27 0 
39 0 0 0 8 71 8 0 0 30 4 21 0 39 35 69 38 0 42 0 0 53 25 36 3 0 21 17 35 15 24 18 39 0 5 0 14 27 8 24 0 7 38 0 9 17 18 8 8 50 7 6 11 0 98 34 
0 0 0 6 0 44 19 31 0 6 15 0 3 0 0 10 0 0 24 20 0 16 0 0 0 19 0 0 0 0 1 0 6 0 0 13 8 2 40 20 5 9 24 0 8 5 7 0 13 25 11 0 0 15 0 0 
0 7 0 0 0 0 34 39 3 12 18 0 4 36 17 9 1 4 0 0 8 14 12 17 0 22 39 0 0 10 10 0 0 0 9 12 0 0 0 10 33 5 0 20 1 74 46 5 5 0 2 24 0 45 41 16 
0 24 34 25 0 40 0 0 0 8 1 24 63 0 28 0 6 18 0 10 0 29 6 0 0 32 27 0 6 18 0 0 21 4 0 24 34 2 0 16 0 1 1 0 0 34 0 18 20 4 29 27 2 28 0 54 
0 0 0 0 0 46 0 0 0 0 12 0 0 7 0 0 10 0 0 0 8 29 0 6 0 20 20 22 0 10 15 5 0 0 0 20 0 0 28 13 11 10 6 38 0 34 0 0 0 0 31 11 0 0 0 0 
14 0 0 35 25 18 0 0 38 0 0 0 17 0 19 7 0 0 0 0 14 7 22 0 2 21 16 0 0 0 0 0 0 37 6 16 0 0 31 0 4 5 0 0 4 0 22 13 39 41 4 2 2 0 0 0 
59 0 0 0 20 0 38 61 0 2 0 0 0 13 36 5 0 8 18 24 18 6 0 0 20 0 0 0 7 8 0 13 15 12 0 0 0 0 0 22 20 0 8 0 29 0 29 22 0 0 42 0 0 0 0 48 
119 41 0 0 20 0 28 0 23 0 9 33 35 4 20 0 51 6 0 0 25 0 0 24 0 0 0 0 19 21 17 3 12 0 10 9 0 19 0 0 27 40 11 8 0 2 1 25 3 36 57 0 36 26 50 55 
1 44 0 0 0 19 5 0 41 21 44 22 1 0 5 35 0 3 18 21 11 0 29 0 7 11 0 12 26 22 21 21 49 41 0 0 26 0 39 0 0 24 0 35 27 11 7 0 47 12 0 0 0 14 0 11 
0 0 0 77 14 0 19 2 0 2 23 14 0 0 0 21 25 9 14 8 4 21 0 0 4 44 9 0 0 0 27 29 29 0 0 0 21 16 0 0 36 0 0 0 0 0 22 0 0 36 0 48 0 0 0 0 
0 43 0 0 10 0 0 0 26 27 42 0 31 0 13 37 0 0 0 0 0 0 46 0 8 0 2 0 16 0 0 0 0 0 10 0 27 0 0 35 29 27 46 49 26 21 36 4 25 6 3 36 0 0 13 13 
18 0 0 0 0 0 0 19 19 0 19 4 0 0 0 15 0 9 27 0 0 11 48 6 4 19 0 9 0 27 0 0 0 15 12 0 0 0 0 0 40 0 14 0 0 0 21 1 15 0 18 0 15 3 0 0 
