56 32
47 0 18 44 0 14 13 0 20 0 0 2 0 10 28 70 16 15 0 2 18 5 0 38 0 31 14 19 1 26 0 35 47 9 16 0 0 16 1 0 1 0 5 28 12 0 15 42 0 11 0 0 38 16 0 15 
0 0 32 0 26 0 0 0 18 26 0 0 0 10 17 0 33 37 16 1 40 8 0 10 29 0 18 6 5 31 0 18 13 6 43 0 21 0 0 15 24 24 14 0 0 13 0 6 0 48 12 2 55 5 0 0 
28 1 0 8 0 19 0 0 0 1 53 35 0 31 0 15 36 0 0 9 0 0 4 0 0 0 9 0 2 23 19 0 34 0 0 0 0 0 0 0 0 11 34 60 37 0 0 17 0 0 48 0 16 0 0 13 
0 39 0 0 0 0 0 13 0 0 17 23 22 0 32 0 16 21 0 0 9 23 5 0 0 25 0 0 3 9 8 4 16 9 7 0 0 0 12 13 6 0 3 19 2 0 22 17 0 20 4 38 0 0 12 0 
41 14 5 0 0 4 4 0 6 79 0 0 9 0 3 7 0 0 27 0 0 9 0 0 0 0 3 0 13 2 0 0 20 22 0 0 0 28 0 1 2 41 25 24 0 43 0 0 0 0 24 0 20 0 45 1 
8 12 48 0 0 0 12 10 8 8 4 0 0 15 0 0 0 0 39 0 0 0 0 0 23 0 0 4 0 33 0 9 6 0 16 11 0 0 0 0 0 5 0 14 0 27 0 6 0 24 64 0 0 13 0 0 
45 1 0 0 10 1 42 0 0 4 4 33 0 31 7 15 13 22 61 0 60 0 42 1 15 20 22 0 0 16 20 0 1 20 18 0 15 21 24 2 5 0 0 0 18 22 0 8 70 0 16 14 32 24 0 37 
0 1 0 12 0 4 0 10 0 11 14 3 0 0 92 7 16 10 0 24 29 24 6 0 14 35 10 6 6 0 0 15 14 9 20 20 32 0 17 4 11 8 4 24 0 13 25 20 0 24 0 16 38 44 0 0 
60 7 58 21 2 0 0 45 22 0 2 0 0 0 11 0 11 0 0 26 12 0 0 14 8 25 6 7 0 4 0 0 2 15 26 35 0 0 21 19 0 7 0 35 39 67 0 13 0 0 30 17 0 23 0 0 
7 8 0 7 3 45 44 12 11 28 30 0 0 0 0 0 20 0 0 33 31 0 6 0 0 29 21 0 9 57 0 0 9 0 20 17 1 46 0 0 14 4 12 21 0 41 17 23 0 0 64 12 23 0 49 0 
47 0 0 9 4 2 12 4 0 0 0 17 15 37 17 0 18 4 0 0 42 6 5 0 0 15 16 3 0 4 0 9 25 5 20 2 3 0 5 15 4 18 25 0 5 0 8 55 0 0 49 0 3 19 8 0 
95 46 41 18 0 36 3 17 42 23 18 0 0 33 14 27 3 29 16 15 0 15 0 50 4 0 6 0 1 20 45 0 4 21 18 30 0 8 16 41 18 0 15 28 0 0 14 93 15 52 86 0 0 30 5 0 
0 0 13 11 22 0 0 0 40 31 0 0 0 0 0 0 0 0 20 0 0 0 37 0 0 0 22 0 0 0 22 0 0 0 2 17 14 0 20 17 18 2 0 2 4 0 0 0 23 8 13 14 20 1 0 4 
7 0 51 0 0 0 13 17 1 8 0 0 21 13 1 1 11 0 40 22 18 13 0 0 25 0 0 1 5 0 25 0 8 13 13 0 0 8 1 0 0 0 0 0 14 18 28 0 4 41 13 0 0 4 0 0 
0 36 0 8 25 73 12 23 41 6 1 14 31 11 4 37 15 12 2 5 0 3 10 0 10 17 53 20 2 44 2 21 0 0 0 18 0 34 31 0 0 17 38 12 0 34 0 38 11 20 0 4 7 30 0 0 
0 0 0 0 7 0 0 76 37 0 0 22 0 0 8 0 0 9 15 0 2 0 0 0 0 0 0 0 6 6 0 36 21 11 15 0 0 0 5 2 29 2 0 0 0 37 0 6 41 16 0 0 0 15 23 11 
49 55 4 0 40 4 42 8 0 0 2 0 8 0 0 10 0 4 21 0 27 0 14 0 0 0 10 0 11 14 0 14 25 6 0 11 9 0 11 19 0 0 10 2 38 0 6 66 0 65 4 4 99 2 3 50 
0 86 1 0 22 0 28 2 1 0 0 0 27 0 24 37 10 23 18 15 3 0 22 0 8 0 12 25 12 42 0 20 20 0 12 0 50 0 3 24 0 13 3 0 62 0 9 46 5 9 8 24 37 0 0 26 
0 0 0 0 0 14 0 0 45 36 0 0 0 17 17 0 0 0 0 0 0 0 0 0 0 0 0 0 0 0 17 13 19 0 0 0 8 0 2 0 0 0 0 3 0 32 0 0 34 0 0 0 21 39 0 0 
91 46 6 59 5 13 0 24 29 0 11 39 5 6 0 22 39 5 0 6 0 0 0 0 0 0 0 0 0 35 9 6 0 0 3 20 0 40 0 2 0 4 7 18 44 6 0 92 0 2 39 0 0 16 51 46 
19 0 7 0 0 0 4 0 0 19 17 0 0 35 0 2 15 0 0 33 3 0 0 0 8 27 0 0 0 13 9 0 0 20 0 17 0 0 0 10 16 0 0 4 28 0 0 0 35 0 0 6 11 14 15 0 
28 0 79 46 15 18 0 0 5 9 0 18 0 9 9 50 0 17 0 0 0 17 12 0 0 19 0 0 21 9 0 8 0 0 8 9 0 0 0 9 0 0 5 0 37 0 54 19 43 7 11 7 0 0 39 28 
0 16 45 0 94 12 8 0 7 0 27 23 0 10 36 1 1 35 30 35 0 8 28 10 7 6 2 20 7 3 26 29 12 20 2 17 18 36 10 4 0 14 9 5 36 6 6 45 0 0 43 0 48 15 0 25 
0 47 0 67 17 43 0 0 0 2 6 52 2 0 9 0 13 0 8 0 13 0 17 0 16 0 15 0 23 0 0 20 6 0 0 25 31 0 15 0 1 15 10 38 0 0 0 19 47 105 0 0 0 0 0 4 
19 21 16 5 5 43 13 8 11 0 23 0 13 10 0 48 21 1 14 26 0 17 1 3 0 15 7 0 0 19 7 0 8 23 13 0 6 3 17 18 28 4 0 0 7 44 0 2 0 7 0 0 18 17 0 40 
32 0 52 44 20 50 0 38 31 24 3 18 10 0 8 14 39 0 22 0 36 4 30 13 29 19 22 30 11 9 0 0 25 79 7 0 18 0 5 31 22 7 21 0 5 44 0 89 4 0 0 17 0 7 0 54 
53 26 41 0 17 0 23 0 0 40 24 35 0 20 21 12 4 48 0 19 0 0 15 0 7 0 40 13 0 8 20 6 1 32 0 4 0 0 11 19 0 0 15 41 0 3 2 2 7 40 17 3 51 41 37 2 
0 0 14 0 17 0 0 0 0 0 0 2 14 9 27 0 7 0 1 0 0 0 4 24 0 28 0 0 5 0 0 0 1 0 0 20 0 0 27 0 0 14 0 0 0 0 0 19 0 0 0 0 0 9 18 0 
0 0 26 50 3 28 46 52 0 0 0 0 31 0 0 32 0 22 1 4 15 0 25 28 0 28 3 0 35 0 36 14 10 0 0 0 21 0 0 0 0 40 0 19 0 0 0 1 43 0 24 19 46 0 13 0 
1 0 16 5 0 0 19 44 0 0 0 59 57 81 0 31 9 0 0 0 20 0 12 15 0 19 0 0 1 0 13 20 0 4 42 17 24 0 4 19 0 0 0 8 28 0 31 70 17 35 47 79 0 7 7 0 
31 63 46 11 0 46 19 0 0 10 0 27 0 19 0 0 4 3 28 15 48 28 3 19 22 0 2 0 0 18 0 36 19 0 47 0 8 0 5 37 0 13 19 25 13 0 28 0 15 28 0 46 0 44 34 0 
2 0 0 8 17 30 0 16 0 0 0 0 41 0 0 11 27 0 0 0 18 0 0 13 0 31 13 0 0 0 23 14 0 0 28 38 3 0 0 31 0 23 0 35 0 12 7 0 0 19 0 0 18 79 0 0 
