56 32
31 0 41 0 0 0 0 0 0 5 16 0 43 0 14 19 30 15 53 0 0 0 0 0 26 8 7 0 28 0 9 4 0 0 35 16 0 0 20 0 38 0 0 20 0 14 12 23 0 0 26 0 5 21 0 14 
0 33 20 3 0 0 35 0 28 10 0 26 23 18 0 25 0 25 0 10 56 14 20 0 12 20 15 0 20 26 0 0 0 0 0 11 40 2 27 26 12 19 25 8 0 1 31 0 0 0 0 0 0 0 0 0 
12 20 26 0 28 0 0 0 0 20 0 31 38 24 0 0 0 22 4 35 20 10 12 0 16 0 0 10 0 31 25 2 3 24 20 22 2 8 0 0 0 0 0 19 0 0 0 10 28 0 12 30 0 0 0 35 
0 22 39 34 12 18 0 0 35 5 20 0 0 0 39 0 53 24 12 37 15 23 10 0 0 0 0 30 18 0 4 31 17 16 25 0 0 17 16 0 0 17 5 19 49 0 26 38 31 0 47 0 3 5 29 0 
6 25 23 14 0 0 0 93 27 0 0 15 28 6 13 0 0 20 10 2 34 17 22 6 0 0 0 0 37 31 0 5 18 11 6 14 14 41 1 0 18 12 24 0 51 17 0 24 31 5 0 0 59 9 37 0 
15 0 0 0 58 25 0 25 10 5 0 0 34 0 0 17 0 0 17 0 0 0 0 3 9 24 0 0 0 0 0 20 28 0 0 17 0 13 0 0 15 0 38 0 0 23 25 0 0 34 3 16 5 0 0 0 
0 17 10 15 0 26 32 10 45 9 11 6 0 3 2 8 1 29 17 7 0 33 3 18 2 21 31 13 18 2 0 29 0 23 37 12 7 0 32 14 0 19 12 0 0 5 4 0 0 32 0 0 30 45 49 0 
0 0 0 12 0 0 22 19 63 23 0 0 0 0 17 13 0 0 24 0 11 29 4 0 14 21 23 3 2 0 5 17 2 12 6 55 0 11 0 20 5 6 33 0 7 0 22 44 0 15 8 61 3 0 0 21 
0 50 63 7 48 13 49 0 55 0 0 0 0 0 0 0 0 6 0 0 17 8 0 19 20 30 2 10 20 2 0 16 0 0 0 8 44 18 0 0 3 0 5 49 43 0 0 22 0 0 1 1 6 49 11 49 
58 28 0 18 33 5 0 33 6 8 43 19 16 14 5 33 3 14 6 15 13 0 0 15 29 0 87 14 10 13 6 13 0 20 0 21 22 0 0 1 39 0 0 8 13 29 0 14 44 5 10 21 0 40 5 0 
2 14 41 52 14 0 6 0 0 0 13 0 23 0 29 0 16 0 0 25 8 26 13 0 21 0 2 15 0 0 0 0 3 23 0 3 0 0 0 36 0 20 15 29 29 0 0 0 3 1 17 0 10 18 58 0 
0 0 72 0 0 0 43 0 0 5 0 23 38 0 5 21 5 0 0 0 11 4 20 0 0 38 10 11 14 0 0 11 0 0 23 5 10 0 10 0 0 10 0 0 0 0 4 11 0 70 38 0 0 28 52 13 
0 0 7 0 4 0 0 18 0 0 68 31 0 6 21 0 12 11 0 14 24 15 29 0 4 3 15 5 9 0 15 0 0 0 0 28 18 8 0 4 0 0 6 12 24 15 72 10 0 0 0 15 0 43 0 0 
0 0 0 44 3 0 10 0 0 0 0 0 21 74 34 8 0 16 4 2 0 11 0 0 0 0 0 0 0 18 16 0 0 43 0 9 0 8 25 0 0 0 0 0 25 0 16 44 0 5 0 0 0 40 0 26 
12 0 8 50 41 73 0 5 14 6 8 0 8 28 14 19 2 17 0 5 0 0 14 0 0 0 17 0 0 0 44 23 0 0 0 27 27 0 0 0 24 5 6 0 4 28 0 0 49 29 47 11 6 11 47 0 
0 5 71 8 84 12 0 7 13 16 0 22 25 0 0 40 5 33 0 2 12 14 5 23 9 0 1 13 28 11 0 23 0 38 0 13 13 8 0 11 3 16 40 11 0 41 27 70 0 8 10 35 24 0 1 0 
0 39 0 0 79 0 2 0 0 5 0 0 7 0 7 39 22 36 0 13 16 27 2 0 2 0 4 0 0 0 0 11 13 7 15 20 13 0 22 0 0 0 0 39 0 0 7 3 0 28 7 9 68 47 46 0 
13 0 6 0 29 35 22 0 6 48 0 0 1 38 0 8 6 0 0 14 0 22 0 0 9 5 0 0 5 13 0 0 0 49 0 0 0 0 0 0 35 0 26 34 0 0 0 5 0 0 22 38 0 0 21 0 
0 33 18 12 67 0 2 24 0 11 0 0 24 6 0 0 0 17 43 0 11 0 21 34 6 0 0 0 24 0 28 18 0 0 50 2 7 43 0 12 29 0 13 8 15 41 10 0 8 27 0 19 2 9 41 37 
0 0 2 103 0 0 33 0 23 22 0 0 0 18 1 7 27 0 2 17 14 21 11 0 0 0 0 0 22 10 8 10 0 0 9 17 0 0 0 0 37 0 21 27 16 0 8 41 0 35 0 0 0 5 58 0 
31 0 44 0 8 0 0 14 0 9 0 17 7 0 0 0 0 0 0 0 1 15 1 21 2 0 8 27 45 0 0 1 24 20 0 9 6 17 0 0 20 0 0 20 21 6 62 10 7 0 0 0 66 61 0 20 
0 0 0 43 47 15 48 43 47 0 77 40 0 0 12 0 12 7 0 16 17 15 0 48 0 33 0 8 20 8 0 5 29 107 0 54 16 27 25 16 8 0 0 19 0 0 36 0 0 0 58 143 15 8 48 9 
3 0 14 3 0 0 0 7 6 35 2 11 26 9 26 0 0 0 0 4 15 19 35 0 20 5 0 0 15 20 8 0 39 0 0 2 0 24 0 0 19 0 20 51 38 0 0 33 0 0 0 0 0 1 0 1 
0 3 64 8 0 0 10 19 0 0 4 29 11 0 1 55 0 0 4 26 32 9 0 0 0 0 0 0 13 8 0 0 0 0 0 9 0 10 2 24 30 0 0 0 0 0 36 60 0 47 4 0 32 13 35 0 
0 3 14 20 56 0 33 4 8 0 22 8 20 19 26 45 22 22 0 8 0 20 4 7 4 7 0 3 45 38 13 16 32 11 0 2 39 0 0 5 23 8 17 12 0 15 12 1 7 5 0 15 0 24 0 22 
12 63 0 0 31 0 0 47 0 31 10 41 34 0 6 0 0 24 0 21 13 0 12 0 18 21 25 0 10 11 8 0 0 26 0 39 0 21 34 0 81 48 0 0 0 23 0 4 42 0 0 9 41 0 6 23 
0 23 0 40 0 0 0 22 6 0 7 0 8 24 0 7 0 30 24 27 0 0 15 11 0 5 0 0 25 0 0 0 2 0 7 0 0 0 0 0 17 0 0 0 0 6 0 0 45 0 22 0 2 0 9 0 
2 29 93 52 0 0 0 21 20 0 0 41 0 0 11 0 24 0 62 30 39 0 0 3 6 0 13 0 0 0 6 23 7 9 0 2 0 0 0 6 0 0 0 0 0 40 8 14 46 30 4 0 0 46 20 0 
0 77 51 42 19 39 0 18 24 38 7 14 23 19 0 0 0 7 0 14 27 0 0 13 39 25 12 0 28 0 25 0 19 2 0 6 13 24 15 36 0 37 17 0 33 3 27 14 3 0 0 0 9 32 1 1 
0 20 11 1 12 0 12 0 48 0 0 0 22 12 6 0 32 0 0 0 0 14 0 0 1 41 11 0 20 3 0 0 29 1 23 34 10 11 0 0 31 9 34 0 12 19 19 5 11 0 4 0 0 0 0 0 
24 0 48 37 60 13 41 40 12 23 0 0 12 30 0 7 17 22 28 6 25 14 27 44 0 0 0 4 0 0 36 0 32 15 0 9 0 0 35 35 0 34 19 30 0 46 27 74 29 0 0 0 0 0 35 5 
68 0 49 33 28 8 0 33 5 56 37 1 1 15 10 0 21 0 0 0 0 24 7 0 0 7 51 16 25 0 14 19 41 21 0 2 0 9 0 2 40 10 0 0 25 0 0 17 0 78 0 75 15 40 0 0 
