56 32
0 0 0 0 36 0 0 23 0 11 0 2 8 0 14 11 0 28 0 20 23 41 0 22 17 1 0 0 24 0 7 0 11 0 20 1 0 0 0 0 13 27 0 28 0 0 23 33 21 4 3 30 28 13 0 0 
26 0 1 13 23 27 0 46 0 2 0 42 20 0 0 47 0 1 46 2 0 0 0 0 6 5 26 40 0 0 5 23 43 0 0 16 18 0 0 0 24 0 0 10 1 25 0 29 0 31 0 0 0 116 0 0 
23 36 59 0 108 9 0 0 17 33 10 55 2 0 0 8 0 8 16 15 16 0 7 0 22 21 0 0 24 1 0 0 0 5 17 22 3 36 5 9 0 39 57 2 17 0 0 0 0 32 75 47 7 0 0 0 
0 4 16 14 15 26 0 16 0 26 16 36 0 0 0 24 0 10 0 26 0 0 25 3 0 9 0 20 1 28 0 11 2 22 23 0 8 28 0 24 0 24 0 21 0 14 0 36 0 7 3 18 0 25 0 12 
25 5 0 0 0 59 0 0 0 0 25 29 1 9 9 3 0 37 0 14 24 3 62 27 11 2 0 25 0 18 4 0 22 46 0 9 0 29 25 4 0 0 8 2 30 2 34 4 23 22 38 0 0 57 37 35 
6 0 0 0 0 0 0 1 20 25 53 0 0 13 0 0 0 32 17 7 59 6 12 0 13 28 0 0 0 21 0 21 2 16 65 0 3 13 28 0 11 25 14 0 24 0 0 0 0 16 0 13 0 26 0 35 
55 48 0 4 36 0 1 72 16 0 0 11 25 0 0 13 0 3 23 34 0 23 0 26 15 0 0 24 15 11 2 0 0 11 0 34 0 0 13 16 36 6 0 0 44 20 0 0 0 48 0 44 0 36 24 0 
0 29 52 0 0 0 29 6 39 0 0 34 35 0 0 27 13 0 30 0 0 10 0 9 22 0 0 0 23 37 13 10 5 0 0 0 0 0 5 0 0 40 26 0 15 56 22 4 0 18 22 0 0 0 52 0 
0 16 0 0 26 0 0 27 24 0 64 39 0 0 0 28 0 25 19 0 0 0 0 0 38 0 9 0 10 17 0 0 19 26 12 0 0 10 47 6 0 0 3 15 0 36 1 5 0 0 0 27 15 36 44 0 
3 20 0 38 0 19 8 29 6 17 20 0 0 0 2 0 0 21 0 0 46 52 7 19 11 0 0 0 0 41 4 11 0 0 5 38 0 1 11 7 4 0 2 0 18 4 0 0 0 15 0 0 5 0 0 53 
35 38 0 0 34 4 19 76 0 0 45 3 0 0 2 15 0 39 13 0 0 15 7 0 0 0 3 6 14 0 0 27 18 4 9 12 0 7 0 20 0 21 35 0 0 0 36 0 31 0 0 1 45 0 10 21 
2 0 1 0 0 9 12 0 0 11 0 0 0 20 41 35 3 11 12 4 25 1 26 10 0 16 5 29 0 0 11 0 0 0 0 28 0 9 0 0 4 13 4 43 9 5 9 3 11 0 0 0 0 0 1 42 
13 0 13 6 50 0 0 0 5 17 0 0 1 19 39 1 8 6 37 2 0 32 0 0 12 11 14 7 0 6 0 0 17 4 0 24 33 13 0 12 0 0 13 11 12 0 0 0 0 28 15 0 29 0 47 0 
45 0 27 22 5 0 4 0 17 0 15 0 9 10 20 13 0 17 0 21 0 23 9 18 0 6 0 0 16 0 0 10 5 0 24 19 0 0 0 0 21 40 0 0 16 60 17 0 9 15 4 0 0 9 23 0 
0 56 12 0 14 0 52 7 2 46 0 11 13 20 0 0 15 0 9 0 0 0 4 15 4 12 0 0 31 9 0 36 16 20 0 0 1 36 0 12 0 0 0 15 1 0 10 3 0 0 0 0 0 47 18 46 
0 44 52 1 1 0 5 0 27 0 0 23 0 0 0 0 20 37 0 3 34 18 0 11 0 0 15 0 0 6 0 17 0 0 16 51 34 0 14 2 4 0 0 0 23 0 0 7 17 0 42 3 1 52 18 34 
2 31 0 57 8 6 0 25 0 17 12 39 0 0 0 0 0 10 0 0 0 8 32 0 0 9 17 0 4 18 5 0 25 0 0 7 5 0 12 0 19 38 0 42 0 0 0 0 0 15 15 0 24 3 0 0 
0 54 0 0 0 46 5 0 12 14 9 28 0 0 8 18 3 17 10 14 0 6 0 2 9 5 15 0 10 11 0 0 6 38 2 23 0 0 0 16 8 0 0 0 0 0 9 0 0 8 0 48 0 1 12 70 
76 10 0 22 27 6 0 0 13 23 0 0 0 32 9 22 16 0 36 24 0 0 5 76 15 22 15 7 15 8 4 0 19 0 13 2 10 10 23 0 1 0 9 0 0 0 12 33 0 0 16 19 0 0 54 0 
12 66 16 9 30 23 0 11 17 34 16 0 6 38 0 3 0 0 7 19 32 10 26 0 14 7 23 7 10 0 26 20 18 6 10 9 2 0 0 10 10 14 14 30 17 0 2 46 70 16 0 88 36 0 0 24 
0 0 0 8 40 32 1 48 43 33 0 0 8 32 0 30 68 37 0 20 0 0 0 0 0 19 0 9 13 0 6 0 22 0 40 0 0 0 2 0 0 0 33 9 12 72 5 0 0 0 18 28 36 0 47 48 
8 16 0 0 0 5 0 6 0 0 17 13 0 7 15 5 29 16 3 31 21 0 0 0 1 19 9 0 30 21 0 0 22 32 15 21 7 6 31 0 12 0 0 43 0 29 26 0 0 0 14 51 0 0 0 0 
0 5 0 0 8 19 0 2 16 39 0 0 8 35 0 0 8 0 0 0 15 0 10 10 0 11 0 11 0 2 19 18 7 6 13 10 11 15 2 7 0 11 0 20 19 0 0 11 4 1 0 42 0 0 0 17 
49 0 41 31 0 0 0 60 0 6 0 0 21 0 0 15 0 27 38 33 23 8 0 0 5 10 4 27 24 0 4 0 0 0 31 0 0 10 0 0 14 0 0 47 10 0 23 0 0 69 21 0 9 0 8 2 
46 28 37 33 0 0 43 48 0 9 5 0 5 0 37 34 5 37 0 0 26 44 0 35 68 0 14 0 31 3 0 10 4 6 11 50 33 0 14 17 0 0 0 0 8 17 51 24 0 15 26 51 4 6 37 5 
32 0 0 0 0 13 10 0 2 33 25 11 23 1 50 0 10 0 0 0 42 0 0 0 11 3 0 0 0 17 22 11 0 30 36 31 0 0 0 6 24 0 16 5 16 0 0 0 5 13 16 31 7 39 0 26 
2 70 16 49 32 0 10 0 0 48 35 21 33 0 16 24 7 0 6 10 2 20 0 0 0 7 0 17 24 11 0 47 0 0 8 0 12 0 0 4 0 0 16 4 0 22 15 0 34 2 40 42 48 7 39 0 
0 1 0 32 0 0 4 0 2 9 0 0 0 2 0 0 15 0 19 22 0 0 0 12 26 21 0 4 3 0 7 8 27 0 1 41 13 6 32 0 0 22 38 6 23 24 24 0 0 19 27 0 25 0 22 18 
0 7 21 28 1 1 6 33 7 14 0 0 39 10 14 0 0 13 27 10 0 0 5 6 16 12 10 8 26 21 0 26 10 15 28 31 10 22 0 32 49 0 28 47 11 7 28 0 5 37 4 3 3 0 71 26 
0 21 0 80 0 1 10 0 45 37 20 14 0 2 5 0 12 0 12 17 1 37 13 15 0 22 0 0 7 18 24 0 13 11 24 12 8 0 10 0 12 0 2 0 8 0 25 12 26 0 0 33 23 22 0 0 
0 0 0 1 19 27 19 0 0 80 0 48 0 1 1 19 8 30 31 10 11 22 0 12 0 34 15 0 0 12 13 4 16 26 19 0 30 0 20 8 0 25 6 12 0 36 47 16 6 0 0 15 1 5 22 0 
1 0 0 1 13 50 46 38 0 8 29 14 18 6 13 11 0 0 19 6 0 2 5 0 31 20 0 12 0 28 0 42 0 0 13 12 13 0 0 0 0 21 22 0 0 48 0 0 0 46 3 3 98 8 0 17 
