56 32
1 42 2 15 0 37 0 17 0 0 23 6 19 17 13 0 0 4 27 2 17 0 19 9 27 3 13 19 0 0 0 0 24 26 0 0 29 0 5 20 0 3 34 42 34 0 3 15 0 17 0 0 0 0 9 26 
1 0 0 0 0 67 30 2 0 32 0 41 0 0 0 13 33 0 41 0 29 0 0 0 19 0 24 0 21 0 11 18 6 0 12 7 0 1 8 0 35 11 0 0 35 0 0 8 0 22 2 3 41 15 0 8 
24 34 0 2 0 5 33 0 9 0 11 0 9 28 0 0 2 8 11 9 0 1 17 0 0 10 15 4 17 8 11 10 16 0 0 58 12 2 0 2 0 28 0 20 0 10 22 0 0 0 12 0 0 25 1 0 
84 22 33 43 48 19 0 13 15 64 2 0 28 0 10 0 0 0 0 18 39 0 13 10 19 30 6 21 4 0 0 2 9 33 12 52 0 18 29 0 0 0 3 4 0 0 88 0 0 0 28 51 28 33 0 0 
0 29 0 0 0 0 3 29 47 0 8 6 7 0 52 12 1 53 0 0 0 21 0 0 8 0 0 35 0 11 2 3 7 6 15 11 0 11 0 38 15 0 8 14 40 15 11 35 7 15 35 17 0 0 27 5 
10 0 21 0 24 0 24 56 29 5 0 32 3 5 0 2 18 0 1 7 13 14 0 0 0 6 0 11 13 3 38 2 21 0 0 8 0 0 0 0 0 0 5 47 0 18 0 0 8 12 39 0 45 0 7 39 
5 5 25 12 4 1 37 6 43 31 0 44 13 0 10 7 21 13 20 4 9 19 0 2 0 7 2 21 22 32 10 13 16 7 14 14 21 23 13 20 1 6 7 12 14 0 0 13 0 20 16 24 0 0 25 25 
27 0 21 0 0 0 64 30 0 10 10 0 0 0 17 21 0 18 0 0 21 0 0 4 0 0 0 16 22 0 0 5 0 23 1 24 38 23 14 0 0 21 7 0 0 39 39 0 0 7 0 0 0 0 5 0 
0 0 12 46 35 0 0 0 11 0 44 12 22 0 10 0 0 10 1 0 0 0 1 2 11 15 20 3 11 9 20 11 0 0 2 2 5 0 9 60 0 12 0 0 4 0 20 0 0 46 0 0 3 0 44 3 
22 45 28 0 0 0 10 0 0 0 0 0 0 0 0 0 0 5 8 28 23 0 21 10 0 11 0 0 0 0 57 8 0 10 0 0 8 0 0 3 34 9 0 0 0 14 6 28 7 0 44 39 21 0 0 61 
51 3 0 4 0 0 19 0 0 20 37 26 21 16 21 0 26 47 0 28 14 0 13 0 0 0 13 13 3 8 19 13 15 21 20 0 30 28 0 2 11 0 1 24 6 14 0 37 9 12 24 0 10 0 24 0 
9 35 0 0 96 48 0 0 0 21 5 64 23 0 0 0 1 13 0 2 0 3 6 0 15 0 0 18 3 0 21 7 7 29 0 28 39 9 0 0 59 0 0 0 17 0 6 0 44 0 2 0 16 48 0 0 
0 0 55 0 11 0 1 28 23 16 12 0 0 27 0 6 0 2 11 16 0 0 10 0 22 0 2 3 0 0 10 23 24 16 0 33 0 2 0 2 17 0 24 0 10 18 0 16 0 20 0 4 0 4 17 0 
0 48 0 0 0 22 50 3 23 0 0 40 0 15 78 69 4 22 10 2 0 8 0 5 15 18 13 10 0 7 23 0 2 7 29 0 6 0 0 16 0 0 26 9 0 0 6 0 17 47 56 40 8 0 26 0 
33 28 0 17 14 0 0 17 33 6 7 4 4 51 24 38 14 0 14 11 0 40 0 4 23 6 2 13 14 0 2 0 2 0 11 3 12 7 24 0 5 0 86 4 0 0 0 40 0 14 25 10 53 45 17 35 
51 0 0 0 102 38 0 7 36 0 0 0 10 9 0 0 7 0 36 28 0 0 15 0 0 3 0 0 0 11 0 0 19 0 0 9 32 26 6 4 0 0 2 0 26 5 0 28 43 49 11 19 0 0 10 51 
5 0 0 6 0 20 16 1 0 0 8 3 25 0 32 17 50 19 27 0 11 13 16 9 3 0 21 6 0 0 12 0 13 0 0 8 19 18 0 3 0 2 4 0 0 0 16 0 7 3 24 0 0 0 6 0 
0 0 48 0 6 0 25 43 13 17 16 0 0 17 0 1 41 0 3 0 0 0 0 0 0 4 31 0 35 4 0 0 0 0 0 0 18 1 0 0 8 13 40 14 0 0 37 0 2 5 48 3 45 38 0 0 
26 0 0 2 0 3 0 61 0 45 9 24 0 51 10 4 0 31 3 0 0 0 0 16 6 0 0 15 0 20 13 31 0 20 0 5 0 11 8 0 2 29 2 46 31 0 32 0 31 8 11 0 0 23 89 45 
32 0 33 9 0 0 0 50 50 8 0 6 15 0 13 37 35 17 0 0 4 0 36 0 3 8 0 16 8 0 18 0 32 4 7 33 0 26 2 20 22 14 0 0 0 20 10 0 0 17 0 35 43 45 19 0 
29 33 12 0 8 29 46 23 0 0 22 27 3 58 0 8 5 15 0 5 10 0 30 12 23 9 0 5 0 0 59 0 5 0 4 20 9 2 0 30 10 28 4 30 4 0 0 34 0 0 50 11 66 0 0 31 
0 41 0 0 31 0 15 0 0 0 19 31 0 27 0 15 0 7 10 0 12 0 0 7 0 3 11 8 23 0 15 10 0 2 0 31 16 29 20 0 27 21 10 0 0 0 0 0 0 21 0 0 16 0 0 0 
9 0 24 125 6 11 22 0 3 20 11 33 7 0 3 0 7 0 5 13 0 0 3 0 0 49 7 0 0 4 0 0 0 0 0 19 0 0 27 0 0 0 0 29 0 0 37 0 50 0 0 0 27 0 9 52 
20 0 1 43 13 11 0 10 0 11 23 7 0 9 0 18 25 15 13 0 20 0 2 48 45 15 16 3 0 23 0 0 15 2 29 16 15 7 2 21 38 22 10 0 3 0 6 44 7 0 22 0 0 0 25 3 
52 0 0 0 0 0 0 7 32 0 3 0 2 0 0 8 39 12 0 0 33 12 0 4 17 2 0 19 0 0 18 23 0 12 0 18 22 0 0 0 0 16 0 0 20 0 22 0 18 0 0 4 62 33 22 39 
0 24 1 0 0 22 20 43 3 22 0 0 0 16 0 0 36 0 0 12 0 17 16 13 12 0 0 15 26 12 0 2 32 0 5 24 0 0 0 0 12 0 10 20 19 21 3 50 0 3 43 0 0 0 0 0 
37 13 21 0 65 17 0 40 5 23 0 0 2 12 22 0 15 34 25 7 0 12 42 0 19 0 27 3 24 16 30 16 37 0 21 1 0 0 3 1 0 25 0 44 10 0 3 65 48 1 11 34 12 1 0 48 
17 2 40 6 0 0 2 41 8 20 0 22 73 0 15 0 60 3 26 0 11 5 20 0 53 21 5 31 14 0 0 15 5 24 0 13 9 28 0 23 1 1 10 0 0 29 0 0 41 0 23 0 28 1 0 89 
0 0 26 0 29 21 27 0 0 0 41 20 23 15 0 27 77 5 21 0 0 14 15 14 31 22 21 0 14 21 0 13 16 29 23 9 0 21 0 25 0 4 53 21 10 34 0 0 0 0 36 37 0 18 0 12 
0 25 0 0 0 0 19 4 0 22 12 0 60 3 2 16 0 13 0 2 0 1 5 0 1 0 27 19 0 5 9 16 7 0 0 0 7 15 6 0 4 0 13 19 0 44 17 0 0 0 9 0 0 68 16 0 
0 0 1 0 28 0 0 0 36 1 0 19 0 28 2 36 2 9 0 16 17 0 7 15 0 0 21 18 0 12 0 0 31 0 0 23 0 17 19 0 11 28 0 0 29 12 0 21 33 61 0 41 0 0 0 40 
42 0 82 0 33 0 110 0 12 11 26 23 28 0 45 0 38 0 13 15 11 13 8 4 30 23 0 1 22 0 10 7 0 1 29 29 26 28 12 35 32 35 0 0 23 0 0 15 48 6 0 4 0 0 5 36 
