56 32
0 22 18 9 45 2 0 0 25 43 19 32 0 6 10 1 25 0 0 33 0 0 28 22 21 0 0 8 0 7 2 17 0 0 16 0 29 31 0 0 0 0 0 19 41 51 0 0 0 45 6 33 36 0 51 0 
0 0 24 18 34 0 0 0 0 6 0 14 0 54 1 5 17 0 0 24 45 24 7 0 23 0 2 16 26 0 0 0 0 0 0 17 3 0 25 0 0 0 0 20 22 25 0 9 22 0 38 0 12 0 26 0 
0 0 16 0 0 0 0 16 0 4 11 2 13 4 37 0 0 21 0 28 14 37 0 0 9 28 11 16 0 4 6 22 8 1 16 46 2 0 45 0 1 25 28 19 0 0 39 0 45 0 30 17 0 0 39 11 
0 0 36 0 36 13 21 7 0 0 42 0 37 0 0 0 0 0 0 0 2 0 0 32 0 15 0 0 13 3 4 22 20 0 33 0 32 0 0 0 3 0 0 24 38 14 0 0 20 0 0 1 41 0 60 0 
0 0 19 0 16 31 0 0 0 40 0 33 43 29 0 0 48 0 32 0 3 3 0 3 0 23 25 0 18 4 4 42 18 0 9 0 32 5 0 0 0 18 5 0 0 33 37 0 32 13 0 10 7 49 12 87 
0 12 45 15 2 4 0 28 0 0 0 15 23 29 0 0 4 3 4 7 4 10 13 3 26 21 21 0 3 21 25 0 15 0 0 38 0 19 0 0 5 0 19 4 0 0 0 45 0 1 0 0 8 0 20 0 
6 0 1 15 0 0 0 0 18 0 0 0 0 6 24 25 8 34 0 7 0 0 6 0 0 0 18 8 0 4 22 15 6 0 3 20 2 0 2 0 24 0 5 0 0 0 0 0 0 9 18 66 22 0 0 20 
0 25 0 11 0 0 0 0 16 6 0 5 0 0 11 0 0 0 0 19 0 0 0 0 0 0 0 0 27 14 0 13 0 0 10 0 25 36 9 1 0 10 0 12 0 0 0 0 4 0 0 0 14 11 0 0 
0 32 17 0 0 0 0 0 36 0 0 0 3 1 34 37 0 0 0 0 0 4 7 0 0 0 11 0 5 13 0 0 15 12 0 0 0 13 36 2 0 5 38 6 43 0 6 0 34 7 0 13 0 0 0 0 
23 38 7 0 0 0 0 23 79 9 11 8 0 0 11 0 0 0 0 0 23 11 0 2 0 0 0 0 26 0 25 0 9 4 11 26 0 0 5 46 0 0 12 14 35 14 15 0 15 0 0 0 48 0 0 0 
0 28 0 0 31 47 25 76 16 23 10 15 38 0 9 35 13 0 28 0 19 2 0 7 3 0 0 5 3 1 30 25 11 0 0 20 0 30 45 2 0 0 0 1 0 30 11 0 22 11 3 0 66 0 7 7 
1 1 0 47 31 0 5 11 43 0 0 7 2 0 0 0 0 19 4 0 32 11 0 6 0 7 9 0 18 0 2 4 4 13 0 55 9 31 18 2 0 1 6 5 0 14 36 0 9 15 47 0 0 0 0 0 
18 0 13 27 40 22 0 55 27 0 0 0 0 19 5 0 15 0 0 10 0 0 6 3 6 0 3 35 0 7 5 5 7 0 2 27 4 0 10 0 0 0 0 0 81 18 0 0 41 0 4 0 0 0 0 0 
40 1 1 51 17 26 27 18 0 42 14 3 14 28 3 40 2 8 22 0 0 0 7 8 20 18 36 0 0 34 29 26 0 27 0 18 7 25 0 0 9 10 32 0 22 16 0 0 25 19 0 39 8 24 0 29 
6 63 23 0 13 0 15 19 10 7 22 0 2 0 13 0 8 34 4 37 7 17 19 0 19 28 16 17 6 1 0 0 35 23 15 0 5 0 12 9 12 22 16 41 26 0 0 28 9 13 49 24 11 13 16 23 
19 0 41 9 12 28 0 1 0 33 0 42 0 2 15 24 0 0 0 14 0 0 0 4 15 0 55 0 6 18 23 0 10 36 0 3 0 7 0 21 2 13 36 41 5 4 16 10 12 5 0 0 26 11 0 44 
9 21 0 0 104 0 3 1 1 2 0 37 0 47 0 10 3 26 0 2 2 20 21 56 0 0 0 0 15 9 17 0 2 20 13 0 0 14 13 0 0 1 0 0 0 5 0 0 0 26 4 0 39 42 19 51 
5 3 0 0 32 5 68 4 0 0 0 12 23 0 22 0 2 12 0 2 0 0 0 0 14 0 0 0 5 25 0 7 0 16 11 0 31 0 32 0 9 20 36 3 6 0 0 0 11 0 0 0 0 0 0 11 
0 35 0 13 0 0 0 8 5 16 0 14 15 9 0 0 2 0 14 12 0 17 0 0 0 8 0 0 0 1 0 0 43 1 0 23 5 16 0 10 0 0 0 12 11 0 0 0 0 0 6 0 18 0 0 0 
0 0 34 17 0 23 0 40 0 3 17 0 9 0 0 0 7 49 0 12 6 10 0 0 0 0 21 9 3 8 1 10 0 21 0 28 60 0 0 0 0 2 0 0 0 0 0 70 0 0 0 17 0 0 0 35 
0 13 22 0 50 30 31 6 0 3 8 0 4 0 19 68 2 4 0 0 40 4 0 8 28 0 22 0 5 0 2 0 4 9 12 9 0 9 21 60 3 5 0 0 14 17 30 0 22 16 1 0 7 23 16 0 
47 0 62 0 0 28 0 46 0 17 2 7 0 0 0 13 11 0 18 10 35 21 0 0 43 0 2 24 0 13 0 26 1 0 18 0 18 0 0 3 5 0 73 10 0 26 0 50 0 0 23 0 0 46 18 35 
0 15 0 28 0 0 40 3 0 0 0 0 0 33 0 0 0 11 30 0 0 14 1 0 0 5 0 4 11 12 0 24 25 0 18 33 22 0 0 11 23 0 0 0 0 7 15 0 5 0 0 0 0 0 0 0 
108 0 83 19 0 0 37 13 62 10 13 20 15 0 3 9 8 10 35 7 1 29 1 13 24 22 5 9 4 2 0 19 8 0 23 35 3 12 18 27 12 8 0 33 58 54 0 4 0 14 9 46 0 0 37 53 
0 0 0 9 27 3 12 0 0 1 0 21 32 2 1 0 6 0 12 21 2 10 0 9 10 6 6 6 6 11 0 18 3 12 0 5 6 13 0 9 21 0 0 0 26 13 33 3 13 40 35 1 0 0 0 0 
35 2 37 23 2 21 32 29 40 2 0 0 24 25 1 8 7 1 0 25 0 11 0 11 8 0 41 0 0 14 0 0 19 9 0 0 19 2 32 13 0 0 1 0 1 0 39 10 17 0 33 28 47 0 2 0 
0 0 0 127 12 2 0 21 5 0 0 40 40 8 5 2 10 0 16 19 0 6 11 0 0 21 5 0 0 30 0 0 12 16 0 28 7 7 4 21 20 0 10 46 30 0 0 26 0 0 17 40 0 39 51 0 
0 12 19 0 21 0 0 0 3 0 63 1 58 19 0 9 6 0 3 0 0 0 0 0 0 16 0 16 25 0 0 8 12 0 9 7 2 2 28 29 22 0 0 34 0 0 19 8 2 0 38 0 0 78 0 48 
0 15 0 42 1 0 0 0 8 5 0 15 38 0 0 12 18 0 22 0 0 37 28 0 0 32 1 0 12 21 0 6 11 0 0 0 8 36 25 0 8 0 0 0 41 0 0 0 11 13 51 0 14 0 0 11 
0 5 39 0 0 0 0 0 18 34 1 0 27 11 0 36 0 30 25 8 0 18 21 6 24 2 7 1 20 0 0 0 4 14 3 13 0 17 10 9 15 53 0 55 0 29 0 30 24 0 5 39 0 0 3 42 
35 23 0 4 49 6 0 6 37 0 60 29 3 0 21 32 0 46 14 15 41 24 12 27 0 0 0 18 6 10 0 20 0 0 0 72 8 19 22 10 1 0 4 17 23 73 26 0 17 19 51 7 17 11 23 0 
33 6 28 49 30 10 0 17 7 13 43 0 0 0 0 2 0 8 5 2 0 0 0 6 13 0 0 18 21 12 0 0 2 33 13 2 0 31 0 35 14 20 0 0 8 0 0 0 38 0 0 27 70 0 0 0 
