56 32
57 0 0 0 0 39 60 0 0 0 6 9 46 35 40 39 20 21 9 0 22 0 0 0 0 27 26 0 0 0 0 31 3 0 0 24 9 0 0 0 0 0 25 0 0 0 87 0 29 14 0 5 27 47 40 0 
0 20 0 45 0 8 0 10 0 11 1 1 48 19 12 22 11 5 0 25 10 25 15 7 0 18 24 17 0 10 18 5 0 6 0 30 0 34 0 0 0 21 0 21 0 0 16 0 119 18 34 0 17 10 35 91 
0 0 0 0 18 38 6 23 0 20 0 24 0 41 0 0 87 29 15 4 0 51 35 0 17 4 0 22 15 13 23 6 0 0 0 4 0 7 0 17 0 2 5 44 27 0 11 0 18 22 2 12 0 0 33 50 
0 0 21 0 23 10 39 40 10 0 0 0 0 0 0 0 0 0 0 23 54 0 0 21 0 9 21 0 0 0 0 0 14 0 0 0 0 17 0 0 7 0 24 0 3 22 0 22 1 0 0 0 15 0 0 15 
41 20 0 8 0 12 27 0 0 17 0 26 0 8 0 40 0 0 0 0 23 42 0 15 0 20 15 12 0 0 4 0 24 0 16 0 0 5 0 0 0 52 13 0 0 7 4 0 1 8 16 1 1 8 0 40 
24 0 0 0 19 13 48 18 6 0 0 19 12 0 6 0 0 0 29 33 33 0 2 7 41 17 0 0 0 11 13 23 2 11 0 12 0 0 0 5 11 0 0 0 5 22 1 11 0 0 0 0 28 0 33 0 
22 24 0 12 20 0 14 1 45 0 20 0 0 0 0 11 0 0 35 7 0 5 0 17 21 15 19 0 0 2 16 25 0 1 0 0 25 11 5 6 0 7 0 17 0 0 0 18 1 20 0 14 0 80 10 0 
0 29 9 67 23 0 9 0 12 0 0 12 0 0 16 19 0 0 3 12 0 21 0 0 6 4 7 0 0 20 0 0 26 32 14 29 33 22 0 0 14 0 0 0 0 13 7 6 0 0 49 48 0 58 15 41 
5 2 0 1 0 30 33 0 5 0 0 0 0 0 16 3 0 0 0 0 5 24 0 35 0 0 0 14 14 0 54 21 0 23 28 63 17 0 5 0 0 40 15 44 0 42 0 0 0 0 0 0 0 0 0 0 
16 7 0 2 29 46 43 12 3 2 14 10 19 0 14 0 24 0 26 6 0 21 0 14 0 10 10 12 36 0 0 8 0 22 5 18 5 3 38 10 22 15 21 5 2 23 19 2 0 18 0 89 0 31 7 2 
0 33 40 2 13 2 38 7 0 34 0 3 0 15 12 21 0 0 0 19 19 1 24 10 0 0 0 11 8 4 26 17 20 17 18 11 0 7 34 0 2 7 36 54 42 0 13 47 0 0 17 0 15 0 0 0 
0 0 10 0 0 0 0 8 0 0 43 17 9 2 0 33 29 0 29 0 0 17 11 2 14 10 0 0 22 0 6 0 28 0 0 0 0 17 0 41 6 15 9 0 0 25 0 6 0 0 0 9 7 0 13 0 
10 0 1 49 25 0 99 0 2 0 30 9 41 14 33 45 0 13 4 5 0 0 12 0 29 16 21 0 0 14 14 0 16 12 30 0 3 0 0 26 25 5 3 57 0 0 4 32 2 64 0 0 46 41 0 0 
22 0 0 34 25 14 16 0 36 8 31 0 21 24 23 35 0 0 10 89 13 0 5 20 0 5 0 0 3 22 0 0 22 21 5 27 0 14 19 0 3 10 0 47 0 6 0 15 0 11 35 1 18 20 0 36 
0 15 0 0 0 0 3 0 22 0 26 8 11 34 3 12 0 5 19 0 0 8 0 0 0 7 8 6 6 8 46 37 10 23 1 21 9 23 0 0 0 0 0 0 38 0 0 3 0 0 37 8 8 0 16 3 
40 20 64 9 0 42 7 0 50 1 0 4 25 5 26 28 0 25 0 0 0 10 4 0 0 0 0 51 4 40 16 33 7 0 0 0 0 10 0 39 68 31 49 23 5 0 37 42 5 0 0 4 1 0 27 4 
16 23 0 0 33 20 6 0 7 1 7 0 0 4 10 0 39 22 18 0 0 12 0 0 1 13 0 23 8 0 6 9 7 0 0 0 15 48 0 23 22 4 12 3 11 2 0 0 24 0 13 0 0 0 12 39 
7 63 48 25 33 17 22 0 1 14 0 10 12 0 16 0 0 4 21 11 18 17 0 20 24 0 6 0 22 0 27 0 6 0 8 15 29 22 17 1 13 24 19 0 3 44 0 14 24 8 48 0 0 4 0 39 
0 3 4 0 0 10 29 0 40 0 29 3 18 5 0 0 0 0 0 0 15 0 6 18 27 25 2 0 0 33 0 0 0 22 10 0 0 29 0 4 0 0 0 0 10 0 0 0 6 0 25 0 0 12 0 63 
0 57 53 2 0 12 25 0 30 16 48 18 5 0 5 2 0 5 0 0 0 0 0 7 0 36 0 0 0 14 0 5 0 25 12 27 28 29 0 0 4 4 22 12 0 2 0 22 4 1 14 50 6 18 12 101 
0 0 13 0 7 49 0 0 0 0 14 0 0 11 31 0 0 0 0 29 10 17 0 3 27 0 13 0 20 13 11 0 4 0 0 0 4 18 14 6 6 0 0 0 0 33 6 0 29 1 4 7 14 0 34 1 
44 84 22 15 35 0 0 73 27 69 31 39 0 2 0 42 0 54 0 9 0 24 15 30 2 0 29 21 5 21 70 33 30 2 0 20 61 10 7 10 13 49 16 13 57 42 32 23 20 0 4 0 0 62 0 1 
0 8 0 25 6 13 0 0 0 28 3 0 0 0 25 5 18 0 0 3 0 15 0 14 11 0 1 29 25 0 19 11 0 20 9 11 0 12 1 0 35 1 4 9 0 0 32 0 38 0 3 7 1 20 24 1 
0 0 0 44 19 0 17 0 0 0 17 44 35 5 75 18 0 0 49 21 0 0 0 17 0 0 1 2 14 0 0 14 0 0 16 0 0 34 31 12 15 25 13 47 6 29 32 56 30 30 16 24 0 0 19 3 
1 10 0 0 3 0 15 3 27 7 0 3 0 18 0 0 0 33 0 0 0 19 0 37 0 0 0 19 0 0 7 8 10 0 10 0 0 0 0 6 29 0 8 0 7 6 23 0 8 0 46 4 0 0 0 4 
8 2 0 16 0 47 10 0 26 0 13 15 31 0 2 0 8 10 1 0 0 0 0 25 0 1 13 0 16 18 24 4 0 0 21 0 17 0 0 18 15 0 12 31 11 9 43 0 16 0 0 0 91 0 0 13 
32 40 44 37 23 0 14 20 0 0 34 28 0 0 7 14 6 0 0 14 34 29 0 12 10 0 0 5 26 29 39 0 3 0 0 0 26 5 0 6 37 18 11 25 49 3 26 16 10 0 0 28 0 52 60 0 
30 25 29 0 7 0 32 0 11 0 3 5 0 0 35 6 25 51 0 22 19 0 22 6 4 17 0 11 7 15 30 31 0 16 20 14 0 0 0 8 14 36 29 3 74 0 7 41 0 35 0 18 14 18 24 12 
6 0 0 0 16 0 0 0 23 0 0 5 9 25 10 0 0 17 0 15 9 5 0 11 12 0 0 5 27 0 0 23 27 0 0 35 16 29 0 0 9 0 9 5 0 23 0 26 0 9 0 0 0 0 12 27 
35 0 0 41 50 0 8 3 13 0 0 27 9 5 28 21 27 0 14 26 3 6 0 16 0 0 24 5 0 33 0 52 0 21 35 35 18 14 0 0 5 0 0 14 11 11 12 44 4 6 14 0 4 47 0 25 
1 21 0 0 58 61 0 0 0 0 8 0 0 0 0 0 0 9 7 0 20 1 0 0 0 19 9 0 16 0 0 5 27 0 5 0 5 0 0 69 20 20 2 0 16 21 4 26 5 0 5 0 0 0 0 5 
0 0 10 0 0 33 28 79 0 7 26 0 31 0 0 36 0 17 14 2 0 0 3 0 5 18 0 17 9 23 7 46 14 0 28 0 19 30 33 0 11 0 0 18 0 0 39 0 0 0 3 11 16 3 0 0 
