56 32
0 29 19 28 0 30 0 0 0 28 0 0 0 0 23 0 0 0 22 0 0 19 22 17 3 6 0 2 0 10 15 25 2 0 0 0 0 3 0 7 22 0 5 18 0 15 0 40 23 0 0 14 0 7 0 15 
4 61 12 0 0 0 0 34 8 0 30 0 14 0 25 66 16 55 28 31 10 0 5 0 7 0 0 7 12 29 0 0 17 0 13 1 0 22 0 38 11 0 0 4 16 0 19 4 31 17 40 37 0 36 39 0 
27 62 0 43 0 14 0 25 20 11 2 0 2 6 13 0 4 25 0 13 0 0 25 0 0 27 21 0 5 35 4 0 11 9 0 0 8 18 0 0 0 38 17 0 4 0 0 25 11 34 41 0 0 20 25 4 
23 32 19 22 4 30 0 0 45 9 27 26 3 27 53 0 0 10 24 3 12 9 0 7 3 21 4 41 3 19 1 13 8 0 0 0 3 13 26 8 36 2 42 0 6 20 45 0 35 8 2 22 0 0 0 15 
26 18 29 2 0 2 21 0 44 14 7 9 5 16 12 24 0 0 9 0 22 0 27 43 4 35 6 21 6 9 0 29 6 10 6 0 0 0 0 24 6 3 0 0 0 12 16 0 0 29 0 3 15 0 12 22 
137 0 0 0 0 0 0 0 0 35 6 57 62 0 0 0 14 0 0 0 30 0 25 23 0 8 0 0 0 29 14 3 28 0 6 0 0 15 11 0 0 0 25 11 37 45 23 0 0 0 16 51 0 41 11 13 
27 5 0 0 0 151 2 24 5 0 0 2 1 0 0 3 33 49 14 0 18 5 35 23 32 0 39 21 0 0 0 0 0 9 6 0 0 1 13 0 0 0 18 38 35 0 23 20 44 0 23 0 4 31 27 53 
22 6 0 33 46 4 26 32 26 0 23 8 40 5 15 0 1 15 27 19 0 0 0 6 0 0 23 0 12 7 29 0 52 13 22 0 17 9 4 16 10 3 38 17 39 60 42 35 43 4 0 3 19 24 50 4 
71 22 0 0 1 0 13 32 0 18 22 0 0 30 53 0 16 23 48 13 9 4 6 0 7 4 21 18 7 8 3 3 0 0 0 0 0 13 18 0 11 0 33 6 44 0 0 0 0 0 16 0 39 0 6 37 
19 0 25 21 8 3 0 47 3 0 5 0 8 48 0 5 21 16 12 12 0 0 22 9 14 0 0 0 0 26 0 5 0 0 23 15 0 38 3 4 0 0 0 0 8 0 0 13 19 12 37 0 0 0 17 48 
13 62 0 0 0 0 0 0 66 37 0 7 0 4 7 21 6 52 61 7 5 0 0 0 39 0 0 0 6 20 8 16 0 25 0 0 27 0 0 0 0 0 31 42 12 21 38 0 0 41 0 33 0 0 0 13 
1 37 103 0 0 4 0 63 0 0 40 8 8 18 1 6 0 0 19 1 7 8 0 0 0 0 0 16 0 0 20 0 0 23 37 0 34 19 5 0 1 3 32 0 37 29 0 0 11 0 0 15 50 0 9 20 
45 30 1 18 0 0 8 0 0 0 10 3 13 0 8 0 0 3 9 22 0 1 32 12 0 30 28 22 0 9 15 0 71 7 6 10 0 0 13 16 3 22 42 8 17 0 21 0 0 22 35 5 5 21 32 23 
22 85 12 6 0 34 0 17 5 11 0 8 0 41 12 1 1 1 0 10 0 0 22 18 7 8 0 27 1 33 9 0 0 0 0 0 0 0 0 12 39 0 0 0 12 0 18 0 11 0 0 0 0 0 41 4 
0 101 7 1 0 34 0 2 0 0 0 105 0 0 13 14 14 0 0 0 36 32 20 0 0 0 13 0 0 0 22 2 31 18 29 20 0 0 0 13 2 0 0 6 22 5 0 3 47 0 3 14 0 68 34 64 
0 0 0 0 0 0 16 31 0 0 0 17 77 0 0 0 0 16 0 0 0 10 0 0 0 0 15 0 8 0 18 0 4 24 0 0 0 0 31 0 7 23 17 0 0 0 11 6 42 0 6 0 29 1 0 4 
6 16 49 2 46 17 0 66 0 0 0 0 47 6 6 0 19 0 0 0 0 14 8 31 0 0 7 0 0 27 0 19 17 7 1 19 0 9 20 0 26 25 0 0 0 15 0 15 2 17 44 0 0 0 59 15 
0 52 3 7 0 4 39 0 0 13 4 24 0 51 40 6 26 0 12 0 0 0 11 0 24 0 0 0 15 5 0 8 1 0 24 0 4 0 8 0 0 39 0 17 8 71 0 17 0 0 3 10 0 82 0 31 
11 0 1 2 22 0 54 9 23 26 45 6 0 0 12 9 7 16 0 11 0 0 0 0 0 14 10 0 9 0 6 1 24 16 0 23 0 10 7 15 0 0 0 0 11 11 0 9 0 43 0 0 0 34 15 35 
0 16 14 0 0 0 0 13 0 0 3 0 0 0 10 37 12 88 12 18 0 0 12 0 2 0 15 2 12 16 0 16 0 0 0 8 0 36 0 22 5 16 0 0 0 7 5 0 0 0 2 5 72 27 36 15 
33 3 21 6 12 0 35 13 0 0 0 9 8 13 0 7 3 0 2 0 9 0 7 0 11 5 0 6 26 0 27 0 0 28 27 0 0 3 10 0 8 35 0 0 0 1 16 0 0 0 0 0 22 0 0 0 
0 0 7 0 0 41 0 0 18 0 0 13 0 0 4 20 0 0 56 31 33 0 21 8 0 0 8 0 1 1 2 8 16 0 0 12 5 0 11 0 0 0 3 19 39 1 0 5 0 23 3 8 27 33 36 5 
79 18 8 0 0 0 0 0 0 47 10 1 0 0 15 0 0 13 0 29 0 0 22 0 0 4 0 19 7 0 10 1 2 0 0 6 0 35 38 13 0 41 7 12 0 0 27 8 0 1 0 11 2 37 2 12 
4 46 1 7 0 9 0 36 17 12 0 0 5 0 7 0 9 1 0 23 16 13 46 0 33 0 17 0 0 24 23 9 11 21 0 0 33 36 12 19 38 0 23 40 0 0 24 9 2 0 37 29 28 32 15 0 
0 62 0 5 40 13 42 0 5 0 24 37 1 7 13 0 0 43 1 10 0 5 0 20 17 2 0 36 23 22 0 7 1 0 24 0 0 6 0 0 0 24 13 17 40 0 0 2 37 0 0 2 20 19 53 49 
12 0 0 0 35 8 47 25 5 0 0 0 48 26 0 24 0 24 0 0 0 10 29 9 0 0 9 22 23 0 0 24 40 0 14 0 3 23 9 63 0 0 17 0 46 0 0 18 0 0 38 7 21 47 0 0 
11 40 14 111 0 0 0 30 0 4 3 50 35 35 32 16 12 16 23 27 0 25 24 36 0 18 13 0 0 26 27 36 15 26 0 8 0 21 0 10 27 2 0 0 0 15 49 51 0 30 0 0 21 0 3 76 
0 0 42 0 0 12 24 1 19 22 0 0 0 16 0 0 10 21 0 28 0 0 0 0 0 0 25 57 19 4 0 0 15 69 24 0 0 25 4 0 0 24 0 3 42 12 0 18 0 2 31 10 0 0 19 4 
42 0 13 28 0 0 0 0 54 28 6 7 4 0 0 13 6 10 0 20 24 0 9 23 24 0 0 10 6 0 1 0 11 0 24 0 0 0 10 0 21 0 0 0 0 25 0 39 19 19 13 0 0 0 0 25 
22 57 0 0 0 16 0 0 6 0 0 0 0 0 17 0 45 0 28 0 21 11 0 0 3 78 0 3 0 23 14 0 0 37 5 14 32 0 0 0 7 5 2 0 43 12 28 31 23 90 0 34 0 7 5 0 
0 18 0 18 51 83 0 2 17 66 10 4 0 5 1 14 0 9 11 12 10 0 33 0 0 0 15 6 0 56 0 20 23 16 0 5 0 28 24 0 11 0 0 3 0 0 41 32 22 0 0 0 29 0 1 3 
0 1 24 0 2 10 7 12 11 0 33 26 0 7 17 26 1 23 7 0 11 3 49 1 0 0 36 0 0 30 24 11 0 3 8 21 5 23 19 0 55 26 16 5 10 5 20 39 2 0 10 0 14 0 13 0 
