56 32
0 41 18 14 23 15 45 0 42 0 0 0 0 0 11 27 0 12 8 0 33 31 0 0 26 5 0 49 0 16 19 0 13 28 0 0 30 10 6 15 28 34 68 16 20 0 0 4 1 46 38 23 5 0 0 0 
73 0 14 0 0 11 2 0 43 15 19 17 0 19 0 9 0 13 3 0 0 3 14 49 14 0 0 0 0 29 49 27 42 13 24 0 0 15 0 1 4 17 32 10 4 0 0 20 49 16 0 0 1 45 28 0 
19 0 1 0 3 17 0 44 68 0 11 0 0 8 39 0 42 25 6 0 30 31 17 14 0 4 12 24 17 64 0 0 0 0 0 13 0 15 30 0 0 46 26 0 0 50 6 56 0 0 51 54 43 0 47 20 
0 0 0 11 0 32 33 22 0 10 35 0 0 27 14 9 0 19 0 5 8 0 15 26 15 7 0 0 20 31 0 15 7 26 17 11 9 2 0 9 26 1 0 0 0 19 15 41 29 51 0 0 45 11 19 0 
11 0 47 49 25 14 34 0 24 11 0 11 0 17 0 1 0 12 0 3 23 0 32 12 0 37 12 0 4 25 4 50 0 0 0 4 20 1 35 0 48 7 11 0 36 21 23 0 17 0 25 6 14 22 9 0 
0 0 32 35 0 0 12 0 0 0 29 0 43 27 0 13 0 2 0 0 0 17 16 12 31 24 11 12 0 22 12 1 6 0 3 0 21 30 51 12 0 3 12 0 0 43 0 2 0 0 40 0 6 12 17 0 
0 0 0 0 0 10 0 0 0 0 41 21 20 0 34 0 0 17 29 2 0 9 15 24 6 0 0 38 18 0 6 0 5 6 16 0 3 21 0 12 29 30 12 4 3 10 18 4 34 0 0 41 0 0 0 0 
55 13 0 0 19 18 12 0 35 3 0 7 20 0 0 0 19 0 0 0 0 6 14 0 0 0 13 5 0 0 0 0 1 1 4 0 42 0 4 0 0 0 16 0 18 0 0 2 0 0 0 0 0 0 16 55 
7 11 39 0 0 2 32 12 0 0 42 9 22 0 12 8 4 0 8 19 0 0 0 22 14 0 0 1 7 7 0 18 0 0 22 6 0 0 44 12 0 0 22 0 0 0 17 8 0 0 40 0 34 0 2 0 
0 2 52 0 0 0 0 0 0 0 0 5 0 0 0 5 0 25 0 8 0 0 30 4 0 6 0 0 11 16 0 0 18 0 0 15 0 5 0 34 0 0 0 0 0 0 18 0 6 0 0 17 52 0 46 0 
17 10 0 0 18 28 0 0 0 0 0 0 0 0 15 7 16 32 0 27 13 1 21 16 4 0 0 0 5 0 0 21 0 7 0 5 30 0 2 0 0 11 0 0 10 13 27 0 48 38 0 10 15 0 0 6 
0 0 13 0 35 69 36 0 15 23 0 20 38 0 17 6 0 0 20 3 34 45 17 0 4 0 0 6 12 25 5 3 32 0 14 7 0 0 20 35 0 7 12 0 0 0 0 16 0 0 127 0 16 0 15 0 
16 0 11 0 0 52 4 0 45 0 4 48 14 65 0 9 4 3 0 29 19 0 9 12 4 0 0 0 4 0 0 0 0 0 10 14 9 10 4 23 0 0 0 0 40 0 15 143 29 0 0 0 0 58 0 0 
33 24 15 2 2 13 0 0 0 10 0 11 3 0 9 33 0 0 3 5 0 0 3 5 5 47 22 22 0 1 3 29 23 1 0 0 0 0 23 0 0 6 0 15 44 0 0 40 22 22 5 0 0 24 31 28 
0 11 0 14 21 17 0 26 7 0 16 17 7 0 7 33 13 44 32 3 0 10 17 16 0 0 0 28 11 0 12 0 2 3 0 10 0 3 5 4 33 0 0 0 0 0 0 6 33 0 70 0 0 2 5 0 
0 0 0 19 0 41 15 0 41 11 0 0 0 0 5 0 0 0 17 5 0 0 0 36 6 46 0 0 10 0 28 8 0 12 0 2 0 46 0 0 0 0 0 0 0 37 41 44 0 12 13 0 0 28 0 0 
0 0 0 43 1 31 19 4 95 4 39 0 19 26 0 0 73 26 24 15 0 0 0 25 0 7 15 16 0 3 4 27 1 2 0 0 6 0 4 49 24 36 64 55 5 27 37 14 0 44 81 0 0 0 6 0 
52 18 2 0 48 5 14 12 10 34 13 27 19 6 10 0 14 25 8 17 3 0 36 13 26 14 0 19 11 26 0 27 0 17 0 51 45 0 27 22 0 0 0 24 23 1 0 4 0 41 4 0 25 4 10 21 
5 44 0 1 42 66 0 1 34 0 0 17 33 0 16 0 4 0 14 13 0 0 4 0 0 0 11 0 10 15 30 0 0 0 15 28 0 14 12 34 22 18 0 35 3 77 0 0 0 0 0 32 0 0 7 0 
0 19 11 34 51 5 11 0 0 25 9 66 2 11 0 0 6 0 49 10 0 0 3 0 0 23 3 16 0 12 34 0 0 6 2 0 28 0 1 0 0 20 0 0 11 36 16 27 45 19 3 35 0 11 5 95 
0 10 0 1 0 9 0 0 4 41 0 14 0 11 5 0 0 3 26 2 0 8 0 10 3 5 0 3 14 18 0 0 19 20 0 17 1 24 4 0 0 39 0 0 19 0 0 11 0 0 0 25 12 5 0 0 
37 1 7 2 0 32 0 18 21 0 66 21 31 16 0 32 28 0 16 0 0 8 20 17 6 0 0 1 16 16 7 0 21 0 24 0 0 23 0 24 3 0 0 0 19 0 0 20 26 0 0 0 42 0 0 3 
29 20 36 34 17 10 0 0 0 38 0 97 1 8 14 0 1 0 20 4 0 18 0 22 41 0 5 16 0 0 21 17 15 12 0 5 0 26 42 0 0 0 12 0 10 0 0 72 0 38 7 1 29 2 22 24 
0 2 0 23 9 0 0 15 0 44 0 20 18 55 2 0 1 17 46 7 13 0 14 4 14 0 23 0 0 0 12 0 19 15 0 0 27 0 0 28 0 28 12 0 0 11 0 7 0 0 14 0 20 44 0 1 
46 0 13 49 30 28 9 1 16 0 15 0 5 50 0 0 10 0 0 8 0 0 9 9 5 36 0 3 12 8 0 0 0 1 2 0 16 3 0 0 4 0 0 0 3 0 121 12 40 24 0 0 48 1 6 1 
50 16 8 4 0 0 0 18 1 0 35 9 23 11 52 0 31 32 0 0 6 0 2 0 7 29 0 3 0 25 0 0 0 9 38 16 0 23 0 0 0 0 27 14 2 87 7 5 4 0 58 9 0 1 0 0 
0 0 1 0 48 65 14 0 1 0 0 0 4 0 5 0 37 1 7 0 14 0 1 11 0 0 22 7 17 3 6 18 0 25 0 14 37 0 15 0 23 11 0 15 0 23 0 2 0 44 38 6 2 74 0 0 
37 0 2 0 0 18 30 1 1 8 0 35 0 0 0 19 2 13 0 7 7 2 1 26 4 6 0 0 0 25 0 29 30 5 0 10 19 38 0 0 0 4 0 0 12 9 3 16 0 27 30 36 16 0 9 0 
18 0 9 89 0 15 39 0 13 4 0 0 20 4 0 3 0 11 59 0 0 44 17 0 2 23 21 0 0 23 13 27 0 0 21 29 0 0 6 0 32 0 13 55 10 0 0 0 23 0 0 3 17 35 10 21 
50 1 0 0 0 63 1 0 0 0 0 24 0 2 0 2 6 22 17 2 0 13 4 0 0 4 0 11 39 0 28 0 18 7 2 15 2 19 0 11 35 13 13 0 9 9 0 27 20 53 25 0 0 4 37 5 
8 28 27 27 0 23 45 0 7 16 0 0 54 0 10 0 0 3 0 24 0 41 22 59 12 4 0 9 16 59 4 0 0 12 52 13 11 8 12 18 23 29 22 24 11 11 25 24 0 13 0 0 1 0 0 0 
45 0 46 38 9 44 0 43 0 0 0 14 6 72 0 19 16 40 35 0 6 40 0 1 1 0 0 42 0 14 5 16 14 9 8 0 3 0 21 0 37 28 8 18 8 57 23 43 1 44 80 3 4 0 0 9 
