49 28
31 3 11 19 0 10 0 19 73 0 15 0 1 4 21 0 0 0 10 25 2 0 9 9 0 15 59 0 0 0 0 0 37 23 0 0 0 8 6 16 14 14 0 0 45 29 18 0 0 
9 0 24 45 0 0 0 0 18 0 0 0 48 34 38 0 49 0 0 0 0 20 19 0 0 0 35 2 14 23 31 30 0 4 0 7 0 11 26 0 0 45 17 19 0 15 0 51 23 
34 36 36 5 9 0 13 63 3 35 5 0 4 22 0 30 23 21 0 8 3 6 1 15 16 16 0 0 0 0 0 22 23 27 92 4 4 30 21 17 4 34 0 11 35 0 0 13 13 
20 3 0 20 32 31 0 44 0 0 0 16 0 11 37 0 0 0 24 0 0 15 3 0 1 14 6 22 18 10 1 2 14 0 27 5 28 21 0 10 0 11 2 29 23 8 29 17 0 
4 51 5 33 53 0 0 13 8 0 16 0 13 9 0 7 27 19 18 7 17 0 13 9 0 19 45 9 4 4 6 0 0 10 13 13 18 20 15 15 23 7 35 3 0 0 0 9 40 
0 31 20 43 3 0 3 6 4 5 0 12 13 0 0 0 6 21 0 0 10 0 0 23 0 10 20 12 0 19 5 3 1 8 0 0 0 0 16 16 0 0 14 1 0 0 66 0 0 
2 6 0 0 0 3 79 3 0 39 0 0 0 0 0 2 0 26 0 0 0 21 10 11 0 0 0 18 0 0 0 4 5 0 4 11 0 0 1 8 0 7 31 53 0 32 11 0 3 
3 26 5 19 8 27 29 16 0 29 16 4 18 8 2 0 14 11 12 0 11 10 2 4 4 0 34 22 7 0 19 1 10 11 0 8 0 3 14 19 18 8 45 56 0 28 0 5 36 
33 1 22 0 0 1 13 0 0 26 0 13 0 5 0 9 0 7 5 0 0 0 0 0 7 14 4 13 0 0 4 16 0 0 1 34 0 0 0 15 0 0 25 0 0 3 0 0 0 
6 1 1 24 18 3 4 8 29 0 0 1 13 0 5 0 0 27 0 34 11 0 49 17 6 11 0 44 8 9 0 31 16 0 0 0 0 66 6 0 0 0 20 8 17 0 0 0 55 
34 42 15 13 34 33 7 18 57 36 0 0 16 0 0 33 9 4 0 1 17 17 15 13 22 0 0 9 12 11 16 1 1 26 11 6 16 37 7 0 0 6 0 88 21 36 45 0 0 
0 0 4 1 43 38 53 0 25 0 15 5 6 0 0 16 6 24 12 0 0 33 13 4 26 9 0 21 15 24 0 20 1 28 2 6 0 16 32 6 0 38 15 15 10 5 9 6 61 
20 10 0 0 0 29 39 1 23 44 0 5 0 0 0 4 8 25 0 22 16 0 0 6 16 6 16 8 0 21 22 42 0 10 10 0 0 22 9 0 0 10 41 3 0 26 0 23 0 
25 11 0 34 0 29 0 1 46 0 0 0 23 1 0 0 8 0 0 0 19 5 10 0 0 29 11 0 20 0 0 0 0 0 29 23 0 44 0 19 0 26 0 3 0 0 0 10 0 
0 38 58 39 0 0 3 3 2 54 1 0 0 12 0 0 0 0 0 0 18 18 5 0 0 0 0 8 0 2 0 8 16 0 3 0 11 24 0 46 19 25 41 0 0 49 37 0 4 
0 35 43 11 23 4 36 27 0 28 31 0 57 3 3 7 15 23 0 0 0 16 5 10 20 32 0 14 14 0 5 3 16 0 61 31 37 29 15 0 4 37 68 32 1 43 0 42 9 
1 27 23 45 14 33 40 13 15 29 9 0 16 7 0 0 0 0 27 0 6 14 33 15 24 23 0 5 0 38 11 15 17 0 12 14 0 2 35 26 1 36 0 0 0 23 40 0 16 
0 0 0 42 0 38 1 1 0 23 29 11 23 3 1 2 2 5 19 7 0 0 11 0 0 28 15 13 13 0 0 17 17 0 0 6 0 6 35 35 1 0 17 30 7 0 28 6 40 
0 0 0 0 0 41 74 10 5 0 9 25 48 0 0 10 65 0 17 0 0 0 0 0 7 11 3 7 9 13 10 38 20 11 0 17 6 12 8 0 35 15 39 4 11 39 22 4 4 
0 0 0 26 4 20 0 0 32 0 0 13 15 0 0 0 12 0 6 0 38 0 0 18 0 15 0 0 12 11 0 10 27 0 0 0 8 0 8 15 2 33 0 0 18 0 7 0 0 
0 0 0 0 13 17 0 0 39 20 0 0 3 0 6 0 4 0 17 0 24 25 6 0 0 6 13 0 0 20 0 6 0 0 4 0 0 0 18 0 0 2 21 21 0 0 9 14 0 
0 0 0 11 22 0 35 7 34 7 0 16 37 7 34 0 25 1 0 0 0 0 0 15 0 9 0 22 18 13 7 0 27 14 28 0 0 7 44 12 0 35 5 12 32 0 2 1 5 
0 0 3 71 1 3 0 0 9 1 1 9 13 0 24 12 0 19 3 0 3 7 0 0 0 0 17 24 12 0 0 17 0 0 17 0 0 0 12 0 32 24 0 1 0 0 7 0 20 
20 0 4 0 0 20 9 0 0 30 2 29 24 20 0 0 19 19 18 0 0 0 24 0 11 22 0 10 0 2 0 15 1 18 21 4 18 3 5 28 0 30 11 0 0 0 22 12 1 
0 18 20 10 0 0 0 1 0 44 0 0 0 0 0 0 0 0 20 0 19 0 0 21 15 0 21 0 17 0 0 6 0 0 0 0 0 1 18 15 22 32 0 0 0 17 0 0 17 
0 0 14 6 36 10 0 36 0 41 0 0 0 39 24 0 0 0 0 0 0 0 15 25 15 1 7 11 17 0 0 0 16 0 0 19 0 0 15 0 18 0 29 0 72 30 0 0 0 
0 0 15 12 19 18 38 0 15 0 10 0 0 5 0 1 1 15 0 0 0 19 0 0 33 7 0 12 0 0 25 25 18 0 26 2 0 11 0 32 24 0 15 0 35 0 0 8 32 
0 25 23 0 18 3 16 20 0 16 0 0 3 0 57 17 0 0 45 0 4 0 0 0 0 6 0 6 0 15 0 6 0 0 15 11 18 0 47 0 23 21 0 0 0 27 0 27 0 
