49 28
16 1 14 43 1 11 2 12 24 0 0 6 24 0 27 3 14 0 14 0 32 42 32 1 0 24 0 16 18 22 3 0 18 19 0 7 0 0 0 11 10 3 22 23 3 0 43 0 24 
0 36 19 0 25 4 0 1 72 21 1 17 1 12 6 0 23 0 13 3 2 24 5 8 0 22 0 0 30 0 0 0 5 17 14 13 26 11 33 0 3 33 0 0 4 0 0 12 47 
0 0 0 25 21 0 0 0 40 5 1 0 0 0 22 9 0 0 0 0 16 0 0 0 22 0 0 20 0 21 2 15 0 0 8 0 0 21 0 0 25 3 0 0 18 8 15 0 0 
10 0 2 0 12 0 0 23 14 0 7 0 18 30 12 0 12 1 0 0 23 43 7 0 4 20 0 0 0 4 22 5 0 0 0 0 5 0 12 0 0 0 0 11 23 0 0 18 18 
0 41 0 0 0 0 13 23 3 39 24 14 0 0 26 34 18 0 19 8 0 0 19 0 0 10 0 0 0 0 0 0 0 0 24 34 22 0 1 25 0 0 11 1 35 0 0 0 0 
20 1 18 37 3 0 16 0 2 0 0 13 0 0 20 32 0 0 4 17 0 0 38 20 38 17 15 1 10 5 6 18 0 0 43 0 7 0 0 26 0 17 20 18 4 0 43 32 13 
41 26 18 27 23 1 19 0 17 21 25 0 2 16 22 10 9 0 1 4 5 8 0 24 30 34 35 17 1 29 15 10 19 4 2 0 20 17 9 11 0 25 0 14 0 4 14 0 0 
48 0 0 0 0 18 38 20 0 15 21 19 0 54 4 30 0 53 26 1 0 23 0 18 24 7 34 36 9 0 8 7 17 0 11 29 0 0 20 26 0 39 16 26 50 0 15 1 50 
0 26 0 0 11 0 0 8 0 35 26 26 28 7 33 9 0 0 0 0 0 15 0 13 10 14 2 26 0 0 23 14 6 12 27 0 40 10 6 0 28 0 8 0 14 0 25 32 7 
0 38 0 1 0 5 29 0 35 0 22 47 15 35 5 1 0 2 22 0 27 3 0 0 18 3 16 15 0 25 16 0 0 0 29 29 5 0 0 34 51 20 0 49 50 13 0 0 83 
0 0 0 1 7 16 0 0 32 0 0 3 0 20 9 0 0 0 0 0 0 0 32 13 7 5 2 0 0 0 0 0 0 20 0 0 25 24 13 28 0 0 0 35 0 0 0 25 0 
0 55 0 0 0 21 0 0 0 0 0 20 0 32 32 0 0 16 0 8 0 25 21 12 8 7 11 13 2 0 6 16 17 0 0 22 12 23 0 0 0 0 0 0 4 30 25 0 18 
0 4 2 6 0 12 3 7 0 24 23 0 9 16 7 0 29 0 0 6 11 10 10 11 0 0 0 0 0 28 0 0 0 0 0 17 0 8 14 29 3 0 7 0 9 49 0 0 0 
27 0 0 0 40 0 0 30 14 0 27 29 8 14 16 27 60 0 24 16 12 10 0 0 0 0 0 3 9 25 0 0 19 16 0 12 1 15 1 8 7 6 24 24 39 0 8 6 32 
11 5 2 0 0 0 12 0 36 5 0 14 20 0 36 0 21 5 0 8 0 4 32 0 0 0 2 0 2 25 18 0 11 8 0 0 0 21 10 10 0 33 0 0 13 0 0 25 0 
5 8 23 0 0 0 15 0 0 8 7 29 0 18 17 31 0 0 11 8 0 0 8 19 0 4 0 22 11 3 0 4 0 0 17 4 21 7 22 13 22 14 0 0 6 16 23 0 19 
9 9 10 0 18 0 1 0 33 4 0 3 0 0 21 1 4 11 0 3 19 7 47 0 22 0 10 0 3 0 0 10 0 0 0 0 0 0 0 4 0 23 6 21 0 0 25 0 21 
0 15 3 38 37 3 13 3 0 0 7 1 1 0 2 15 0 0 0 19 19 3 0 0 0 23 0 0 0 4 7 0 0 0 9 14 0 7 4 27 25 17 0 0 0 0 3 0 0 
37 32 0 10 8 4 31 37 0 9 6 46 0 0 13 0 3 0 0 15 0 0 13 12 0 18 19 7 0 28 0 12 5 11 0 0 0 6 0 0 9 17 0 0 4 34 0 6 17 
1 0 13 3 3 0 0 1 8 8 32 15 1 0 12 20 9 0 0 22 0 0 21 18 0 14 8 0 0 0 0 0 3 9 30 8 14 0 0 0 0 18 41 0 10 0 11 0 21 
40 0 19 0 13 27 0 0 0 16 22 0 34 35 9 0 0 13 25 7 12 0 21 10 15 3 21 13 0 15 0 0 21 0 21 0 23 2 0 9 0 0 12 4 78 2 31 0 9 
0 0 46 2 0 0 7 34 28 21 0 6 13 0 0 0 29 4 0 13 27 7 0 6 17 15 0 0 6 0 24 0 8 5 5 0 18 0 0 3 2 17 1 15 8 27 4 44 65 
0 0 1 23 12 2 0 0 4 16 7 0 19 0 0 0 0 0 14 8 19 10 28 20 0 5 0 39 12 0 0 19 5 0 9 10 5 4 0 30 0 6 0 11 1 0 19 0 1 
38 43 52 0 3 5 8 3 5 2 5 7 0 5 20 0 15 0 41 8 0 20 18 21 22 11 14 9 0 1 19 0 0 1 36 0 30 1 46 0 16 0 0 34 17 2 49 0 4 
29 0 18 3 30 0 73 0 18 9 18 30 12 1 33 27 23 37 21 0 0 10 0 0 4 21 9 6 2 29 12 14 9 13 13 0 0 64 10 26 27 0 33 37 0 12 13 0 35 
28 0 4 4 12 0 20 33 19 2 0 36 15 40 0 0 32 24 0 24 1 27 22 15 2 0 14 5 43 0 6 0 0 0 18 35 29 15 18 23 41 0 0 1 64 0 0 40 0 
0 9 0 0 17 0 7 23 0 0 13 11 5 0 3 0 0 5 0 0 0 13 19 13 8 0 0 0 27 0 5 0 7 0 4 0 22 4 14 0 0 7 0 0 0 17 3 0 0 
0 0 27 54 11 0 0 42 40 9 0 35 12 26 16 9 0 22 0 0 14 7 2 0 28 5 19 0 7 35 6 8 60 18 26 0 13 34 2 0 40 0 8 0 1 3 0 0 17 
