49 28
0 10 0 68 0 6 0 0 1 2 2 21 3 6 2 24 17 15 8 12 0 0 0 3 0 20 0 0 5 4 30 5 22 28 37 0 13 15 1 17 10 10 23 44 0 0 36 56 83 
0 10 0 6 18 0 9 0 0 0 13 2 32 0 0 37 29 0 18 13 0 0 17 28 23 17 0 0 13 0 0 0 30 0 0 26 22 22 26 0 0 0 0 0 6 29 2 39 2 
11 7 6 0 40 0 18 16 4 12 54 8 34 22 16 0 0 18 8 33 9 0 11 9 15 4 0 6 0 2 10 17 9 0 0 22 0 7 18 0 0 0 21 49 101 39 74 19 0 
24 40 0 10 0 0 0 0 20 0 9 0 0 9 37 0 9 4 5 0 0 12 16 2 10 0 0 11 27 26 11 0 0 12 0 27 0 0 24 59 5 0 0 14 30 0 0 32 1 
0 0 0 51 5 0 2 0 0 0 0 25 48 0 2 31 3 0 0 0 21 0 5 0 0 42 0 5 5 18 10 0 0 30 0 0 0 0 6 9 10 1 19 0 0 0 31 0 32 
0 0 73 43 22 5 0 0 0 3 0 0 0 0 26 4 19 0 11 0 13 0 15 2 0 20 24 9 0 0 0 4 0 3 0 0 0 27 52 8 41 15 0 7 0 20 25 5 0 
0 3 57 65 0 0 7 29 15 0 24 9 0 0 0 18 20 7 16 0 0 0 28 2 20 14 1 34 6 9 23 3 20 0 17 0 19 0 12 9 0 0 18 45 41 56 35 19 0 
0 0 0 6 14 0 0 2 12 2 0 32 14 18 0 0 0 20 19 18 16 0 0 6 2 0 0 15 0 3 0 18 0 0 0 0 9 11 18 0 0 0 15 0 0 0 4 0 0 
30 34 0 21 18 0 31 38 13 21 4 0 30 19 4 0 10 0 1 51 0 0 18 14 36 18 15 33 5 0 36 11 1 8 0 7 6 33 37 23 2 0 2 13 0 12 9 28 5 
40 7 0 16 10 9 0 15 37 16 9 41 0 0 0 1 0 0 0 0 0 0 0 6 21 0 0 23 33 0 9 15 40 0 0 18 12 0 0 24 13 14 0 0 30 24 0 9 0 
16 9 0 32 0 0 28 0 21 0 29 8 32 22 0 29 12 0 0 0 0 8 17 0 0 0 0 5 6 8 27 13 0 0 34 34 12 5 5 11 7 10 0 0 31 0 5 0 0 
0 12 10 22 52 12 17 2 0 9 7 2 32 29 0 0 20 4 0 20 13 44 6 17 10 0 22 7 21 0 0 0 0 13 3 0 0 0 6 20 0 0 29 40 0 0 4 150 23 
0 68 0 50 29 0 14 0 8 6 9 19 15 8 0 42 8 27 42 0 17 6 0 20 0 6 0 39 34 20 12 6 16 2 7 2 35 12 14 0 15 30 0 37 24 2 13 13 0 
45 49 36 0 0 6 0 20 0 0 2 52 0 31 0 1 10 0 28 0 13 7 3 24 12 0 7 5 5 0 0 0 0 46 1 0 27 25 27 8 0 9 19 0 20 55 44 0 5 
0 13 62 0 14 9 43 6 0 0 19 13 35 35 28 0 26 0 20 0 3 19 0 24 10 0 0 0 0 19 3 20 0 0 10 0 12 0 8 26 0 10 0 29 52 0 0 33 46 
28 0 25 0 12 0 11 5 4 0 37 0 0 0 0 3 15 19 0 44 15 1 10 0 0 0 7 42 28 21 5 13 13 14 0 32 1 0 36 0 0 10 12 0 16 0 8 14 0 
34 0 6 0 0 0 4 32 0 6 8 13 35 0 0 6 0 19 0 0 65 23 0 0 0 1 13 0 17 4 8 0 12 0 41 0 0 17 8 19 0 6 1 42 8 17 0 35 0 
55 0 0 6 5 0 3 0 0 3 6 9 0 9 0 2 13 8 0 8 44 0 26 0 14 1 0 0 16 10 0 0 0 0 10 35 0 0 0 4 0 8 0 24 40 0 0 16 0 
12 38 0 44 0 0 17 5 35 29 17 8 10 0 16 20 34 2 11 0 20 18 12 12 18 0 7 0 0 31 0 0 23 20 19 19 0 0 23 0 0 20 4 16 14 10 34 36 4 
0 9 0 16 1 6 43 41 4 0 0 1 21 0 3 0 1 0 12 32 42 0 0 0 0 13 0 10 0 3 0 35 0 14 0 0 0 0 5 0 0 3 0 0 0 0 26 35 34 
36 24 5 0 3 0 12 15 2 1 6 16 0 13 17 0 1 29 23 22 20 3 0 24 1 27 0 0 0 28 14 0 12 5 4 13 67 13 23 0 15 8 6 34 0 0 0 18 33 
12 0 6 37 97 2 0 6 2 32 37 0 14 17 10 0 13 0 0 18 4 0 0 1 0 0 0 13 0 0 0 12 3 0 0 3 43 0 7 37 0 0 38 0 21 0 0 37 39 
39 0 0 0 11 0 0 32 0 31 0 6 18 0 5 0 9 31 0 3 0 0 0 22 0 19 0 0 0 3 23 6 22 0 7 0 12 14 13 40 31 16 22 0 0 13 0 6 31 
0 19 0 0 0 29 7 0 2 0 8 18 0 0 9 31 2 0 26 0 21 0 2 23 4 19 0 3 0 8 0 13 5 0 5 0 22 15 32 0 0 12 18 0 0 19 0 0 0 
0 0 31 1 13 0 0 15 12 0 19 13 0 0 15 1 26 0 0 0 30 0 0 4 48 19 0 13 0 0 0 19 18 49 0 0 0 4 27 0 0 4 18 0 20 0 13 33 0 
0 25 0 28 28 9 3 0 34 17 23 0 6 0 9 0 17 8 0 5 17 0 24 0 0 5 25 19 0 0 15 15 28 0 56 0 0 0 27 4 0 23 0 2 24 0 15 6 0 
16 58 21 10 13 0 0 0 7 0 0 16 30 39 13 7 0 1 19 0 0 0 0 20 24 0 0 14 0 8 27 14 17 3 14 0 25 13 12 0 0 0 27 14 9 0 37 8 34 
0 13 18 27 34 0 19 0 0 0 25 4 8 4 0 3 0 16 22 0 0 0 31 0 0 7 24 0 0 0 27 0 20 0 0 49 25 39 1 1 39 0 0 8 4 0 0 11 0 
