49 28
0 0 99 0 0 10 0 0 0 8 64 0 17 7 30 0 0 25 25 0 15 12 29 6 0 7 22 0 0 2 0 12 30 24 1 1 8 14 28 38 25 10 42 0 18 0 0 27 0 
43 1 30 0 0 1 5 33 1 0 40 0 0 32 7 5 0 7 4 14 0 6 20 0 15 0 0 17 0 26 13 12 0 31 0 0 36 0 14 15 25 0 31 5 54 4 36 0 0 
0 19 0 0 24 47 0 4 27 20 29 31 30 0 0 24 22 24 10 0 0 5 0 25 24 0 8 0 0 4 0 0 8 0 0 6 6 0 14 24 0 24 17 0 4 23 0 0 0 
0 45 0 0 0 0 0 7 1 57 0 22 4 10 15 0 0 0 0 2 0 0 9 0 15 2 5 0 0 15 0 13 16 8 25 0 0 0 0 20 4 32 0 0 0 15 45 0 10 
0 6 0 43 13 6 0 3 43 35 0 0 1 21 0 0 13 6 21 0 0 18 21 22 0 0 22 0 12 62 13 0 0 0 0 27 10 20 30 22 18 0 5 13 31 15 60 3 5 
0 0 0 0 0 0 4 6 1 26 0 0 1 25 47 11 28 0 0 20 23 0 24 1 0 2 11 8 14 0 0 0 5 0 0 39 0 0 3 20 3 10 6 0 23 8 0 33 0 
0 0 0 38 0 20 0 26 7 40 0 11 0 1 1 0 0 19 9 37 3 20 13 6 4 0 0 0 17 20 0 36 2 5 25 0 4 30 5 20 8 31 0 11 4 13 0 0 31 
0 0 8 0 15 50 0 50 0 7 7 15 5 4 0 0 17 11 0 2 12 32 18 0 17 4 16 0 0 0 0 21 4 17 0 0 1 16 33 20 66 0 0 0 0 2 19 0 0 
0 11 0 9 0 0 0 0 24 0 19 13 10 13 20 17 20 15 0 3 43 1 12 0 0 0 0 16 0 4 7 10 30 13 0 0 10 20 0 15 23 0 0 30 0 31 0 34 8 
11 0 0 0 0 2 25 10 18 5 0 0 0 13 0 33 0 9 3 28 20 0 16 3 12 0 3 23 0 0 0 6 12 0 0 1 4 14 0 3 3 0 42 61 2 8 33 17 5 
5 0 21 2 0 36 8 11 0 0 0 0 0 16 0 0 0 33 0 38 0 3 0 6 0 20 0 10 0 0 0 0 30 31 0 9 0 23 8 29 4 0 0 9 9 3 0 45 9 
72 6 0 0 42 22 36 26 0 0 0 0 7 0 0 54 0 0 26 0 0 0 3 0 15 0 0 16 0 0 13 0 6 43 33 15 11 0 4 0 0 0 48 12 26 1 45 0 48 
35 38 0 0 0 0 6 0 12 0 11 0 0 8 0 0 0 4 1 19 12 0 12 10 0 0 3 1 0 0 12 0 10 23 0 61 0 35 0 45 0 0 1 37 1 13 11 0 0 
14 9 0 0 3 33 16 38 13 0 9 32 7 0 17 18 2 0 0 5 0 16 24 0 4 0 0 9 0 0 0 0 0 18 17 0 6 0 35 0 6 0 35 32 17 0 0 0 10 
0 0 35 17 5 40 0 0 4 31 0 11 11 0 31 20 1 62 0 1 40 13 17 14 23 0 3 0 0 0 0 0 0 35 0 32 6 72 21 0 16 0 14 0 0 59 13 62 1 
25 0 0 0 0 0 0 0 13 0 16 24 12 0 0 0 0 15 12 11 5 0 1 18 23 0 0 0 0 16 3 12 0 5 17 0 0 0 16 0 9 8 25 11 0 18 0 0 0 
10 0 0 0 20 0 49 9 16 0 12 15 0 12 15 0 15 15 3 0 25 7 7 0 60 12 15 17 5 8 0 11 1 0 6 0 15 0 0 0 16 0 2 0 11 36 0 41 22 
18 6 75 0 0 27 25 0 0 11 0 17 12 0 0 0 0 8 29 26 11 10 31 0 4 19 0 0 15 2 1 12 18 13 0 2 0 2 46 8 33 0 12 16 0 0 0 8 0 
0 0 41 0 0 0 7 1 0 0 7 0 2 0 0 0 3 14 19 0 13 0 8 11 4 0 0 0 8 6 11 10 0 8 0 33 7 0 6 41 35 8 0 6 0 18 0 0 2 
7 43 10 26 33 17 10 10 32 20 4 24 43 0 11 0 10 1 28 2 0 14 0 0 21 0 0 0 0 20 2 0 8 2 0 53 7 5 0 4 0 13 0 7 43 42 28 0 0 
0 0 0 0 0 0 2 0 0 24 0 2 8 34 0 25 0 8 13 12 21 0 4 0 5 0 7 10 4 10 0 0 0 12 0 17 0 0 9 0 37 9 18 0 3 50 0 31 0 
0 11 0 18 55 16 0 46 13 14 2 13 23 0 39 0 9 5 0 8 1 33 0 0 9 15 0 0 24 15 0 3 18 0 26 37 4 11 0 3 45 1 0 4 37 7 14 8 23 
0 0 0 0 32 0 0 0 13 0 4 27 0 11 0 0 2 5 22 0 14 0 0 0 4 22 0 10 20 0 0 0 0 0 6 0 25 12 0 26 5 28 0 0 4 0 0 0 16 
100 0 0 2 13 28 0 16 0 0 32 0 0 13 0 0 25 13 7 0 21 0 19 19 18 0 0 0 14 6 2 0 13 34 0 1 16 14 14 11 19 31 40 0 1 46 3 6 0 
0 0 24 16 23 2 10 0 35 0 6 18 5 20 0 0 18 0 10 19 22 0 0 17 0 0 13 28 17 8 16 0 0 12 22 0 0 16 8 17 15 0 8 18 0 7 0 0 0 
0 15 10 66 0 16 4 0 34 0 0 101 17 0 15 0 15 19 12 38 14 16 10 0 6 0 30 34 22 14 25 4 28 5 2 16 19 31 0 10 14 0 3 0 22 42 0 0 16 
10 0 6 70 34 1 29 0 45 25 0 0 17 6 26 14 0 9 13 10 38 12 0 0 13 23 17 20 0 7 0 18 25 25 38 14 1 0 8 0 4 7 26 28 0 9 67 26 7 
0 0 16 0 38 0 0 35 5 58 1 18 0 33 18 0 0 0 49 15 22 0 10 0 8 0 14 0 0 23 0 0 11 0 19 9 8 11 0 21 2 0 5 26 45 0 34 1 0 
