49 28
0 0 0 0 0 0 15 17 17 39 0 13 12 36 9 25 0 0 0 12 0 26 0 9 0 0 7 0 0 0 0 0 11 24 0 0 5 0 0 26 25 3 0 0 5 0 0 15 0 
0 26 41 8 0 22 0 28 35 30 29 0 22 0 0 0 0 0 0 0 0 0 0 15 6 16 4 62 17 0 6 0 0 3 24 0 0 0 0 34 6 0 0 5 17 0 23 0 2 
47 0 0 35 32 0 2 30 9 9 0 14 9 1 1 0 0 32 0 16 0 9 0 0 6 0 33 2 1 14 15 10 10 14 3 0 61 0 46 0 23 7 4 0 1 0 12 48 24 
47 23 26 14 0 0 12 24 34 8 17 23 11 12 3 8 0 14 10 13 0 0 0 0 0 0 11 23 21 0 0 15 4 0 31 18 0 0 38 0 9 0 0 19 0 0 2 4 40 
0 8 32 0 41 0 10 26 45 26 4 0 0 29 0 0 0 0 0 0 0 0 0 1 0 0 5 0 0 0 21 0 0 20 32 27 4 21 18 0 4 4 33 0 1 72 15 2 11 
20 41 25 34 0 11 72 40 11 27 0 16 0 0 0 0 5 13 0 0 20 11 11 46 21 0 11 6 0 22 13 2 26 27 2 0 5 8 0 11 0 3 31 15 12 9 23 0 0 
5 1 1 3 17 21 21 36 0 0 0 0 5 6 22 18 27 0 0 14 0 10 25 11 0 0 7 21 18 0 33 27 0 21 27 2 20 0 0 34 18 0 20 2 0 6 16 0 0 
28 0 0 0 0 0 0 33 22 4 10 0 6 0 23 0 0 0 22 1 0 0 0 35 6 2 18 1 39 13 0 0 14 8 13 0 11 21 0 16 39 0 6 10 0 0 107 5 0 
61 13 46 12 44 51 0 2 10 6 0 34 0 55 13 1 11 8 20 0 6 27 20 0 42 19 4 1 23 2 29 0 8 19 0 11 0 24 30 0 40 33 24 32 50 45 0 15 29 
0 44 22 30 0 0 15 22 49 0 34 7 0 5 10 1 14 21 0 0 14 11 31 9 60 15 6 11 6 0 0 0 21 12 27 1 9 11 14 0 21 10 0 0 73 54 6 0 5 
12 0 0 0 0 0 21 0 0 0 3 13 0 10 18 0 0 0 8 21 8 10 0 0 4 7 14 0 20 2 0 0 5 0 0 1 0 14 1 0 4 0 0 0 12 0 0 0 2 
4 14 4 32 19 0 4 0 22 9 0 2 0 0 21 37 0 2 7 4 0 16 21 7 3 7 5 16 18 0 50 18 0 15 0 19 6 0 2 8 7 0 6 16 16 6 0 38 33 
0 10 32 25 0 0 0 0 0 0 0 15 12 29 0 0 0 4 7 0 0 0 11 5 0 11 22 0 32 0 0 35 0 0 31 7 0 1 0 0 1 19 28 0 0 0 0 4 0 
0 0 0 0 19 0 9 0 0 44 3 1 1 4 12 19 0 2 23 27 0 0 4 6 6 2 2 33 0 2 0 0 1 19 10 17 0 11 3 24 0 20 0 5 10 1 27 34 35 
0 3 17 0 3 22 4 0 3 0 5 13 2 0 1 31 0 0 9 4 0 8 8 0 3 0 0 0 7 1 14 0 1 21 0 0 6 12 5 39 9 0 9 28 9 0 12 11 33 
0 4 0 0 0 3 22 9 0 32 5 0 83 0 46 0 0 0 1 13 18 0 1 9 0 6 8 0 44 0 21 12 0 4 0 23 4 0 8 27 7 0 0 0 0 9 32 5 12 
4 3 34 8 1 32 0 0 13 5 51 6 0 10 25 0 25 14 0 10 0 13 0 10 0 0 12 0 0 4 0 14 0 14 24 0 34 4 0 14 14 36 0 0 15 0 0 32 0 
8 15 0 0 4 0 12 0 35 21 3 0 17 0 8 0 20 0 0 0 4 0 0 38 12 1 17 0 2 0 0 0 0 30 21 0 2 0 37 3 16 0 0 17 8 12 0 0 0 
7 0 22 8 37 8 13 20 12 13 8 18 1 5 0 34 16 0 18 0 0 5 20 7 10 0 10 0 4 22 2 10 16 1 16 56 0 0 0 6 18 70 27 2 0 23 0 0 0 
54 0 44 0 18 13 0 0 0 27 8 6 1 21 11 13 26 4 17 31 2 34 18 0 1 1 12 0 6 29 0 15 2 26 23 0 2 3 5 0 22 19 20 0 6 0 55 7 34 
6 21 28 12 18 0 0 9 19 0 19 2 0 11 0 7 15 0 0 26 0 8 38 0 0 5 5 0 0 19 33 0 15 1 7 0 0 11 0 0 0 0 8 0 0 26 0 5 0 
47 0 0 0 9 0 4 1 1 26 0 7 14 19 4 15 11 6 4 0 6 0 15 25 0 14 19 8 1 7 0 22 15 12 9 18 0 0 0 0 0 0 33 0 0 19 23 52 0 
55 10 76 13 0 0 0 22 0 15 0 0 0 2 0 0 16 13 14 15 5 0 0 0 0 19 20 4 0 17 48 5 32 0 0 0 12 35 8 1 2 27 0 0 27 36 2 8 10 
0 44 22 37 40 73 0 0 3 0 2 2 0 55 9 0 18 13 0 33 9 0 24 2 11 11 27 0 0 5 0 0 0 32 5 0 0 5 1 0 7 0 0 0 31 17 4 28 0 
0 0 27 0 0 29 0 0 0 0 0 1 5 0 10 0 0 4 0 5 0 0 20 9 6 0 9 19 5 0 0 17 9 10 0 0 0 0 0 0 16 27 20 3 2 0 21 0 0 
6 8 4 0 0 2 19 0 0 12 43 17 0 4 23 0 0 0 26 13 0 3 0 0 0 0 9 0 0 0 0 0 13 0 0 21 0 21 27 2 6 0 32 29 0 3 1 44 3 
8 0 36 12 0 2 16 6 0 13 16 0 4 0 14 0 21 0 0 24 0 0 0 0 12 29 0 0 16 26 0 14 0 11 24 0 17 12 36 0 0 5 0 0 2 0 29 0 0 
23 34 0 0 19 0 39 0 0 0 2 0 4 10 0 18 8 0 0 0 6 18 0 8 18 4 0 25 3 1 21 4 1 19 0 19 0 0 0 16 0 0 22 19 16 39 0 0 21 
