51 29
0 0 0 23 0 20 11 28 23 0 0 0 0 0 7 0 0 14 9 0 0 0 41 22 0 46 0 8 13 18 0 1 18 9 0 18 0 0 2 0 2 0 11 21 16 0 0 0 0 0 5 
0 25 0 0 0 0 0 22 26 4 0 15 22 0 0 1 8 0 0 6 8 0 1 0 2 0 15 0 5 0 20 0 0 0 0 12 0 15 0 5 0 15 0 0 24 0 0 0 0 0 20 
0 0 3 0 1 37 17 21 14 0 6 0 16 0 10 32 0 21 0 9 14 1 5 0 21 0 0 23 25 23 0 0 11 17 0 18 30 0 5 0 0 0 35 0 42 0 0 27 4 0 0 
0 0 0 0 8 9 62 22 0 35 7 0 0 29 1 6 0 0 0 0 0 0 22 0 9 0 1 1 22 19 3 0 0 3 52 29 12 3 8 44 12 0 0 30 0 14 0 9 0 3 52 
0 48 0 20 32 0 2 25 13 3 0 0 0 23 16 0 41 19 0 15 0 11 3 12 0 2 1 4 22 0 0 29 28 0 0 20 0 0 0 0 0 13 0 16 0 0 30 22 0 21 22 
27 21 42 0 14 0 34 6 20 13 14 0 14 9 8 24 16 10 11 4 0 0 18 0 16 8 50 7 23 19 0 57 0 0 7 27 0 6 0 0 0 12 0 27 15 5 20 0 63 6 50 
0 20 1 0 0 0 0 0 21 0 0 12 32 8 0 3 19 20 0 19 0 25 0 2 0 16 0 16 0 17 0 10 9 0 0 18 4 0 36 5 0 6 0 0 0 33 0 0 0 33 25 
11 0 33 33 14 0 24 4 7 10 0 2 0 0 6 7 14 10 0 15 6 0 0 0 18 15 0 0 25 0 24 0 0 0 32 19 0 0 5 0 0 7 18 18 0 0 0 5 13 0 0 
0 10 38 19 22 0 7 60 0 0 0 6 0 0 0 10 26 11 0 0 0 0 0 48 0 14 4 0 1 12 0 0 28 0 0 4 0 8 10 0 71 6 26 0 21 0 23 32 0 0 9 
0 15 21 0 0 14 16 65 18 20 0 2 17 1 12 28 8 37 24 5 19 4 0 0 20 6 1 18 20 0 29 0 11 10 10 10 0 3 0 0 5 9 29 4 14 3 16 55 37 0 42 
0 0 0 0 0 7 0 6 38 30 0 0 31 0 34 0 0 0 0 0 0 0 0 0 13 6 5 0 0 0 0 10 22 0 0 0 0 13 0 37 0 14 2 31 22 27 38 15 0 7 6 
14 0 0 0 27 36 30 32 0 0 0 0 0 0 13 0 0 0 4 15 0 20 0 0 0 0 0 0 3 25 0 0 0 10 15 0 0 6 0 7 0 19 0 0 0 0 0 0 0 0 0 
2 19 32 13 35 0 30 12 25 0 0 12 0 0 52 0 42 69 0 28 19 0 8 40 17 3 15 0 0 0 5 0 19 39 34 15 11 3 0 46 0 39 1 11 28 0 0 25 0 0 0 
0 0 0 0 0 36 61 12 20 26 0 2 9 0 8 25 8 5 0 1 18 5 10 35 16 10 0 15 10 15 24 11 22 12 0 38 0 0 18 0 0 36 10 37 2 25 23 0 0 0 2 
40 0 0 6 0 14 9 0 36 22 6 17 0 17 10 0 2 8 14 14 22 12 7 2 0 8 0 0 34 10 2 28 22 0 7 0 0 29 41 12 48 22 25 0 26 13 41 13 18 3 12 
68 18 0 12 12 0 7 0 3 15 7 2 16 14 0 19 12 22 0 18 4 13 10 0 18 0 13 7 20 19 20 2 0 33 7 35 12 0 0 9 25 9 17 19 0 0 0 0 20 0 22 
47 0 0 0 16 60 11 2 11 0 12 45 0 0 18 21 3 4 0 3 25 0 10 15 1 0 15 0 15 22 11 0 8 0 0 26 21 15 0 0 0 41 13 0 47 0 8 47 0 0 0 
0 40 0 10 0 0 15 0 13 36 13 5 29 0 0 7 0 0 31 0 0 13 7 7 1 0 7 1 0 0 0 12 0 10 10 0 0 11 0 0 14 14 19 23 1 36 0 5 0 31 0 
71 1 0 0 0 5 29 0 0 14 11 2 9 0 0 0 0 0 5 12 0 20 0 31 7 9 0 0 0 0 0 75 0 11 0 9 0 30 0 0 17 9 0 12 2 10 0 3 0 0 9 
50 40 25 0 0 0 0 16 3 30 0 1 0 0 11 16 0 0 7 0 8 0 10 11 7 0 6 35 18 13 22 0 31 12 28 43 26 5 0 34 10 44 32 0 0 3 0 5 12 0 50 
0 39 0 41 0 0 0 13 0 33 0 0 0 4 5 0 0 21 0 0 11 0 18 0 0 6 0 0 0 8 0 1 0 0 0 21 8 0 25 0 39 0 0 12 41 0 0 0 0 17 0 
0 14 36 0 43 17 30 9 0 0 24 0 0 0 0 18 22 0 0 4 3 0 9 3 0 9 0 14 21 0 0 10 0 53 20 5 30 31 37 12 0 9 8 0 0 18 0 14 43 0 0 
0 0 22 0 17 0 2 0 0 22 22 3 16 13 0 8 0 20 0 2 7 0 0 6 22 0 0 11 0 1 29 0 13 0 1 1 17 0 0 22 0 0 12 0 29 0 0 8 0 0 0 
89 8 0 7 3 9 0 85 28 0 29 1 18 0 11 33 8 62 36 0 0 0 22 0 27 0 19 0 12 0 0 19 0 0 0 1 0 13 0 40 0 23 0 0 0 0 0 0 15 0 24 
43 34 3 0 16 33 8 1 31 0 0 6 4 0 36 7 35 33 0 5 0 0 4 9 0 24 0 9 22 18 20 2 9 10 29 100 0 32 43 33 0 2 48 33 18 43 23 7 10 45 80 
52 33 12 5 57 0 39 12 22 25 9 0 45 3 12 39 19 29 0 2 6 0 0 9 17 16 27 0 0 26 22 46 9 0 33 0 17 0 0 35 11 29 0 35 36 0 2 7 0 0 0 
0 11 5 0 31 0 29 17 0 22 0 38 0 0 34 9 9 2 2 12 0 0 10 0 1 17 1 13 0 0 0 2 0 0 0 53 0 0 22 12 0 0 6 0 0 0 0 0 17 38 0 
82 4 0 19 0 26 0 0 26 0 0 0 12 21 34 28 0 0 17 2 0 0 19 0 4 10 26 0 12 3 0 26 0 0 0 36 36 0 0 4 0 19 0 22 30 0 46 0 34 0 0 
82 0 0 13 0 6 24 15 0 0 0 6 8 0 0 41 0 5 0 19 19 6 8 0 8 9 0 0 23 18 8 0 2 0 68 21 8 11 17 10 0 0 0 0 0 0 0 0 46 0 2 
