51 29
0 32 19 0 17 0 0 15 17 48 0 0 4 0 0 25 10 22 9 0 28 0 12 16 0 24 10 0 23 18 15 0 0 32 0 13 0 0 13 22 23 10 18 0 0 0 0 25 0 0 1 
9 47 46 0 19 0 0 43 0 20 9 25 0 11 0 28 15 0 0 3 22 24 0 2 27 13 21 0 13 0 0 25 0 66 34 10 0 0 15 7 0 22 41 10 10 0 0 14 0 29 64 
0 19 45 17 0 0 23 0 2 0 0 19 9 0 18 0 5 0 0 0 0 17 6 14 9 0 0 3 0 0 12 25 0 32 0 14 0 0 15 0 1 5 0 19 0 21 0 13 0 19 0 
0 21 21 0 0 0 0 16 12 0 34 16 10 26 6 0 9 0 5 20 2 2 20 14 19 9 10 0 3 18 0 18 0 26 32 17 0 0 19 8 0 12 20 1 28 0 25 16 33 0 0 
11 15 19 0 0 0 5 0 0 12 0 0 0 0 9 8 0 0 11 0 0 49 15 1 1 0 0 0 13 29 0 0 0 0 0 7 0 0 17 0 0 0 0 29 28 0 0 0 29 0 31 
0 37 0 0 5 2 0 0 22 4 0 0 0 0 0 0 0 10 12 0 21 0 0 32 0 0 20 3 14 15 12 2 0 0 15 0 14 0 37 3 5 0 17 1 0 18 20 0 0 15 7 
11 0 10 0 38 0 0 0 21 16 0 11 42 1 0 0 0 48 0 5 26 0 22 1 0 0 14 0 3 0 0 0 19 8 13 18 0 7 26 0 3 11 63 6 22 0 0 31 11 17 0 
0 151 44 0 19 2 0 0 0 2 111 9 2 0 2 26 13 6 0 22 30 0 6 25 0 6 3 25 0 34 1 1 18 0 27 0 20 6 28 30 15 47 22 48 24 0 14 26 4 27 40 
10 27 2 0 0 0 0 7 0 0 10 7 12 19 2 18 3 0 10 0 15 21 2 7 7 4 3 1 61 15 12 7 19 0 0 0 23 22 0 1 0 0 0 19 10 0 0 0 9 0 0 
0 20 0 0 19 0 45 30 9 0 30 7 0 0 0 5 29 0 0 0 20 25 21 0 0 0 3 0 0 13 0 0 0 0 10 0 0 0 0 0 63 0 0 21 8 7 42 27 0 0 7 
15 0 0 87 0 25 5 0 2 2 16 12 0 0 28 25 1 0 7 0 26 0 0 35 0 10 20 0 11 0 31 0 0 9 14 0 0 0 0 43 0 42 3 40 0 8 11 0 6 0 46 
0 6 24 0 0 54 0 0 20 0 16 10 15 0 0 0 1 13 8 15 0 4 3 4 3 0 25 3 0 0 20 0 0 0 17 0 0 0 30 0 0 0 0 16 3 40 0 0 4 0 0 
0 0 0 0 0 0 0 73 19 18 0 1 0 0 1 4 0 0 0 0 0 0 10 9 6 32 0 44 6 0 0 0 3 0 3 0 11 0 0 14 0 0 0 36 56 0 0 12 0 0 7 
33 41 48 14 0 42 16 32 0 14 3 0 23 0 20 8 17 1 21 0 0 9 21 3 0 30 50 0 2 0 11 0 0 25 0 9 0 0 17 30 0 0 7 21 44 40 8 0 9 0 48 
10 0 97 0 35 27 0 11 0 9 10 14 0 0 0 14 0 39 37 0 22 0 32 15 0 0 11 19 13 6 0 0 23 39 23 2 0 7 12 2 7 0 47 20 6 13 32 0 0 7 23 
11 0 0 27 3 0 0 0 5 9 4 3 0 5 0 15 0 0 10 2 0 5 0 0 19 0 0 0 0 4 23 0 11 4 0 0 0 0 0 18 0 11 12 19 0 6 5 2 30 0 6 
0 0 0 0 7 0 0 0 11 28 0 7 0 0 34 0 11 28 0 0 0 0 5 14 0 17 0 11 17 6 0 0 0 0 0 14 14 0 15 0 0 9 6 0 0 20 0 0 40 0 0 
0 5 22 2 28 2 36 21 29 13 19 22 35 1 7 11 6 0 6 34 8 3 4 30 0 20 2 6 22 31 15 0 16 26 8 0 13 47 15 13 0 0 57 18 0 11 27 13 22 0 39 
42 0 0 0 3 17 30 0 17 0 20 0 15 1 28 6 0 0 8 9 2 12 7 23 3 0 0 12 0 0 10 4 11 10 3 11 23 0 0 0 0 16 88 0 0 0 5 0 0 0 29 
32 37 41 22 0 0 0 17 1 0 34 16 0 0 12 1 0 24 41 0 0 4 9 25 17 4 0 30 5 0 0 0 10 5 0 0 0 0 37 0 0 24 0 41 17 22 28 0 0 0 0 
0 16 1 0 19 0 0 60 20 21 0 0 0 0 10 4 24 6 22 0 0 0 6 0 0 18 6 0 10 46 9 0 6 19 0 0 0 8 0 2 24 6 7 0 0 27 0 40 0 0 0 
5 19 6 44 0 5 0 11 50 30 0 19 7 0 36 8 0 0 15 27 15 1 4 13 0 0 0 2 21 14 17 5 4 18 0 15 9 0 0 1 21 11 18 29 0 47 23 27 3 0 0 
0 18 21 43 22 0 0 0 39 16 31 28 0 21 0 0 0 0 6 0 0 0 47 0 46 0 0 24 20 21 17 0 0 0 0 0 0 0 0 19 0 31 18 0 22 4 28 0 0 0 0 
0 32 35 0 12 0 0 0 15 0 16 10 24 0 0 33 0 0 0 23 56 1 41 13 0 12 0 2 2 0 1 0 4 21 13 28 39 2 6 0 0 12 23 40 6 20 0 25 3 24 0 
0 39 0 0 0 0 0 0 3 37 0 10 0 0 0 42 0 2 0 36 30 25 5 1 1 0 0 5 19 0 0 0 0 5 3 0 0 0 5 0 7 0 0 0 0 0 12 4 32 0 47 
35 22 17 0 0 23 41 0 16 0 18 15 14 0 9 0 0 0 22 0 5 14 13 3 3 0 7 0 0 5 23 4 17 23 28 37 30 2 15 15 0 0 0 2 39 65 34 0 0 0 0 
13 13 20 0 2 0 13 0 13 9 8 0 47 13 13 36 17 10 11 10 0 43 12 20 22 7 20 14 18 10 0 0 0 3 11 3 0 20 0 37 0 31 0 0 0 4 5 19 36 0 0 
25 0 0 17 35 10 6 30 23 0 0 1 0 34 0 29 0 25 12 0 17 10 0 0 16 57 27 1 21 0 29 0 0 0 3 0 50 19 0 18 1 0 25 4 4 2 2 10 0 0 0 
0 11 29 0 0 0 0 0 20 0 2 12 40 10 26 25 30 0 0 0 28 0 28 0 0 10 0 4 0 0 0 25 7 0 2 0 0 0 0 8 0 18 45 0 0 0 55 0 0 0 38 
