51 29
0 0 1 0 0 0 4 10 39 16 0 15 0 0 0 0 5 0 0 0 7 4 0 20 0 18 0 0 0 0 0 0 0 0 0 18 13 0 20 0 0 0 5 0 15 0 0 17 20 37 0 
0 48 25 0 0 71 0 0 28 0 0 0 0 4 0 0 0 24 0 0 31 0 17 0 0 0 3 0 0 6 4 22 0 33 3 0 31 32 7 0 0 33 40 0 0 0 0 9 0 32 0 
0 0 62 9 0 0 26 0 0 7 0 23 0 9 0 0 0 46 0 0 12 0 0 0 0 12 0 11 13 0 0 1 21 0 29 0 19 0 15 0 6 0 0 0 46 43 0 41 15 0 0 
34 24 22 26 19 7 0 15 36 47 0 14 39 29 5 8 44 18 11 19 13 0 4 0 7 21 0 18 13 26 0 12 0 13 29 23 7 4 21 4 0 86 62 6 99 0 5 7 24 6 0 
0 0 20 0 0 0 0 12 0 0 0 36 0 14 15 0 0 0 43 0 21 0 0 45 7 0 14 14 0 15 20 21 2 19 0 0 4 0 2 0 14 0 0 0 0 58 8 37 54 0 22 
0 9 5 0 0 4 36 42 42 0 24 20 22 29 0 47 25 6 24 0 9 0 16 6 9 0 7 23 14 9 3 20 1 0 51 14 10 33 1 5 0 16 7 0 0 0 5 0 73 51 15 
0 1 0 22 1 21 0 0 0 0 0 10 1 0 0 0 1 0 0 5 0 49 0 2 6 0 10 6 0 2 5 0 1 0 14 0 10 0 3 0 8 0 0 0 5 0 20 3 27 20 0 
0 0 29 23 0 0 0 0 2 0 27 16 0 0 0 0 27 10 0 0 11 0 15 0 0 7 23 21 13 13 9 48 1 6 0 0 20 12 0 15 20 0 13 16 0 0 0 0 0 0 0 
0 0 0 0 0 0 7 0 5 36 28 12 0 11 0 0 0 0 0 7 7 37 18 2 0 14 17 6 0 0 16 11 0 0 0 0 0 11 21 0 0 0 29 0 0 25 20 0 8 0 5 
0 14 0 0 36 8 22 58 6 0 7 0 9 0 11 0 18 20 0 6 6 0 5 0 10 0 20 7 24 31 14 7 31 0 7 0 11 0 0 5 0 34 0 7 5 0 3 19 19 0 7 
0 28 0 0 0 11 0 8 0 10 0 10 5 0 9 27 11 5 10 0 0 4 0 9 0 0 3 18 0 33 0 0 0 0 0 0 20 6 0 21 0 26 0 13 7 18 0 14 0 0 8 
0 0 0 9 0 1 22 3 39 36 0 4 5 5 11 11 0 0 0 0 0 12 0 26 0 0 19 0 0 0 24 25 9 2 0 26 0 0 3 0 0 9 7 0 0 0 0 29 3 16 0 
21 2 0 0 9 5 59 0 15 29 0 13 18 0 1 0 11 29 7 0 0 8 0 0 0 16 9 5 6 0 25 20 0 27 0 15 0 12 57 9 10 0 1 0 0 0 21 35 0 0 1 
1 0 19 0 42 32 0 6 42 0 70 8 0 0 0 0 8 1 0 6 0 19 13 0 0 0 7 11 0 0 14 0 0 9 0 0 0 0 0 2 0 0 0 0 29 1 36 43 0 0 87 
79 30 12 15 0 33 0 14 2 0 0 0 3 12 0 37 18 11 14 21 14 28 3 0 24 19 0 22 0 2 0 44 18 0 6 20 14 27 32 7 26 9 23 6 12 0 0 0 41 73 34 
0 0 1 35 35 1 10 0 0 2 0 21 0 4 3 0 8 1 0 17 0 0 9 27 0 12 0 0 1 16 13 0 6 1 11 3 0 0 0 33 0 3 0 13 15 23 0 9 45 0 55 
2 3 1 0 10 7 0 12 0 0 0 14 0 0 8 0 0 13 0 0 0 25 10 0 0 14 0 13 0 0 0 0 10 0 0 0 0 12 0 0 10 1 8 3 0 0 22 5 14 11 10 
10 12 14 3 0 0 19 0 4 37 46 0 0 0 51 26 0 0 13 0 0 12 0 7 4 7 0 9 0 20 9 0 8 8 0 9 1 4 9 0 0 1 13 0 14 9 36 17 81 4 0 
18 6 2 3 0 17 0 10 6 18 8 0 23 20 0 43 0 3 24 10 8 0 4 4 14 3 0 4 13 0 0 14 0 12 0 5 0 0 14 0 0 0 29 31 0 1 37 15 10 2 14 
43 0 60 13 0 0 10 6 0 25 0 0 0 7 20 0 20 1 30 0 18 1 0 0 40 2 1 9 14 0 14 11 0 4 10 8 22 0 18 7 0 45 17 0 23 15 38 22 4 24 8 
0 0 7 0 32 0 24 0 0 18 0 12 0 0 18 0 34 47 16 0 0 1 12 30 0 27 0 21 13 0 0 19 8 0 11 13 45 0 20 0 0 24 11 0 0 11 0 0 24 0 20 
2 0 3 7 9 30 27 34 67 0 0 0 0 31 8 3 2 12 11 0 0 3 0 0 16 21 5 2 23 0 0 2 0 31 6 0 0 30 0 24 1 0 0 3 50 4 39 4 6 4 0 
0 65 0 2 22 2 26 0 0 19 0 0 19 26 12 0 0 17 0 19 0 12 0 0 0 0 12 0 0 28 0 0 26 9 17 0 0 3 56 26 0 0 0 0 0 43 0 2 0 8 0 
32 0 0 0 0 52 8 12 0 0 0 14 0 35 16 0 12 5 19 0 13 0 21 0 9 0 20 0 23 0 13 16 6 8 0 10 0 4 0 34 0 46 3 0 0 10 0 16 37 0 0 
17 36 28 22 0 4 0 22 6 22 10 18 73 0 0 0 2 0 2 3 20 16 0 4 26 10 0 15 0 0 35 0 15 0 1 21 0 65 0 28 1 8 0 3 0 1 21 19 1 2 38 
0 41 0 0 0 0 0 1 0 0 0 0 2 0 38 0 19 60 0 0 3 5 3 0 0 3 12 0 0 25 8 2 0 2 4 0 7 17 0 0 0 0 54 0 0 5 0 0 0 0 41 
29 4 39 12 13 26 0 0 0 23 0 0 20 11 0 0 24 33 16 14 8 16 48 0 0 3 15 0 0 0 0 18 55 0 14 9 0 16 0 0 52 22 5 2 56 0 1 47 37 0 94 
27 0 7 21 4 3 22 0 60 0 21 0 0 25 7 31 0 29 28 16 25 22 0 23 0 0 0 48 3 12 0 26 0 6 0 0 6 0 30 0 20 3 22 0 0 37 37 0 34 66 0 
0 0 34 41 0 23 0 38 0 20 14 0 15 0 11 0 68 26 0 21 1 0 6 17 14 5 20 14 1 0 0 7 8 0 0 19 1 6 0 0 0 3 0 25 78 44 2 2 18 2 45 
