51 29
11 0 0 0 0 25 0 0 1 11 15 4 0 4 23 0 79 0 0 0 0 0 0 9 7 0 0 0 0 20 0 8 0 19 0 0 0 0 0 0 31 0 0 0 15 0 0 11 0 2 0 
34 12 0 0 7 3 11 111 3 14 0 15 0 33 10 8 23 49 27 10 25 31 11 0 0 0 0 26 0 0 10 14 0 0 13 34 18 0 31 0 5 3 5 0 42 116 0 20 0 47 43 
0 0 0 0 50 39 39 0 0 27 0 0 0 9 20 0 0 12 11 0 0 4 0 21 0 0 19 18 5 16 0 7 12 14 26 18 27 3 45 16 37 1 10 20 18 6 8 2 2 26 0 
12 0 0 45 0 2 0 3 12 22 7 2 13 30 12 0 6 0 25 0 0 10 10 0 11 2 22 9 13 17 0 0 14 24 31 17 0 13 18 1 0 5 0 42 0 15 6 0 47 0 0 
3 6 0 14 0 40 63 7 36 3 5 10 1 2 32 28 19 16 0 0 16 22 0 18 10 0 0 23 0 26 18 5 1 16 44 0 30 26 27 25 19 0 0 37 2 24 51 39 2 11 0 
26 30 6 39 0 2 0 17 5 2 1 5 46 7 26 23 0 17 45 3 22 0 9 0 6 10 21 0 5 15 1 5 2 0 41 4 24 0 48 21 0 39 41 29 43 0 0 0 0 39 0 
2 25 59 23 49 0 10 1 1 0 32 6 16 11 9 0 47 0 0 0 0 25 11 14 0 0 1 14 22 2 0 0 4 3 19 0 12 15 12 0 38 3 0 27 0 44 2 7 17 0 18 
11 8 18 34 0 62 47 23 13 0 2 7 49 4 1 0 8 24 0 0 0 9 5 0 7 0 9 11 17 16 30 0 0 4 0 0 5 2 0 19 0 0 0 13 0 29 0 72 42 48 0 
31 34 0 0 3 1 25 16 12 33 0 1 10 12 26 7 0 0 6 16 34 0 0 0 6 19 4 0 0 1 12 2 31 18 46 0 0 36 0 0 0 68 22 0 26 0 0 0 39 0 0 
11 0 0 0 10 5 31 71 0 0 2 10 28 67 4 19 38 8 0 0 20 8 0 0 31 10 15 0 7 0 6 0 3 0 1 18 0 23 0 24 15 51 7 21 20 33 0 0 41 40 0 
0 20 35 57 28 0 0 0 0 8 0 3 16 0 0 0 10 18 0 0 0 36 0 29 0 0 12 0 26 4 7 0 27 12 3 0 0 48 2 0 0 38 8 0 12 42 44 2 10 21 10 
11 0 0 0 30 4 0 33 0 0 0 0 10 12 23 29 0 0 0 7 0 10 28 10 6 2 0 0 0 6 7 0 0 10 45 0 13 0 0 0 33 0 0 0 0 16 5 11 0 15 68 
0 0 0 0 24 0 0 0 16 0 0 0 0 7 10 0 11 0 14 0 14 0 2 0 2 12 0 4 0 0 0 0 24 0 0 0 12 0 0 0 0 12 0 0 0 0 16 2 0 0 2 
0 0 12 0 0 10 9 5 35 20 24 0 6 35 16 9 18 30 23 0 6 3 0 0 0 4 0 21 0 4 9 16 0 0 28 0 9 0 0 15 0 0 0 0 12 16 46 23 4 0 0 
39 21 42 29 8 16 36 0 12 20 0 0 7 12 0 5 0 0 6 0 0 12 9 0 0 16 0 0 5 8 12 0 29 7 0 0 28 0 0 39 0 28 35 0 28 11 2 0 0 0 0 
12 0 0 0 16 35 1 1 12 41 13 33 6 4 0 14 31 16 0 0 8 0 0 3 0 0 0 12 9 0 0 11 0 0 6 0 18 6 0 5 13 0 26 0 72 5 0 2 0 2 41 
0 0 0 0 0 0 10 5 0 0 14 0 0 7 0 0 2 0 0 0 0 9 0 0 6 0 0 4 0 12 0 5 0 2 0 0 3 3 0 0 0 0 0 8 20 7 0 0 0 0 1 
0 0 48 0 0 0 0 30 0 6 0 0 7 0 11 0 26 0 0 0 0 0 0 11 17 0 22 0 6 20 13 14 0 1 0 4 2 0 0 0 7 17 59 12 0 38 0 17 18 0 48 
12 76 0 0 0 73 0 0 0 0 27 10 7 21 8 0 15 4 0 0 5 0 21 10 0 0 0 0 0 14 14 0 0 0 11 0 14 2 21 8 16 0 41 26 31 33 41 47 0 49 0 
19 30 9 0 0 22 0 0 0 0 0 25 1 36 0 5 0 0 0 19 17 0 0 0 0 0 0 35 0 0 11 7 0 0 0 0 26 14 14 8 0 0 5 0 0 10 0 0 0 36 0 
39 0 0 0 0 0 0 7 9 3 0 0 2 0 19 8 0 0 0 0 0 14 0 8 0 0 8 0 0 20 0 0 32 19 0 18 0 0 0 0 18 0 6 11 0 1 0 0 0 0 4 
0 0 22 0 0 0 1 48 0 0 0 35 4 0 32 0 21 6 21 0 15 0 0 0 2 3 33 0 10 0 0 16 0 7 24 35 18 0 16 0 6 0 0 9 30 0 46 3 10 0 43 
42 0 0 0 0 1 18 2 33 27 3 0 16 0 0 0 0 0 2 11 0 0 0 0 0 1 0 9 16 0 0 0 0 0 19 0 0 6 0 41 0 1 42 0 3 4 0 0 0 41 11 
4 34 21 0 0 11 0 38 0 29 0 0 2 14 4 0 51 3 33 0 8 0 0 0 26 0 0 0 6 3 0 0 30 3 0 11 9 6 38 0 0 0 26 0 19 0 3 0 43 22 17 
2 0 29 0 0 26 21 23 2 20 0 9 40 9 24 18 0 11 2 13 0 0 55 8 24 14 0 0 3 0 23 23 0 0 14 13 15 0 4 0 34 12 0 0 0 29 10 0 14 19 18 
0 0 19 14 4 80 7 1 18 0 6 0 5 2 0 9 0 24 6 6 0 0 0 0 3 0 0 0 0 4 18 26 20 8 28 2 0 0 1 5 0 5 1 4 31 0 0 8 37 20 0 
0 0 19 0 57 0 0 0 49 0 0 21 8 0 25 0 2 0 18 30 51 11 0 0 25 0 0 0 0 0 2 0 32 2 5 23 12 23 0 39 10 0 0 0 0 3 16 41 3 8 30 
54 0 8 23 0 20 0 19 0 6 0 3 4 0 37 16 29 14 0 19 15 0 0 10 0 0 0 11 13 0 0 23 0 0 0 15 0 25 0 0 25 0 0 28 13 19 0 0 34 0 50 
0 0 6 7 0 0 0 13 4 1 28 0 10 16 0 0 24 18 0 0 9 0 10 18 9 0 28 0 0 0 20 7 0 4 0 0 19 0 7 3 6 18 0 0 0 0 19 0 0 0 0 
