51 29
0 9 0 25 12 20 28 0 0 22 42 0 0 11 3 0 0 30 0 0 15 0 0 21 11 0 0 0 0 24 0 0 0 10 28 5 0 0 0 0 0 17 7 0 0 5 0 18 38 0 5 
75 13 6 1 28 0 6 0 0 0 14 0 87 0 14 17 15 0 2 26 2 11 44 0 16 1 4 24 0 28 0 7 15 4 5 0 47 0 16 20 56 0 0 0 0 0 29 0 0 3 23 
8 0 0 0 0 0 0 28 19 0 33 0 0 7 0 0 30 0 11 0 7 6 0 14 0 0 0 6 9 0 33 0 0 0 10 27 1 38 0 6 0 5 2 11 1 28 26 20 0 1 1 
0 36 20 11 37 17 0 0 16 73 28 29 0 10 27 3 6 0 0 10 5 0 1 14 30 24 15 0 0 0 17 0 0 30 0 9 16 0 8 8 37 43 0 0 69 0 0 38 0 0 9 
0 22 0 19 0 20 3 5 0 14 1 0 0 0 0 0 0 0 32 0 0 0 16 0 0 2 19 5 19 0 19 19 0 0 0 0 7 0 0 19 0 0 22 26 0 3 0 11 3 40 13 
0 20 0 39 17 14 28 16 22 25 7 2 24 29 10 13 0 5 10 0 0 7 17 19 17 0 0 0 0 0 12 2 0 3 18 7 42 0 4 74 31 0 60 18 9 1 0 32 0 1 10 
0 34 22 9 42 0 0 13 13 0 115 20 30 0 15 3 28 0 0 16 7 39 27 14 0 17 11 10 29 0 6 40 0 60 5 40 7 41 23 0 19 0 0 12 2 1 47 0 0 10 59 
0 41 0 0 0 0 0 0 0 0 2 6 11 0 0 7 0 0 27 14 0 0 11 3 0 14 3 0 0 0 0 0 0 21 0 0 6 24 0 20 1 1 24 44 5 25 0 0 0 0 35 
17 0 18 0 0 0 77 0 0 0 0 5 0 0 0 22 0 29 0 0 47 0 1 12 18 0 15 0 0 0 0 0 26 11 1 12 0 12 0 36 20 0 16 26 24 0 12 16 0 0 0 
0 0 1 27 0 0 43 33 0 5 0 37 0 0 0 0 0 0 0 0 0 32 0 0 0 8 0 2 0 0 27 0 0 14 0 28 8 4 0 0 7 19 21 0 0 2 0 14 60 51 0 
15 0 0 16 19 11 0 4 0 17 39 8 0 22 2 26 11 0 14 3 3 18 39 16 0 0 0 0 0 6 0 0 14 5 1 3 17 37 0 0 4 7 0 2 33 0 0 0 0 77 28 
0 7 0 0 5 0 0 0 0 26 0 0 0 0 0 0 11 8 36 0 0 10 0 0 7 3 0 12 9 0 0 3 7 0 0 0 0 0 0 8 8 0 0 0 9 21 0 0 3 0 32 
17 1 0 0 1 2 39 38 0 0 0 1 0 0 14 11 0 0 3 0 5 2 0 16 1 10 1 4 0 0 16 6 10 7 0 16 0 15 1 6 13 0 12 22 5 122 21 5 1 0 0 
22 7 0 33 0 0 0 21 0 0 0 13 28 10 30 0 0 0 0 38 2 0 2 9 8 0 0 0 9 19 2 0 10 26 0 0 16 4 0 0 47 0 5 0 26 16 0 0 3 17 0 
0 0 41 0 0 36 0 1 3 0 0 0 4 6 0 12 1 0 3 0 0 0 0 0 0 0 3 12 3 0 0 18 0 5 0 0 31 3 5 0 8 0 9 63 4 14 0 0 3 1 13 
0 12 0 24 19 45 30 0 1 4 7 0 13 0 4 14 12 0 27 7 0 0 0 19 0 0 0 24 1 14 0 0 15 0 0 17 16 0 0 7 21 0 10 11 13 11 0 13 0 3 45 
0 9 11 7 12 4 16 0 3 20 12 57 0 0 0 6 13 40 2 0 2 0 0 14 1 2 15 87 0 0 0 0 0 6 0 0 0 0 36 0 22 32 19 0 0 3 0 0 0 34 40 
40 3 0 6 0 7 3 0 0 2 0 0 3 26 0 0 0 0 0 0 0 0 0 18 2 0 3 0 12 20 22 0 16 7 0 0 2 0 0 26 46 17 0 0 0 5 5 10 0 17 0 
0 14 41 0 16 15 41 6 13 43 0 0 0 11 0 0 14 16 14 3 15 0 11 25 11 2 5 5 0 12 14 7 0 0 0 0 0 16 0 3 3 17 5 58 5 7 5 7 2 26 19 
0 13 34 0 70 26 0 17 6 0 0 0 5 0 0 0 4 7 7 0 0 6 14 17 0 15 0 29 3 0 0 27 0 13 0 7 46 33 0 0 0 46 7 0 18 0 0 4 0 4 23 
48 32 19 0 12 21 24 0 1 34 0 0 28 7 13 15 27 12 0 4 22 25 1 4 0 14 0 0 11 0 14 0 13 17 3 0 0 16 0 29 0 0 6 34 0 13 25 35 55 0 45 
0 0 48 0 0 0 13 46 7 8 0 6 0 0 6 0 5 0 0 27 0 0 12 3 4 0 0 23 0 0 0 0 0 0 10 0 0 0 0 31 3 7 13 0 0 0 0 40 0 0 71 
4 0 0 23 2 0 32 0 0 11 23 17 0 15 0 33 11 0 30 0 0 11 17 0 0 17 39 4 8 0 0 3 10 25 0 2 30 27 0 5 0 0 27 0 0 0 5 0 3 24 17 
24 45 0 6 86 0 7 0 0 0 28 0 0 0 34 15 0 0 0 0 3 6 21 18 60 0 10 0 0 0 0 17 6 0 0 0 0 21 28 22 0 18 0 27 28 41 47 4 29 25 46 
1 42 0 0 0 4 39 18 2 16 61 8 10 0 5 0 4 8 0 11 0 0 45 24 0 15 10 0 3 32 0 17 10 14 3 25 34 8 25 5 0 0 21 22 48 8 36 8 0 13 64 
15 63 1 45 0 0 0 68 6 28 1 0 36 3 33 17 0 0 0 0 0 0 41 0 0 0 24 2 21 1 0 7 0 10 27 0 9 33 11 0 5 10 41 16 0 0 0 33 36 22 19 
4 67 0 17 10 0 8 35 47 35 0 15 25 12 15 0 0 0 7 0 26 0 23 0 11 0 0 26 0 5 6 0 1 0 0 0 33 29 31 11 1 0 2 6 57 0 26 48 0 12 0 
0 31 0 0 7 13 0 6 18 14 0 7 7 17 0 0 0 0 0 0 0 5 0 0 17 19 12 16 23 0 4 0 1 21 33 10 0 14 0 11 0 17 0 0 43 0 0 0 0 1 0 
51 0 1 0 4 0 22 37 0 15 13 0 13 0 0 1 4 25 0 0 18 0 0 34 14 4 0 5 25 0 16 13 5 17 15 0 0 35 6 7 6 19 25 23 45 0 4 2 0 19 12 
