51 29
6 9 54 43 48 0 0 31 4 12 5 0 22 25 0 11 34 0 0 0 3 2 18 0 13 22 0 0 24 0 23 15 0 33 0 0 24 0 30 0 24 39 0 36 36 0 30 22 5 0 51 
0 65 52 7 59 0 2 51 0 2 3 6 7 9 35 1 1 56 4 50 54 20 11 16 47 19 14 0 0 4 1 0 0 30 5 3 3 10 5 5 0 20 3 26 25 0 0 10 44 60 25 
37 65 0 2 21 0 47 0 8 1 37 0 17 0 0 13 9 0 24 0 9 21 0 7 8 7 0 17 18 17 6 0 0 32 12 3 10 37 1 15 8 0 0 2 0 0 3 78 49 0 23 
0 40 14 0 0 0 2 0 0 2 25 0 9 0 0 0 0 0 0 12 27 0 22 0 0 0 0 0 8 0 27 12 11 0 0 0 18 30 0 0 3 29 0 0 0 0 16 0 0 0 0 
26 47 0 53 0 0 3 0 4 0 0 0 9 21 0 13 0 15 2 0 0 0 0 0 10 0 0 0 17 0 13 3 55 5 66 0 19 59 10 39 9 0 19 2 0 0 0 0 68 20 0 
40 51 0 0 21 0 40 0 9 16 29 0 14 0 0 9 0 2 12 14 4 0 25 5 0 17 11 0 5 0 0 30 0 28 0 23 0 31 0 19 32 0 4 0 13 3 3 32 1 0 4 
0 27 18 0 0 0 8 33 0 16 21 15 3 5 35 3 8 5 28 0 15 0 15 28 0 16 15 7 2 2 14 2 47 4 0 7 13 5 44 0 33 12 7 0 22 0 44 0 0 0 0 
13 0 24 17 0 0 0 0 0 7 1 1 0 5 0 22 0 28 47 0 52 8 0 8 2 23 24 0 10 8 19 0 0 0 0 20 0 22 13 0 1 27 0 0 0 28 0 10 0 0 0 
0 0 35 41 20 12 3 0 10 1 10 0 0 0 23 11 0 13 13 0 0 11 0 8 28 0 0 0 0 2 2 0 0 0 0 14 7 12 0 0 0 0 2 0 101 20 0 0 5 0 0 
33 0 0 38 0 50 3 8 5 35 0 0 0 0 6 10 0 5 12 0 17 3 3 19 1 19 0 0 0 0 0 24 25 33 0 0 0 0 35 0 22 0 19 0 16 20 0 0 0 0 0 
0 14 9 40 8 9 8 19 0 47 22 0 0 16 13 14 0 9 0 0 0 0 0 13 0 5 19 36 2 17 0 0 1 12 9 31 0 0 0 0 0 16 0 40 0 12 0 13 16 0 3 
54 0 0 35 16 5 9 0 0 6 0 0 7 0 17 1 1 1 1 0 9 16 14 1 0 8 0 5 1 0 0 0 13 3 0 10 9 16 39 0 0 19 11 0 0 45 3 9 6 5 17 
0 0 2 8 0 0 0 22 11 33 14 41 9 24 16 0 13 7 12 20 18 41 31 4 0 15 8 3 7 12 24 27 0 9 0 24 9 24 14 24 0 10 29 0 51 16 60 0 9 18 10 
10 0 20 9 0 0 40 22 0 0 0 0 0 47 0 11 0 4 18 9 0 0 0 0 13 0 9 7 0 19 17 0 0 14 0 33 18 35 0 24 0 0 35 0 0 16 40 29 53 2 10 
8 83 19 18 39 6 6 0 49 14 11 0 19 5 18 3 0 0 1 0 5 10 19 7 0 0 20 0 5 0 6 31 14 2 14 6 39 0 0 0 0 16 31 39 17 19 16 0 0 0 0 
24 55 15 17 10 0 0 1 3 0 0 0 0 14 51 13 0 0 9 3 4 15 0 13 38 0 1 0 0 0 15 12 2 0 0 7 0 0 0 0 0 0 7 45 15 15 0 15 11 24 14 
60 3 0 37 11 0 0 11 17 8 0 0 13 27 15 0 59 11 0 0 0 26 0 0 12 27 0 0 0 12 11 36 20 0 0 0 0 0 9 23 57 41 0 0 29 0 0 17 32 0 20 
43 0 17 15 27 0 0 0 31 12 0 7 21 0 34 3 20 16 0 0 0 12 0 0 13 9 0 24 0 3 0 13 17 0 18 24 0 0 9 46 0 6 42 43 0 34 0 34 34 0 0 
0 27 0 0 0 51 8 6 0 0 10 6 38 6 13 0 3 31 9 0 10 24 9 0 0 0 0 13 68 1 0 0 0 0 0 0 0 0 6 0 0 0 7 3 16 68 0 16 64 44 21 
13 47 4 0 32 23 30 0 0 19 0 0 14 0 0 15 0 14 0 5 16 2 0 11 15 8 11 17 31 2 0 0 3 9 21 0 85 4 0 9 0 0 0 0 16 0 0 0 38 0 0 
9 4 5 0 0 12 1 0 8 3 34 0 46 84 0 0 7 24 0 0 0 7 34 7 24 3 6 0 18 0 0 0 19 35 6 6 0 0 0 0 30 4 8 0 0 4 34 5 15 0 49 
0 0 5 4 14 31 4 4 0 28 0 0 15 0 0 0 3 17 14 1 1 31 3 4 0 0 0 12 17 0 6 0 0 21 0 0 39 28 15 9 0 5 0 10 0 0 0 3 6 0 29 
53 20 43 15 46 0 0 0 1 0 46 0 0 0 0 0 0 0 0 19 6 0 0 0 0 0 8 1 0 0 0 31 16 0 8 0 0 18 0 29 0 4 0 4 0 41 0 0 3 0 59 
0 0 6 0 0 9 0 7 1 3 20 8 35 0 5 0 0 4 0 7 23 21 0 0 0 0 0 15 0 0 15 0 0 0 0 5 0 7 0 30 0 0 44 23 7 0 0 0 0 0 10 
4 4 4 0 4 0 38 0 0 8 20 0 0 0 0 0 0 13 0 0 15 6 0 13 0 0 0 27 0 0 41 0 5 2 0 1 23 8 0 19 10 0 0 26 0 3 0 0 18 0 0 
0 3 0 25 11 1 0 0 5 0 0 7 8 4 0 0 24 4 7 0 0 0 46 18 13 0 6 0 30 0 0 0 8 0 0 0 0 0 10 11 0 0 0 0 9 0 0 0 0 0 11 
2 4 14 3 0 11 0 2 17 0 0 45 0 1 0 0 34 5 18 13 0 0 42 24 6 40 6 0 3 0 27 12 36 19 0 9 0 22 9 1 1 9 30 4 25 17 0 30 16 27 1 
0 30 5 0 0 0 7 5 25 39 21 1 7 0 15 4 0 32 0 14 0 0 11 13 12 16 0 0 0 14 0 42 23 14 34 0 0 14 0 3 0 16 1 0 0 19 0 0 15 0 0 
0 8 33 0 20 0 26 5 11 0 8 24 49 0 54 17 8 22 24 0 7 16 0 0 0 13 0 7 10 17 47 12 54 0 17 60 16 0 0 0 7 0 0 0 14 0 46 48 10 0 35 
