51 29
0 6 0 14 0 0 10 6 0 12 43 2 0 0 0 1 10 7 4 34 1 0 0 6 19 8 0 14 4 0 0 3 4 12 0 11 16 14 34 10 0 0 31 0 38 10 0 0 0 0 0 
27 0 0 0 6 0 12 21 24 18 0 0 0 0 15 35 0 0 5 34 27 36 69 0 16 0 2 0 0 0 7 0 8 0 0 53 13 1 19 13 16 0 0 0 26 4 0 25 1 56 28 
30 27 6 0 69 0 0 0 4 33 0 28 14 14 21 2 23 0 17 9 7 0 0 6 0 63 29 19 18 0 17 6 12 46 13 9 32 23 38 35 0 13 33 0 4 5 21 25 0 11 35 
19 31 7 19 5 0 0 16 29 9 0 18 0 0 23 0 21 2 17 17 36 46 2 31 0 5 24 18 22 52 12 13 31 0 1 33 9 31 15 17 45 20 17 7 8 52 22 25 0 0 26 
0 21 35 14 0 0 0 40 28 0 2 0 7 0 0 0 0 0 0 0 0 5 0 25 0 16 0 14 0 13 0 10 6 7 0 0 0 35 6 53 4 40 8 0 4 0 10 19 25 0 0 
35 7 0 6 23 9 0 0 11 60 33 6 10 0 4 15 0 20 21 0 0 0 4 7 5 17 4 7 0 0 0 0 24 0 25 3 0 0 5 12 27 19 7 59 0 23 2 0 19 38 41 
19 3 0 0 28 0 20 0 38 2 26 0 25 0 31 14 12 2 0 28 0 0 22 0 0 3 21 0 33 0 3 1 15 2 14 0 9 25 1 6 0 0 33 2 13 42 24 1 14 30 4 
87 27 26 17 96 0 0 11 0 0 39 0 0 6 0 0 9 0 55 0 12 21 0 0 0 21 6 27 30 0 0 10 0 0 0 0 23 21 0 11 0 10 46 65 6 9 0 0 30 0 42 
0 28 18 7 46 66 7 21 0 1 7 7 29 6 13 34 6 0 27 4 0 44 10 23 0 0 18 13 27 0 23 0 27 29 0 6 18 32 0 0 17 49 27 0 9 0 41 0 0 24 8 
0 0 0 7 2 0 8 0 0 19 21 0 0 0 0 0 0 0 0 0 0 6 0 0 0 0 0 22 19 0 0 21 3 0 6 0 13 7 4 0 14 0 13 0 0 0 0 0 0 22 26 
23 41 25 17 29 43 0 14 0 0 7 21 0 0 24 15 0 2 31 0 8 4 0 5 29 0 15 0 0 2 0 2 7 0 61 1 28 2 42 1 23 0 41 0 0 53 14 0 14 2 0 
1 11 0 27 2 0 0 42 0 0 0 0 1 0 0 8 2 1 1 27 0 15 15 11 0 0 4 0 0 0 9 13 11 0 0 3 0 18 0 0 0 5 0 0 0 24 0 0 18 14 7 
40 0 9 46 7 43 0 8 21 12 23 21 0 8 6 10 4 9 11 18 0 16 3 8 3 3 0 16 0 0 3 1 7 14 0 32 3 0 2 74 0 24 0 0 5 6 0 0 34 0 0 
3 3 1 0 21 27 0 0 0 0 0 0 0 25 31 0 36 3 13 13 16 0 0 3 0 5 23 0 8 17 10 1 27 0 0 0 0 10 13 23 0 0 13 26 13 67 0 0 0 4 0 
0 57 25 5 40 0 37 4 19 0 0 0 0 0 0 0 24 13 4 25 0 10 15 1 22 0 3 20 11 13 14 0 0 19 0 0 0 15 5 0 24 0 8 44 17 0 31 14 0 14 0 
0 9 0 9 8 23 0 30 3 0 0 3 32 3 12 0 0 0 5 7 16 7 6 16 0 0 7 0 42 1 13 15 4 3 0 23 10 0 2 14 0 0 8 0 5 0 33 0 0 0 0 
15 11 0 7 30 1 0 0 0 0 29 11 0 0 15 0 13 0 0 0 0 8 11 13 0 13 10 0 0 7 0 0 0 0 0 3 26 4 25 37 5 0 8 11 15 5 10 14 13 0 4 
0 33 0 2 0 3 8 0 34 3 0 1 0 12 0 0 7 0 0 0 0 16 63 6 22 0 0 0 14 12 0 11 0 0 25 0 0 31 4 12 0 12 26 0 14 14 22 0 0 4 0 
2 8 13 0 6 0 0 0 0 33 12 1 11 3 0 14 0 32 0 0 0 0 10 11 8 5 26 0 0 0 7 0 0 3 0 0 0 0 0 11 0 0 72 0 15 0 0 0 13 32 7 
27 4 0 25 21 45 0 9 0 18 0 0 0 0 25 0 10 1 1 14 7 9 0 24 0 16 16 14 0 0 19 0 13 0 0 35 13 0 8 25 36 14 0 0 0 0 41 24 0 5 12 
70 0 22 62 10 0 0 11 8 0 3 0 0 8 16 21 9 0 29 0 1 2 20 16 3 53 10 0 0 0 28 0 0 0 0 0 21 4 19 10 0 0 37 0 19 0 39 0 0 46 0 
9 21 0 12 0 14 0 11 0 0 0 0 23 0 0 16 0 0 0 14 0 1 1 0 0 0 0 0 18 8 0 27 0 0 0 41 0 1 6 0 46 10 1 6 29 17 7 0 17 54 0 
0 5 8 21 0 0 11 34 0 5 2 0 11 0 16 18 13 0 0 0 0 0 5 0 0 0 11 0 0 0 16 0 25 1 0 0 13 16 0 0 0 3 4 0 0 0 1 21 0 0 0 
0 49 0 76 0 0 0 0 2 41 33 0 0 8 21 0 37 0 14 0 16 3 0 8 5 0 9 0 7 0 0 3 29 0 18 14 19 0 0 0 10 0 32 0 0 0 37 0 0 0 137 
21 0 0 2 15 14 0 18 0 0 0 21 0 0 0 1 23 15 0 4 21 21 0 16 12 18 0 22 22 10 0 4 36 0 0 7 0 27 27 26 27 3 0 0 44 0 1 13 14 22 0 
42 21 4 0 0 0 5 24 33 14 38 0 0 35 0 9 16 24 0 0 0 0 31 51 0 0 0 20 11 23 7 23 0 10 0 22 0 0 12 18 18 55 40 10 0 0 24 0 33 0 0 
7 0 47 18 0 0 6 4 19 0 2 23 2 0 0 0 24 5 14 10 20 18 5 0 0 0 5 19 0 0 11 11 0 0 0 33 3 18 22 2 0 0 0 0 0 1 1 22 0 0 0 
1 12 0 44 0 0 0 0 26 0 11 0 2 0 0 0 4 22 19 0 30 19 2 27 22 0 16 20 26 11 0 1 0 0 26 0 0 9 6 20 24 0 0 11 5 22 0 3 0 0 31 
0 49 59 0 2 0 0 0 8 0 38 20 33 0 14 13 0 0 0 14 0 0 27 17 5 0 14 16 3 25 0 15 0 0 0 7 0 18 0 3 3 0 0 0 0 8 0 25 84 27 30 
