51 29
0 4 0 14 0 14 0 0 0 0 0 0 10 0 0 15 8 14 28 0 26 0 14 19 0 0 10 12 0 0 0 0 2 0 12 0 0 0 0 21 24 0 8 0 0 0 24 0 0 0 11 
14 0 17 23 8 29 21 0 3 0 0 0 38 0 32 4 11 18 6 41 18 3 0 0 7 17 0 31 0 0 0 0 0 7 0 0 31 23 28 0 31 10 0 0 0 0 27 4 20 37 38 
7 10 25 13 55 40 23 14 0 23 20 1 0 44 15 9 26 0 16 8 1 1 0 0 1 20 17 70 19 23 37 0 20 0 1 34 18 3 0 23 0 0 38 3 43 49 19 8 48 49 0 
45 0 2 21 0 0 0 0 17 0 0 29 13 0 0 0 0 9 0 11 0 1 0 0 28 10 9 0 0 6 0 7 0 14 6 0 0 0 0 27 2 30 0 39 7 0 14 3 23 2 0 
0 1 1 18 35 0 0 0 0 0 28 11 0 0 10 0 19 22 22 14 5 45 32 0 15 0 0 3 0 16 15 0 2 13 0 0 11 11 0 71 0 0 24 26 0 60 0 11 0 0 0 
0 7 50 4 18 30 0 0 0 30 0 0 0 0 5 27 0 31 0 0 4 0 8 0 15 0 48 0 2 0 14 0 23 0 0 3 0 0 4 38 0 0 27 0 0 71 3 0 0 23 11 
0 0 0 9 22 0 21 0 0 2 0 13 9 30 0 17 0 0 20 7 39 0 0 0 10 9 14 4 8 7 0 10 0 21 29 0 6 0 10 0 19 4 0 42 2 4 0 0 0 0 0 
0 0 17 0 0 0 0 0 0 0 0 33 21 0 3 20 0 21 6 0 5 0 0 4 0 4 0 0 24 0 0 0 0 0 0 14 0 0 7 0 0 0 3 0 6 0 23 5 0 0 3 
0 21 15 40 13 0 0 16 0 9 9 0 3 16 0 15 67 15 20 10 1 20 17 11 4 0 3 20 12 38 0 4 30 0 5 34 2 3 0 9 28 7 0 31 2 10 46 8 33 0 34 
0 0 0 47 14 36 0 34 14 0 10 0 2 7 0 13 8 0 0 0 8 0 7 0 1 0 11 8 1 6 0 0 0 0 6 0 0 0 33 0 37 2 8 0 39 0 0 0 11 0 14 
8 0 0 13 5 10 0 0 0 22 0 8 42 0 2 0 12 17 0 17 0 0 0 0 0 13 40 23 24 6 0 42 5 0 0 6 8 11 3 25 0 9 28 0 0 12 0 0 0 0 0 
0 0 28 78 0 0 23 0 0 0 0 5 0 7 0 9 6 0 15 25 22 27 35 17 0 9 0 0 0 0 0 0 15 0 0 18 0 2 0 2 37 10 0 0 0 0 36 10 0 21 4 
0 0 7 10 10 23 21 0 30 15 4 0 0 6 4 0 14 1 5 0 0 1 0 0 3 0 0 21 0 3 0 0 7 0 0 0 0 0 30 7 14 0 0 4 0 0 0 14 0 44 0 
28 27 64 15 18 0 19 7 37 0 12 7 0 0 27 4 8 12 63 15 0 0 12 0 36 19 0 13 16 7 22 15 0 0 0 35 17 32 24 12 0 0 0 41 26 14 0 0 4 3 0 
33 12 28 9 5 9 0 0 1 29 26 46 0 0 0 28 20 0 4 0 35 10 34 3 0 0 23 0 0 0 40 0 10 35 0 12 6 0 18 0 20 0 27 0 35 0 0 0 33 0 0 
7 0 0 14 19 5 7 13 0 0 1 35 32 7 27 15 0 0 0 79 45 23 0 20 20 0 1 0 0 3 0 9 10 14 0 15 0 11 0 19 18 27 0 3 1 0 35 27 0 27 7 
5 1 0 48 0 5 0 14 0 9 0 0 9 0 0 10 10 0 8 1 1 0 0 0 9 0 32 0 0 0 0 0 0 25 0 0 0 0 13 0 0 3 39 10 0 0 0 0 0 26 11 
47 1 0 4 46 27 0 0 0 12 8 0 9 20 4 34 0 40 6 16 24 4 4 0 0 0 16 20 0 0 13 6 42 18 9 5 0 6 0 0 1 40 14 0 27 0 42 60 4 0 46 
0 24 0 42 16 1 1 42 8 0 0 2 9 10 17 31 28 0 3 0 0 9 0 0 6 30 0 16 0 5 0 0 0 0 0 0 0 0 0 0 1 0 2 28 0 38 31 31 0 45 11 
45 32 2 32 94 28 12 7 7 21 4 0 0 0 0 0 51 23 0 1 7 0 0 19 0 20 7 30 0 0 1 0 0 37 0 35 33 0 0 0 3 28 0 0 0 66 0 0 0 9 34 
0 0 77 11 36 64 24 0 0 0 0 0 36 22 0 12 0 0 0 0 19 16 1 18 16 9 0 1 0 0 24 0 0 0 32 24 0 0 3 13 52 0 2 38 0 18 0 45 47 35 0 
1 0 47 5 0 62 25 0 0 0 17 0 0 0 0 15 12 12 1 0 0 0 3 18 0 14 6 9 0 16 0 25 6 0 4 12 0 2 21 22 0 0 0 0 0 16 0 0 19 4 0 
16 0 0 8 0 21 0 7 27 0 8 0 24 22 21 0 8 0 10 0 9 22 2 0 24 0 6 15 10 0 7 0 6 0 1 24 24 7 0 0 1 0 15 21 0 12 0 0 0 15 0 
0 15 0 0 24 35 0 0 0 47 0 43 31 2 0 32 12 0 15 31 0 23 17 5 3 14 0 3 9 39 0 16 0 7 0 21 0 0 24 0 8 0 0 30 40 30 35 42 0 45 3 
0 0 0 86 0 7 11 0 39 0 4 0 56 13 0 0 6 11 20 14 0 13 26 7 21 6 0 42 3 0 11 15 20 0 0 8 0 2 0 4 26 23 0 2 0 1 2 59 36 46 9 
0 0 28 19 41 76 0 0 13 0 4 0 15 3 15 1 39 15 12 14 0 21 41 0 20 27 0 25 0 0 0 5 21 0 32 5 15 32 13 33 43 0 7 0 0 0 0 0 0 44 0 
0 0 0 0 27 14 40 8 36 10 36 0 0 0 0 17 0 22 0 10 50 0 15 19 20 9 0 3 0 0 0 0 0 7 9 12 0 0 0 23 12 0 0 0 0 5 74 25 0 0 5 
0 0 31 16 0 0 21 26 0 0 13 15 13 0 0 20 0 0 0 27 0 23 0 21 13 15 32 28 0 0 0 0 0 78 1 0 0 13 0 0 0 0 0 0 3 5 0 1 0 0 5 
36 40 0 32 25 26 1 27 15 27 4 13 36 0 6 0 23 55 27 4 13 11 19 11 33 0 17 9 21 46 19 4 23 28 1 8 16 1 5 61 10 17 16 8 0 44 29 5 31 0 11 
