51 29
24 0 28 0 6 15 0 9 0 9 30 84 0 15 0 2 20 7 3 3 15 7 0 0 8 18 7 0 17 7 17 20 0 0 0 0 0 0 0 14 37 0 18 17 0 0 0 0 0 16 0 
13 19 36 0 0 0 0 0 34 23 0 45 0 17 0 0 0 0 0 0 17 0 14 25 0 80 0 0 20 12 0 0 18 0 0 6 0 0 2 0 0 6 19 0 19 7 0 0 0 3 1 
48 19 1 6 14 57 42 14 19 2 1 0 9 4 20 7 0 45 2 6 9 19 0 3 0 10 0 0 0 14 3 0 0 20 20 0 0 12 13 0 0 0 0 26 0 0 36 37 90 12 1 
0 44 0 10 1 50 0 0 0 0 31 0 23 0 25 0 0 24 25 15 5 23 0 1 16 49 1 12 0 13 8 11 0 19 22 23 0 0 18 0 36 52 17 17 4 60 0 0 23 39 45 
0 11 48 11 9 0 6 19 0 0 0 0 12 0 31 2 25 9 30 21 9 0 0 0 26 0 67 2 14 10 0 8 0 0 0 42 0 0 7 0 8 54 0 7 0 0 0 0 30 0 46 
14 6 27 61 41 18 59 6 0 63 25 0 83 4 16 0 16 1 22 26 0 14 0 18 20 14 6 0 16 27 1 0 6 30 1 6 0 0 6 30 5 0 52 18 55 15 5 35 28 0 0 
0 2 0 15 23 6 5 0 0 9 0 6 1 0 22 34 0 0 45 66 0 0 11 0 7 0 0 35 3 0 1 17 0 6 0 0 5 0 1 0 20 0 0 0 0 0 4 0 29 65 13 
0 18 0 0 21 31 29 0 0 0 27 44 11 0 4 0 0 0 0 8 6 25 2 0 28 48 0 3 15 1 12 21 0 0 22 35 0 0 1 0 0 0 22 14 0 20 25 36 4 11 0 
0 0 0 0 0 5 1 32 11 17 3 12 3 0 0 19 0 6 0 0 6 8 0 0 0 0 0 0 1 0 0 0 0 0 0 0 0 0 0 0 8 0 27 0 0 0 59 0 0 4 0 
18 0 0 9 0 10 3 11 6 24 10 40 1 0 6 46 0 6 3 0 19 0 20 4 2 22 18 18 3 31 0 0 0 33 2 0 27 0 12 0 18 0 0 3 0 0 1 22 0 0 48 
0 76 0 25 2 3 2 0 35 4 5 32 17 4 0 0 0 0 4 16 0 0 16 0 0 51 0 14 25 0 29 0 24 8 12 0 7 0 8 5 19 0 0 69 0 5 13 22 50 0 0 
8 0 0 6 0 61 56 0 0 4 28 0 10 19 0 0 0 20 24 12 0 16 0 3 2 6 17 19 14 0 21 5 19 0 35 41 2 4 4 0 0 31 31 7 39 17 19 12 7 3 12 
0 43 48 0 0 8 0 34 7 9 0 6 41 0 0 15 0 0 24 45 0 12 27 0 0 2 2 15 21 0 0 0 0 0 12 0 0 35 19 21 9 0 0 2 0 0 0 35 0 48 61 
0 0 0 10 18 0 0 0 35 0 8 0 30 45 0 2 2 0 14 0 20 0 0 9 5 22 0 3 8 0 3 0 0 0 0 0 8 0 0 0 5 0 30 35 0 6 0 34 0 29 0 
0 0 0 40 0 0 9 4 0 0 10 14 0 19 0 4 13 0 20 8 0 0 7 0 25 4 10 4 0 18 9 8 19 0 0 0 0 9 0 6 0 4 1 9 5 0 0 10 0 25 0 
0 8 23 11 41 0 0 0 44 19 54 7 11 4 0 27 7 15 0 22 13 0 0 13 24 28 0 0 0 9 11 0 0 3 0 0 3 0 47 59 30 0 30 0 0 0 38 0 0 16 0 
11 3 45 22 0 9 0 8 0 41 0 3 0 0 4 0 1 9 19 0 0 11 0 0 0 7 8 10 12 20 0 0 14 2 0 0 0 0 29 0 0 0 11 0 44 16 0 41 9 0 0 
2 13 0 2 22 1 6 15 0 47 11 5 4 4 0 32 1 18 6 14 14 0 34 15 14 9 22 17 0 0 0 27 0 0 14 0 13 0 6 0 18 3 4 17 1 0 31 0 21 0 41 
18 0 0 36 0 31 19 2 17 0 3 32 52 4 34 3 0 0 32 13 0 8 3 13 11 35 0 13 5 4 18 0 2 2 10 2 32 0 0 0 18 0 14 38 29 9 0 15 18 15 0 
4 9 2 31 18 6 28 31 53 8 0 18 15 0 13 0 0 14 28 20 0 2 18 0 0 0 0 13 0 10 0 15 37 0 4 1 0 6 39 33 32 23 10 6 5 10 0 2 0 41 0 
0 8 0 0 0 0 0 15 0 0 47 16 25 17 0 0 3 27 23 6 26 0 4 0 0 24 0 11 8 8 0 0 15 11 0 8 0 40 0 5 0 11 2 9 4 17 0 6 4 4 0 
36 24 1 37 0 0 0 7 41 0 4 0 14 21 41 40 0 0 30 0 1 2 7 18 0 22 0 18 16 0 27 1 36 0 9 0 2 0 38 25 0 0 0 0 0 0 0 26 16 54 0 
0 33 25 9 0 0 26 38 20 12 17 0 56 0 0 10 23 0 0 0 11 10 0 25 0 4 0 0 0 0 0 25 10 0 0 34 4 0 0 0 5 0 0 36 10 0 4 0 29 37 4 
13 0 8 0 32 0 0 0 9 0 6 1 0 30 4 12 30 0 14 11 0 10 19 10 16 3 0 0 0 0 20 1 0 20 19 0 32 11 16 0 1 25 4 25 0 0 35 0 29 0 0 
3 41 27 6 0 0 41 13 0 57 17 0 0 0 5 0 19 30 0 1 2 0 12 0 0 0 0 0 0 18 0 11 0 0 6 19 0 27 0 0 18 0 41 12 11 0 3 71 0 24 18 
2 35 29 16 44 12 0 0 27 0 7 0 37 36 15 0 0 0 0 22 5 17 5 9 7 25 11 15 0 0 17 37 15 0 13 27 5 0 0 0 2 5 56 14 9 31 0 0 62 73 0 
50 42 0 0 13 0 0 43 0 11 0 0 38 52 36 10 0 0 32 16 0 0 0 25 11 57 0 0 0 0 11 0 0 33 21 0 0 0 0 0 0 0 0 49 31 0 20 0 0 19 110 
4 6 5 0 3 21 0 30 0 0 27 0 0 13 32 6 27 0 0 0 3 0 0 0 0 0 37 5 0 0 0 0 0 20 0 0 0 0 0 0 0 0 4 0 0 7 19 0 0 0 36 
44 0 107 0 71 0 0 19 0 12 11 0 17 30 10 19 16 8 0 0 0 0 21 0 23 19 24 14 20 31 3 0 23 4 10 24 0 0 39 37 0 37 6 6 60 0 0 0 6 0 0 
