51 29
55 37 0 28 3 16 14 20 20 4 1 9 2 32 0 0 8 15 0 10 0 0 0 0 15 18 0 22 25 10 0 18 10 9 23 0 0 29 7 24 0 0 0 0 0 37 0 42 16 9 4 
12 5 48 0 46 0 0 0 0 0 36 0 32 13 0 0 0 18 0 0 0 24 21 2 7 0 13 0 57 0 6 43 0 0 0 12 6 30 0 0 0 0 0 0 0 0 44 0 23 21 2 
0 25 0 8 21 24 3 5 47 0 13 0 3 0 0 0 10 0 27 0 9 13 2 13 2 0 22 22 12 11 9 0 0 0 6 25 0 0 28 16 44 3 0 4 41 25 16 5 0 22 47 
0 0 0 41 0 50 4 0 17 13 10 0 17 0 28 4 0 21 0 16 10 0 0 0 15 14 0 17 0 0 1 0 17 1 42 16 23 0 0 14 0 0 12 0 48 0 0 9 14 24 0 
0 31 21 0 0 15 0 8 19 29 0 9 7 0 4 8 0 0 13 31 7 17 0 24 0 32 0 19 13 0 0 5 30 19 0 0 5 0 25 0 0 0 0 0 0 13 0 43 0 0 21 
0 0 0 39 0 0 0 0 16 44 6 0 5 20 0 0 18 13 12 6 0 0 0 1 1 16 0 14 0 0 13 0 0 24 0 0 0 23 0 0 16 13 3 0 0 42 0 10 17 0 13 
6 66 0 30 0 24 11 11 50 19 0 5 4 0 0 17 23 0 0 0 0 0 9 0 7 4 8 0 0 0 14 37 2 0 22 0 18 0 30 0 10 5 12 0 0 1 0 0 0 15 0 
0 11 0 16 20 0 19 0 2 0 25 0 11 0 13 3 19 5 0 0 9 13 8 10 0 0 23 23 19 3 6 0 0 0 7 25 6 0 0 17 7 39 0 0 32 6 7 16 0 15 0 
14 12 26 42 10 0 0 17 3 8 29 17 1 2 4 36 24 16 0 22 4 0 2 8 4 21 20 7 14 8 32 21 12 29 5 0 6 0 7 27 15 61 25 0 19 36 16 14 25 44 27 
0 0 0 44 41 19 0 21 17 6 0 31 18 5 8 4 4 0 4 11 2 21 14 1 4 14 9 0 0 13 0 13 0 9 0 9 0 8 1 6 0 16 18 0 0 0 8 44 0 8 29 
14 0 0 0 28 1 34 29 36 7 22 0 0 0 23 0 27 23 6 0 17 0 0 0 0 4 28 13 0 0 2 18 4 0 0 13 0 17 0 0 23 0 0 37 39 20 0 0 13 9 36 
46 26 0 51 0 3 13 51 21 28 4 62 38 0 15 45 26 19 18 0 5 35 1 0 19 0 9 9 39 15 14 0 11 0 0 0 0 63 35 2 0 1 10 97 39 0 14 1 7 0 80 
0 0 0 6 0 11 1 4 9 0 0 8 0 3 0 0 0 0 29 0 3 12 6 5 0 13 0 13 6 0 0 4 0 16 0 0 0 0 0 0 0 38 0 40 23 3 0 37 0 16 5 
0 37 0 1 13 1 30 7 30 6 0 15 0 12 5 0 11 16 0 0 0 0 14 0 0 25 0 0 11 18 5 4 8 0 5 0 0 0 62 4 0 0 5 0 0 0 0 17 0 0 74 
6 0 0 0 6 25 3 27 0 0 0 11 0 7 0 0 1 1 6 7 13 10 0 2 0 0 7 9 15 6 48 0 15 0 16 0 0 0 0 1 0 0 0 0 4 1 0 7 0 0 0 
42 40 0 0 46 0 16 20 6 2 39 26 4 0 0 15 0 11 2 43 0 11 31 8 13 0 5 6 19 1 1 19 5 31 14 13 0 30 40 12 7 36 0 0 0 0 11 0 100 3 17 
5 0 0 30 14 16 12 7 0 0 0 0 0 5 7 23 9 0 6 1 0 16 1 0 0 0 0 0 4 13 0 0 12 30 0 5 0 4 0 0 2 4 0 0 0 0 5 0 0 34 0 
0 0 0 10 2 45 0 11 9 8 0 0 0 0 1 8 0 0 3 41 57 0 0 0 26 16 0 0 18 0 0 11 0 0 0 0 0 0 13 9 0 0 6 7 24 0 18 0 6 0 11 
10 4 0 10 0 4 0 5 0 26 9 5 0 10 4 19 28 0 16 0 0 13 17 0 3 0 0 7 0 14 9 0 0 0 44 39 0 0 20 27 2 0 12 16 0 20 0 12 23 0 7 
0 27 0 0 38 15 0 9 4 0 8 0 31 11 30 0 3 15 0 19 0 7 10 31 0 0 9 4 56 15 0 0 0 32 26 16 8 14 30 37 4 0 16 0 4 21 0 0 0 21 0 
0 3 43 12 0 10 0 0 15 0 60 5 17 0 0 0 0 0 6 0 3 13 0 0 0 1 12 26 13 6 0 8 0 0 24 0 0 27 16 17 39 13 8 0 0 43 23 8 0 0 8 
5 0 0 88 64 21 23 15 16 0 0 20 1 0 0 0 0 0 0 0 0 17 15 0 2 1 21 7 0 1 0 0 20 9 0 35 5 0 0 23 16 5 0 0 0 11 38 43 45 0 0 
57 0 6 0 4 0 0 0 11 0 0 14 28 0 0 21 11 0 0 15 0 15 21 0 21 0 18 5 27 14 0 13 4 0 4 35 0 9 23 0 4 0 0 0 0 11 0 8 17 0 0 
1 0 0 3 10 19 35 0 17 0 0 0 44 0 10 21 0 0 6 0 0 7 0 20 5 0 15 6 0 0 0 0 12 35 23 1 0 4 6 20 0 0 0 0 38 0 0 2 1 1 38 
1 0 0 17 17 31 10 0 22 0 13 0 9 0 0 21 2 30 10 2 0 18 0 13 0 0 2 0 23 0 11 0 0 0 0 0 2 32 0 0 0 0 0 5 0 0 14 11 15 1 0 
0 0 21 0 0 0 0 0 0 37 0 6 0 12 0 0 17 0 16 8 0 24 0 1 8 21 0 13 19 0 0 17 11 17 0 1 29 24 0 7 0 16 24 11 0 0 0 20 12 21 0 
16 12 0 0 13 2 0 0 0 0 0 0 11 0 0 0 35 19 24 0 0 0 4 0 0 2 34 0 22 0 0 0 0 15 0 3 73 0 4 28 0 0 0 15 0 24 0 19 15 48 0 
7 32 0 33 66 21 6 0 62 7 0 7 17 9 18 4 7 2 36 2 0 10 14 19 23 10 25 5 24 6 0 2 28 0 41 45 0 0 8 0 0 7 24 31 19 0 38 32 0 0 64 
6 0 17 29 19 43 12 56 8 0 0 1 7 0 0 4 42 2 0 5 0 0 0 9 13 12 0 20 0 0 0 2 4 9 0 0 0 0 22 0 0 0 27 0 0 0 41 32 0 20 0 
