51 29
23 0 0 31 32 40 0 0 40 0 0 47 33 0 0 15 0 0 0 0 5 23 0 0 21 2 0 0 39 34 0 0 0 4 31 0 57 0 38 31 0 11 5 0 21 9 18 8 40 0 13 
4 16 24 18 4 25 42 0 0 9 49 37 31 34 17 20 29 5 8 7 0 1 1 0 0 0 0 0 0 28 0 0 0 4 0 0 22 57 25 0 3 0 40 31 15 61 0 0 0 38 62 
0 0 0 15 0 22 0 0 0 10 0 2 0 3 0 6 0 10 29 0 22 0 0 0 0 21 24 0 16 0 0 14 5 14 7 0 0 0 0 6 2 0 20 9 11 0 21 55 24 0 23 
24 42 38 4 3 38 24 5 0 14 0 50 10 0 28 38 20 0 0 22 20 0 0 13 24 13 1 23 6 0 24 0 30 0 0 6 20 0 0 0 20 10 9 100 0 0 35 0 15 0 11 
25 0 0 2 0 2 6 40 0 19 0 2 6 6 45 0 1 1 0 14 9 1 12 14 0 13 18 0 3 3 0 23 0 15 12 20 0 0 0 0 3 15 28 3 0 0 3 40 0 8 0 
36 1 4 71 0 7 0 0 7 4 14 32 8 11 6 28 0 42 0 0 5 1 0 0 14 0 5 6 13 0 0 25 0 3 0 32 34 6 0 0 0 0 12 34 0 0 0 22 3 7 0 
68 3 24 15 29 18 8 2 18 24 0 14 2 0 2 3 24 5 14 0 35 33 0 35 43 20 15 18 0 17 0 10 0 57 7 6 25 0 12 0 21 0 26 39 0 0 71 0 17 0 64 
48 12 7 17 41 0 0 0 0 31 0 20 1 25 15 0 0 6 0 22 0 4 0 0 7 0 0 7 18 0 2 7 9 0 47 35 2 0 0 0 29 0 2 0 0 49 27 0 11 0 0 
46 0 0 37 3 0 0 2 0 0 0 15 13 0 0 0 0 0 0 0 0 0 0 6 0 0 15 0 0 7 0 0 18 4 32 0 2 0 0 4 42 0 0 0 10 14 17 0 21 12 37 
0 3 24 36 0 23 0 15 0 7 0 0 9 0 2 8 2 15 0 28 11 0 24 0 19 3 21 13 27 3 0 11 13 0 0 17 0 0 0 12 0 0 39 17 0 4 6 0 22 0 0 
0 27 4 27 7 0 0 0 0 13 0 1 4 29 20 4 0 0 26 2 10 2 6 14 30 6 4 0 47 5 27 0 20 10 10 31 6 0 15 11 16 10 9 18 23 0 0 0 13 0 0 
37 0 4 0 10 42 0 0 20 11 40 16 22 14 7 0 31 0 13 10 18 0 0 18 6 10 23 23 2 5 0 0 2 28 13 11 0 0 0 4 0 7 0 0 0 4 46 27 0 22 33 
0 15 6 0 0 5 0 0 0 30 12 0 20 7 0 0 2 10 0 24 8 12 15 4 0 0 0 0 7 14 14 0 34 0 0 6 13 0 0 0 0 0 0 24 0 0 14 0 27 1 14 
12 0 12 0 0 12 12 2 6 12 0 0 34 6 26 0 0 12 0 10 0 0 0 0 0 0 0 0 22 0 0 14 9 14 0 0 0 0 26 0 49 0 0 0 2 2 5 14 1 14 9 
12 0 46 17 0 23 0 32 0 4 33 0 19 5 0 0 0 18 7 0 13 0 14 14 25 7 8 0 23 27 0 36 0 0 4 18 3 0 4 32 0 0 0 0 1 0 15 0 6 25 36 
50 0 43 43 17 26 0 0 5 16 0 5 0 1 14 12 59 0 52 0 0 0 0 31 5 16 9 4 14 18 26 23 17 0 3 0 0 14 0 27 11 12 24 0 0 50 71 27 0 4 68 
4 0 21 30 0 7 19 0 20 14 0 13 2 1 0 21 33 5 9 0 0 0 13 6 0 19 14 0 20 9 0 53 13 30 0 6 13 0 0 3 11 6 1 0 41 21 0 9 0 0 34 
24 13 37 48 6 5 15 36 4 0 11 5 0 30 14 25 3 29 0 29 0 0 16 13 24 0 3 0 56 18 0 2 0 0 0 0 65 0 16 37 2 0 0 22 0 0 0 0 29 0 0 
0 59 0 0 12 0 0 0 0 0 0 22 0 0 17 0 28 3 1 1 0 0 25 6 7 15 0 25 42 12 0 0 16 0 5 0 19 0 0 0 15 56 7 0 17 9 5 24 21 7 23 
0 0 0 2 0 5 25 6 0 37 0 3 22 7 0 0 12 18 0 15 1 18 0 7 0 15 0 0 2 2 4 25 17 2 26 40 7 0 0 28 0 0 9 7 0 0 23 1 0 18 0 
25 0 0 24 0 19 7 17 0 0 0 0 0 7 0 5 0 16 0 11 36 0 3 0 12 3 0 6 3 0 14 9 0 26 2 8 0 12 0 6 0 17 59 8 14 4 0 0 6 13 10 
0 3 8 0 0 37 43 25 0 0 0 14 9 0 12 0 63 15 11 0 17 41 3 4 0 11 28 21 1 11 0 0 25 0 0 0 0 0 0 0 8 39 36 0 5 2 30 20 1 76 29 
15 0 0 24 0 0 44 0 7 28 0 42 9 0 0 13 0 2 0 2 0 4 0 0 22 0 0 6 3 0 0 28 0 2 0 13 0 19 0 0 0 0 12 0 22 13 1 36 0 0 44 
38 24 29 65 7 1 1 0 0 0 0 16 0 0 0 0 0 46 14 0 0 3 0 0 17 37 0 2 0 2 27 0 14 4 21 8 22 0 34 0 0 38 0 8 0 0 29 0 4 0 0 
0 0 0 33 0 34 18 54 17 4 12 0 0 37 0 0 14 15 0 4 0 0 12 3 20 23 0 0 5 0 0 0 0 0 11 5 41 0 0 14 0 0 26 0 14 1 42 0 0 0 44 
26 62 35 22 31 12 8 6 42 0 27 89 8 29 57 10 48 38 0 3 13 0 16 0 0 2 23 0 51 24 0 0 0 14 24 5 35 49 24 0 12 20 0 27 36 0 18 39 45 38 37 
0 0 0 5 0 52 22 0 32 28 33 26 8 16 4 0 0 26 26 0 0 3 19 1 7 5 23 25 0 0 19 4 19 0 0 26 0 54 0 21 53 5 0 43 15 0 3 35 25 11 0 
29 42 27 22 2 45 13 25 38 0 10 29 0 0 20 0 3 0 0 4 10 21 26 3 0 0 0 0 27 27 22 11 7 0 20 2 0 0 19 0 24 0 23 0 0 0 0 22 0 0 71 
0 11 25 7 0 5 25 16 20 0 7 0 0 11 0 0 1 0 5 21 5 18 0 11 0 18 0 5 26 3 0 25 9 10 29 0 0 0 0 22 20 0 0 10 0 0 0 26 23 0 0 
