51 29
0 0 0 0 0 8 17 0 0 0 0 40 0 0 0 0 0 0 0 0 0 0 6 0 19 0 4 0 6 0 0 7 0 0 0 0 0 0 0 34 29 0 27 38 0 26 13 0 1 23 0 
0 0 9 0 0 43 0 25 67 0 8 0 62 0 22 0 0 20 27 0 6 10 10 0 40 0 7 65 20 0 6 0 41 21 32 0 44 19 12 22 10 15 0 94 4 11 0 19 28 63 0 
0 0 0 0 0 19 2 0 14 0 0 19 36 33 0 33 29 7 0 0 26 12 0 13 0 0 15 0 23 0 7 0 16 0 0 0 0 7 0 0 26 7 0 1 21 0 50 0 61 6 0 
20 38 0 0 26 31 14 58 0 25 21 11 30 0 0 10 30 15 23 27 6 15 11 13 0 0 0 19 0 21 17 26 15 0 0 4 13 0 10 4 2 40 6 17 0 5 3 42 0 0 19 
17 0 10 3 0 27 0 4 11 0 0 18 0 0 39 6 0 15 24 0 0 0 7 8 0 20 4 0 0 24 0 13 27 30 20 0 7 0 2 0 4 0 0 0 14 0 1 0 0 0 0 
16 0 0 0 23 23 22 0 0 4 12 0 9 0 11 0 16 4 14 0 20 24 12 0 0 5 0 23 22 8 12 0 0 0 0 0 15 3 0 0 20 0 21 7 0 0 24 0 7 0 5 
35 23 9 0 4 0 15 0 30 11 20 0 0 0 8 0 0 45 17 0 11 15 0 0 0 0 5 0 11 12 23 31 16 3 15 6 19 0 58 0 15 12 0 26 2 15 13 0 8 0 20 
70 2 0 8 0 0 0 0 5 15 2 0 0 0 14 15 0 0 0 0 0 5 0 5 0 0 0 39 5 0 9 3 0 0 5 12 7 0 4 12 6 0 0 43 0 0 3 0 0 0 0 
71 20 46 18 14 16 0 13 26 20 4 63 0 20 4 0 31 0 21 0 18 54 16 0 14 5 20 0 9 18 5 0 10 11 41 0 5 9 0 0 16 0 0 0 1 40 20 10 69 15 0 
58 19 7 2 21 0 0 1 54 24 19 0 0 14 0 15 0 10 0 22 12 0 0 11 5 17 0 20 0 3 0 0 12 7 11 0 0 0 0 0 0 31 0 46 7 0 0 20 0 0 51 
11 26 9 0 0 7 8 0 0 0 0 0 6 22 6 25 0 0 0 0 4 0 0 26 3 0 0 25 0 0 11 0 10 0 0 19 0 0 0 0 25 0 10 0 0 0 7 0 0 23 0 
7 28 0 26 19 12 0 30 16 1 4 13 0 28 0 0 0 9 42 6 0 0 0 0 13 0 13 17 0 76 6 0 0 0 6 0 3 30 0 0 0 0 0 0 24 0 0 18 0 0 58 
0 25 0 26 25 0 54 0 0 0 0 0 3 0 8 11 6 32 0 0 0 5 0 0 32 8 0 0 0 52 0 7 0 0 0 19 0 1 0 0 11 0 36 39 0 0 0 0 0 68 0 
7 48 0 0 0 0 29 10 0 0 17 0 0 0 0 15 0 6 11 0 0 4 20 11 0 0 4 12 0 17 7 0 0 0 3 30 5 2 13 13 0 0 19 15 0 0 23 0 0 39 0 
0 0 10 66 45 0 0 24 6 53 11 0 0 17 24 0 9 0 5 17 0 12 9 0 30 9 41 4 0 0 33 0 0 0 21 31 15 6 14 0 9 5 39 6 25 0 9 0 24 23 0 
21 0 56 44 0 19 0 11 11 36 14 3 3 0 35 0 0 14 3 0 0 2 12 12 32 0 0 0 1 9 0 0 0 9 8 3 4 0 3 0 10 0 31 1 24 79 3 0 1 40 0 
33 9 0 0 5 0 0 27 89 40 0 8 31 22 11 21 19 0 10 32 15 0 4 0 5 20 8 0 10 19 13 7 13 40 19 41 17 15 9 0 8 1 9 31 35 0 0 0 32 14 0 
40 0 5 34 0 0 69 20 0 0 4 0 37 42 8 0 0 0 12 5 18 0 21 4 0 0 0 12 11 17 31 0 0 0 6 4 0 34 38 2 0 2 0 0 0 0 23 0 0 56 9 
41 38 15 45 0 16 25 49 0 1 7 0 39 25 11 0 18 16 9 4 0 34 1 9 0 5 0 0 0 7 0 31 10 19 1 13 22 9 0 29 0 61 9 27 0 0 3 0 95 4 0 
0 46 0 0 10 7 0 0 9 41 4 36 24 44 31 0 0 12 56 0 3 18 23 18 21 3 0 0 0 0 8 0 0 16 18 12 19 19 25 47 33 10 9 0 4 42 0 46 0 13 0 
24 0 44 14 11 0 0 0 11 0 0 0 0 2 0 20 8 27 0 0 0 10 4 0 19 8 0 0 0 3 0 13 0 1 13 14 17 4 0 0 1 0 5 17 9 5 27 2 18 5 0 
43 14 0 0 24 0 15 0 0 0 4 19 0 2 14 23 7 17 33 0 3 29 15 4 0 2 11 0 34 17 11 8 32 0 2 0 0 31 12 0 13 17 0 0 0 0 15 6 0 12 29 
0 19 4 0 5 18 0 0 13 39 0 0 0 5 0 0 0 0 0 0 0 30 0 0 23 0 8 22 11 3 0 0 18 0 11 0 1 0 0 3 20 0 11 2 20 36 0 26 0 17 18 
0 0 22 0 0 4 0 9 41 0 15 11 13 14 0 4 0 0 0 0 0 5 0 6 3 13 0 0 0 3 4 0 0 28 7 0 11 0 0 22 15 1 21 22 10 0 18 0 30 13 16 
83 0 0 9 44 0 36 0 0 0 0 0 0 12 0 11 21 0 0 0 0 0 0 0 0 11 0 21 0 12 0 16 0 0 0 29 0 21 32 0 28 3 0 41 3 0 31 0 23 4 44 
46 60 2 10 0 15 0 32 0 0 0 26 24 6 0 0 0 55 11 41 3 2 0 0 0 6 0 6 12 19 0 0 3 0 13 11 30 32 15 2 66 0 1 0 0 0 27 0 0 15 43 
6 33 15 2 15 13 16 23 0 0 17 109 0 8 0 27 70 9 30 8 14 2 0 26 0 0 10 19 11 17 21 17 2 24 18 0 18 11 0 0 0 0 91 52 43 26 2 0 52 9 20 
16 32 38 0 0 0 24 0 6 8 31 13 23 0 0 0 0 0 25 0 0 0 2 30 45 24 0 0 0 7 0 0 0 16 0 23 12 15 14 0 18 14 56 14 26 8 9 0 0 0 0 
8 6 41 0 36 65 0 13 17 39 6 24 3 22 12 3 28 4 22 6 42 70 0 0 0 9 11 7 27 0 0 29 0 20 9 24 0 0 39 0 29 40 31 27 17 0 19 64 44 6 3 
