51 29
35 33 23 0 0 18 0 7 6 4 3 16 0 7 8 25 0 0 30 37 48 0 0 0 0 0 0 33 22 0 0 16 15 28 35 30 0 0 11 0 54 0 0 25 16 0 0 7 29 0 0 
16 0 21 0 0 0 0 41 19 15 30 0 0 12 26 34 0 12 0 0 0 4 3 0 6 17 3 8 0 22 0 0 12 39 8 18 36 10 0 2 16 2 17 0 0 9 0 10 0 34 0 
46 7 40 0 0 18 0 0 7 25 0 23 0 0 0 0 24 33 53 0 30 0 0 39 0 0 4 1 0 0 8 26 24 0 25 0 0 0 0 0 0 0 0 0 0 0 46 0 0 48 21 
0 19 122 1 0 0 0 5 0 0 43 6 36 36 0 13 39 13 0 5 15 0 1 6 8 13 0 2 17 7 0 22 0 0 3 11 29 0 7 29 24 13 6 16 42 17 17 0 49 0 48 
46 0 0 9 14 32 13 0 33 0 7 47 0 0 29 0 31 0 8 0 0 25 29 14 0 0 0 20 20 0 0 0 32 15 23 0 15 25 0 34 11 8 4 0 0 6 38 11 11 44 10 
0 47 14 6 0 75 19 6 3 2 35 38 0 0 34 10 4 11 11 0 31 0 0 11 22 0 0 0 36 0 19 0 49 22 0 0 4 0 0 32 9 21 1 38 19 35 0 18 101 17 0 
7 0 29 0 42 37 9 7 10 5 0 0 0 0 10 24 14 3 8 19 2 2 0 18 25 0 9 9 4 0 15 10 0 0 0 0 53 0 0 18 0 10 37 17 0 0 28 0 0 0 12 
6 41 0 0 13 34 26 34 52 43 0 0 0 35 0 9 5 25 4 36 0 0 16 12 29 0 0 0 0 3 12 0 0 6 26 0 0 29 32 17 8 29 53 0 0 0 27 0 40 0 0 
0 18 32 44 13 3 0 14 33 5 36 0 22 0 7 0 0 13 0 24 8 0 0 0 0 16 11 0 16 0 0 0 0 0 2 7 0 11 0 15 20 0 0 0 0 25 2 45 1 0 0 
65 37 33 89 16 30 2 41 10 9 4 65 28 0 21 28 22 8 5 0 0 10 2 0 32 12 0 5 0 6 12 11 0 0 14 12 29 20 19 23 38 30 0 3 37 45 0 0 45 0 0 
13 12 0 5 4 0 9 17 16 26 16 47 7 1 0 9 14 7 1 3 4 12 0 0 14 0 12 13 0 0 22 12 3 0 6 0 15 0 0 0 0 5 11 1 0 3 0 10 0 0 45 
0 50 0 21 17 3 0 0 0 16 24 22 0 18 21 0 0 8 0 0 10 1 1 4 3 0 0 25 0 20 10 3 1 28 7 16 0 33 0 0 0 6 41 0 0 0 0 0 45 0 0 
25 9 0 24 46 23 7 17 18 19 0 7 0 14 20 9 11 4 6 19 0 20 6 0 42 24 18 11 22 0 27 18 2 4 10 0 10 0 0 0 0 0 0 36 0 0 7 47 9 9 0 
36 32 0 9 0 0 24 17 12 4 0 0 4 14 14 0 14 46 36 19 26 0 0 7 6 0 0 0 14 0 33 0 12 32 20 11 12 1 0 2 13 10 24 36 0 15 8 15 2 5 0 
0 56 70 5 0 13 0 0 12 10 3 0 7 5 0 0 0 0 5 3 19 0 0 12 0 0 0 0 0 15 0 23 30 28 10 0 0 0 37 34 0 11 40 0 14 0 0 9 0 0 0 
0 0 0 0 32 27 4 0 2 0 7 0 21 5 0 0 0 36 0 29 0 11 0 0 12 0 0 9 0 0 10 0 19 21 0 11 44 0 0 0 0 0 0 15 0 0 0 0 31 0 0 
0 41 7 10 0 7 39 35 24 0 7 2 22 38 20 0 6 26 29 31 12 0 6 0 0 5 20 16 10 3 8 16 9 4 37 0 6 26 0 6 3 28 76 13 39 0 41 0 12 21 6 
0 0 0 45 0 0 13 13 0 0 11 0 0 0 0 0 0 0 1 14 5 16 0 0 50 0 0 0 36 10 3 6 0 12 0 0 5 0 0 0 0 17 0 0 16 0 0 0 21 0 0 
3 7 16 15 0 0 16 6 0 6 0 13 0 10 0 2 0 26 41 0 0 0 2 0 0 6 13 0 42 0 0 3 0 15 7 6 19 0 0 13 26 3 0 0 16 17 1 3 15 5 44 
0 0 51 5 44 30 4 7 0 0 0 0 0 0 0 4 12 26 0 9 19 0 0 4 0 0 25 20 33 10 19 10 21 0 13 30 0 0 6 0 3 6 0 23 1 1 56 32 34 35 0 
0 0 0 0 0 19 43 0 5 13 19 0 1 30 0 2 14 7 0 4 7 0 0 8 17 0 0 0 15 16 0 15 0 0 3 29 0 0 0 0 0 21 0 0 0 7 0 10 1 0 18 
1 8 0 11 22 0 13 1 24 1 4 0 20 0 17 2 0 20 0 16 0 0 0 19 10 9 0 0 16 0 5 0 0 0 27 0 0 0 0 8 0 0 1 15 0 0 0 9 36 9 0 
0 0 6 6 33 0 3 0 9 3 13 0 0 11 5 24 0 0 0 5 0 12 0 0 2 0 0 0 0 0 9 0 2 6 2 0 0 4 0 24 0 0 8 0 0 0 0 0 0 0 0 
0 19 0 0 5 0 40 0 0 0 0 5 6 0 0 2 0 26 10 22 4 0 16 5 0 4 22 0 0 21 0 8 0 0 11 0 18 7 0 14 0 22 0 9 0 45 20 0 11 0 0 
0 33 0 27 0 42 29 24 7 0 0 10 0 6 0 5 0 15 22 14 0 8 24 3 23 0 0 12 20 0 44 0 0 0 11 84 0 0 0 1 6 34 3 22 0 0 7 17 0 44 0 
7 1 25 27 0 25 0 7 66 30 40 43 38 37 35 16 0 3 0 7 25 0 0 0 0 16 6 0 20 0 47 42 0 16 0 27 0 10 0 30 0 2 0 0 0 0 12 43 12 27 95 
34 25 0 0 17 6 17 0 0 8 31 6 0 26 0 0 24 16 35 1 27 0 0 16 0 0 9 0 0 0 0 17 24 7 27 11 0 0 0 21 0 2 0 11 0 0 0 27 0 0 0 
0 42 22 31 16 0 8 0 3 0 0 10 0 0 0 0 4 6 0 8 0 24 0 11 47 10 0 2 9 0 0 0 0 16 64 35 21 0 22 18 27 0 32 0 0 20 0 0 44 0 25 
0 0 0 0 32 32 1 2 0 2 6 2 0 43 0 18 15 1 0 0 0 0 0 0 0 0 18 0 16 0 0 41 13 10 0 0 27 5 1 22 0 4 0 0 0 8 0 15 0 0 0 
