51 29
50 0 0 0 0 0 2 0 0 0 0 18 0 14 0 0 8 0 0 0 20 7 0 0 9 25 36 14 1 6 9 0 0 0 0 0 0 0 0 0 7 27 0 14 25 19 0 0 0 11 25 
7 0 26 0 0 22 0 0 0 2 0 0 0 0 12 20 0 24 6 0 18 0 9 0 0 8 12 22 15 15 16 0 15 0 5 20 3 10 0 3 31 0 0 24 0 3 37 5 27 0 0 
19 21 3 0 0 30 27 41 5 1 0 0 4 5 0 0 32 27 0 11 0 4 31 0 15 24 0 20 0 0 25 0 0 0 32 54 0 0 22 39 3 0 55 17 19 43 0 22 39 43 0 
0 0 0 26 0 6 86 19 62 22 1 24 42 1 9 0 14 0 3 0 0 29 16 39 19 18 51 17 0 0 25 27 5 0 23 40 11 29 31 11 18 22 20 1 55 39 3 24 17 0 41 
3 80 38 5 0 13 12 1 11 3 0 1 0 8 35 0 32 27 18 16 0 17 0 1 14 22 0 10 22 0 29 19 0 16 12 0 0 25 10 0 38 0 4 0 38 3 10 41 21 35 8 
0 0 35 34 0 31 16 12 0 18 0 0 0 2 46 0 0 6 1 0 0 2 0 0 0 6 17 22 7 0 0 20 0 6 17 0 12 26 0 0 0 0 0 14 0 8 0 0 34 14 0 
0 0 38 0 4 0 47 22 14 3 30 17 4 17 0 21 0 0 0 10 15 0 0 5 2 0 0 15 5 52 3 7 44 0 0 0 0 5 10 8 68 0 28 12 13 0 0 0 10 0 0 
0 38 22 37 15 0 0 18 9 11 16 0 15 17 9 0 4 10 101 15 0 11 24 19 13 0 0 16 0 20 0 4 0 0 0 12 0 0 0 0 1 14 24 18 41 12 30 41 9 0 9 
35 34 0 12 0 29 25 26 0 0 39 24 0 5 0 17 8 18 14 3 15 0 0 19 2 12 0 0 24 0 0 7 31 26 0 34 19 2 0 42 30 0 36 0 35 0 0 0 0 2 0 
0 0 61 1 0 8 0 7 0 7 0 0 5 17 0 0 0 0 11 10 14 2 5 6 9 2 24 1 0 0 11 29 24 0 0 17 0 0 0 13 7 9 0 0 5 0 0 0 0 17 17 
1 89 36 8 38 28 0 0 0 6 6 0 25 0 0 45 2 16 36 37 0 8 12 26 4 23 0 17 5 0 22 4 17 14 2 0 0 57 0 15 6 20 14 6 4 51 88 2 13 23 11 
0 0 0 0 0 0 38 0 5 1 0 7 0 38 0 40 21 19 0 3 0 16 13 24 11 22 0 0 0 2 16 10 0 25 10 1 0 2 17 3 10 28 0 0 48 0 31 22 0 10 30 
42 17 11 9 37 0 22 0 0 10 0 0 0 0 0 0 0 0 0 27 0 10 1 1 0 23 25 3 20 12 0 9 0 0 5 14 0 0 0 5 0 37 65 7 0 0 11 0 23 1 2 
50 0 0 0 0 3 19 35 1 1 0 0 0 19 0 3 0 8 0 0 9 5 0 0 4 19 0 19 0 7 0 0 9 13 0 0 15 9 0 0 0 34 0 3 0 0 7 1 0 0 54 
12 49 20 38 0 0 0 9 12 30 42 0 0 9 0 3 0 14 0 0 0 0 7 0 7 0 0 0 0 14 23 0 13 2 48 12 11 0 30 4 0 0 8 7 41 48 0 0 0 0 58 
0 50 0 0 0 42 41 0 13 0 2 5 0 0 28 6 5 4 0 0 10 8 0 0 0 24 12 47 0 8 10 7 5 16 0 0 9 0 0 0 0 0 13 0 0 0 0 83 0 16 0 
0 0 0 11 31 24 94 0 5 26 0 0 8 0 11 10 0 0 14 0 31 0 0 0 0 10 21 0 15 0 0 10 1 0 1 38 0 0 29 0 7 13 38 32 2 6 2 3 2 0 33 
0 0 0 16 70 13 1 15 0 0 22 0 0 0 0 9 37 59 13 16 14 0 0 27 0 0 0 0 3 3 3 10 0 5 0 40 6 7 1 11 0 0 0 7 40 7 0 30 41 0 23 
0 7 4 7 34 0 0 0 0 0 7 0 17 9 0 0 0 8 8 0 0 0 9 1 7 1 0 3 0 0 8 0 0 0 0 0 0 16 0 0 1 0 0 0 0 0 42 1 6 0 0 
0 0 82 52 9 0 0 29 0 47 0 0 11 2 26 11 25 0 0 10 0 0 24 1 21 12 0 10 0 0 0 24 13 20 25 0 5 2 31 0 23 0 0 9 11 14 15 63 0 0 10 
16 1 34 0 0 30 18 0 0 0 0 0 34 0 0 22 0 17 21 0 3 0 0 0 0 11 0 0 13 26 25 0 0 33 0 30 11 0 4 18 6 8 0 0 0 1 51 0 46 0 0 
4 9 59 8 1 35 12 0 13 1 4 22 2 0 3 16 8 15 0 0 24 17 0 0 8 9 0 11 0 15 0 0 8 0 9 0 36 0 5 0 83 2 0 0 27 0 0 0 57 0 0 
0 0 47 0 0 0 0 0 6 13 0 0 19 0 0 0 0 15 0 0 0 29 0 0 12 0 9 0 13 0 0 3 0 2 0 0 0 18 0 37 0 0 0 20 0 0 0 5 0 0 0 
21 0 11 67 42 0 11 13 0 47 10 15 0 0 7 0 8 1 9 0 21 26 2 0 22 17 23 19 20 0 8 61 3 19 34 0 25 0 22 21 0 52 16 0 4 5 5 63 0 0 0 
36 0 32 0 9 21 0 23 0 14 23 0 15 29 0 3 0 20 9 20 0 0 5 0 9 13 65 22 11 7 3 21 20 17 44 1 50 20 7 30 13 0 14 19 0 5 20 23 15 0 5 
47 15 23 55 0 0 24 18 24 65 0 0 1 1 0 0 0 23 9 0 0 0 0 0 6 0 13 0 0 0 13 0 27 0 0 0 0 34 0 29 0 0 0 24 25 0 0 47 0 0 25 
12 0 0 0 0 0 0 3 14 0 5 15 0 17 6 2 0 23 4 0 0 0 14 26 0 0 20 0 22 0 10 1 0 6 7 41 0 23 0 0 6 7 0 0 23 3 0 0 3 47 17 
47 13 47 3 0 2 21 13 13 55 31 0 3 25 36 29 0 4 1 1 11 24 11 19 20 0 0 23 0 20 16 26 17 4 0 0 11 9 10 30 25 11 0 0 4 8 0 16 0 47 43 
0 21 8 47 22 13 36 6 0 4 49 0 18 30 32 7 16 20 9 0 0 0 0 0 2 0 14 3 18 0 18 0 2 22 0 8 5 0 5 0 0 5 0 42 0 2 40 12 24 0 51 
