51 29
32 0 74 0 22 64 0 25 22 5 8 0 14 2 0 2 1 19 13 0 12 4 0 18 17 0 3 0 11 4 31 15 2 6 5 15 13 0 0 9 17 0 9 0 0 0 9 11 55 0 7 
32 0 27 3 0 24 50 0 3 20 0 20 0 14 0 33 6 5 0 4 0 7 6 0 18 18 0 4 6 4 22 0 12 11 0 8 0 5 0 25 0 0 0 18 12 0 17 0 75 0 25 
0 0 9 0 0 15 13 0 26 31 28 4 55 10 0 0 11 24 29 20 19 0 0 7 0 0 24 32 19 19 0 13 5 10 0 0 0 0 0 0 7 29 7 29 15 17 20 71 22 0 0 
0 0 18 18 6 0 29 0 0 27 0 38 7 25 0 8 0 0 0 38 0 26 13 2 26 0 7 0 8 0 0 0 0 12 14 0 8 0 25 0 0 0 0 0 25 12 19 0 28 0 13 
0 5 23 31 11 36 55 40 0 19 3 3 0 17 15 4 0 36 32 39 7 24 22 12 0 36 4 0 34 8 3 0 24 5 59 0 13 0 0 32 3 50 25 13 0 0 0 28 30 0 28 
0 39 31 0 0 0 0 0 0 30 0 0 0 7 0 12 4 28 12 19 26 0 6 0 0 6 4 1 0 20 0 31 3 50 0 0 0 15 0 37 39 8 11 14 20 28 8 1 0 0 0 
0 0 22 3 12 7 49 0 8 0 53 12 7 35 4 0 8 0 0 30 0 0 0 0 10 0 0 0 37 0 0 1 0 5 0 0 14 5 4 15 0 5 3 0 4 32 0 0 0 27 0 
0 0 2 5 45 3 31 0 17 0 47 4 0 9 0 21 0 3 45 3 12 28 3 5 0 0 18 0 8 0 0 22 14 0 2 29 3 12 4 8 3 9 0 6 13 16 0 29 0 94 0 
0 14 0 0 14 0 0 6 0 7 8 0 17 7 0 1 0 1 15 0 0 4 13 0 0 16 13 21 0 17 0 0 0 8 0 0 0 0 0 13 16 0 18 0 0 0 9 0 21 1 0 
27 0 2 0 14 27 10 0 0 15 0 0 8 12 16 1 0 3 12 0 12 0 9 23 25 14 3 0 18 0 0 9 0 0 11 8 0 32 5 1 7 0 19 5 0 12 0 7 12 26 50 
0 0 11 0 0 17 33 0 0 16 0 0 5 0 0 12 12 0 32 0 22 0 35 0 1 12 7 0 0 0 0 0 0 0 0 0 0 0 0 14 18 2 22 37 10 1 3 22 0 3 36 
8 0 2 11 0 0 11 0 60 0 49 2 5 14 7 26 0 9 0 10 0 20 0 13 5 14 0 19 4 14 0 0 0 0 0 0 5 0 0 33 0 25 0 0 0 33 0 11 0 0 40 
1 0 0 0 5 2 6 41 5 3 4 0 5 4 0 14 0 5 0 0 0 0 0 0 0 13 3 0 6 16 26 0 24 0 0 0 0 43 12 7 27 2 3 2 20 1 0 0 41 0 52 
1 0 9 24 42 0 0 0 13 0 0 0 0 0 0 5 0 10 0 21 44 21 13 6 5 0 0 0 0 0 0 0 12 16 4 13 19 0 4 0 17 0 0 26 52 26 22 0 10 0 0 
0 0 32 0 0 15 38 16 0 30 0 0 10 0 22 2 0 7 0 0 0 0 0 1 0 0 11 0 0 0 3 0 0 0 25 1 22 1 5 30 2 0 0 0 38 13 1 0 0 0 14 
0 30 0 35 31 0 5 4 0 18 24 0 0 7 0 0 0 0 9 11 0 0 16 4 4 0 0 6 0 4 0 53 0 15 24 0 13 33 68 14 0 0 0 0 37 0 3 0 41 3 14 
25 38 30 26 22 16 15 0 0 5 4 10 0 14 16 44 29 0 0 6 0 7 0 0 0 4 0 0 0 3 16 0 0 9 9 0 36 0 34 0 30 4 7 14 16 0 6 46 7 0 35 
0 40 26 0 1 17 34 3 19 0 0 16 0 4 3 30 0 35 29 24 1 13 11 16 13 23 0 19 0 0 36 7 0 13 3 20 1 8 0 34 44 15 12 15 5 30 8 17 0 0 33 
0 44 0 0 47 0 43 1 0 14 36 12 0 0 0 25 0 1 19 0 3 0 0 0 19 0 0 11 13 0 0 0 0 27 16 10 26 0 2 24 0 0 24 19 0 24 36 18 0 0 0 
5 16 17 0 11 0 17 8 19 0 0 15 0 12 0 11 9 36 16 10 0 43 15 0 20 5 8 0 49 14 11 0 19 11 23 0 13 2 6 3 0 20 4 35 8 17 0 0 27 0 0 
8 0 2 0 34 0 1 0 0 28 0 11 36 1 1 5 28 23 0 16 24 23 0 0 27 13 0 0 13 0 9 13 21 20 4 4 1 28 21 18 0 0 0 32 81 21 1 15 36 14 10 
0 0 80 0 1 0 0 0 6 22 0 46 1 26 0 0 23 7 0 0 2 0 13 8 0 0 15 14 0 0 0 8 27 0 0 0 33 0 0 42 14 4 21 31 0 0 8 0 29 17 0 
6 0 22 11 9 2 0 15 1 0 0 1 9 2 0 45 7 4 0 0 18 0 9 0 16 13 18 0 24 17 5 1 0 0 0 0 29 0 0 0 4 0 0 113 0 0 21 0 69 6 48 
0 28 1 0 39 50 25 0 0 0 3 22 0 5 0 0 0 0 15 49 0 11 0 0 11 41 5 23 0 4 48 8 2 12 0 2 4 0 8 36 1 0 0 19 0 16 21 0 22 26 19 
5 16 21 0 29 0 0 0 0 33 0 23 12 20 16 0 0 20 14 0 18 4 0 0 0 21 0 0 0 0 10 0 0 19 4 0 28 11 12 0 10 0 25 8 0 0 0 0 31 0 20 
14 74 29 0 9 3 0 19 0 3 0 0 0 11 46 2 0 16 0 48 49 12 9 0 0 0 29 0 39 0 0 0 4 0 0 0 22 0 0 0 39 4 0 0 50 0 27 7 0 47 30 
0 96 111 0 0 4 0 0 0 61 0 19 0 20 0 23 23 30 0 0 19 0 0 12 0 0 17 8 0 0 0 0 0 0 0 21 34 14 19 4 0 0 18 0 3 0 0 46 47 11 123 
32 0 36 0 0 0 40 0 0 0 37 0 0 19 0 0 5 7 0 0 5 0 0 24 0 0 0 0 18 17 0 0 32 0 0 13 5 0 33 4 0 5 1 4 0 13 26 28 11 0 0 
11 8 20 0 3 2 0 23 50 95 32 26 6 0 0 17 9 12 6 7 15 6 0 22 0 9 1 0 0 0 23 0 6 2 2 33 13 2 13 37 11 0 32 0 0 12 37 0 0 10 26 
