51 29
0 25 9 17 31 38 16 65 20 3 22 11 20 28 7 12 14 18 23 0 26 26 39 0 12 0 46 0 28 7 10 0 0 9 0 53 18 0 0 37 0 56 0 0 0 19 62 26 46 0 43 
8 36 14 15 0 55 0 0 0 4 0 0 7 5 0 1 11 12 1 7 30 27 27 19 0 13 21 0 12 0 28 18 11 0 20 0 11 12 9 11 15 0 19 0 4 27 0 15 0 39 7 
0 0 0 17 22 5 0 0 12 0 18 0 23 22 0 11 0 0 0 13 5 0 0 19 0 14 0 0 23 0 0 27 28 21 0 7 10 0 0 0 0 0 8 0 0 25 7 8 0 39 3 
54 43 17 74 0 0 0 7 0 0 9 15 0 24 7 0 0 4 5 27 1 0 0 21 23 23 21 0 17 0 13 53 19 0 0 28 7 34 0 30 21 6 0 19 0 10 0 45 0 6 0 
45 0 2 17 0 1 43 0 0 3 0 0 26 44 20 0 0 10 0 1 11 0 0 0 9 27 0 0 0 0 0 0 3 0 9 23 0 13 0 0 23 0 20 5 0 45 12 0 5 43 33 
28 0 0 0 18 4 10 0 0 0 0 0 10 0 0 15 4 0 24 0 15 0 12 7 2 32 3 0 40 0 15 20 0 5 7 0 3 50 34 0 0 7 1 1 0 20 0 5 0 11 0 
0 0 2 9 0 0 0 34 21 0 32 0 13 26 0 0 0 0 0 3 0 0 23 0 0 13 5 0 1 31 0 2 0 3 5 0 20 20 0 21 0 15 0 0 31 0 0 0 38 39 5 
36 0 0 3 0 5 7 46 18 0 0 0 0 26 4 1 8 0 4 1 7 25 0 0 20 0 52 10 4 6 0 0 8 11 0 14 26 11 0 32 6 6 0 20 36 0 53 21 0 0 5 
3 0 0 2 0 0 0 3 0 0 17 0 0 35 4 0 0 5 12 0 3 0 19 20 0 2 8 15 0 0 17 6 6 0 0 18 7 0 0 9 18 7 2 5 6 57 16 0 66 0 0 
5 0 35 0 17 1 8 16 0 0 38 8 16 19 0 0 12 0 7 3 11 9 15 0 8 0 0 9 8 9 17 5 8 42 0 0 5 35 27 3 0 0 0 2 0 0 0 28 38 0 0 
19 17 3 28 8 3 0 30 29 0 12 6 0 0 37 29 10 8 44 36 6 45 20 6 10 0 0 0 5 21 87 6 0 5 1 13 7 31 4 7 0 20 19 9 23 0 42 18 0 0 15 
0 0 10 8 0 14 0 7 30 0 0 1 24 0 0 0 34 30 15 12 19 0 0 7 9 6 0 12 0 0 0 0 0 9 0 13 0 19 29 57 0 0 8 0 27 0 0 0 0 0 69 
0 0 0 0 0 0 1 0 0 0 0 1 0 13 34 0 11 0 3 3 3 0 0 21 43 2 20 7 0 0 0 0 6 10 0 0 0 0 6 1 0 1 2 0 0 3 4 33 0 25 4 
6 1 11 5 0 0 1 43 13 8 0 0 0 11 0 17 42 0 3 0 6 21 0 16 35 0 3 35 11 0 5 0 2 11 0 0 7 0 15 0 0 16 1 0 17 6 0 0 0 17 76 
32 1 0 0 0 0 0 0 10 0 8 75 0 19 0 2 5 14 1 0 0 0 27 0 24 6 4 0 0 0 26 0 0 4 0 0 49 22 0 0 0 0 0 0 0 56 1 23 0 13 1 
6 37 21 21 0 0 13 10 5 24 0 0 10 10 41 6 0 8 0 3 20 0 0 0 10 8 0 18 6 0 15 0 10 1 5 3 21 0 37 0 20 2 0 0 0 6 25 32 7 36 0 
10 43 1 15 0 86 9 40 0 66 0 4 36 0 33 0 15 23 0 15 64 5 11 0 12 19 40 2 22 4 0 0 1 0 22 21 0 0 0 23 11 0 8 4 19 0 48 43 8 44 55 
0 0 21 0 0 30 11 0 0 24 4 0 0 21 42 0 0 7 36 14 24 0 21 21 15 0 0 3 10 0 3 0 8 31 0 29 0 20 23 19 0 9 10 0 3 0 0 10 0 35 0 
45 39 15 14 8 0 0 3 69 3 0 15 25 16 1 0 0 3 0 16 5 0 11 0 0 0 0 10 20 48 5 0 10 34 0 0 0 8 30 0 28 0 13 0 0 15 2 3 2 48 4 
50 77 34 0 0 54 36 1 26 30 0 0 16 1 19 24 9 5 0 25 25 0 0 0 5 0 10 0 7 0 3 8 4 0 26 0 54 11 0 3 0 0 35 0 25 37 17 33 47 21 68 
46 0 0 1 15 41 1 1 17 67 0 15 35 1 16 8 0 0 21 11 11 0 10 1 3 0 11 15 0 1 18 17 10 0 4 1 16 37 0 3 19 23 4 0 36 2 33 38 0 0 0 
0 0 0 0 20 2 0 14 1 8 0 7 10 28 5 21 8 0 16 0 0 7 0 19 14 0 14 22 3 0 0 15 4 0 0 15 14 0 16 0 7 22 0 3 0 0 4 11 7 22 15 
21 16 41 0 9 4 19 0 0 21 20 22 32 2 0 0 0 0 0 16 0 25 0 0 6 58 0 0 5 0 18 0 0 32 1 16 0 17 0 0 0 3 0 41 30 2 25 43 0 0 0 
0 32 0 0 19 37 28 31 0 9 23 2 6 10 0 0 0 0 4 0 5 7 0 10 10 0 0 12 0 5 25 0 0 11 26 6 0 13 31 0 0 47 38 2 0 0 8 0 43 0 0 
19 16 0 0 22 0 0 0 47 24 0 0 0 0 0 9 24 0 17 19 7 0 15 16 0 10 9 0 31 0 0 12 0 9 0 6 0 0 8 0 0 0 20 17 2 0 16 0 0 0 19 
0 0 0 0 0 0 0 16 0 0 0 0 2 13 7 0 0 0 19 0 0 3 16 14 16 0 0 0 0 12 6 22 8 41 0 11 19 39 31 0 12 25 0 2 6 0 17 0 0 0 6 
18 0 0 0 22 7 11 45 11 11 26 11 0 0 33 0 11 10 33 2 2 26 3 0 28 0 2 21 0 5 12 15 0 0 8 0 0 41 0 0 33 0 4 0 0 0 15 23 0 45 0 
0 18 0 0 0 1 11 38 0 28 0 13 9 23 0 0 0 0 22 0 1 0 19 15 14 0 26 9 27 0 19 0 0 12 0 0 0 28 14 17 39 0 10 0 0 18 0 16 0 0 0 
0 0 41 12 0 46 39 26 7 38 0 19 0 15 12 13 0 13 29 2 0 21 27 18 12 0 0 0 0 0 0 0 25 16 18 0 0 0 0 0 0 0 0 31 0 39 0 25 7 0 0 
