51 29
0 6 0 0 10 45 0 7 0 0 32 12 0 0 10 0 0 4 0 39 0 0 0 0 18 0 4 17 22 0 13 0 5 5 9 0 6 8 0 9 0 33 71 33 28 0 0 0 0 47 54 
21 67 0 35 51 2 31 62 0 9 5 0 0 20 0 0 0 18 0 0 0 0 0 19 24 0 21 26 0 12 0 14 0 16 15 42 32 41 35 32 0 0 22 0 0 0 0 31 0 0 0 
0 7 0 13 40 0 0 7 1 13 0 0 0 1 1 0 0 0 15 0 0 0 20 10 12 0 60 11 15 0 41 0 0 8 23 0 9 24 12 0 0 2 4 54 0 15 0 0 6 0 0 
0 21 0 0 2 7 0 19 0 0 39 2 34 0 9 6 15 0 0 13 0 8 0 1 0 27 7 0 0 0 0 19 0 0 1 0 0 5 0 16 0 15 0 0 0 23 34 0 3 39 0 
18 0 37 0 0 0 37 0 0 0 0 0 4 7 0 0 15 0 3 13 0 0 0 15 0 0 19 8 11 0 0 0 1 0 14 14 3 19 0 31 0 0 4 4 1 0 0 0 11 14 33 
0 63 47 0 0 67 0 2 41 0 0 35 0 4 0 0 22 5 6 0 0 13 7 7 6 41 20 20 2 2 0 0 26 18 0 32 1 2 9 0 0 0 6 0 1 17 18 42 0 52 0 
39 21 18 1 21 48 40 2 0 16 7 0 2 30 33 0 0 23 0 2 40 21 12 3 0 7 8 0 23 0 0 18 27 1 6 0 0 9 26 10 28 7 0 30 19 5 49 0 3 14 5 
10 0 0 63 5 23 7 8 0 8 20 12 0 7 0 8 25 14 3 0 0 0 0 33 0 0 1 17 6 12 0 0 0 6 6 0 11 0 12 0 0 7 8 14 4 0 0 42 12 33 0 
28 7 0 0 2 33 9 53 0 0 0 15 5 25 34 9 0 5 19 0 15 0 0 0 0 15 32 5 28 0 0 0 3 15 0 0 6 22 0 0 33 7 0 0 0 0 11 0 34 16 4 
0 0 12 32 29 18 0 19 12 6 0 4 0 0 9 24 26 0 7 17 12 0 0 4 0 6 0 16 8 10 8 0 0 29 18 32 37 0 12 0 9 0 22 16 0 48 0 0 12 0 9 
0 19 10 3 0 6 20 8 8 0 32 5 17 12 12 0 2 15 14 23 6 29 0 0 8 19 25 0 0 0 7 44 5 0 14 0 0 18 0 29 6 0 0 4 5 12 15 26 0 43 15 
29 34 37 43 13 0 0 58 0 28 0 7 0 28 0 9 1 17 1 7 12 1 0 38 27 0 2 6 0 39 0 0 0 6 0 0 0 24 0 45 0 68 29 0 21 0 43 0 0 17 0 
41 0 37 0 21 51 30 51 50 10 16 9 0 2 0 10 20 0 0 15 2 8 0 0 0 16 0 4 0 0 0 0 23 11 32 25 10 0 0 28 0 5 0 3 32 8 23 0 0 39 9 
12 0 42 0 40 0 0 35 0 0 7 0 0 6 0 4 0 11 23 0 0 4 0 30 0 13 9 0 7 0 0 0 0 2 0 6 0 22 20 11 0 15 0 0 73 0 11 0 66 14 0 
0 0 6 0 0 0 36 27 0 0 0 27 0 0 8 0 0 0 0 0 46 7 0 10 0 0 29 7 8 13 0 0 33 0 27 0 34 0 46 0 5 0 24 4 0 0 0 0 19 0 30 
46 3 19 21 45 0 34 3 9 59 30 59 63 0 11 14 6 84 5 13 4 10 2 13 24 27 4 23 34 23 8 28 8 0 30 21 4 51 7 61 18 35 2 19 6 16 123 0 73 37 11 
0 15 23 21 6 0 0 12 0 0 25 0 50 5 0 1 33 0 0 0 0 0 0 11 20 0 4 0 31 0 4 1 9 0 15 44 9 0 0 0 1 20 11 0 0 0 0 0 0 10 0 
10 0 0 36 0 3 0 23 3 5 0 0 0 10 5 21 0 0 2 0 30 14 13 23 0 7 15 3 0 0 39 1 3 10 1 4 8 2 0 38 7 10 7 0 0 0 0 0 28 7 0 
23 0 0 0 58 34 31 14 10 0 0 0 6 17 0 8 38 38 12 7 4 15 3 4 23 10 4 0 0 27 28 3 26 0 20 12 7 13 26 86 2 7 2 1 27 2 23 0 11 20 34 
36 0 3 0 8 0 0 9 0 2 8 14 0 2 7 9 14 0 8 0 8 0 0 0 3 7 4 4 8 4 0 0 11 0 0 0 0 3 12 39 3 0 0 14 8 0 0 0 0 4 0 
0 56 0 1 9 0 30 17 0 11 0 0 39 1 0 37 42 0 0 0 6 17 0 0 17 12 2 18 4 6 30 1 24 0 8 0 45 20 37 14 28 0 0 28 0 10 0 31 0 3 0 
0 0 47 0 0 8 22 0 52 38 0 0 0 1 32 0 12 0 0 0 0 20 0 0 18 0 10 7 5 0 0 0 12 0 0 0 21 0 19 9 0 4 0 0 9 37 42 47 3 46 9 
31 5 3 0 6 0 0 21 0 0 52 10 0 14 5 1 19 21 25 0 49 0 0 8 14 0 7 32 14 0 10 3 13 0 27 19 0 17 4 0 0 0 1 0 43 2 46 0 15 22 62 
23 17 7 0 44 13 21 11 18 0 0 0 0 0 0 25 19 0 0 0 13 13 1 40 0 3 6 28 11 0 0 0 0 0 3 0 0 21 0 31 36 0 2 0 0 3 0 0 49 3 0 
0 23 5 0 32 0 0 44 26 0 0 15 10 10 0 0 3 16 0 3 14 0 2 10 0 18 7 0 19 0 6 18 0 0 27 6 26 0 0 0 0 6 0 0 0 0 0 0 0 17 0 
40 0 0 0 0 19 0 0 6 34 0 43 0 0 31 32 0 15 32 0 7 0 0 0 5 0 0 0 0 0 0 23 0 41 0 0 21 46 0 25 40 0 12 0 33 0 0 33 31 10 32 
7 70 0 19 0 47 53 7 14 0 0 0 0 34 0 0 0 16 1 0 19 0 0 0 8 1 0 24 0 0 0 4 26 55 0 4 42 0 0 14 0 0 0 7 0 20 0 34 0 0 0 
0 30 6 0 22 2 22 41 21 7 5 0 12 19 0 8 0 21 10 0 12 19 0 2 3 34 34 0 35 1 0 0 0 0 0 0 35 0 0 32 0 0 4 0 8 18 7 40 0 24 0 
0 22 0 0 0 36 0 17 27 2 0 1 0 0 0 15 0 1 0 21 0 0 0 59 4 18 23 8 13 5 26 0 0 0 0 26 1 0 7 0 0 36 3 0 0 7 0 0 31 49 0 
