51 29
5 4 0 18 0 45 0 0 54 0 0 0 24 6 0 31 0 4 42 21 0 0 0 0 0 0 23 16 6 0 14 0 0 0 3 26 0 3 0 0 23 0 0 22 0 0 44 4 0 28 23 
16 19 0 31 24 0 28 8 0 14 53 0 23 0 11 0 16 0 0 0 0 5 12 0 0 1 9 0 0 0 0 6 29 0 71 9 0 0 0 8 0 0 32 0 0 3 0 0 0 0 0 
47 0 0 12 0 0 0 0 29 15 0 0 0 0 19 9 0 0 0 0 0 3 13 0 1 3 0 0 21 0 25 0 6 0 0 19 1 1 6 0 0 0 34 0 0 7 0 59 24 0 12 
27 17 5 0 0 23 38 6 6 25 0 10 4 0 14 0 23 3 18 14 8 0 0 0 0 23 28 3 35 0 0 9 3 0 4 0 0 0 2 1 37 0 10 0 48 24 34 0 23 49 8 
47 29 0 40 81 19 22 23 41 6 12 0 0 0 11 16 22 0 0 0 0 3 0 0 38 14 23 30 18 0 21 30 28 6 0 6 12 12 41 0 36 26 0 0 40 5 18 1 52 5 35 
3 13 2 0 0 0 10 12 0 0 46 0 34 0 1 0 37 0 0 5 0 20 0 23 18 4 26 0 21 16 21 0 0 0 8 3 18 0 0 7 2 21 48 5 0 35 10 11 12 0 24 
0 12 10 22 2 0 30 1 0 3 58 0 44 6 4 7 4 0 0 0 4 0 12 0 0 1 0 0 17 0 2 0 10 0 28 33 30 0 0 11 8 0 4 42 0 0 41 0 9 0 31 
28 7 16 0 16 25 0 1 49 0 0 0 14 11 29 0 8 7 0 0 0 0 0 0 0 0 22 15 38 0 21 4 0 0 8 0 0 0 0 8 19 0 2 14 0 0 10 27 1 0 0 
19 30 2 26 25 51 4 0 1 0 13 0 10 14 16 0 7 0 18 0 0 0 16 0 22 0 23 14 13 0 0 72 1 0 10 15 0 0 0 31 16 0 0 0 0 40 30 0 0 49 0 
0 0 18 2 21 2 0 27 6 33 10 32 0 30 0 27 18 33 0 12 15 4 7 2 5 4 1 0 0 0 0 0 0 1 6 0 60 0 8 1 10 26 12 23 0 8 31 0 5 12 23 
0 0 0 59 0 21 0 2 70 76 0 13 22 1 2 0 4 14 0 11 18 23 0 3 0 1 0 0 2 7 4 0 0 4 5 0 17 0 4 0 0 0 0 0 23 1 37 33 96 5 42 
0 0 1 22 14 4 23 8 8 7 0 10 8 56 7 19 0 0 0 0 28 17 0 10 0 22 2 10 0 5 3 8 0 16 0 0 0 17 12 5 0 0 0 0 31 0 0 0 0 16 0 
0 0 30 0 3 0 0 3 1 28 0 26 9 0 11 0 0 0 0 0 10 0 0 14 0 0 0 0 0 0 16 15 0 0 0 0 0 12 0 0 0 9 0 0 16 14 0 5 0 0 9 
28 33 46 0 0 36 0 0 0 7 7 0 16 0 19 8 14 0 17 0 11 11 8 0 0 0 2 15 49 9 0 0 12 19 13 17 9 3 7 0 0 100 0 0 0 22 0 0 15 0 30 
8 88 0 1 3 48 11 29 7 0 0 16 0 0 0 0 15 3 14 2 0 42 5 18 19 8 6 0 0 0 11 10 13 15 7 32 19 5 0 18 0 18 0 45 4 20 0 3 4 7 53 
42 69 0 0 4 12 15 31 2 27 0 0 21 5 0 8 2 27 22 13 0 2 1 8 0 26 2 9 23 0 10 0 5 10 8 14 12 0 31 47 59 0 2 13 35 44 0 1 0 12 0 
0 34 23 0 6 8 0 0 0 0 23 0 52 6 0 10 2 30 0 6 0 15 6 0 6 64 0 0 14 0 14 0 0 0 29 10 14 0 9 38 28 0 37 0 0 0 20 23 0 2 0 
16 0 0 0 0 12 10 12 0 0 0 0 26 0 15 25 9 0 0 21 0 0 0 0 5 0 0 19 19 8 0 9 7 0 0 15 8 0 0 0 14 32 0 28 3 4 29 0 0 0 0 
0 38 0 0 30 0 44 6 7 1 43 28 27 25 2 23 0 11 0 9 0 18 0 0 14 3 0 12 15 0 11 0 0 0 33 0 6 0 30 52 0 7 3 22 0 57 5 4 0 36 10 
43 16 12 0 11 11 0 0 0 0 17 3 0 35 26 0 0 7 7 32 0 0 0 0 15 0 0 4 0 0 15 26 0 6 34 0 0 5 0 8 0 0 0 0 4 0 1 24 39 56 1 
29 63 0 1 27 6 36 8 0 0 3 31 0 14 36 16 0 0 0 0 16 7 9 0 22 0 0 2 17 9 0 0 0 14 31 0 36 0 27 0 40 0 0 0 38 14 23 17 0 48 0 
31 45 12 21 0 0 33 0 27 3 72 5 37 7 13 13 13 1 8 19 14 0 18 0 0 0 23 48 5 0 20 31 22 0 5 29 3 38 21 21 0 16 41 14 22 16 114 37 0 35 20 
23 39 0 14 6 48 24 4 0 26 0 1 3 1 9 0 11 0 0 27 2 11 0 23 6 0 8 7 22 37 6 0 11 0 0 26 0 0 0 0 0 0 37 0 0 0 27 4 5 7 0 
0 3 16 0 16 40 5 0 0 0 0 30 0 45 0 0 0 0 2 5 28 0 27 0 24 0 0 23 5 0 17 0 0 0 10 0 14 0 0 0 3 21 3 0 10 40 5 4 0 27 67 
10 75 16 0 0 5 10 0 0 0 25 10 2 6 0 0 10 0 16 6 0 0 19 4 0 1 0 4 27 0 5 31 0 0 0 10 0 0 0 0 16 19 0 0 19 8 21 0 0 48 15 
0 6 8 10 24 53 25 22 16 0 5 0 8 0 29 0 0 0 0 2 0 1 0 0 19 0 14 0 25 24 19 26 41 17 11 0 7 0 0 0 37 12 0 36 11 11 0 0 0 0 0 
45 3 55 0 31 17 32 29 19 4 0 11 0 9 31 11 15 9 6 2 9 18 0 0 10 0 0 0 25 6 11 17 11 37 5 45 0 35 0 0 16 36 7 0 31 4 39 12 4 0 0 
0 2 0 3 1 0 4 0 0 18 0 0 11 25 33 0 14 0 0 0 4 2 0 0 26 0 0 23 0 0 14 7 6 9 18 0 0 0 32 0 10 0 0 19 0 31 0 56 5 0 11 
2 0 0 0 45 0 3 11 2 2 3 12 38 0 9 0 15 0 0 0 0 15 0 38 0 22 0 16 6 2 16 12 14 0 0 2 27 2 15 0 55 10 7 13 16 15 0 0 16 17 38 
