51 29
22 0 0 0 8 0 43 0 0 14 0 27 0 0 0 18 0 0 0 0 0 0 3 0 24 17 19 27 8 0 0 0 0 18 0 2 8 2 1 26 0 35 0 0 0 2 0 22 15 62 0 
0 0 0 0 0 14 4 25 0 9 35 0 0 0 0 0 0 0 0 21 0 6 0 12 0 0 12 52 0 0 25 0 33 0 10 0 2 7 0 0 21 0 0 11 3 35 0 0 5 0 0 
58 0 3 12 16 12 0 0 0 0 35 14 0 8 0 0 13 7 0 0 16 8 0 0 7 8 0 0 21 1 27 28 17 0 0 35 10 21 9 0 0 0 15 0 0 7 4 0 0 0 0 
0 13 5 0 28 25 26 13 12 15 11 24 28 24 0 0 0 19 52 11 0 11 11 16 15 0 6 0 2 14 2 23 54 15 0 8 26 35 0 30 4 38 0 22 7 0 0 0 0 13 0 
15 40 0 0 31 3 0 0 18 9 0 69 0 17 0 0 0 10 0 30 1 0 2 25 0 0 33 18 0 0 0 0 0 21 0 0 0 0 14 0 0 2 0 2 45 140 8 18 25 0 0 
1 0 29 21 5 0 13 5 40 0 0 8 22 0 12 28 32 0 15 24 0 10 0 4 0 13 0 0 0 0 8 0 0 0 16 27 0 0 0 9 0 22 0 0 0 0 16 0 50 0 35 
24 18 0 16 39 34 45 26 0 2 0 13 0 33 2 29 11 16 2 10 11 23 3 0 4 7 0 13 3 33 30 31 1 5 17 9 0 0 0 34 32 0 0 0 11 41 7 0 24 0 30 
43 0 0 0 0 0 5 18 11 0 3 18 0 3 55 21 3 7 7 5 0 0 0 0 24 22 0 0 15 16 0 17 0 0 20 12 0 10 0 18 2 0 0 28 0 0 0 4 0 20 17 
4 0 26 1 18 0 0 16 0 0 4 11 6 25 14 2 25 4 17 0 0 0 0 16 0 6 0 0 0 11 26 0 0 0 0 8 9 1 26 0 4 0 0 0 11 10 0 24 2 0 2 
41 16 0 0 21 31 23 10 6 0 1 41 30 6 19 0 39 21 13 36 0 2 0 6 1 28 0 2 0 0 0 8 0 8 29 0 10 31 5 10 19 0 30 10 0 9 59 0 0 49 0 
0 4 0 0 2 0 9 42 0 31 8 10 7 12 0 0 0 0 22 0 0 0 7 0 10 0 13 0 0 10 16 8 0 4 0 0 14 0 0 2 0 8 9 0 7 0 66 0 0 40 17 
0 0 0 26 37 38 3 28 6 8 12 0 9 94 0 0 2 11 0 3 20 50 17 14 4 0 12 28 24 0 23 0 27 7 0 18 8 3 21 0 1 24 0 16 41 39 24 34 0 0 24 
18 11 2 38 39 30 0 10 16 17 10 0 0 0 0 14 0 32 0 4 33 0 0 0 1 0 26 0 13 0 8 0 0 9 25 10 6 7 0 12 5 32 28 52 16 33 0 0 0 32 8 
0 0 0 3 7 0 40 0 35 0 2 1 7 0 4 13 0 2 0 0 0 0 24 28 0 0 23 30 0 0 8 0 7 7 1 1 0 11 0 10 25 14 0 72 0 15 36 0 0 0 4 
6 4 34 0 15 13 0 0 37 14 5 2 23 24 0 1 3 26 0 15 6 0 22 18 7 0 4 0 9 7 4 30 24 56 0 11 62 5 10 35 0 18 6 0 0 9 0 0 41 17 0 
0 0 43 24 0 0 0 3 0 3 9 10 0 0 0 28 13 41 9 0 0 9 0 3 3 6 27 11 0 0 0 0 0 14 6 0 0 0 11 14 37 0 15 28 11 43 21 14 15 0 24 
0 44 7 0 0 23 0 35 0 6 13 7 0 1 17 0 0 6 9 12 23 1 16 13 0 3 7 9 0 5 2 17 22 11 0 13 5 2 16 6 35 0 0 0 24 0 39 2 0 2 0 
20 0 3 1 1 5 0 49 0 0 0 13 29 0 0 0 0 0 0 0 7 22 0 4 8 1 0 4 0 13 0 17 2 13 6 0 0 9 4 14 35 0 21 9 13 38 16 5 0 0 11 
7 0 22 6 20 0 12 5 0 34 0 0 0 0 0 0 27 10 0 0 29 0 29 0 26 13 0 7 0 0 2 0 17 0 0 0 29 15 2 0 2 0 21 2 0 0 24 10 0 1 7 
0 45 0 0 23 0 5 12 0 8 16 38 0 0 0 13 0 0 0 0 0 0 8 0 0 20 19 23 21 13 0 0 31 23 0 12 29 27 5 10 0 0 15 32 4 0 31 1 1 74 23 
45 0 0 0 0 3 29 0 32 9 31 38 36 0 0 0 9 11 44 14 0 1 1 0 7 0 3 19 0 33 17 15 0 16 0 22 0 0 3 0 29 31 37 14 0 85 30 1 32 0 0 
5 15 0 0 2 22 28 13 0 0 34 2 0 110 12 2 15 4 5 0 3 20 0 13 0 15 0 48 0 9 5 0 7 5 62 9 10 0 19 43 0 1 4 0 27 9 50 18 13 0 0 
0 0 31 0 0 11 0 11 0 34 30 0 35 0 18 0 0 6 15 0 0 0 0 0 0 0 0 5 18 11 0 0 33 1 1 0 0 0 3 3 35 0 0 34 26 0 18 24 0 15 0 
17 35 62 12 4 0 44 0 14 0 3 10 22 13 0 9 0 0 0 29 0 12 9 25 3 24 25 10 17 12 0 0 16 13 0 4 0 21 0 13 13 20 0 0 25 9 0 0 32 47 46 
63 18 0 0 33 0 6 21 0 9 15 20 6 0 0 0 4 20 0 15 10 10 9 7 2 10 19 0 27 0 19 17 7 2 0 14 8 53 37 12 0 41 4 56 0 5 0 0 0 0 17 
77 0 0 0 4 34 0 0 8 9 0 35 2 9 3 0 10 10 0 36 0 10 29 22 0 0 4 0 11 0 0 20 9 7 0 4 0 0 34 24 0 0 41 0 25 66 0 12 5 33 34 
47 42 16 8 0 44 8 20 0 23 0 17 9 0 8 0 0 24 14 0 17 0 0 20 0 0 0 0 28 0 16 7 2 0 0 28 0 6 20 4 3 0 11 39 13 1 17 39 0 43 1 
15 0 32 0 4 11 0 27 0 8 0 43 22 0 15 0 0 14 20 31 0 1 7 23 30 11 0 22 0 15 0 27 0 0 59 7 6 10 23 23 0 5 6 5 1 0 45 10 6 0 0 
37 0 0 0 0 2 15 0 22 0 0 0 12 6 0 21 37 0 6 6 0 0 24 18 0 20 23 27 0 4 40 1 0 4 10 0 0 34 0 0 3 15 1 0 16 0 0 0 7 9 0 
