51 29
0 0 17 0 0 0 33 8 5 0 18 0 35 17 17 28 0 16 15 7 0 0 35 0 0 0 4 0 12 0 14 17 0 34 3 0 14 0 16 57 0 0 0 9 22 0 0 35 0 0 0 
0 2 31 102 0 18 20 0 33 21 48 32 4 9 0 0 0 3 0 38 3 0 21 0 15 0 36 0 25 0 26 1 23 45 0 21 0 0 0 17 25 38 53 10 0 37 0 37 2 0 2 
17 86 1 11 19 2 0 32 0 0 0 0 32 26 0 18 7 86 0 0 24 10 0 19 0 22 18 0 0 1 0 6 0 41 26 0 0 0 16 36 30 0 4 0 38 36 25 30 47 0 19 
0 0 1 49 0 0 11 0 4 29 29 3 0 7 3 5 13 5 37 18 7 9 5 0 26 25 24 1 11 5 0 2 2 0 12 7 2 10 13 50 0 3 7 2 2 0 4 0 0 0 5 
46 0 0 40 23 0 0 6 16 29 46 0 5 27 57 0 0 3 0 10 0 0 0 0 6 0 0 0 34 0 2 13 37 0 17 6 0 0 23 0 0 33 0 0 30 13 46 0 0 36 0 
39 34 0 26 20 1 24 36 17 0 20 32 0 9 0 0 0 0 21 20 23 12 18 0 25 0 0 16 0 1 11 0 0 0 0 34 40 6 0 9 0 0 0 48 40 0 0 0 0 13 0 
20 0 22 35 9 8 0 0 3 6 0 26 7 30 0 13 0 0 0 9 0 3 5 0 5 23 4 0 0 0 0 0 0 0 22 0 23 2 4 2 0 3 11 0 41 5 33 0 35 0 13 
0 0 27 0 27 27 27 3 4 29 0 27 12 6 0 0 32 11 6 26 11 11 32 5 5 2 0 5 25 41 3 18 27 6 0 19 0 0 15 0 0 25 0 15 0 26 0 25 0 0 2 
11 43 0 0 0 33 0 23 0 1 1 0 8 10 0 14 0 0 12 7 15 20 14 15 0 15 0 0 0 5 0 4 32 0 47 15 0 15 33 10 4 0 0 0 46 28 14 26 0 0 28 
4 0 32 0 4 17 0 30 22 26 18 3 18 20 95 0 15 6 1 29 0 22 0 0 2 9 0 8 18 0 5 23 7 38 21 34 28 5 10 11 23 35 21 28 10 7 47 10 7 8 33 
20 15 0 45 4 2 0 46 0 15 0 0 1 20 6 24 9 14 1 2 18 52 5 23 29 21 21 4 21 26 0 0 9 15 0 22 0 0 6 18 0 25 11 43 25 2 23 0 0 3 0 
0 12 0 16 0 35 21 0 0 21 0 0 30 9 0 0 0 0 0 40 7 0 0 17 15 0 0 7 16 11 1 12 0 0 0 0 6 0 2 0 59 15 0 23 2 3 3 0 0 1 0 
32 0 29 1 0 0 0 5 0 0 0 0 3 11 24 0 0 0 14 9 0 9 0 5 0 0 0 0 0 0 8 5 3 0 0 0 7 0 0 0 4 9 9 0 1 0 0 0 4 1 0 
0 7 0 11 2 35 0 34 5 0 0 12 10 58 13 10 0 0 6 0 0 11 7 0 23 11 1 0 0 0 0 0 3 12 3 0 2 13 1 1 35 34 0 0 7 0 33 23 0 5 0 
0 4 45 0 30 3 31 0 0 0 0 8 9 3 0 9 0 0 0 5 0 85 1 13 3 0 0 0 0 41 4 1 0 0 12 29 0 0 55 0 2 23 12 13 0 37 3 62 3 17 5 
0 0 0 0 2 0 0 7 0 5 0 0 0 0 0 26 0 28 5 12 0 0 28 29 0 0 0 5 0 4 0 20 0 0 0 0 0 0 0 21 8 24 0 3 18 33 0 0 0 9 28 
1 0 3 16 39 23 37 0 5 29 26 0 4 0 0 0 0 25 30 23 0 6 8 0 8 0 0 0 0 9 0 0 4 1 25 29 25 0 2 7 2 0 17 76 0 2 0 38 9 7 0 
0 0 22 25 0 0 42 0 0 36 0 11 0 0 0 4 0 0 25 6 0 6 0 0 6 0 0 6 0 7 0 13 10 0 14 0 40 34 0 0 22 0 6 0 0 37 0 36 42 0 0 
21 47 27 0 1 0 0 0 0 4 0 8 0 4 49 0 33 7 7 0 29 24 5 0 7 0 0 2 2 0 10 35 14 27 18 0 6 6 0 8 0 0 49 10 24 2 24 8 47 5 19 
87 48 3 15 4 0 7 15 66 0 0 0 0 9 0 10 21 4 25 7 0 2 7 2 0 9 11 0 5 4 6 6 41 0 0 9 28 37 46 0 0 0 16 25 0 0 45 10 3 27 0 
42 0 40 3 17 0 0 18 39 5 0 0 28 0 8 0 0 0 0 0 9 17 0 0 0 18 18 0 1 0 0 35 0 8 11 0 0 1 0 0 21 0 13 0 0 0 0 7 0 0 0 
18 0 35 17 0 0 0 0 41 29 8 3 7 0 9 35 4 24 13 38 7 24 0 5 0 0 17 0 0 0 0 0 13 0 0 0 16 34 43 0 0 0 26 0 0 36 0 31 28 41 23 
45 0 12 18 35 26 0 0 32 22 22 16 0 14 28 0 1 30 13 16 9 34 14 0 4 0 6 14 29 0 4 26 22 9 3 21 27 16 0 35 3 23 12 41 11 45 37 19 0 30 0 
0 0 0 0 31 0 31 11 0 4 0 0 0 6 0 0 0 5 0 6 13 0 18 0 9 35 19 0 16 0 38 0 12 9 0 27 0 28 0 11 10 1 0 0 12 20 0 0 0 0 20 
8 0 0 60 4 0 0 11 0 27 0 10 3 29 0 0 17 11 6 21 7 3 6 0 0 5 17 0 1 27 0 5 0 17 0 0 16 11 17 19 20 0 0 0 41 0 6 0 0 36 0 
33 6 17 30 0 29 11 0 8 0 11 21 14 22 0 0 0 27 0 11 8 0 10 0 0 2 22 1 23 7 0 0 0 14 3 30 20 10 4 0 1 36 0 0 0 0 0 28 0 11 0 
20 13 33 54 24 26 48 0 21 2 0 28 13 0 78 0 34 0 13 0 4 8 0 6 15 27 0 11 0 24 3 28 18 0 0 27 0 9 13 63 20 16 19 29 0 22 9 54 0 45 23 
0 13 1 22 67 1 0 0 0 0 18 1 22 12 0 0 0 0 0 26 0 20 0 25 6 0 0 0 0 13 0 18 10 18 22 12 14 0 0 0 5 2 13 19 0 31 24 0 11 45 0 
0 0 54 0 4 16 0 14 0 27 24 26 8 18 0 0 0 5 0 5 31 45 0 0 18 0 0 0 0 20 9 8 0 8 22 9 42 26 14 3 0 0 26 0 26 43 0 0 0 8 7 
