51 29
25 10 0 9 46 44 23 0 0 0 0 10 44 57 0 0 27 5 0 0 16 0 0 2 10 2 24 2 6 23 0 16 0 7 4 34 4 0 12 0 15 7 37 0 16 0 3 21 15 3 35 
135 39 53 0 46 0 39 0 0 34 0 0 18 0 1 34 31 0 9 0 27 0 37 0 0 23 0 26 0 0 4 19 50 34 12 0 0 0 38 26 25 0 0 77 20 0 31 1 0 9 0 
13 0 28 30 30 21 55 0 16 0 6 0 12 11 5 14 0 12 8 54 0 7 20 0 16 0 15 25 0 19 4 8 13 30 27 16 12 0 33 7 14 0 23 0 21 26 9 8 8 0 3 
53 9 28 0 30 0 19 40 1 4 0 9 24 12 14 0 21 34 0 13 0 3 10 0 3 46 10 19 0 14 28 2 0 33 3 0 0 1 24 0 0 7 1 11 0 0 17 10 1 8 1 
2 0 66 0 0 0 40 6 59 10 0 0 34 0 0 3 7 4 0 28 0 7 23 16 22 4 5 10 13 12 0 18 0 10 2 26 2 37 0 0 0 29 34 50 0 17 19 0 4 18 16 
52 3 4 0 0 25 54 12 1 24 0 0 15 0 0 0 23 31 18 4 0 0 0 38 0 5 11 0 8 2 4 17 0 32 34 0 0 0 0 0 0 0 0 37 0 3 0 0 14 0 41 
0 1 15 0 14 22 20 5 14 34 0 0 28 0 0 10 0 9 14 0 3 0 14 8 14 3 41 6 14 0 0 0 0 12 32 33 2 9 3 3 28 15 0 34 0 0 8 29 0 0 21 
0 2 0 48 21 0 0 0 3 11 0 25 0 0 14 14 36 29 10 27 1 5 0 3 3 11 0 0 2 0 2 7 0 30 0 0 45 20 0 23 0 0 0 0 0 0 0 0 10 0 0 
60 0 0 0 4 20 0 0 19 15 0 36 0 12 22 0 0 0 0 0 1 21 0 3 25 11 0 0 29 19 6 0 0 0 0 3 3 9 38 0 0 0 0 0 44 0 0 44 3 0 0 
20 23 54 17 0 8 11 0 0 19 9 5 4 0 0 0 0 11 0 16 13 0 48 7 0 0 20 0 26 18 25 11 0 0 13 0 14 0 0 6 14 30 0 7 0 26 10 1 0 27 0 
0 5 1 19 0 0 5 36 0 1 34 36 0 0 10 0 27 3 24 29 31 13 30 0 1 15 13 23 8 7 0 0 0 15 24 0 11 0 8 13 5 22 35 27 0 41 4 45 28 1 26 
13 0 1 47 0 9 0 8 0 0 9 23 16 21 25 22 0 22 19 0 0 0 21 0 9 0 5 0 16 0 0 20 17 9 24 3 0 19 11 3 14 11 20 0 0 11 20 14 0 28 43 
2 33 5 30 0 5 0 0 24 0 0 11 0 10 32 0 0 12 0 0 0 28 0 5 1 23 0 6 0 0 0 0 24 0 2 0 7 0 4 0 0 6 0 7 0 3 41 3 0 28 0 
0 14 1 27 0 0 0 8 0 0 14 0 6 0 11 3 0 0 18 0 0 11 10 0 22 11 0 0 3 14 0 28 0 7 0 12 0 0 0 0 0 5 0 0 5 37 9 12 0 2 32 
0 85 0 0 33 0 0 0 13 0 0 24 75 0 7 0 25 26 6 0 29 0 0 8 2 0 0 0 0 0 24 7 0 27 0 19 13 32 0 16 12 0 0 4 0 0 2 14 61 43 11 
0 0 0 0 8 8 0 0 0 18 29 0 7 0 0 0 0 0 17 0 6 11 5 9 0 10 0 0 9 0 3 0 13 0 0 15 26 0 0 3 0 11 3 0 21 3 0 3 0 0 6 
0 0 23 1 13 0 8 0 0 5 13 0 11 2 9 5 13 10 14 0 20 9 0 11 14 6 8 16 18 7 19 0 2 7 22 0 5 0 4 0 13 2 21 19 11 0 0 18 0 0 0 
50 0 0 0 0 6 0 0 27 2 14 28 0 0 0 0 0 29 10 29 42 0 32 8 15 0 0 0 0 34 0 3 0 8 14 29 4 8 15 15 10 8 2 26 31 8 28 0 54 0 2 
15 26 0 0 0 9 10 30 13 11 17 4 0 10 15 2 0 3 28 0 3 19 0 12 0 17 3 39 21 0 2 48 0 0 0 0 0 0 15 3 1 6 0 0 3 9 36 12 10 0 0 
2 0 13 0 0 0 0 1 0 0 29 5 8 0 12 0 0 0 0 8 5 0 20 4 0 16 5 0 0 12 4 12 0 0 0 0 9 0 13 31 3 0 20 29 18 0 0 0 19 0 15 
40 0 39 5 0 12 4 33 0 14 9 0 38 8 23 6 0 16 23 0 0 16 4 23 26 0 0 21 4 0 13 14 15 11 9 0 10 15 0 19 46 74 0 36 1 9 39 0 25 0 23 
0 14 3 33 20 3 19 5 25 0 24 4 12 0 6 52 0 5 8 18 9 4 7 0 0 7 21 0 16 16 0 4 0 0 37 0 34 7 30 2 0 0 0 0 24 17 19 12 0 0 0 
0 30 15 0 15 0 0 0 0 45 22 3 0 36 36 0 0 15 0 45 13 0 0 3 15 0 15 19 0 19 14 30 0 0 1 20 0 11 0 0 0 13 29 0 5 0 1 1 23 30 36 
0 54 19 0 1 8 7 0 0 8 15 0 23 31 0 9 14 13 2 0 30 19 0 0 9 15 0 3 0 0 0 0 0 0 0 0 0 0 17 0 0 0 0 0 21 0 0 55 0 0 30 
28 0 0 25 0 0 20 0 16 9 0 13 0 1 0 8 28 0 17 19 31 6 0 0 16 16 15 0 21 0 12 0 0 13 0 17 0 0 1 4 15 5 0 13 28 0 0 18 0 0 0 
50 30 0 23 27 0 0 15 50 7 32 26 22 0 0 18 20 0 0 22 19 13 8 11 14 18 17 17 12 47 15 48 0 0 53 25 12 5 0 71 14 22 49 9 18 30 15 0 12 0 21 
0 0 14 0 26 0 0 5 12 35 34 3 0 0 0 0 0 52 0 26 0 8 14 0 0 5 0 3 0 0 9 21 0 16 0 0 14 6 0 1 24 0 0 0 96 50 0 0 40 0 0 
25 29 0 41 0 0 0 24 13 0 0 0 16 0 9 16 79 0 0 13 8 0 23 0 13 0 0 0 8 0 0 8 13 0 0 0 19 53 31 26 10 0 0 0 41 2 9 31 13 0 21 
0 13 0 8 63 0 26 0 0 0 0 8 0 22 7 0 21 0 6 0 8 22 5 0 3 12 0 0 27 0 17 0 13 0 0 22 32 23 0 19 3 0 0 10 0 0 24 0 0 24 0 
