51 29
70 42 0 4 12 41 0 75 0 2 28 3 0 4 10 0 0 21 24 31 0 0 0 0 0 18 0 8 18 0 30 0 12 14 0 23 1 16 13 11 0 0 15 36 40 59 44 34 0 27 31 
54 3 0 0 11 34 0 25 3 34 43 15 0 8 10 13 36 0 4 30 32 2 8 3 44 21 22 6 0 14 7 0 41 12 0 45 1 12 0 29 0 0 13 19 0 0 8 42 16 8 21 
0 22 0 0 7 36 16 36 0 0 0 0 49 0 7 0 0 0 0 0 0 0 13 0 15 14 1 32 22 0 10 0 5 2 0 35 4 0 26 32 22 0 0 11 4 0 7 20 0 7 0 
0 0 6 8 3 32 74 18 1 3 6 37 0 0 0 0 0 0 7 33 0 22 0 19 2 49 11 0 0 2 31 6 15 0 8 0 0 34 0 20 10 30 31 15 0 0 0 0 0 43 25 
26 87 30 11 12 11 0 0 0 12 16 0 15 16 1 31 6 0 102 1 17 23 11 0 8 0 66 0 0 26 0 0 2 0 0 20 16 11 26 3 0 0 24 28 0 44 0 51 0 0 0 
5 25 2 11 21 2 6 24 0 0 0 9 23 20 43 39 0 26 39 0 5 9 55 3 1 0 44 5 15 22 19 22 0 0 12 3 30 8 16 12 2 39 0 31 8 23 17 32 34 17 0 
0 0 10 0 0 0 0 5 0 41 2 48 9 0 3 0 0 0 15 10 0 0 0 0 0 0 22 0 0 0 0 0 9 12 0 26 2 47 2 6 3 30 0 0 0 18 0 0 1 0 8 
15 20 6 7 10 2 24 0 0 22 19 0 27 0 30 15 0 18 0 0 0 0 0 3 8 0 0 29 22 0 4 16 1 0 18 13 0 0 13 27 10 0 0 9 9 0 0 0 75 0 0 
24 0 0 15 0 0 0 3 28 0 3 0 0 0 0 3 0 0 0 2 0 4 0 18 22 0 0 28 8 0 0 17 0 0 17 8 24 17 14 0 12 25 0 0 0 5 0 9 11 20 0 
18 1 0 14 37 5 3 6 0 0 2 0 13 6 33 3 0 11 17 0 29 22 5 0 0 7 14 23 14 0 0 0 0 0 20 9 1 0 9 0 35 0 19 30 9 6 0 21 5 23 19 
40 14 0 45 0 9 0 0 0 0 3 1 0 0 32 0 0 0 0 0 9 0 47 2 8 0 15 10 0 0 0 0 0 0 43 5 0 0 0 0 16 21 0 7 3 0 0 0 15 1 1 
12 0 0 26 0 0 0 5 8 15 0 1 1 32 5 15 29 0 0 0 8 15 1 13 3 10 0 5 0 0 0 7 32 0 0 10 0 0 9 1 1 0 0 6 0 61 0 17 0 0 0 
0 0 0 0 0 0 3 14 65 24 6 2 34 0 11 0 0 11 0 16 11 0 3 0 0 15 2 0 0 0 0 34 8 0 27 10 43 30 0 32 0 33 0 11 0 13 20 15 0 0 0 
0 0 6 36 35 22 28 0 92 33 3 0 0 0 37 27 0 7 2 11 0 0 0 0 22 0 0 3 0 0 0 0 14 0 0 0 7 2 30 74 10 0 31 4 8 36 22 41 0 10 0 
14 0 0 0 0 0 7 0 39 0 8 8 31 19 8 12 19 0 0 8 19 20 4 2 0 4 10 7 0 0 0 18 44 0 5 0 0 0 0 0 12 27 13 31 28 0 0 38 22 5 13 
0 0 0 45 28 2 12 6 1 46 0 0 2 0 2 7 0 0 9 0 28 0 34 0 0 9 0 0 12 0 10 0 7 19 41 0 27 9 0 11 28 7 0 0 0 5 1 1 16 6 0 
2 0 0 0 0 14 0 11 0 12 0 0 0 27 10 19 0 0 25 0 0 21 0 13 19 10 2 6 0 14 9 16 9 0 0 4 4 5 0 14 27 24 26 9 9 0 0 7 17 0 0 
0 0 31 0 26 7 21 2 0 15 5 4 0 31 0 8 30 9 11 0 0 0 0 0 10 16 0 10 0 0 47 0 0 31 0 0 0 20 21 9 2 16 0 0 31 27 30 15 0 22 0 
8 59 0 0 1 24 25 16 0 62 0 0 3 0 8 1 12 20 0 0 0 14 21 0 0 0 7 9 6 26 0 0 17 7 0 0 22 45 0 0 0 8 41 0 0 18 5 18 39 43 0 
64 17 2 38 21 0 16 0 39 0 0 0 15 12 47 0 0 0 6 0 5 0 14 8 2 16 0 13 1 0 29 9 0 0 3 14 6 20 26 0 0 37 3 0 5 45 0 37 17 13 0 
13 0 0 0 5 0 0 17 0 4 24 10 0 37 17 0 9 11 10 19 16 0 1 0 2 0 0 23 6 14 23 0 3 0 13 14 13 1 2 0 6 6 0 0 0 17 0 56 17 0 0 
21 0 0 0 36 25 0 0 0 0 31 4 0 0 7 0 0 0 15 0 10 0 0 0 0 0 0 0 0 0 10 0 5 28 0 0 0 0 0 0 36 42 0 0 16 2 0 0 0 0 0 
1 22 0 34 0 5 0 20 0 0 14 3 21 14 4 0 3 0 0 3 8 35 0 0 16 1 28 44 0 0 19 0 0 0 0 0 15 44 0 20 0 14 0 23 0 0 0 0 9 0 0 
14 13 0 21 0 2 0 0 0 0 0 9 25 0 25 0 14 8 7 0 10 0 0 0 0 12 0 12 0 18 2 1 17 0 0 0 19 48 0 0 0 16 0 1 0 3 1 33 0 26 1 
14 0 22 10 9 0 0 0 0 3 15 0 0 1 21 0 0 0 12 0 0 0 53 21 0 3 1 24 0 0 29 0 0 10 0 23 0 2 20 0 0 33 0 11 0 0 0 6 0 27 0 
21 0 22 0 36 7 0 27 0 7 0 8 22 21 0 28 0 12 0 12 0 3 11 24 16 0 23 0 0 12 25 26 22 0 26 35 0 16 0 16 45 18 30 28 0 38 17 25 0 0 24 
0 1 0 19 0 0 14 10 0 0 19 0 58 0 27 0 0 13 22 0 22 1 18 0 23 10 0 13 8 0 20 0 12 0 0 5 14 7 7 8 17 1 30 0 0 0 14 0 0 7 0 
7 52 0 38 0 5 0 15 0 0 0 11 23 37 26 5 0 8 55 0 0 0 0 4 0 7 0 10 0 0 3 0 9 38 12 31 0 0 13 0 44 29 0 0 0 0 0 0 14 9 14 
10 0 28 0 0 0 0 0 0 13 0 0 19 20 7 13 4 3 2 23 15 10 14 4 18 22 22 27 2 4 7 6 0 4 0 0 0 17 0 2 3 0 10 19 31 0 27 7 6 1 0 
