51 29
38 10 0 0 0 54 6 29 9 0 0 15 0 23 0 3 9 0 48 2 25 0 0 24 0 3 21 0 0 0 0 2 7 0 0 0 36 0 0 0 15 1 0 0 68 0 6 16 0 0 0 
0 21 0 4 9 0 8 21 16 0 23 23 0 6 0 0 33 10 0 0 1 0 0 17 23 24 0 0 0 28 19 4 9 25 0 5 10 0 6 0 5 2 9 0 11 0 30 0 13 3 18 
5 36 0 11 11 23 6 30 0 59 25 39 0 25 0 1 10 6 0 31 8 0 0 14 2 5 44 21 0 0 2 11 6 28 0 0 27 31 6 0 0 32 1 0 38 35 0 27 8 0 13 
0 64 2 10 19 0 0 0 0 0 0 10 21 0 0 19 27 0 17 0 16 10 6 17 1 13 0 0 0 0 4 13 0 21 0 33 14 6 0 0 0 4 26 0 0 0 15 0 47 33 14 
26 9 0 60 0 0 0 37 0 0 0 18 0 17 34 33 0 7 0 21 0 24 0 0 1 0 0 0 19 0 13 0 0 8 0 0 0 0 0 5 21 0 39 0 56 33 0 19 1 20 0 
0 0 43 13 0 0 28 0 26 16 0 5 0 10 18 0 3 0 30 7 17 0 0 0 0 16 0 0 18 8 0 0 35 0 26 0 0 0 0 0 22 0 0 0 4 4 0 89 0 43 0 
0 2 0 0 0 0 64 0 51 40 0 0 0 0 0 0 56 13 7 22 0 16 0 0 8 8 0 18 12 0 18 8 0 0 10 29 0 25 13 0 0 0 0 22 0 0 4 39 0 40 42 
3 59 0 12 0 4 0 10 4 27 1 4 38 0 0 0 0 40 20 6 13 0 0 0 0 23 0 0 0 2 33 0 9 16 0 0 27 15 20 11 10 13 0 0 3 0 6 28 24 1 38 
17 16 9 7 2 0 19 7 0 31 17 10 0 9 0 0 2 14 0 10 1 9 16 14 0 0 1 9 19 0 6 13 0 2 0 16 15 14 0 2 0 42 0 12 0 0 7 0 0 18 0 
3 62 0 0 37 25 6 19 7 72 0 3 0 28 12 0 9 0 0 12 6 0 0 0 0 16 39 0 20 4 2 18 4 24 0 0 4 36 0 11 39 71 0 0 0 16 0 0 27 14 27 
0 2 0 0 0 37 4 1 40 19 1 2 0 9 20 0 21 1 0 0 15 5 0 0 15 17 0 11 24 37 16 6 0 25 9 19 0 32 33 0 0 5 26 0 17 0 21 19 8 16 4 
0 37 8 63 0 0 51 0 50 2 1 3 1 22 21 13 27 16 0 0 0 10 0 24 0 0 3 1 0 26 14 1 0 0 0 6 10 16 47 58 64 12 0 16 12 0 8 24 2 1 0 
0 0 30 0 0 0 0 0 0 0 9 12 0 4 16 19 29 5 6 7 11 0 10 0 18 0 16 24 0 18 0 9 46 17 0 0 7 0 0 0 0 30 2 0 6 3 0 0 0 1 6 
35 0 2 59 2 0 0 0 50 32 27 8 0 4 0 0 0 0 8 7 1 0 5 0 4 14 14 0 3 0 10 0 31 8 0 35 0 42 32 0 0 35 0 0 36 0 24 44 2 0 0 
0 1 0 3 0 4 3 0 37 66 4 0 24 2 38 38 0 6 0 2 35 6 0 0 0 0 1 0 8 0 0 14 0 9 25 14 1 7 25 0 0 0 5 0 0 32 1 39 20 14 33 
0 23 0 5 44 18 0 64 43 38 1 0 0 0 0 0 3 16 9 0 0 11 0 7 0 0 0 20 0 0 13 5 13 0 0 0 0 4 0 6 0 39 33 12 0 0 38 0 14 1 42 
34 29 17 0 21 8 51 0 2 37 0 0 11 22 8 4 13 0 2 21 0 9 0 3 0 27 2 0 7 24 40 4 42 1 10 36 16 0 11 2 0 0 10 6 0 39 31 0 0 4 1 
0 5 5 0 9 0 17 31 41 40 5 7 11 5 8 31 1 15 0 25 0 11 4 23 4 0 2 5 0 0 20 9 0 26 0 12 0 12 1 6 10 0 0 6 1 30 7 0 0 7 0 
25 36 5 3 31 42 1 42 12 0 3 0 12 14 2 0 8 7 35 28 2 29 20 0 15 0 16 0 0 25 9 0 0 6 0 35 14 55 0 19 0 0 3 0 38 0 15 28 41 0 29 
26 0 45 52 0 1 35 33 4 0 9 37 17 17 0 0 18 0 44 0 27 5 6 1 0 12 14 15 14 29 34 0 0 6 7 16 1 0 0 0 47 41 36 40 0 68 17 77 14 20 15 
0 26 21 7 0 15 55 0 0 20 41 28 33 18 0 34 0 21 0 0 11 0 0 4 19 0 12 14 21 29 0 6 24 6 14 0 25 27 0 17 55 8 0 0 0 42 47 0 3 27 23 
0 7 3 43 32 8 4 35 41 6 9 0 0 0 0 0 13 0 1 53 19 0 20 0 5 0 21 0 5 13 17 0 2 8 0 0 32 11 11 22 0 14 66 0 0 5 0 21 0 34 22 
27 14 0 26 50 0 11 38 10 0 0 0 12 34 0 15 0 2 15 18 19 20 0 0 0 0 3 0 0 38 0 18 15 0 4 13 0 20 34 0 0 1 35 0 0 18 3 23 13 0 0 
1 0 12 46 0 0 0 0 7 41 0 0 27 0 0 0 0 0 21 1 1 13 0 0 0 0 0 14 18 0 14 3 0 9 0 0 0 0 0 50 0 26 1 0 19 0 0 0 0 25 55 
1 49 0 0 0 0 18 0 7 35 0 29 1 0 0 7 11 2 6 0 0 0 23 7 0 0 0 11 0 20 7 24 19 6 0 0 0 0 0 1 5 8 1 0 22 0 0 0 0 24 49 
25 44 0 21 3 80 23 0 0 4 26 0 0 13 2 3 18 12 33 9 0 21 0 0 15 24 16 0 9 4 0 8 11 0 2 0 6 0 29 8 2 0 2 0 0 39 37 2 33 4 45 
10 0 22 0 0 0 0 0 36 0 0 1 46 0 33 14 0 17 2 0 9 0 0 11 17 0 0 0 0 29 0 5 20 25 27 14 0 12 0 0 6 0 14 0 21 0 0 37 0 53 0 
23 0 0 0 17 0 0 18 29 9 0 0 0 25 0 22 0 0 9 0 3 13 0 10 15 0 15 0 0 0 18 17 0 0 0 0 0 92 1 0 0 28 0 0 0 8 0 0 26 0 0 
19 25 47 0 2 28 12 21 34 12 9 0 0 29 3 0 18 28 5 22 14 15 4 2 0 2 47 16 13 12 20 5 0 0 3 0 18 0 3 0 0 1 42 19 6 3 10 45 0 0 32 
