51 29
33 0 0 11 0 44 38 0 0 0 0 0 0 19 16 22 10 0 26 0 0 0 27 32 17 26 0 39 28 0 20 0 24 13 0 0 14 0 0 8 0 48 0 21 17 0 0 12 7 44 16 
0 39 6 45 0 15 8 0 0 0 37 0 0 18 0 29 0 0 0 0 0 14 0 1 0 45 0 0 0 2 0 43 13 0 24 2 2 1 3 0 39 9 18 4 26 20 0 0 17 0 0 
3 0 42 19 0 0 0 46 0 1 5 34 11 6 0 19 0 0 24 0 9 0 10 0 0 0 22 38 0 0 0 9 0 38 43 8 27 0 0 5 0 7 0 8 42 34 0 9 23 22 7 
31 10 28 0 3 14 0 3 19 34 19 33 12 16 40 20 34 17 21 0 15 0 0 0 18 10 0 6 0 24 28 25 0 12 17 11 0 8 9 0 0 4 18 0 2 8 34 0 1 35 18 
53 55 0 0 16 12 16 0 9 17 26 14 13 0 0 13 19 47 17 12 16 1 24 0 8 27 14 0 0 11 0 7 29 0 2 7 100 9 7 7 9 21 0 0 0 1 20 25 0 28 2 
24 0 62 0 5 0 31 2 26 15 30 0 20 0 5 15 42 0 0 16 14 14 15 0 0 17 0 27 15 18 13 22 10 19 58 10 0 22 33 0 30 4 17 62 7 15 1 0 28 9 43 
24 0 42 41 0 39 18 19 15 0 1 27 0 0 29 4 11 21 0 12 4 4 1 0 18 16 9 11 0 3 3 3 0 0 0 8 0 0 37 14 0 0 5 0 33 4 0 42 9 10 0 
0 4 17 0 2 0 15 40 18 22 38 0 14 4 0 0 2 3 17 2 2 19 1 0 0 6 3 10 0 7 19 0 11 10 0 14 0 29 2 56 0 9 35 0 3 0 0 12 7 19 55 
8 0 30 31 43 0 10 9 0 0 40 29 0 26 0 0 0 32 42 16 8 2 0 0 0 0 0 0 13 5 19 13 21 0 12 15 2 0 11 62 19 7 0 0 13 5 12 45 31 11 59 
0 0 0 28 0 5 11 15 0 1 1 39 0 32 0 11 0 11 0 0 29 0 23 0 0 18 2 0 0 6 0 28 0 0 0 0 0 0 0 0 0 4 0 0 0 50 0 17 13 29 43 
0 40 29 17 6 0 30 38 30 0 6 27 0 0 0 25 18 0 0 19 13 8 14 10 0 25 0 6 14 0 0 0 9 0 0 10 9 13 12 1 0 9 3 0 10 47 0 22 49 10 9 
10 26 0 2 0 40 32 36 20 0 5 8 0 4 1 1 9 0 0 0 13 0 0 0 0 7 12 0 0 2 0 5 0 1 8 0 0 0 19 64 0 7 48 0 0 37 3 0 15 1 0 
23 0 0 0 0 0 2 5 0 34 0 0 34 39 0 32 0 5 0 0 3 0 7 34 0 0 8 12 0 7 0 0 0 6 8 15 17 0 0 0 27 0 0 34 0 0 0 0 0 1 3 
7 3 6 34 3 42 3 11 0 23 5 0 23 0 0 34 0 0 0 5 0 0 0 0 12 16 0 20 0 0 0 0 27 7 0 3 4 0 0 0 0 16 3 0 0 0 0 13 0 41 0 
0 5 4 0 0 60 100 2 6 4 0 8 0 14 13 0 0 3 0 0 0 12 0 22 0 6 0 0 22 5 19 2 0 0 0 12 30 3 0 0 3 0 0 0 48 0 42 12 0 10 0 
16 0 26 34 0 10 10 2 9 0 8 11 9 0 0 23 11 19 18 0 0 9 0 0 5 0 0 0 0 9 0 9 0 20 13 10 13 13 22 0 2 0 0 0 0 4 1 7 0 0 0 
41 6 4 27 69 5 13 0 17 24 11 1 37 34 51 10 15 7 24 19 13 28 0 6 0 19 0 10 0 0 27 4 18 30 34 9 11 10 0 0 1 34 25 0 35 0 42 25 0 81 20 
38 24 0 0 31 14 0 34 0 28 0 31 11 0 13 20 0 2 1 0 0 0 8 25 8 0 0 18 0 4 0 17 41 3 10 37 51 0 4 0 6 30 10 12 11 0 15 11 34 0 0 
0 0 0 0 0 16 17 31 47 39 4 49 15 2 21 5 0 0 0 71 0 0 0 10 0 7 0 2 0 10 0 0 0 7 0 0 10 0 31 32 1 0 0 1 0 0 27 0 13 1 38 
6 0 0 37 26 1 1 4 24 0 0 5 21 0 0 15 0 16 6 0 0 0 0 5 0 0 0 0 0 0 2 28 10 45 4 12 7 0 8 0 10 7 18 0 0 38 0 0 0 0 40 
0 6 4 12 0 41 15 69 10 0 2 3 0 2 2 10 0 0 0 7 0 11 0 20 4 4 0 2 4 0 15 0 9 0 15 0 1 1 0 39 26 34 4 0 0 0 41 11 27 15 0 
7 0 0 0 0 0 1 7 5 33 11 0 14 0 7 18 0 0 33 16 0 3 0 0 0 20 0 0 13 0 0 0 0 0 16 4 0 0 3 0 0 0 19 0 0 11 0 0 0 0 0 
47 0 16 0 19 3 9 0 10 0 16 5 0 26 47 14 26 0 0 27 37 0 0 39 0 0 5 10 0 0 0 4 0 13 3 15 21 0 0 52 4 6 4 20 4 0 13 47 13 0 21 
13 28 0 60 4 53 0 0 0 0 0 33 9 8 23 14 0 7 0 0 0 18 22 0 24 0 0 0 30 4 2 0 19 4 31 9 0 11 33 34 0 0 4 40 35 13 16 46 0 0 0 
0 0 0 0 0 6 0 0 21 10 7 0 0 2 0 0 3 7 21 0 0 0 0 10 0 0 2 19 0 19 0 0 0 0 0 5 0 1 3 0 0 24 0 0 10 0 30 8 0 0 0 
36 0 0 0 0 36 0 0 39 36 0 0 28 5 31 0 34 0 8 8 7 2 0 0 0 25 0 38 0 24 0 10 0 23 0 6 33 0 20 0 35 38 4 0 2 69 0 0 0 24 17 
0 40 21 0 0 22 1 0 29 0 16 13 0 2 8 5 21 0 30 0 21 23 0 4 20 0 16 22 0 31 0 23 31 0 0 18 0 8 0 0 6 0 16 25 3 0 5 0 35 0 6 
40 28 1 0 0 21 0 0 35 0 37 0 0 0 13 0 9 0 11 37 0 28 0 0 19 73 0 27 0 36 22 29 1 4 0 15 7 1 3 0 40 3 0 19 15 9 21 37 0 2 0 
0 0 14 0 0 14 21 0 54 26 0 54 0 14 9 0 23 0 0 19 9 0 0 5 0 17 0 0 0 9 28 14 24 0 16 12 13 14 14 0 0 30 0 0 0 37 0 12 12 0 16 
