51 29
0 0 17 2 18 22 38 0 4 0 13 0 4 0 0 0 21 0 0 17 13 0 9 0 18 10 0 0 15 0 0 0 7 58 0 13 34 21 0 11 0 0 7 0 38 0 0 16 10 8 3 
0 0 12 0 19 0 16 6 25 29 0 0 39 44 0 0 20 18 10 15 19 10 14 7 11 28 0 10 0 22 0 0 11 2 0 40 14 22 3 31 0 0 0 30 0 0 0 0 15 43 0 
123 6 0 40 0 0 34 0 35 19 11 0 10 0 0 0 0 30 0 26 19 11 13 19 0 0 0 0 13 0 16 13 24 0 34 0 0 7 11 1 39 0 0 75 0 42 0 19 8 38 0 
10 0 33 0 0 0 9 24 0 0 0 0 37 25 0 13 9 15 4 0 8 0 0 0 15 7 4 0 4 0 20 0 6 3 10 13 0 0 25 11 9 0 16 0 0 0 0 13 0 37 0 
0 5 64 0 0 5 4 1 20 24 19 28 33 1 4 48 0 12 22 5 3 0 0 40 3 0 0 0 4 23 0 16 0 9 1 1 0 24 0 15 0 0 0 0 0 14 16 65 46 26 0 
0 3 18 0 27 0 0 16 20 18 0 7 14 9 23 18 0 0 12 6 19 0 0 6 19 0 3 0 41 0 6 1 33 0 12 28 8 0 0 1 4 26 17 36 41 0 0 24 31 0 11 
47 21 0 0 0 43 0 0 0 1 0 0 0 31 30 0 20 0 0 0 7 0 20 0 5 0 23 0 21 7 1 0 0 0 0 28 27 24 1 25 0 0 13 0 0 16 0 33 36 23 0 
7 32 8 43 0 57 7 7 4 6 15 0 34 0 8 8 11 7 0 21 10 0 0 0 5 1 7 0 0 5 8 15 7 60 0 0 0 9 1 0 12 14 8 0 4 1 42 39 1 0 3 
0 0 0 0 34 0 0 0 0 29 5 9 13 0 0 5 7 20 1 12 0 6 0 12 9 3 3 6 17 5 1 6 8 9 30 10 17 7 36 0 28 8 25 0 0 9 0 29 0 38 31 
0 0 13 25 0 29 33 0 22 0 0 32 1 25 0 15 1 0 15 19 14 19 9 0 0 9 0 35 0 0 22 5 0 0 18 11 0 3 24 45 3 21 7 5 0 16 6 0 0 17 0 
0 0 0 19 24 1 0 0 0 8 1 1 51 0 2 5 0 8 0 0 25 23 19 9 15 0 0 1 36 0 2 0 0 0 0 0 6 0 0 0 0 14 10 16 9 4 0 7 54 0 0 
0 16 0 34 25 16 36 0 4 42 15 0 2 6 4 38 2 23 2 37 8 16 18 2 20 10 14 4 0 0 0 19 14 32 0 27 0 56 16 6 0 12 30 11 1 11 2 40 0 40 27 
0 0 0 0 0 19 7 0 38 15 30 33 10 0 28 24 20 33 11 23 0 0 1 0 11 0 0 16 0 13 13 14 14 9 8 40 0 0 10 24 35 27 23 2 69 5 16 0 1 0 16 
4 14 12 37 19 0 43 5 12 0 13 36 22 1 24 1 0 27 0 0 12 4 15 28 13 0 0 0 14 8 1 8 0 0 34 11 0 0 7 4 26 29 8 22 10 0 78 16 46 43 13 
34 0 3 0 6 0 7 0 14 0 14 0 0 0 3 0 0 0 3 0 3 17 32 17 11 6 0 0 11 1 1 32 0 0 14 0 0 1 0 5 0 4 8 0 0 0 0 0 27 0 8 
0 0 4 16 0 3 0 17 38 11 0 0 0 0 0 13 22 13 0 0 41 0 18 15 0 9 0 2 2 0 0 28 0 0 0 9 11 7 16 0 7 0 39 0 0 0 6 0 26 0 30 
0 0 9 38 0 0 14 5 0 29 14 49 19 9 9 0 0 7 0 2 22 0 14 0 33 15 5 0 0 21 0 5 0 0 0 12 6 0 29 0 9 56 23 0 9 0 35 13 0 46 32 
0 0 13 0 76 0 0 0 0 0 29 0 31 29 0 0 0 0 18 0 14 16 4 0 1 0 6 0 18 0 0 0 18 0 3 31 0 0 0 33 18 0 17 45 0 9 33 7 5 47 5 
0 0 0 3 10 3 0 0 0 14 0 1 0 1 0 4 0 0 24 0 0 5 0 0 29 16 8 5 0 0 16 10 0 7 1 7 12 0 0 17 0 4 24 0 0 2 0 0 0 0 1 
0 0 88 37 31 35 1 0 41 28 3 0 30 33 0 18 0 24 12 10 1 22 0 4 14 0 11 14 8 0 12 0 8 0 0 7 0 24 14 0 7 0 46 19 0 0 0 28 0 104 1 
7 0 0 0 0 17 1 0 19 0 31 0 38 0 26 1 8 18 0 0 0 0 2 0 9 0 0 19 0 0 0 6 0 28 8 41 0 25 19 8 1 31 0 0 3 0 8 14 2 0 18 
0 0 0 0 0 9 10 7 25 20 0 3 21 5 12 41 34 0 15 0 12 0 0 26 17 0 21 6 0 20 0 0 17 54 0 30 8 0 0 0 6 3 8 0 11 0 0 19 8 31 0 
0 49 10 0 19 32 16 0 7 0 39 20 1 1 0 3 14 0 13 31 0 0 23 45 19 5 0 9 0 0 5 13 17 3 0 0 6 21 0 10 0 2 0 2 0 12 0 0 23 43 79 
0 0 25 0 0 3 4 20 0 18 39 3 29 18 6 10 0 0 11 25 2 8 4 1 0 3 0 26 10 27 25 22 2 19 0 7 0 15 0 0 10 22 0 0 41 5 0 0 0 39 6 
11 0 0 10 17 0 28 9 61 4 2 0 4 67 0 11 0 0 9 0 0 0 0 9 7 37 13 0 10 0 10 0 24 22 33 7 0 40 0 0 3 1 14 3 38 0 0 22 0 0 4 
0 0 38 53 24 0 22 0 23 21 2 0 0 0 15 2 0 0 13 13 0 0 27 10 11 0 4 24 5 0 4 20 18 17 0 0 0 1 2 0 36 0 0 0 0 16 0 0 0 27 0 
42 25 11 0 7 0 4 0 47 25 38 29 0 15 24 0 25 0 22 12 0 28 0 25 16 0 46 16 15 0 19 45 27 0 25 6 23 0 24 31 0 5 42 0 5 0 9 26 13 55 45 
57 4 0 0 0 0 0 0 0 25 26 0 23 0 0 39 0 0 0 19 0 30 0 0 0 0 0 0 0 0 9 0 17 27 0 22 0 0 44 0 6 4 0 0 0 11 0 23 0 0 9 
42 11 0 0 0 21 25 0 14 1 27 19 19 12 17 19 0 0 0 6 9 26 0 13 8 6 0 14 7 0 0 39 0 0 18 0 0 0 0 17 16 0 39 18 31 0 0 0 14 0 0 
