51 29
49 5 0 27 46 0 0 31 20 41 18 39 0 0 9 0 5 37 0 65 0 11 0 0 0 7 0 5 21 7 26 0 12 0 25 6 26 0 0 14 24 20 0 0 0 0 0 0 29 16 121 
0 7 0 0 0 20 0 0 43 0 0 0 0 3 0 15 0 16 1 0 31 0 13 0 18 0 0 0 0 16 26 0 0 8 1 11 3 0 0 3 27 0 1 14 12 17 0 64 0 1 27 
34 0 25 24 35 1 6 0 4 0 0 0 0 9 0 9 0 31 1 25 0 0 29 0 9 20 0 58 0 0 1 47 0 9 37 31 0 0 0 0 0 8 2 0 29 0 36 0 28 32 0 
6 35 45 73 55 9 22 6 56 0 39 0 2 3 14 12 16 1 0 18 30 0 3 6 27 29 7 11 22 18 35 48 16 53 24 0 23 15 0 12 79 0 0 52 19 37 43 21 0 0 3 
0 25 25 10 5 0 0 0 27 1 37 0 0 0 0 30 15 20 0 0 0 0 0 8 0 0 0 26 1 0 0 4 0 0 14 13 10 0 30 0 5 0 17 0 0 0 10 37 0 15 0 
10 11 22 27 56 0 0 0 0 21 32 0 2 7 4 50 0 0 5 0 51 5 0 22 26 0 0 5 14 0 27 27 6 5 14 0 26 0 0 0 0 0 0 0 0 6 0 0 0 45 28 
0 49 0 0 1 0 33 0 0 0 10 17 0 29 14 66 0 30 0 0 6 6 43 0 12 24 9 0 0 3 8 13 0 0 0 9 0 0 0 30 1 0 0 0 13 47 0 2 18 43 77 
0 21 0 47 0 0 20 11 3 0 0 33 1 0 28 0 35 0 0 52 18 0 2 7 18 0 0 14 9 7 0 15 0 16 0 13 0 0 19 28 0 13 47 11 0 0 0 0 0 59 19 
14 0 0 6 16 0 0 0 56 6 7 17 0 8 10 16 7 0 5 23 21 7 0 24 0 26 0 0 3 2 10 16 2 0 0 2 0 12 13 4 0 16 4 0 0 34 14 45 3 0 0 
0 0 44 0 0 0 0 0 0 0 0 0 0 0 47 2 58 7 7 0 6 0 18 0 6 9 0 3 0 0 9 0 0 0 0 9 0 0 4 14 18 25 0 0 9 0 44 0 0 33 0 
0 0 7 0 21 0 7 49 21 2 0 0 3 9 3 18 0 8 9 0 12 0 18 0 30 17 25 0 0 1 0 0 2 13 0 0 0 13 0 0 14 8 17 0 0 0 8 0 0 42 0 
10 5 0 39 1 28 0 0 8 17 0 11 4 34 29 5 18 0 14 10 2 25 17 12 0 15 9 9 28 6 8 0 35 0 0 0 22 6 8 17 6 1 11 21 12 1 25 0 0 0 15 
0 0 0 0 29 16 0 0 0 31 0 12 7 0 20 18 2 27 16 25 0 0 9 21 0 14 14 0 0 18 0 48 0 5 12 1 0 8 0 0 1 6 1 26 8 0 0 16 0 0 43 
48 0 0 0 12 23 24 1 0 15 0 7 10 0 24 27 0 0 0 13 15 0 2 0 14 0 0 0 0 18 0 10 0 11 0 26 0 0 4 0 0 1 1 38 30 27 0 0 48 0 41 
38 0 11 58 6 0 5 0 0 0 0 2 0 11 2 2 3 16 0 2 67 0 0 7 0 21 0 0 0 0 11 0 14 48 0 10 0 9 38 4 4 49 10 0 14 25 30 6 0 10 0 
0 18 0 2 8 44 30 2 11 0 7 31 15 15 2 0 0 24 0 11 0 9 41 0 23 0 9 35 15 0 0 11 0 3 0 0 1 3 0 0 1 24 34 14 34 9 0 0 26 37 14 
16 49 19 13 9 14 12 0 40 0 21 49 30 68 34 7 1 90 4 1 3 19 31 10 0 10 0 13 6 6 9 39 0 32 33 28 22 0 8 11 5 28 25 23 27 18 26 11 31 68 10 
11 3 0 2 32 15 24 0 0 3 0 4 9 9 5 0 0 2 28 6 14 17 0 21 0 0 0 0 0 16 0 27 0 16 0 0 15 7 6 5 0 0 3 0 26 0 28 0 0 0 0 
34 10 25 0 0 0 0 5 41 0 0 10 0 14 18 0 0 11 3 5 5 17 0 10 12 3 0 39 0 44 16 18 14 0 29 28 36 15 57 0 0 30 0 0 0 3 16 0 41 0 0 
15 0 0 0 2 0 0 0 0 0 0 0 0 0 18 13 0 20 0 19 29 7 27 20 18 0 0 0 0 0 0 23 5 5 28 1 0 15 2 0 26 0 0 0 0 0 17 0 0 4 12 
22 25 0 18 10 0 0 7 23 40 2 27 2 0 14 15 0 20 0 0 3 53 0 0 0 5 9 0 9 7 27 3 11 0 0 7 0 15 0 0 0 33 3 0 0 24 0 0 0 40 0 
10 1 0 44 16 20 19 0 27 19 53 0 6 6 12 12 31 9 6 5 11 0 0 0 19 14 21 12 9 2 0 2 19 0 0 5 0 25 0 0 0 32 6 24 0 15 0 102 0 39 0 
14 27 0 0 18 11 0 2 39 0 0 0 30 1 0 0 0 13 0 25 21 0 0 5 0 18 0 15 27 0 0 0 0 0 2 0 0 0 2 0 0 9 0 35 3 0 48 0 0 0 11 
20 0 5 0 17 0 6 15 30 0 3 5 0 1 19 1 0 23 0 8 7 0 21 12 2 0 22 13 18 0 13 0 0 32 0 27 26 0 0 29 13 15 0 0 0 25 0 3 0 0 36 
3 29 16 0 14 0 0 2 3 8 0 34 0 0 31 7 0 0 14 0 10 15 0 9 0 10 12 4 6 0 0 22 0 25 19 0 0 5 42 9 26 0 36 0 0 25 0 0 37 3 8 
27 17 0 11 18 14 0 33 17 4 0 21 0 0 11 19 3 0 10 8 22 17 18 3 25 20 0 10 0 5 9 6 27 13 0 0 0 4 17 34 33 9 30 18 20 11 1 0 0 9 19 
50 45 27 0 18 33 13 24 0 18 0 3 22 18 71 22 0 22 0 31 12 46 15 20 0 15 14 15 14 0 24 42 14 2 0 0 23 23 41 18 31 41 2 45 0 26 24 0 8 0 0 
44 16 0 14 0 0 2 0 24 0 30 0 6 21 18 0 0 23 0 0 20 7 21 0 33 0 0 0 22 0 0 0 0 0 0 7 0 0 0 0 4 41 0 0 4 0 0 37 0 25 0 
28 125 0 0 15 0 17 0 14 19 0 28 10 0 29 0 15 0 31 0 0 24 22 7 26 0 41 21 0 17 2 27 0 0 16 27 0 0 10 17 0 6 38 29 39 43 0 0 20 37 1 
