51 29
0 1 30 53 0 40 0 0 22 32 30 19 10 24 0 0 0 0 0 23 0 0 16 0 2 22 0 5 1 0 19 18 0 14 0 15 12 35 51 0 54 0 0 6 0 62 38 22 15 18 13 
0 0 1 115 37 1 2 0 0 12 6 0 0 4 9 0 12 9 20 0 0 0 0 14 16 24 35 13 2 6 0 0 9 0 0 17 33 1 4 50 0 38 13 5 35 1 43 9 0 11 0 
0 0 0 0 14 0 0 11 0 17 24 0 25 0 29 0 2 6 24 5 7 0 31 20 2 8 0 2 7 0 0 17 20 0 0 7 0 10 0 9 47 0 0 0 0 0 0 0 2 9 28 
28 0 0 0 0 25 82 10 24 3 0 1 7 0 0 43 2 16 9 0 9 0 0 0 2 0 24 0 31 23 52 41 24 3 0 0 5 0 3 0 0 0 11 28 0 0 8 0 0 34 0 
0 0 0 0 53 0 0 0 39 14 0 0 0 0 0 18 21 0 0 30 14 0 22 0 0 9 0 22 0 0 0 0 0 0 0 0 0 25 1 0 6 0 5 0 0 41 0 50 0 52 0 
0 0 41 0 25 9 23 0 6 35 31 48 79 7 35 7 33 19 2 31 9 22 2 7 4 23 0 0 0 45 6 23 0 0 11 4 19 7 28 4 26 0 0 19 4 33 0 32 23 18 70 
0 0 9 35 51 0 0 0 1 14 38 21 14 0 2 0 0 13 0 0 22 7 33 0 0 0 5 6 0 0 0 0 1 1 14 29 0 6 35 1 0 0 42 6 0 5 0 0 58 0 1 
0 17 0 10 0 0 6 0 21 5 6 3 14 10 5 0 0 0 8 14 19 0 14 6 0 0 0 7 0 0 8 23 19 0 0 0 2 8 7 0 0 4 12 0 3 1 0 27 0 0 1 
23 0 40 30 0 1 6 0 0 2 0 26 3 27 20 0 0 0 19 4 20 0 0 0 18 0 0 9 0 12 27 0 1 3 20 0 0 26 2 0 0 4 58 0 0 4 0 0 0 7 0 
0 0 0 0 7 2 0 0 1 0 0 17 0 5 55 8 3 12 12 0 67 0 0 8 0 9 0 5 15 0 0 1 6 0 14 6 14 19 1 25 18 0 0 0 30 0 10 2 3 2 47 
10 11 25 51 2 0 16 0 6 21 27 1 17 0 3 0 11 10 6 27 0 0 22 3 0 0 0 14 0 13 21 0 9 0 0 6 30 27 0 33 40 6 0 0 0 0 0 4 0 10 0 
0 0 38 4 0 16 40 25 61 0 3 12 9 9 0 0 0 0 9 0 0 16 22 25 0 0 0 18 1 0 0 0 14 0 26 0 0 0 15 6 53 23 35 35 43 1 40 13 0 3 0 
23 52 18 39 0 0 12 0 0 0 0 10 6 0 3 4 0 17 7 5 18 12 0 0 17 12 11 0 0 28 12 11 5 2 5 27 0 12 11 30 19 21 5 7 0 12 0 3 12 24 0 
2 46 13 0 15 0 0 52 4 1 66 25 0 20 21 23 6 0 0 18 6 59 6 24 0 23 9 6 0 0 20 0 0 45 34 21 36 9 71 1 4 0 0 10 1 24 0 18 11 91 1 
0 20 15 4 20 15 31 9 0 0 0 9 0 8 0 0 9 15 20 1 29 35 0 0 7 0 0 8 7 11 12 1 12 17 12 0 0 31 7 0 4 7 11 0 0 13 5 0 28 0 17 
11 0 41 38 11 5 0 0 5 0 0 0 21 0 0 13 0 0 15 9 23 0 24 14 0 0 13 0 0 0 24 0 0 21 0 49 0 0 0 3 0 0 12 41 2 15 24 11 0 0 8 
0 0 0 45 26 0 0 10 0 6 69 0 0 0 10 6 22 28 2 1 1 0 0 12 19 23 3 10 0 11 0 19 0 6 11 0 0 9 22 0 4 32 41 19 27 16 4 37 22 0 11 
0 0 0 0 0 35 13 0 0 15 0 0 12 1 0 22 1 0 28 13 5 0 0 0 0 3 0 17 3 1 3 0 1 4 15 0 0 0 5 17 35 6 0 0 0 0 32 0 0 15 4 
0 83 1 18 66 31 16 24 16 45 32 15 13 1 0 31 31 0 11 10 24 0 19 0 91 31 19 2 27 11 19 0 7 0 30 0 33 0 33 7 71 0 38 0 43 0 21 8 24 48 26 
0 0 18 4 0 5 0 17 0 5 2 0 17 20 20 2 0 16 8 0 32 29 12 16 0 0 17 31 13 17 0 0 0 22 0 2 0 10 0 17 8 0 0 10 0 0 21 0 21 19 29 
0 0 0 30 0 0 6 1 0 20 0 0 6 9 0 19 0 0 20 0 6 0 0 0 0 17 0 10 1 0 7 15 2 18 19 0 0 7 19 12 0 0 4 0 0 0 15 15 0 10 25 
0 3 12 42 17 6 0 93 0 53 8 0 21 37 27 6 12 17 15 52 5 17 12 0 0 22 0 24 0 0 0 14 0 0 15 4 7 28 1 32 0 34 0 0 6 4 1 72 9 30 37 
0 85 0 0 0 0 0 0 0 22 0 0 0 25 0 11 12 0 14 7 11 0 0 0 6 0 0 0 12 6 22 22 14 0 2 15 4 9 25 0 39 6 0 0 1 0 2 52 9 20 18 
0 11 0 0 0 5 0 0 0 17 23 0 33 0 22 7 13 0 22 0 11 13 5 26 0 1 0 11 13 30 1 12 4 0 13 13 0 55 0 0 20 9 0 4 0 19 0 4 12 27 8 
14 18 0 0 1 23 43 0 36 23 4 0 10 0 0 0 0 0 0 27 54 24 15 0 0 3 0 0 24 8 9 0 0 0 0 0 0 17 0 0 0 8 0 7 49 62 26 0 0 0 29 
0 0 0 5 1 0 3 0 30 0 4 26 7 0 19 0 0 3 10 18 0 0 40 0 0 14 11 0 7 5 0 0 18 0 15 0 17 5 17 11 0 0 0 21 0 5 38 15 25 35 18 
32 3 0 21 9 16 0 39 23 20 20 17 0 30 27 0 8 0 0 7 12 19 8 24 56 18 16 28 1 24 11 34 19 0 4 0 0 11 29 25 53 1 57 61 4 18 74 62 13 38 17 
0 43 56 29 0 16 9 0 0 35 67 0 0 35 53 9 0 10 2 17 29 4 0 0 0 0 1 14 0 1 35 0 4 0 1 0 0 10 0 26 19 39 46 25 24 35 0 25 35 34 36 
18 10 32 0 0 25 44 0 17 16 0 0 0 0 16 10 0 48 0 28 0 0 0 9 0 6 14 6 20 2 44 23 0 15 17 0 35 0 0 18 23 2 0 0 21 0 0 0 0 18 0 
