51 29
0 15 0 0 41 0 0 43 0 0 0 0 14 7 0 14 18 2 0 0 8 8 5 11 2 14 14 3 19 8 9 0 23 0 0 32 16 5 11 4 21 26 0 0 0 41 26 20 0 0 11 
25 23 0 3 0 0 69 14 0 41 0 0 6 0 0 0 0 0 0 0 3 3 0 3 0 0 17 6 0 0 0 25 2 3 2 0 21 0 0 0 0 0 0 0 38 3 0 0 3 0 54 
0 0 26 0 0 0 18 49 0 0 0 12 7 23 32 4 0 10 0 0 15 1 3 11 0 8 0 14 16 24 0 3 0 0 0 0 14 13 17 0 21 11 0 57 2 0 5 0 47 0 11 
0 0 0 0 0 42 0 3 0 0 75 15 0 0 9 0 16 0 0 8 0 6 0 12 0 12 5 21 0 0 0 0 1 0 20 0 10 1 22 25 13 0 0 18 10 0 0 5 59 0 6 
2 0 18 3 0 6 6 0 7 0 1 15 6 20 14 7 0 4 0 0 0 1 0 9 0 0 3 0 0 3 0 0 20 3 1 0 1 0 0 0 4 0 14 33 42 0 43 0 0 46 0 
20 23 0 0 0 14 0 0 0 16 15 0 31 42 30 0 0 26 0 7 20 0 28 20 56 15 2 6 0 0 0 0 12 6 0 14 8 0 0 0 38 19 0 61 43 0 14 15 21 25 46 
72 38 0 18 0 0 0 0 22 39 0 0 0 58 12 20 0 4 0 18 9 30 1 21 0 11 0 1 25 0 0 1 11 0 4 33 29 18 0 0 0 16 6 3 33 0 0 47 26 0 0 
36 0 38 0 9 34 0 2 4 20 14 3 10 0 0 49 0 0 0 32 0 0 15 0 26 0 2 31 0 4 18 49 13 0 0 0 38 0 25 0 0 0 0 2 13 35 0 2 0 0 48 
27 14 20 31 0 0 0 0 0 46 0 0 11 0 56 0 7 37 0 1 1 5 0 11 0 8 0 36 0 8 5 0 7 0 45 30 0 8 0 7 0 0 1 37 2 0 3 0 39 35 33 
0 26 49 0 30 0 0 37 45 37 25 32 2 22 9 0 3 4 4 10 7 0 6 16 0 31 24 23 19 7 20 0 0 0 16 47 14 0 9 0 0 0 0 26 37 0 13 0 0 3 24 
27 19 30 4 17 40 3 69 9 30 2 11 18 3 29 11 38 0 17 5 3 5 0 1 21 43 0 8 11 1 10 1 28 8 16 0 24 14 0 32 11 11 26 17 1 23 25 2 16 0 0 
0 0 0 0 0 24 41 8 6 0 0 0 31 0 0 6 0 40 0 0 0 15 14 36 7 0 0 7 0 24 0 0 10 31 17 0 5 0 0 7 0 0 0 46 8 9 0 33 19 0 0 
0 3 62 13 45 1 4 0 0 11 1 0 0 0 0 0 16 7 0 29 0 0 6 0 6 15 0 0 20 0 0 0 11 0 6 12 9 13 0 0 16 39 17 0 0 3 0 34 26 3 0 
7 0 37 0 34 0 33 35 0 0 0 13 17 0 36 0 0 0 6 5 14 22 6 27 37 0 14 0 0 17 16 0 0 0 0 0 29 0 34 73 7 20 0 0 0 34 16 7 0 0 27 
0 0 0 0 0 0 0 0 21 2 0 0 0 0 11 36 1 0 0 0 0 0 0 0 0 10 0 0 0 1 0 0 0 0 10 0 0 0 0 4 16 0 0 0 0 0 11 0 0 29 23 
35 1 2 19 0 7 0 6 42 2 3 1 7 47 1 11 8 3 0 0 15 1 19 0 0 0 15 25 3 1 10 0 1 12 0 6 23 24 27 3 0 0 0 22 0 6 0 0 30 0 46 
47 0 0 0 9 0 0 6 28 5 0 5 0 0 0 10 32 0 8 21 0 0 0 3 0 8 5 8 0 13 0 14 11 0 28 0 30 0 0 0 0 0 0 3 42 3 4 11 32 0 19 
17 1 0 0 0 1 1 4 0 0 0 2 0 26 0 6 15 4 0 0 0 3 1 0 0 11 0 2 0 0 0 15 0 0 13 0 0 9 11 7 0 6 0 8 0 0 28 34 0 0 7 
23 0 0 41 0 4 5 30 36 27 59 18 5 1 13 11 25 0 8 12 14 75 0 38 5 0 2 21 0 12 4 0 10 8 16 10 2 23 2 3 66 34 10 22 48 38 2 0 26 27 38 
3 0 0 0 34 11 0 10 38 5 0 12 4 0 0 0 39 0 0 0 15 13 0 0 24 40 0 0 19 0 0 0 7 0 0 1 20 0 52 0 0 0 4 8 18 0 4 0 24 0 1 
7 4 39 10 46 30 45 21 25 4 31 14 10 23 18 9 0 0 0 13 0 4 18 30 0 14 0 12 10 2 7 29 0 27 0 34 59 8 29 34 2 10 0 23 1 30 3 14 5 0 6 
5 47 1 41 12 4 0 0 0 52 7 66 0 0 0 1 0 16 0 6 4 28 0 10 0 6 3 0 22 29 0 0 4 6 25 19 6 27 0 0 29 2 2 34 79 30 0 5 60 9 17 
50 14 29 39 13 0 56 20 22 7 0 39 23 19 0 40 0 27 1 0 7 23 13 14 0 22 20 15 3 17 18 2 0 20 14 22 17 0 0 3 2 38 7 1 8 0 0 0 0 0 64 
0 0 0 47 32 27 7 0 0 7 0 1 0 18 0 0 10 1 1 0 1 17 12 0 0 0 8 0 0 0 0 0 21 0 0 9 0 0 34 0 21 19 0 0 7 0 0 0 5 5 38 
3 18 0 38 0 24 0 31 42 23 0 1 0 20 0 0 13 0 0 12 1 7 14 20 0 0 2 5 7 24 0 39 1 0 19 11 2 0 4 3 0 36 0 8 3 29 0 0 7 0 17 
46 0 35 13 0 0 0 33 5 0 0 23 4 9 16 0 6 16 0 9 4 0 2 2 18 4 3 4 23 14 7 0 14 20 16 35 14 22 22 0 33 2 0 17 22 16 11 0 1 1 23 
0 0 63 39 1 1 43 3 30 34 0 27 0 0 6 5 3 9 11 12 53 15 1 0 0 0 0 0 0 24 7 16 23 24 0 25 8 2 57 5 19 49 17 1 22 15 46 14 49 96 8 
27 0 17 18 17 0 7 0 0 0 0 17 0 15 0 0 14 0 0 2 9 21 0 0 0 10 0 39 0 0 8 0 0 12 11 0 0 0 0 0 3 27 0 20 0 20 0 0 18 0 0 
74 0 39 0 0 0 0 0 22 9 35 0 0 0 0 0 0 0 0 0 26 0 0 0 0 0 0 13 0 0 30 0 17 0 0 35 0 9 4 0 13 0 0 0 71 0 6 3 13 3 0 
