51 29
22 0 0 0 21 21 16 0 0 41 24 0 0 0 0 0 10 34 1 0 0 0 2 0 24 0 0 22 0 0 0 19 0 21 0 0 0 0 0 9 0 0 0 37 0 0 11 0 0 0 20 
6 0 0 32 9 0 14 66 5 0 0 0 8 0 0 0 2 11 21 14 14 0 0 0 22 0 20 0 12 19 37 18 26 6 18 0 0 2 0 2 6 0 0 0 0 2 67 2 19 18 0 
21 0 0 38 0 17 60 36 0 41 0 8 14 0 7 9 20 11 15 12 70 40 12 31 30 37 58 0 0 0 1 16 7 13 8 0 4 0 0 0 24 16 0 0 0 42 11 15 31 0 62 
10 4 1 0 0 4 10 9 0 8 10 0 1 1 4 0 0 4 0 0 0 0 0 0 0 0 8 20 22 0 1 4 4 0 0 0 16 25 0 38 15 4 8 0 0 0 0 0 1 0 0 
46 0 57 0 1 0 23 0 41 3 23 1 34 23 0 0 14 21 0 17 0 1 17 20 3 3 17 29 5 0 0 1 8 23 32 0 26 0 32 0 0 37 77 17 0 19 11 12 0 0 11 
22 0 21 48 54 45 22 44 0 0 0 8 19 10 0 0 2 0 0 20 0 23 0 7 7 0 0 19 22 0 14 7 13 0 23 30 3 0 0 20 0 11 35 32 17 18 10 0 21 0 0 
0 38 68 0 0 15 9 0 0 24 0 0 2 0 0 0 13 0 0 0 4 0 20 10 0 9 0 0 12 1 1 0 7 10 9 0 14 0 15 39 31 0 0 0 0 0 0 0 0 0 48 
15 0 0 24 0 0 12 20 0 0 39 0 0 11 4 3 0 4 24 0 14 18 0 4 0 0 15 26 18 0 0 27 12 16 14 19 15 5 18 29 7 0 5 10 0 42 11 28 0 18 0 
0 4 0 25 45 0 0 5 14 0 40 10 3 0 0 0 0 0 3 0 0 0 12 0 0 0 14 0 0 4 0 0 0 20 28 0 33 40 6 0 0 0 0 0 0 7 9 10 0 29 40 
35 20 0 4 0 15 33 0 0 0 0 8 1 33 1 17 0 7 0 0 34 49 0 11 1 11 0 13 0 7 5 2 0 0 0 23 7 1 0 16 0 7 0 0 0 27 0 17 0 29 0 
3 0 0 27 0 0 58 8 0 7 0 0 0 22 11 26 17 11 17 4 6 0 0 8 18 0 0 0 9 0 0 23 0 11 0 22 0 30 35 0 9 0 29 0 27 0 0 16 0 0 3 
34 10 37 3 4 37 15 14 12 13 0 33 0 0 3 11 12 29 0 0 60 23 0 15 0 0 0 0 21 15 10 15 0 12 18 21 0 13 0 70 0 0 8 0 32 0 40 0 28 0 0 
0 0 30 18 18 42 0 43 0 3 0 19 32 0 0 0 0 23 19 0 0 28 0 0 0 0 0 0 7 0 50 2 25 0 5 0 18 33 8 8 7 0 43 22 32 0 0 56 0 0 36 
8 25 3 25 1 16 10 30 0 0 13 34 0 15 11 11 19 6 45 3 16 25 11 0 21 36 31 0 43 10 10 0 18 18 0 2 5 33 0 0 20 3 2 7 26 24 13 0 6 67 33 
0 6 45 37 1 39 30 0 0 0 0 0 8 0 31 1 10 11 13 0 0 26 13 10 12 5 0 10 0 9 0 6 15 5 36 0 0 0 6 0 13 7 0 62 38 0 0 101 0 0 0 
30 0 54 5 40 44 9 0 14 2 0 3 38 11 0 0 29 10 0 19 0 8 10 0 26 0 18 10 1 0 0 5 12 14 16 14 0 4 38 27 0 0 20 4 0 60 33 8 0 45 27 
0 0 70 16 0 0 41 0 0 10 0 0 0 7 0 22 12 9 0 3 0 4 5 29 11 0 4 4 11 2 13 0 0 0 32 12 13 22 5 2 0 16 0 41 0 0 0 4 0 0 44 
0 23 0 0 7 12 0 24 1 25 22 8 5 4 0 0 11 27 1 0 0 5 0 6 19 24 0 7 0 22 0 2 22 26 7 9 0 4 2 0 2 0 5 3 0 0 0 30 6 20 13 
0 0 19 8 21 0 4 4 0 28 4 1 8 11 0 0 38 6 0 0 16 12 0 16 0 0 3 0 0 12 9 0 13 15 0 32 11 24 6 0 39 8 5 2 5 0 3 9 16 19 0 
6 42 9 0 0 28 23 0 9 67 20 44 21 0 7 0 13 0 1 6 13 17 0 0 0 17 27 0 9 0 36 0 11 8 18 0 44 24 0 27 6 0 0 56 0 90 16 15 45 0 38 
0 0 5 36 17 28 47 7 0 14 0 0 0 29 0 15 0 8 15 0 0 56 11 28 53 6 23 4 12 1 11 9 5 0 17 29 7 17 7 49 0 0 42 7 0 0 0 0 0 0 0 
0 11 0 0 17 79 6 0 37 15 0 0 3 0 2 0 10 0 0 7 1 13 14 0 4 22 20 0 18 0 25 0 5 37 0 31 1 17 5 0 0 0 1 4 39 4 0 22 5 3 0 
55 0 0 28 19 17 0 0 22 22 0 2 6 0 0 27 21 0 0 0 12 11 17 0 0 20 4 3 0 20 0 34 25 29 0 0 12 40 0 0 0 0 18 0 17 0 20 39 5 0 0 
0 0 46 0 53 0 0 0 16 0 17 0 18 26 32 24 8 25 0 0 10 0 0 23 22 0 0 37 0 2 23 0 0 8 13 0 2 14 0 50 0 0 5 23 0 29 10 25 48 0 2 
0 0 34 29 30 15 25 16 23 29 24 21 17 0 0 0 18 28 7 0 17 5 0 16 5 4 21 0 0 17 19 25 9 2 58 15 9 39 23 23 0 0 0 0 0 21 4 22 1 1 63 
0 0 30 14 21 0 0 0 0 25 0 0 8 35 26 4 0 12 24 7 0 18 0 2 0 5 0 20 5 11 4 18 24 0 13 0 0 7 24 5 45 0 53 6 0 0 0 17 3 1 12 
0 77 32 21 0 0 27 33 0 0 8 13 8 19 36 17 8 0 0 12 24 20 0 11 8 4 0 6 0 0 0 15 14 33 51 26 0 9 0 0 33 12 3 0 0 49 0 28 0 1 0 
22 45 0 0 22 2 60 2 8 0 0 0 0 21 28 15 22 11 13 12 0 18 0 8 30 0 8 5 0 0 1 11 14 0 21 0 6 0 40 0 39 2 64 21 19 0 0 3 40 26 0 
21 7 0 31 32 1 26 27 0 0 26 0 6 0 0 18 0 0 0 0 22 45 0 0 0 0 0 0 9 0 9 2 0 27 31 0 5 0 2 34 1 1 0 0 0 9 0 0 6 28 0 
