51 29
22 0 45 0 0 40 9 9 0 0 9 0 0 0 0 40 17 20 0 0 25 0 0 57 40 8 30 24 13 0 0 11 64 0 20 0 13 3 0 7 9 0 29 7 3 0 10 85 41 17 27 
37 11 0 22 0 0 0 23 25 0 0 0 0 0 10 0 14 4 56 0 23 21 20 0 6 2 0 0 2 0 23 0 0 55 13 0 0 14 5 1 18 0 5 0 27 0 3 22 0 0 18 
1 20 29 27 15 52 15 10 0 9 0 0 11 27 36 27 26 0 26 55 26 16 9 20 0 11 7 0 55 11 0 2 0 0 0 0 43 0 17 1 11 0 40 23 0 0 6 0 29 0 14 
0 0 0 18 54 59 34 0 5 0 0 0 9 0 0 5 5 14 2 29 24 16 0 1 0 0 0 2 27 0 0 6 16 12 13 15 16 0 0 35 2 0 38 12 11 3 0 0 0 44 0 
0 0 8 10 30 0 0 0 6 0 24 0 0 8 0 24 0 10 1 17 0 33 12 0 14 20 4 0 3 0 0 16 0 0 30 0 36 9 5 0 0 0 0 0 0 2 42 9 0 0 9 
0 11 0 9 0 4 0 0 0 30 0 0 36 30 0 32 0 28 0 0 0 0 0 12 15 19 11 2 1 14 0 0 31 0 17 0 0 0 26 0 8 3 0 30 2 28 0 0 22 0 4 
17 9 0 0 3 78 67 15 15 1 29 0 36 0 8 7 1 12 16 18 5 47 22 0 27 65 25 3 0 17 0 4 14 0 21 30 17 8 0 85 6 43 12 16 0 9 22 8 9 6 8 
5 12 0 0 0 0 0 1 18 41 0 23 0 12 33 4 4 0 8 13 12 2 26 24 0 0 2 0 0 0 0 0 0 17 4 0 8 7 0 0 0 0 0 2 7 0 0 28 0 27 24 
0 48 8 43 0 0 37 21 13 23 0 0 7 0 0 0 31 0 20 7 17 0 0 9 10 7 0 0 7 0 0 0 21 0 0 3 4 19 2 0 2 0 18 62 0 0 43 0 0 81 0 
80 45 49 13 0 14 27 0 3 8 0 40 0 18 1 0 7 0 13 10 5 0 18 3 0 23 2 0 25 0 40 3 0 25 0 35 20 0 0 0 18 0 0 0 19 42 50 0 37 0 0 
18 0 15 0 18 0 20 4 6 0 0 0 9 17 15 26 4 0 0 5 14 1 8 14 5 4 23 7 0 21 15 0 9 0 7 3 13 15 7 3 17 9 8 0 0 13 0 32 0 17 8 
11 16 23 19 122 20 23 32 0 0 27 12 0 0 32 13 6 48 0 0 0 18 0 12 23 27 22 35 9 0 2 6 0 0 0 0 20 17 0 45 0 14 0 0 4 8 2 62 11 61 13 
0 4 0 32 0 19 6 0 0 0 0 0 0 0 0 0 0 0 0 7 15 0 0 0 27 1 1 0 11 0 0 0 8 0 5 48 4 0 1 12 0 14 0 0 0 5 6 0 0 0 0 
7 0 13 41 0 26 18 0 0 0 9 0 57 0 0 4 0 26 12 0 14 0 0 0 18 0 0 0 7 17 37 0 0 30 8 15 43 7 0 0 15 0 0 6 16 0 3 0 14 3 9 
0 53 59 87 23 14 4 35 0 18 2 29 1 11 4 0 10 32 17 0 48 8 23 10 15 9 31 34 20 1 0 13 14 26 5 14 33 0 11 0 0 40 0 34 5 27 10 45 19 99 0 
11 0 0 0 21 0 0 0 0 0 0 66 28 0 6 1 21 0 8 0 8 10 6 12 0 14 0 17 0 6 18 0 0 0 4 6 7 0 3 5 4 27 11 0 4 4 0 36 0 0 14 
0 0 8 0 0 0 0 0 0 0 16 4 0 31 0 1 7 0 11 0 28 13 2 18 0 0 21 9 0 4 0 0 0 13 9 0 1 10 0 0 29 18 0 9 63 7 0 31 0 10 0 
0 0 0 0 0 0 98 6 0 41 0 10 0 0 0 0 31 0 0 0 9 24 12 9 0 3 0 0 0 0 0 0 7 0 11 0 15 0 0 33 0 0 0 37 1 19 0 0 0 0 41 
0 0 46 0 0 0 0 16 0 6 16 48 0 7 0 1 0 30 0 11 8 0 0 27 0 12 17 1 0 0 0 0 9 0 14 0 14 0 27 0 0 0 0 38 1 15 0 0 60 0 13 
8 0 0 10 3 2 7 0 45 0 19 3 0 0 0 0 10 0 43 9 15 3 28 7 1 0 0 0 15 0 8 0 0 1 8 9 13 0 24 0 22 0 19 21 0 38 0 0 7 31 0 
0 0 3 17 0 37 0 11 33 6 0 23 20 28 24 0 0 0 56 35 28 16 17 20 4 7 14 16 5 39 0 0 22 0 33 2 23 2 15 0 18 33 14 16 26 0 0 0 9 0 0 
8 4 7 0 0 4 0 40 16 7 0 0 18 0 8 0 7 0 7 26 0 2 0 0 0 0 1 0 13 0 0 9 4 17 0 3 0 24 0 0 10 7 2 26 10 0 0 50 0 0 0 
0 3 0 21 5 0 0 0 16 0 0 0 0 0 0 0 15 4 0 0 0 0 21 22 16 0 23 0 0 7 0 2 14 0 3 34 0 0 0 0 0 0 0 0 0 0 0 43 1 56 0 
25 37 3 7 11 1 39 6 4 0 25 9 0 0 20 12 6 0 0 12 1 0 25 0 13 0 0 10 0 2 14 0 0 5 20 0 35 0 0 1 34 0 44 3 20 39 5 32 1 0 17 
20 38 0 4 62 0 0 3 0 14 0 0 0 25 20 5 0 27 0 0 18 0 5 22 0 25 0 43 24 0 0 30 0 0 24 0 0 35 25 24 0 24 38 0 0 0 29 0 0 0 0 
0 0 15 0 10 0 0 21 54 0 3 32 0 3 0 0 10 26 9 6 0 0 6 0 25 0 9 2 21 37 11 0 0 0 0 14 0 0 0 0 8 1 0 18 41 1 17 0 0 20 0 
11 0 3 0 4 18 24 0 0 0 28 0 12 26 10 5 5 0 0 0 5 12 0 9 8 0 0 0 0 8 0 0 19 25 29 18 8 1 28 82 24 14 9 7 10 8 25 5 4 10 0 
0 17 0 0 0 0 0 40 0 40 18 29 0 53 0 0 21 15 3 7 27 1 1 25 17 9 0 0 43 30 0 27 22 10 19 0 2 27 18 0 0 0 0 0 24 0 29 0 23 131 5 
24 26 31 4 5 41 6 20 0 27 0 1 0 0 0 31 5 11 3 0 16 0 43 0 9 22 0 0 25 31 8 0 5 26 23 0 7 23 0 0 21 12 0 1 7 15 2 0 8 3 4 
