51 29
43 29 0 10 20 0 18 64 44 0 0 4 11 33 58 0 48 0 28 0 0 0 2 17 2 14 21 34 0 16 32 24 0 0 0 17 0 10 22 0 6 33 0 0 71 15 27 13 0 1 25 
9 0 27 0 25 0 8 87 18 5 0 0 0 27 40 0 0 0 20 27 0 0 3 1 0 0 9 24 6 49 7 0 25 17 0 23 13 0 3 20 0 3 14 11 3 31 28 2 36 2 21 
35 12 20 0 18 0 0 0 31 0 23 20 12 18 0 0 40 0 13 0 10 0 4 10 20 0 2 29 6 4 28 15 11 15 0 2 0 26 0 0 17 0 0 0 0 0 23 39 0 19 0 
0 14 0 45 7 20 0 0 28 0 0 21 0 9 0 34 0 0 21 31 0 13 10 24 0 36 5 25 2 0 0 15 31 33 0 1 0 0 0 21 0 16 0 0 21 23 44 0 45 34 0 
24 44 6 11 1 0 0 16 7 0 0 23 34 12 28 0 0 0 23 3 0 39 3 1 39 10 0 6 0 33 0 12 18 12 0 16 0 0 15 0 0 23 21 0 26 44 39 0 0 0 0 
15 0 19 0 7 32 76 32 0 0 40 0 13 5 0 3 4 22 0 7 0 3 21 0 2 0 0 3 2 0 20 3 4 21 13 0 0 21 14 0 38 22 0 0 19 0 10 0 4 21 2 
0 40 11 0 20 7 6 0 33 0 12 57 26 0 15 0 10 14 23 25 16 0 20 0 7 6 0 0 10 7 2 8 33 4 24 24 0 9 7 0 0 26 36 2 34 0 5 0 2 6 24 
0 0 8 0 22 0 0 7 35 25 8 0 30 2 18 0 5 0 3 11 0 5 0 0 16 0 4 0 26 0 6 10 0 4 25 6 48 0 0 0 0 10 30 0 25 0 0 0 44 0 14 
18 18 0 0 24 0 37 9 0 0 0 0 0 14 1 3 12 21 0 12 0 21 11 1 0 12 6 3 4 0 5 14 6 3 28 7 1 19 17 6 5 4 17 0 0 11 8 10 0 15 15 
4 0 0 9 0 0 0 34 15 0 9 0 0 8 23 0 0 0 0 9 0 18 7 16 0 12 22 7 0 3 0 0 9 0 0 0 18 37 5 22 4 20 0 0 0 0 6 0 10 12 0 
11 0 27 0 2 21 14 0 37 31 0 0 0 0 8 0 9 0 14 35 0 0 0 30 0 0 16 0 7 10 0 22 7 17 5 16 0 0 0 16 25 0 2 0 0 39 0 7 0 11 33 
21 0 0 0 28 2 0 35 20 0 40 11 20 0 1 5 0 0 11 0 20 18 11 16 0 25 5 1 0 0 0 0 28 5 0 16 12 4 3 14 0 11 11 0 18 35 0 43 0 0 0 
9 0 0 18 37 8 5 5 22 11 0 0 21 17 0 0 12 0 0 10 13 1 0 6 6 0 0 0 0 24 6 12 12 15 0 0 0 0 19 16 52 10 3 14 0 19 0 0 0 2 0 
14 0 0 12 19 45 26 7 9 0 0 7 17 0 7 12 0 62 0 0 0 22 5 11 24 12 0 0 0 17 0 22 10 24 0 9 36 5 10 13 0 0 4 0 0 0 25 0 0 44 33 
5 20 0 39 91 11 5 34 1 0 26 27 7 6 19 7 30 4 26 21 14 5 0 11 0 7 34 4 0 0 18 3 2 19 3 0 50 0 24 0 4 9 90 0 30 29 21 0 15 0 9 
0 10 29 0 0 0 0 16 0 47 29 13 11 0 0 24 1 0 0 3 4 5 13 16 13 0 0 0 0 14 0 36 10 18 5 4 4 0 0 29 0 11 26 34 21 0 10 0 0 0 0 
9 0 0 24 59 0 37 0 7 1 22 0 0 0 1 22 6 0 0 46 0 31 0 0 9 1 0 23 7 0 0 12 30 12 13 7 0 9 9 0 0 20 8 47 25 0 42 3 6 0 0 
37 3 36 4 0 33 0 0 0 0 0 14 24 8 0 0 15 0 5 0 0 0 0 8 0 0 0 1 23 0 20 8 7 11 5 32 24 35 20 0 40 0 4 0 37 27 32 0 0 0 35 
83 0 4 1 0 0 4 0 0 13 0 18 2 39 17 3 4 5 2 2 10 0 13 0 0 22 23 0 0 15 0 0 12 33 0 0 0 2 1 0 0 7 29 0 7 0 0 0 0 0 50 
0 45 0 70 19 0 0 18 17 0 0 0 10 0 0 5 1 0 3 14 6 4 18 2 21 18 0 0 3 0 9 12 8 21 15 0 0 34 15 36 0 0 11 17 0 0 45 7 29 0 0 
8 66 0 0 22 2 49 11 0 33 34 0 28 0 0 0 16 0 0 30 0 3 0 0 3 16 17 0 27 0 14 0 10 0 0 3 0 0 11 0 11 0 0 0 8 0 0 41 13 49 0 
0 5 0 56 0 10 17 39 0 0 0 0 25 3 0 1 0 0 12 0 0 0 5 0 9 7 0 1 25 17 27 0 7 0 3 7 3 30 0 0 0 0 7 4 0 32 39 0 35 11 0 
0 13 0 12 27 0 0 0 16 35 0 11 14 12 28 12 7 9 31 19 28 0 0 0 20 13 19 0 19 0 0 11 0 19 5 0 0 11 0 30 0 10 69 0 11 0 21 0 42 18 0 
0 0 0 0 22 0 15 10 0 29 0 0 0 0 0 0 0 0 48 0 2 0 0 18 16 0 13 0 0 0 0 0 0 18 16 0 0 0 26 32 0 4 0 0 18 0 0 0 0 0 47 
3 0 0 0 1 23 33 18 26 2 20 21 0 0 2 0 28 33 0 23 14 12 0 3 6 4 3 16 40 4 20 5 30 0 15 23 8 29 0 11 0 0 34 53 0 16 23 0 20 1 11 
9 10 0 0 40 0 11 0 6 27 0 59 0 11 9 33 19 0 0 0 2 0 0 0 18 2 0 28 0 0 0 0 22 8 0 18 1 23 0 30 15 10 1 35 31 0 0 15 36 38 0 
18 111 0 39 52 0 6 0 0 1 0 23 6 1 13 13 26 29 32 4 20 32 4 26 9 11 12 2 13 9 7 20 24 1 4 16 1 29 42 7 0 33 38 22 0 0 23 25 0 12 2 
0 26 0 12 0 56 3 36 16 0 0 0 0 0 0 0 33 19 20 0 0 13 0 1 16 0 0 42 0 0 0 0 0 2 3 16 0 32 0 0 0 0 0 40 10 24 0 27 0 0 22 
19 0 0 0 0 1 43 24 0 0 0 0 0 12 0 0 0 38 28 23 0 0 0 28 0 0 20 49 15 23 16 39 0 2 0 7 1 40 0 16 16 0 0 0 28 28 27 14 0 22 22 
