51 29
74 80 11 0 0 5 33 0 14 26 53 31 18 10 15 0 34 19 4 0 5 0 6 0 19 5 12 27 45 12 41 0 0 0 0 16 0 0 0 0 30 22 31 33 0 53 36 0 0 0 9 
24 26 20 0 5 0 81 20 0 0 21 39 0 0 12 23 24 15 0 0 0 9 20 0 0 0 18 4 20 0 9 0 0 0 0 9 0 0 0 0 24 0 0 0 19 18 65 0 20 0 1 
71 0 1 29 0 20 0 0 12 16 19 9 0 0 4 0 0 22 36 2 33 28 15 4 23 3 20 19 33 1 19 10 61 0 8 7 0 11 21 6 22 29 11 43 0 5 4 15 6 22 14 
0 37 8 0 63 24 17 21 0 0 0 23 12 7 25 0 0 0 16 2 0 0 0 0 17 22 0 13 21 0 0 0 0 29 0 7 11 12 12 8 0 0 0 8 0 80 39 41 0 0 44 
0 11 29 13 25 0 35 36 14 84 39 19 35 0 0 0 0 0 33 0 1 30 8 10 5 16 2 12 6 3 0 0 25 10 27 17 3 8 14 13 0 0 6 70 0 20 4 0 0 93 18 
12 18 0 35 0 10 38 0 0 0 3 29 50 0 13 0 8 0 0 12 15 0 0 12 0 0 0 10 0 0 15 16 38 8 10 4 22 0 32 0 21 0 0 13 28 15 0 9 0 0 18 
43 11 3 0 5 0 9 2 23 3 17 0 40 18 29 0 0 0 0 4 5 0 23 2 0 2 0 30 0 0 17 5 15 0 3 6 0 14 26 0 22 8 0 11 44 38 8 21 16 0 19 
16 55 16 0 0 2 41 19 0 0 0 12 6 0 0 0 34 0 0 2 0 26 0 12 0 0 0 0 5 8 18 0 0 0 12 0 8 0 23 0 33 0 0 0 1 0 39 0 24 0 0 
12 0 4 0 44 8 19 0 33 4 0 0 7 25 0 33 4 9 6 0 0 0 0 0 15 0 0 1 0 0 31 0 0 0 0 6 0 0 4 4 0 0 0 4 3 8 30 0 23 0 12 
0 0 54 60 0 60 21 0 16 1 0 4 0 7 26 9 11 1 0 0 26 7 8 22 4 0 20 14 7 0 7 26 0 14 0 44 13 31 22 0 37 1 22 9 15 0 13 42 1 25 27 
43 93 32 29 7 13 1 14 0 4 12 12 0 41 0 0 12 0 0 15 8 2 6 18 25 26 0 26 3 0 0 0 14 0 9 10 12 13 0 36 12 21 1 67 9 44 15 0 6 0 49 
27 0 43 22 0 0 61 44 43 38 14 27 10 13 28 15 50 21 7 11 0 3 20 4 6 39 3 1 3 0 13 21 0 0 0 4 32 0 9 0 18 0 21 6 10 6 1 38 0 13 25 
27 0 20 44 0 22 16 49 1 2 11 13 0 6 0 28 1 0 0 22 0 18 4 0 4 0 0 5 14 0 0 0 3 0 0 11 0 0 7 17 0 1 0 0 21 7 0 47 15 9 43 
3 41 0 0 5 44 1 0 0 1 5 0 0 0 13 0 25 0 0 0 0 4 0 10 4 0 13 0 0 0 22 0 9 15 0 21 0 0 1 1 0 0 26 0 14 0 0 9 0 9 0 
2 0 2 30 0 0 5 1 75 0 0 24 0 0 12 0 12 31 0 0 0 27 0 0 16 0 6 0 12 0 27 17 0 0 0 62 19 0 0 14 32 4 0 0 0 0 8 0 33 0 0 
0 6 0 0 0 0 5 0 0 0 0 0 22 6 2 0 7 0 17 12 15 13 13 22 29 8 8 22 0 1 6 0 10 0 0 9 0 12 0 0 19 0 0 0 0 20 0 0 0 14 0 
3 0 0 0 0 0 0 0 0 0 0 0 0 10 0 0 0 15 31 19 0 9 0 0 26 0 0 6 0 0 0 0 0 0 0 0 0 0 19 0 0 0 0 0 0 1 8 0 0 31 16 
10 6 3 54 0 28 20 1 0 4 0 0 0 14 7 18 0 1 4 0 0 2 0 1 28 0 5 14 0 17 0 14 13 18 13 5 31 0 0 0 6 38 5 0 0 0 0 0 0 7 0 
0 2 17 0 9 9 0 0 0 16 5 8 11 0 32 0 0 19 0 9 0 0 0 11 0 2 0 0 3 0 0 0 0 19 19 0 17 9 26 3 3 0 3 8 0 0 23 0 0 0 16 
42 4 0 0 3 0 43 4 11 41 0 0 32 0 16 4 23 0 28 15 17 0 21 27 23 8 3 0 28 9 0 0 0 24 0 0 10 0 3 30 4 0 26 29 34 18 20 0 0 0 71 
0 0 20 0 0 10 16 0 22 0 0 24 0 11 9 0 7 0 0 0 0 10 4 0 2 15 2 1 0 0 0 4 0 0 0 0 0 7 21 15 0 6 1 1 0 19 0 45 2 0 0 
29 0 19 0 0 4 4 0 11 26 27 20 2 15 0 9 0 0 29 11 5 0 11 13 12 2 3 22 10 14 0 1 14 10 3 17 18 0 30 5 0 0 0 0 44 15 5 0 0 26 0 
13 10 10 5 0 0 0 0 25 86 0 39 24 13 16 7 1 0 28 40 26 20 0 0 27 21 31 23 11 6 12 0 1 19 5 1 13 10 18 0 0 2 9 0 0 24 63 6 31 0 0 
26 19 16 0 0 0 102 0 14 0 0 43 15 34 23 0 31 0 0 0 0 0 25 0 0 8 26 23 0 0 23 4 0 0 0 0 1 23 0 10 29 0 0 0 38 0 40 90 0 9 24 
0 0 16 0 0 0 0 36 0 0 0 0 0 28 11 26 0 2 16 0 0 0 1 8 0 20 0 0 0 14 0 0 0 18 0 0 0 0 6 3 0 28 0 17 0 2 0 2 5 7 0 
30 0 0 0 0 37 42 7 0 0 21 27 0 0 0 14 0 15 0 31 20 11 0 0 17 0 13 6 33 15 1 53 15 12 0 0 0 4 16 20 12 20 23 26 32 3 0 19 2 24 78 
0 0 0 5 0 7 25 1 36 26 0 31 7 27 7 0 0 2 0 19 0 38 0 0 0 12 2 25 14 0 9 4 0 0 0 0 10 0 6 32 1 0 0 26 17 0 30 0 0 0 10 
98 35 6 5 9 24 54 65 0 0 15 43 38 5 7 0 24 6 21 7 14 20 19 0 30 13 62 0 21 29 0 25 32 0 0 0 8 2 25 0 11 15 16 3 46 39 10 47 52 0 48 
0 0 78 9 0 43 32 0 6 0 13 29 31 18 19 0 15 0 16 0 0 0 13 21 0 0 3 34 0 3 0 19 0 31 0 0 0 25 53 14 7 0 0 0 0 0 0 20 79 19 3 
