51 29
16 30 0 0 46 45 1 1 58 0 45 19 0 18 0 0 0 0 0 28 0 27 6 0 10 0 0 0 30 0 19 37 9 0 0 13 25 0 3 0 0 0 0 0 0 0 0 0 0 0 43 
46 23 18 0 46 0 6 0 0 2 18 0 0 12 14 0 32 15 0 0 4 0 0 0 6 9 19 0 2 14 4 8 32 0 4 1 10 4 0 8 24 0 0 14 6 0 40 0 0 0 6 
0 13 33 0 0 9 23 15 0 35 23 29 0 5 6 4 0 0 0 14 0 19 15 19 17 0 4 0 0 0 0 10 0 0 0 34 0 0 0 12 12 22 0 6 38 0 21 1 0 0 8 
41 0 0 33 19 0 0 0 78 25 41 0 0 1 30 12 0 39 37 9 0 5 25 18 15 22 14 17 14 15 7 21 0 0 0 26 19 9 64 0 42 35 0 0 0 8 32 93 85 35 30 
34 43 28 25 1 22 6 0 1 26 36 16 1 14 14 0 33 33 0 7 4 17 0 15 13 0 1 6 10 0 0 4 7 26 60 19 23 10 10 8 5 0 0 8 40 28 33 36 43 0 41 
0 18 41 87 0 57 24 22 0 15 2 0 0 0 22 0 1 0 0 14 26 2 1 34 11 0 17 0 1 23 18 0 29 13 0 18 6 8 0 26 0 0 42 8 7 15 14 44 40 0 21 
16 0 15 0 16 0 2 0 34 45 4 15 21 23 16 0 0 21 0 0 20 0 24 19 1 0 7 0 18 0 14 29 16 6 8 0 23 0 3 37 3 0 1 0 15 0 6 0 14 18 0 
30 0 12 25 43 21 36 17 20 38 4 0 1 12 1 0 0 14 21 4 0 76 10 0 34 0 21 0 32 0 30 0 15 0 0 0 0 4 0 1 0 4 36 26 0 24 25 55 0 25 0 
0 12 0 0 0 0 18 0 20 0 88 3 1 1 6 0 10 5 29 13 0 16 12 16 38 12 12 0 20 0 0 0 6 0 0 0 0 16 0 14 39 0 28 6 0 46 0 25 55 39 0 
0 3 18 23 13 7 0 18 0 8 0 0 0 0 29 0 0 24 0 0 17 15 0 17 10 18 0 0 0 0 0 3 0 19 32 0 15 0 0 0 13 0 0 0 0 0 0 0 0 0 8 
0 0 0 0 27 0 0 9 19 3 3 0 19 8 18 4 29 0 14 16 0 3 11 6 3 9 0 39 0 0 0 12 4 11 0 16 0 8 7 30 0 0 0 5 5 37 4 30 0 35 0 
14 27 30 0 0 13 26 5 0 0 0 11 0 0 0 0 0 0 0 0 0 19 22 23 16 3 25 13 27 13 2 0 9 6 0 0 0 52 2 3 21 0 18 0 0 7 14 0 0 0 0 
0 3 3 0 8 0 0 2 27 2 12 15 0 2 4 0 0 5 22 28 0 15 0 16 8 11 5 25 12 0 28 0 0 13 0 27 0 0 0 8 0 0 0 1 7 0 12 32 0 31 1 
0 0 41 40 23 38 3 0 12 13 22 0 52 14 1 9 7 0 28 0 10 5 0 3 0 0 17 0 0 0 0 27 13 0 0 13 13 23 59 16 0 0 0 119 6 9 1 29 0 40 20 
30 7 47 3 0 21 35 0 8 9 0 0 0 0 0 4 14 0 20 0 30 33 0 0 7 0 21 9 0 0 1 9 0 12 0 8 1 0 30 12 12 35 0 0 0 10 14 0 0 30 30 
0 44 49 0 0 0 1 13 0 0 28 9 0 0 23 9 7 0 0 0 0 0 20 0 10 0 12 12 50 0 13 10 0 29 0 5 0 32 28 8 17 6 20 35 0 43 8 45 30 6 47 
16 0 1 46 12 21 1 5 16 0 14 0 3 0 0 0 2 11 0 0 13 17 0 0 0 0 24 0 21 0 28 0 12 1 7 0 8 0 10 21 0 37 3 4 0 11 0 47 18 46 12 
43 5 0 13 21 1 12 0 5 26 33 0 31 17 0 0 30 18 21 0 0 12 6 27 8 12 22 0 0 0 0 12 0 0 0 29 1 5 0 4 22 15 0 77 0 0 18 37 0 0 21 
0 32 0 0 2 9 21 17 0 12 0 26 0 27 27 11 19 0 3 0 7 7 25 10 30 0 58 5 24 0 0 0 18 52 0 0 9 21 11 0 5 0 14 0 19 17 20 28 0 9 24 
0 0 50 40 0 19 41 0 0 48 39 8 3 11 33 6 0 11 0 4 0 26 0 4 9 0 0 0 28 6 34 0 0 8 11 13 0 0 0 0 38 17 7 40 0 0 16 100 9 0 41 
0 5 15 40 16 13 5 0 0 9 8 5 7 0 0 4 0 0 33 10 0 27 0 15 0 21 0 6 10 28 14 6 7 16 30 0 6 9 2 15 0 7 0 40 0 0 5 1 6 0 0 
17 2 0 32 0 2 0 2 0 22 0 0 0 0 0 0 0 17 0 0 0 0 7 19 0 12 10 0 1 0 0 30 12 6 0 0 20 8 2 6 0 6 0 16 25 42 0 0 0 13 2 
16 25 13 45 29 0 40 0 0 0 7 0 25 36 37 34 46 0 15 16 0 4 22 3 21 0 0 0 3 0 7 22 0 17 3 31 0 53 8 0 11 0 11 0 0 8 32 0 0 70 5 
0 11 14 73 3 0 0 0 27 0 0 0 32 38 0 0 0 0 6 0 0 15 0 0 0 15 9 9 27 26 20 4 0 0 0 42 29 0 4 8 0 28 0 0 0 17 0 34 15 1 41 
0 0 17 10 0 6 0 24 14 0 4 3 0 0 43 9 0 4 12 17 28 0 3 0 20 0 1 8 0 0 12 26 0 11 10 2 0 2 12 19 16 27 0 20 11 6 0 9 74 0 24 
20 0 0 31 5 0 23 36 0 0 1 1 29 18 0 15 42 0 28 23 5 0 12 3 22 0 0 3 25 0 3 10 0 20 13 2 65 0 0 0 16 5 0 16 0 15 3 31 10 0 0 
36 0 43 0 0 19 37 0 22 19 61 0 34 0 23 34 0 24 0 13 0 16 0 17 10 16 6 0 19 0 65 23 17 0 0 0 25 0 7 0 12 29 0 0 0 43 23 0 0 45 9 
1 1 0 2 0 0 9 0 20 0 30 40 0 0 12 9 2 3 0 15 0 6 22 0 0 0 1 1 0 0 0 5 0 5 15 0 3 23 0 0 28 10 22 11 0 0 6 32 17 9 9 
0 5 38 0 13 0 5 0 23 0 0 13 0 0 0 29 14 15 23 29 27 0 0 31 16 8 13 0 11 1 0 23 0 9 0 24 0 7 0 4 0 39 0 0 9 25 0 26 0 0 0 
