51 29
39 0 0 1 1 6 10 26 0 62 20 35 0 19 5 42 4 8 0 0 0 19 0 6 0 0 0 19 17 20 0 0 7 4 0 0 0 8 7 39 0 0 0 0 0 20 35 16 0 17 21 
25 7 17 40 0 42 4 27 15 0 11 4 1 27 0 0 5 0 0 28 26 15 0 15 0 10 0 1 0 0 0 0 0 30 25 0 2 0 6 0 15 0 0 5 7 0 12 0 0 0 6 
0 34 5 0 13 22 25 0 0 0 0 25 0 7 4 0 0 0 7 5 10 0 0 4 6 0 0 22 22 7 2 0 21 15 0 0 12 0 15 0 0 35 29 11 2 0 0 5 0 0 7 
39 0 0 0 0 25 0 27 0 0 0 30 0 8 34 3 0 22 0 7 0 0 0 8 0 10 0 13 36 0 14 13 9 5 10 0 0 0 7 39 10 4 0 0 0 0 0 1 53 0 33 
0 0 0 0 41 0 17 0 0 20 0 14 0 0 19 0 0 0 0 30 0 26 0 17 0 5 17 0 0 9 1 0 9 36 0 12 0 1 0 0 11 10 4 2 0 24 37 38 0 33 0 
24 6 3 0 44 8 0 10 0 47 64 0 12 0 0 0 0 0 0 19 0 0 0 0 2 0 0 0 0 0 3 0 20 24 0 0 0 23 17 0 0 31 0 84 40 0 20 22 16 0 18 
0 27 25 23 2 21 0 0 0 0 2 27 10 18 0 0 0 2 45 81 20 3 2 0 3 15 28 27 18 11 17 20 14 29 0 0 16 18 19 0 0 0 17 25 3 0 0 19 29 4 78 
17 0 5 69 1 37 0 0 36 30 19 0 0 16 29 0 0 0 31 0 3 15 0 0 40 22 0 0 1 8 19 7 46 0 31 3 48 0 5 2 0 9 42 34 35 0 14 47 0 3 0 
83 6 3 0 7 28 0 0 0 0 9 0 0 0 34 25 8 22 0 0 0 18 1 6 0 0 0 0 0 8 3 6 3 28 0 21 36 10 6 0 44 0 8 17 0 0 0 47 0 26 4 
0 33 8 13 28 52 37 0 16 22 0 39 0 31 10 10 0 0 50 15 16 23 10 17 27 0 0 0 18 7 0 6 10 0 39 15 0 0 24 26 0 23 8 19 23 13 41 19 0 0 80 
13 5 22 0 0 0 35 0 6 12 34 15 0 19 6 8 0 0 15 11 6 5 23 3 22 4 31 0 6 0 16 18 6 0 21 3 25 0 0 45 1 42 0 5 34 0 15 0 14 4 2 
48 6 47 32 13 0 14 0 14 6 14 0 7 29 10 31 0 0 4 5 24 13 1 27 32 58 22 6 18 4 2 21 0 11 30 0 0 3 0 0 0 20 1 22 3 11 93 23 22 12 21 
13 30 0 0 0 0 33 0 0 0 15 23 3 0 0 8 17 18 22 3 9 0 0 0 6 0 0 0 0 0 8 58 10 17 0 18 30 14 8 24 18 0 7 26 19 0 25 16 0 32 32 
0 0 4 13 13 4 31 1 0 15 44 10 0 36 12 0 13 7 6 22 0 0 3 13 10 24 36 0 0 9 19 0 7 11 0 10 2 0 2 22 11 0 0 11 0 49 10 0 2 7 1 
31 24 3 0 24 0 0 27 4 0 40 26 1 0 0 1 20 14 0 0 39 0 0 0 0 1 4 12 0 7 1 29 0 5 3 0 6 3 27 12 2 11 0 5 13 0 29 1 0 16 11 
45 44 40 52 76 14 3 10 4 11 0 0 7 4 28 1 12 0 0 1 19 0 5 18 0 18 19 5 5 0 12 0 29 3 35 8 12 3 2 3 9 0 111 3 2 8 9 11 46 15 7 
8 0 3 0 23 0 11 42 27 6 0 0 0 0 0 19 8 7 30 0 0 0 0 0 17 0 15 13 15 0 17 0 5 15 30 21 0 0 0 0 2 26 0 4 0 0 0 1 45 42 0 
0 0 30 0 0 71 27 27 26 22 9 0 10 0 3 16 0 0 0 7 0 0 26 0 0 0 0 25 20 24 0 33 0 35 34 0 0 5 6 7 1 10 34 0 0 40 6 9 7 41 0 
0 0 58 24 0 21 89 0 23 5 0 22 15 8 0 0 10 10 35 8 0 0 0 0 2 7 17 8 0 27 16 35 0 4 0 8 0 0 16 0 1 0 0 18 1 0 31 0 0 0 51 
0 0 5 0 31 19 0 11 0 37 8 0 10 19 15 0 0 0 17 2 0 10 6 0 0 24 0 0 0 7 20 0 0 0 0 2 14 0 11 0 3 6 0 8 0 9 20 8 4 28 6 
5 0 0 11 6 15 17 0 0 0 6 0 0 29 3 0 0 39 0 28 0 0 25 11 0 0 0 5 10 0 3 0 10 0 17 12 30 0 3 0 0 0 52 0 2 0 0 25 0 0 0 
16 0 18 0 0 0 0 0 0 0 19 4 27 0 0 16 16 0 26 0 0 19 6 0 16 0 0 0 6 19 7 25 5 0 0 4 0 0 1 27 0 0 5 8 26 17 9 0 16 21 21 
11 16 0 0 21 0 0 0 11 34 6 13 4 0 50 1 0 28 1 0 11 0 12 5 28 8 12 0 2 25 0 1 0 8 30 0 16 0 5 22 3 11 1 0 0 3 0 21 3 46 8 
0 0 0 47 0 11 5 26 0 11 12 9 0 0 5 0 0 15 0 0 9 0 17 0 61 0 0 0 0 0 3 1 21 2 0 0 0 0 0 0 0 0 17 0 6 0 22 11 0 4 57 
26 0 0 0 33 23 0 5 16 24 0 0 5 0 0 0 0 21 0 11 0 0 0 0 34 34 0 0 22 0 10 0 18 13 16 9 0 33 21 0 4 6 42 4 12 35 13 7 0 0 0 
13 0 22 0 0 35 35 0 46 6 34 11 37 32 27 25 12 0 17 18 0 0 1 0 30 0 1 3 28 20 0 16 14 17 0 4 0 18 5 0 35 5 0 12 5 20 18 0 0 17 1 
56 0 8 4 28 0 0 11 32 0 4 2 43 8 0 0 0 27 0 0 29 0 0 6 2 15 16 0 0 15 20 31 0 3 0 0 0 14 0 0 0 0 34 0 9 0 0 35 2 0 13 
0 0 0 37 0 36 44 0 17 0 23 25 2 0 2 32 34 7 17 0 26 10 0 0 4 0 0 0 0 17 6 10 0 23 0 17 7 22 0 10 34 36 6 0 0 0 12 18 0 0 49 
17 26 0 17 0 31 16 5 5 27 9 0 5 27 5 37 0 23 0 27 2 0 0 0 26 42 0 13 4 10 28 7 24 0 3 4 25 40 0 0 23 38 17 4 24 8 10 0 2 0 25 
