51 29
0 0 0 0 24 40 46 0 23 0 0 0 0 0 0 0 0 0 0 0 19 22 1 14 0 0 4 0 40 20 13 0 0 23 17 19 0 0 6 0 4 35 0 0 34 40 0 0 0 20 0 
14 2 0 30 4 14 3 62 29 9 0 0 13 0 6 44 22 0 0 7 12 0 0 7 15 16 0 0 5 0 14 16 12 0 36 8 0 0 0 25 17 0 0 23 0 2 39 34 0 14 0 
90 1 0 0 34 26 0 21 34 0 0 9 0 10 14 0 32 0 0 0 0 0 5 4 20 0 0 10 22 0 0 26 0 0 0 9 0 0 0 25 0 1 50 0 44 0 30 47 0 12 31 
0 0 0 0 11 1 0 0 0 0 9 0 0 37 2 15 49 0 13 15 0 2 4 11 17 21 9 0 13 2 15 0 6 4 0 24 0 0 24 0 0 17 0 27 15 12 0 23 0 0 20 
5 0 11 16 1 22 0 22 8 0 15 18 21 13 0 41 60 0 20 26 9 1 1 12 16 11 0 0 23 10 6 16 16 0 12 17 0 25 26 21 16 15 12 21 10 0 12 31 18 0 0 
78 25 36 11 26 0 17 0 7 7 13 39 17 29 19 35 11 14 17 25 20 3 18 41 0 16 6 0 3 44 0 3 0 0 12 10 19 9 0 11 0 16 2 0 58 52 2 35 25 0 45 
2 0 42 35 36 0 10 52 0 0 0 3 9 33 0 0 6 9 32 0 13 29 8 7 9 0 8 13 36 0 3 19 15 39 5 0 0 0 86 0 50 0 0 27 0 0 3 15 0 45 19 
42 0 0 34 18 0 0 5 52 23 30 6 3 0 3 46 0 0 21 20 21 10 0 0 0 20 0 0 0 13 0 4 11 3 15 0 21 17 0 8 30 0 29 35 0 11 13 0 12 0 30 
11 23 0 39 5 0 0 0 0 34 14 0 0 16 1 2 15 0 20 7 20 4 0 6 23 16 0 10 0 20 28 0 0 0 13 18 11 0 8 18 2 17 39 1 6 0 0 6 0 0 3 
34 0 0 11 0 35 4 0 7 0 0 34 1 0 37 1 4 0 0 0 1 42 0 2 13 0 0 0 15 0 27 0 0 21 31 0 12 4 0 0 32 22 15 16 23 0 4 0 49 5 0 
6 0 32 39 0 0 0 0 0 0 10 0 19 14 6 11 13 0 0 0 28 1 13 0 7 0 0 0 19 6 14 21 7 2 37 16 0 0 0 0 0 17 46 0 14 0 2 19 16 0 5 
5 0 28 0 0 0 11 0 0 10 37 14 0 37 0 6 24 0 5 0 3 53 8 0 0 0 0 0 0 30 28 4 5 0 13 10 0 0 0 0 24 0 0 14 0 0 6 63 0 0 9 
13 22 11 0 36 0 0 5 0 18 7 0 0 0 1 10 23 7 0 9 15 5 1 3 0 0 0 6 33 0 4 0 13 10 4 7 36 0 0 0 0 0 0 0 0 11 0 2 0 8 0 
12 0 0 3 29 17 19 0 0 0 21 0 2 0 1 6 4 1 8 0 0 2 8 12 25 0 7 0 0 11 0 8 0 7 0 0 9 27 2 8 3 12 0 3 0 0 42 25 0 28 0 
44 0 0 0 41 0 33 0 0 0 0 0 28 8 42 0 0 48 20 20 23 0 0 23 0 0 22 34 7 0 17 4 0 17 0 16 13 0 7 59 20 27 24 0 27 7 6 3 0 38 0 
43 0 0 0 12 30 43 0 0 0 12 14 37 0 12 26 0 35 0 22 0 0 5 0 0 33 0 22 4 0 0 0 0 0 0 13 0 10 32 0 0 26 0 69 68 0 0 0 5 76 10 
2 0 5 0 14 43 37 3 0 34 18 30 41 0 22 44 25 7 0 27 9 14 0 10 3 10 21 12 13 21 16 0 27 31 1 1 0 7 28 30 0 14 22 0 16 23 70 7 42 24 16 
0 8 1 56 8 0 0 7 0 39 0 0 8 6 14 18 5 0 3 11 19 19 0 0 23 0 10 11 25 28 0 4 0 0 26 0 0 0 0 0 8 0 0 41 97 0 27 0 39 0 0 
0 46 8 0 0 0 13 0 17 33 28 0 22 0 0 0 0 19 10 15 31 0 11 32 0 0 0 12 22 19 16 25 12 11 22 0 23 0 0 19 17 4 52 0 1 16 16 0 66 0 0 
54 21 9 33 7 3 23 23 4 5 3 5 19 15 18 19 1 10 0 16 13 9 5 0 0 18 15 7 12 23 55 10 4 1 40 49 44 18 4 23 25 66 26 0 0 0 12 0 76 0 22 
13 13 14 22 0 0 25 0 11 4 3 1 0 3 13 0 31 17 14 0 0 0 0 0 6 22 5 12 2 0 0 50 16 16 4 0 0 0 34 0 0 18 0 14 0 0 42 0 1 34 0 
31 7 0 0 4 0 5 0 90 20 6 27 6 0 47 29 13 11 0 0 0 0 0 0 0 0 17 0 10 0 16 26 0 2 27 0 6 0 6 9 17 27 0 30 14 37 0 0 2 0 0 
0 37 0 35 0 3 0 25 0 4 13 16 7 4 10 0 0 0 16 0 18 1 0 0 6 2 0 14 25 0 15 0 6 10 0 28 17 2 16 6 2 2 18 0 0 9 0 4 0 0 0 
0 0 25 0 0 0 0 21 37 24 18 30 7 0 12 19 7 0 0 0 0 24 31 0 0 17 8 0 5 0 0 0 12 1 35 0 0 0 0 10 0 30 17 1 11 24 9 0 0 10 0 
0 0 16 23 3 0 19 3 7 40 21 0 3 30 3 0 32 29 31 0 12 0 8 0 0 19 25 0 8 0 22 0 13 0 0 22 69 0 0 2 6 25 39 23 30 4 1 0 68 36 0 
0 0 0 17 5 0 30 0 7 0 0 0 6 20 11 7 0 13 0 0 39 0 0 0 22 0 6 3 2 21 24 0 4 20 0 11 11 0 0 40 8 6 0 21 0 0 31 2 0 0 21 
0 24 162 0 21 0 0 0 13 19 20 10 32 0 0 0 0 5 0 0 0 23 0 19 42 12 2 5 19 27 20 29 5 19 5 39 0 8 9 24 0 0 59 0 41 10 22 5 46 47 0 
0 0 0 0 8 25 0 0 38 36 13 0 1 16 0 34 0 5 26 10 0 0 0 0 37 7 4 0 0 0 6 0 9 4 0 0 0 44 26 25 0 36 0 0 0 35 39 32 0 17 0 
0 2 23 5 9 0 0 9 0 0 3 0 0 0 0 5 2 0 28 0 9 0 5 0 0 23 0 6 21 0 5 12 0 0 0 5 0 0 0 0 0 0 18 12 0 25 0 0 0 12 0 
