51 29
0 0 51 12 4 0 32 2 29 20 8 9 0 12 41 0 6 0 0 0 11 0 15 15 1 0 0 8 14 0 0 0 15 0 28 11 11 0 0 23 0 8 24 0 36 0 42 0 0 0 22 
13 0 42 16 53 20 0 7 1 9 0 0 2 21 3 32 19 0 30 0 4 0 16 0 4 0 22 0 0 17 9 0 1 12 21 0 20 30 16 21 5 0 0 0 17 0 17 32 30 0 0 
24 0 0 0 4 0 0 38 25 33 5 0 24 0 14 0 2 0 0 0 0 10 22 9 0 0 0 0 27 21 0 13 9 0 8 8 22 0 0 0 0 0 22 0 9 55 0 5 16 0 14 
9 0 0 3 34 0 3 0 0 3 0 13 2 10 20 0 7 5 0 22 1 13 17 10 27 0 6 0 7 12 8 9 1 6 10 0 32 0 9 1 0 0 0 0 0 0 0 11 14 2 0 
14 45 35 0 1 0 28 0 33 48 10 0 0 0 0 32 36 0 9 31 19 0 30 14 0 10 20 9 0 15 0 9 0 27 45 55 11 35 34 28 5 29 2 10 11 0 27 4 48 16 5 
10 0 47 0 2 20 0 0 18 0 19 0 18 6 0 20 20 5 18 0 21 0 0 8 0 9 22 9 0 0 22 2 0 16 0 20 18 7 53 21 10 9 27 0 0 0 6 44 37 0 0 
0 0 0 25 41 61 28 33 0 0 8 0 0 0 0 0 25 0 7 19 2 0 27 0 1 0 0 0 10 13 0 28 0 0 28 0 0 30 0 11 1 4 0 38 0 40 2 0 0 6 46 
35 0 0 43 0 0 36 41 0 0 28 0 4 10 22 10 11 19 5 52 0 27 20 0 16 17 0 6 15 0 0 5 12 1 21 32 55 10 0 0 0 11 46 33 0 0 43 0 68 0 0 
0 2 63 0 4 36 0 40 68 10 22 17 15 23 0 0 17 16 29 0 10 18 41 0 18 16 16 14 11 5 12 30 28 19 27 2 9 29 33 0 0 12 0 6 0 11 17 29 31 22 55 
0 18 0 0 23 0 0 0 1 2 0 2 0 30 0 0 18 0 0 15 0 7 0 12 14 0 6 23 7 0 8 1 0 15 5 1 1 0 11 0 0 0 0 30 9 3 0 11 0 16 13 
0 15 1 21 8 0 0 4 0 0 5 10 6 11 0 0 22 0 6 0 0 31 9 16 0 22 0 29 14 0 0 5 0 0 0 6 0 0 11 0 0 11 21 0 0 0 0 0 0 0 0 
1 16 3 30 21 0 30 27 9 0 0 0 4 6 1 1 0 0 0 0 0 2 11 0 7 21 0 0 28 17 20 8 0 30 5 4 21 0 0 0 4 17 12 30 0 7 18 0 0 0 0 
7 0 12 0 18 0 19 0 0 0 0 2 0 12 12 15 10 0 4 11 6 0 29 24 23 21 29 5 0 0 0 0 14 15 13 0 12 15 3 7 0 0 0 0 0 24 7 58 49 2 59 
0 30 0 44 0 0 0 25 61 16 25 0 0 0 15 27 0 13 7 0 0 7 0 23 0 12 17 3 34 0 10 39 0 0 15 46 13 29 11 0 33 1 51 0 12 0 5 27 0 3 4 
0 0 0 0 0 0 18 26 3 6 34 0 0 0 0 0 25 28 0 6 0 7 29 58 12 15 17 17 8 0 0 19 0 54 0 5 13 12 12 11 23 24 0 7 0 21 3 0 0 0 28 
33 61 30 0 34 25 52 0 7 8 29 0 10 15 0 0 0 25 3 32 15 0 16 6 0 0 4 0 0 12 7 2 15 26 23 0 0 0 6 37 0 30 30 1 71 0 0 21 0 0 31 
0 0 37 24 0 0 0 18 0 0 0 23 0 0 16 10 12 0 4 0 0 18 10 0 0 8 0 42 0 0 0 0 0 0 0 0 17 0 0 55 0 0 0 0 0 9 0 33 0 10 3 
6 4 0 41 0 4 2 0 8 14 4 0 0 29 0 0 0 7 0 0 0 0 0 0 0 6 0 20 21 7 15 4 15 9 21 17 24 7 10 11 7 10 1 6 0 0 0 30 7 14 4 
50 0 4 28 0 33 14 0 0 11 11 0 0 13 18 0 8 0 0 2 0 4 3 0 18 10 3 8 5 7 17 28 3 9 9 7 0 37 16 0 13 0 0 0 3 7 23 15 0 7 3 
0 1 48 4 3 0 0 46 19 3 0 33 22 0 0 0 33 0 0 30 0 17 0 4 16 17 18 0 3 9 0 0 16 73 16 0 13 24 37 0 0 10 12 1 35 17 30 50 0 3 14 
0 0 0 0 0 0 6 7 0 0 39 0 6 0 0 0 19 0 4 0 0 2 0 11 20 0 0 5 18 0 0 15 5 0 11 2 1 1 15 0 0 0 0 0 0 0 5 0 0 39 12 
6 44 0 2 3 26 21 39 0 0 0 0 11 0 10 0 0 18 0 9 0 0 7 13 0 0 30 31 9 0 15 0 0 13 7 9 57 4 3 16 35 11 16 7 3 37 5 0 0 0 3 
16 8 3 25 20 22 0 0 12 16 38 0 0 0 0 0 28 13 10 11 0 14 4 0 0 12 0 12 11 20 11 15 0 0 6 7 0 0 10 10 0 0 16 0 0 0 18 1 32 16 13 
0 18 0 2 20 0 14 0 4 27 18 32 31 0 0 0 0 35 0 9 59 0 0 4 0 19 0 26 18 0 24 0 15 29 5 3 0 0 0 0 6 0 0 63 0 0 6 6 0 29 34 
36 0 7 0 0 9 16 11 0 0 13 16 22 0 0 0 0 0 0 0 0 0 60 27 25 1 45 0 32 18 0 16 10 8 0 9 29 0 4 0 7 35 4 7 22 0 0 0 19 0 1 
22 26 1 3 0 20 0 19 8 21 34 0 0 1 10 5 41 0 0 17 0 2 22 9 8 30 9 39 0 0 16 0 9 0 13 5 0 0 0 0 37 10 3 0 0 29 0 0 7 52 0 
24 14 0 77 4 24 21 4 84 8 2 6 28 32 19 38 11 13 0 29 19 6 0 13 17 19 0 17 51 46 0 0 0 89 0 3 14 12 38 21 0 63 0 35 31 0 18 0 28 38 47 
6 6 0 18 4 2 42 2 0 18 18 0 31 0 0 21 3 0 65 0 12 5 1 6 0 22 43 11 26 4 0 0 12 4 25 0 14 36 0 0 5 11 0 31 0 1 0 50 35 31 11 
0 1 54 0 25 0 0 6 6 4 1 1 0 0 15 8 28 10 0 21 0 13 0 6 14 0 13 25 0 0 13 16 0 0 14 0 0 0 0 24 0 9 37 0 0 0 0 13 0 3 0 
