51 29
21 0 25 17 0 49 13 13 0 0 29 0 0 28 0 0 9 0 0 35 38 60 0 0 33 24 7 7 0 18 10 23 0 0 9 7 11 0 26 29 39 51 4 1 24 14 0 0 0 47 0 
26 46 0 0 0 6 0 0 30 11 17 0 0 24 8 0 0 0 2 0 5 6 8 50 0 18 11 6 27 0 0 0 0 0 0 20 17 9 42 0 0 0 4 0 19 34 1 22 0 26 0 
17 56 8 6 27 0 30 22 0 0 8 38 0 2 45 23 53 7 0 16 6 11 0 0 36 0 16 0 21 20 0 0 42 7 0 0 0 0 0 0 0 0 0 27 0 0 0 27 0 23 0 
0 40 0 0 14 38 0 15 0 44 0 0 0 0 0 6 8 0 0 0 5 19 8 7 8 1 6 0 35 25 24 0 5 22 0 1 5 8 0 2 0 13 30 23 6 0 15 38 0 7 17 
11 0 14 4 13 9 36 7 56 39 0 33 0 54 1 22 10 0 0 0 0 10 0 18 0 2 10 22 0 0 0 4 24 0 28 1 0 0 37 0 32 19 33 0 80 0 0 0 39 31 20 
35 29 39 29 20 3 43 40 27 32 0 40 12 23 1 47 41 2 1 14 24 15 11 15 9 36 28 0 13 19 2 0 9 0 8 24 16 0 7 7 0 89 11 0 30 21 9 36 19 28 8 
0 16 0 19 35 0 0 34 0 5 0 3 5 0 13 0 0 8 0 21 0 0 25 1 33 6 10 9 0 6 0 5 9 0 16 21 51 0 0 0 8 17 0 21 12 0 0 12 0 15 12 
0 0 20 0 15 1 0 9 56 7 0 0 0 13 0 6 3 1 0 0 49 9 25 3 2 0 2 10 8 13 0 0 5 0 0 34 15 10 11 0 0 0 0 0 5 0 0 36 0 0 30 
9 0 0 10 36 11 1 29 0 17 0 0 13 0 23 26 0 0 72 6 28 0 12 0 0 0 0 8 0 6 18 0 0 15 27 4 1 26 0 0 42 26 13 39 15 3 13 6 30 0 10 
4 34 13 0 36 6 30 0 0 18 1 0 12 8 25 13 45 0 0 0 2 13 0 0 7 0 6 0 0 0 51 0 0 25 11 34 28 0 0 36 0 6 0 0 6 11 46 43 0 19 31 
40 0 13 0 4 0 0 0 6 5 0 26 0 20 1 0 0 17 2 0 29 3 0 0 0 0 12 22 0 0 0 0 0 20 5 0 10 33 0 0 43 0 0 20 0 0 3 0 0 15 0 
0 11 0 0 2 0 0 7 0 5 0 0 5 15 20 12 0 0 6 11 2 2 25 0 0 0 13 28 0 0 0 13 0 9 1 0 0 9 0 0 1 0 0 11 1 26 0 34 0 0 17 
46 0 32 20 23 12 41 58 0 3 0 9 18 3 0 0 2 0 2 27 1 8 4 14 10 15 0 23 7 12 0 0 0 0 68 0 3 3 7 32 23 0 0 43 5 40 9 41 0 3 8 
42 0 18 11 5 30 0 50 15 17 34 19 7 37 0 42 0 0 27 1 6 10 20 25 14 7 23 3 0 9 11 18 0 15 0 34 10 48 10 15 2 0 32 13 39 0 2 0 12 7 27 
22 12 1 32 24 30 0 14 0 18 0 0 12 30 0 0 2 8 0 14 0 27 36 16 0 19 0 18 8 8 0 0 0 1 31 10 13 2 0 1 6 6 0 0 14 9 0 0 26 0 37 
51 31 4 2 42 8 27 0 0 23 6 8 20 9 0 23 13 0 0 6 0 5 17 0 21 0 32 3 7 0 4 12 11 16 0 4 0 7 33 7 11 0 16 12 11 0 46 10 7 45 55 
0 11 51 31 0 6 13 39 0 0 7 6 0 13 5 1 2 30 11 50 8 15 11 1 0 0 3 21 1 0 0 0 0 0 45 33 15 35 24 0 0 20 0 6 25 5 39 51 0 17 5 
9 48 0 0 15 0 38 1 8 14 1 4 4 0 0 13 5 6 0 15 12 0 11 0 2 8 0 0 0 19 15 0 4 3 0 5 23 0 5 0 5 1 0 0 51 0 27 23 19 36 21 
21 27 12 9 34 28 0 10 1 27 6 0 0 0 0 12 6 33 0 0 0 35 15 0 0 4 2 19 0 18 14 11 15 17 0 61 0 0 0 15 6 0 0 0 56 6 13 23 32 0 0 
3 6 0 0 0 36 0 0 0 1 44 7 0 0 0 10 0 18 3 17 0 5 2 7 0 24 0 7 0 15 8 0 0 0 19 14 0 0 9 14 0 0 0 50 23 35 0 8 0 0 0 
16 2 2 0 16 0 0 15 29 0 0 0 0 5 0 0 0 0 0 0 0 37 12 24 19 15 4 0 2 35 6 0 0 9 0 14 0 10 0 0 26 0 0 14 0 0 0 24 0 0 0 
0 0 8 0 35 39 0 0 0 41 0 0 0 0 0 0 0 0 0 6 11 0 60 3 0 0 23 0 0 8 21 17 0 0 0 24 6 15 0 35 0 19 19 0 39 4 0 12 43 19 41 
43 27 12 23 25 22 0 26 11 14 0 22 0 0 0 5 9 13 3 6 0 3 0 6 10 12 0 10 0 0 0 0 4 22 0 1 16 1 35 0 1 1 38 63 3 0 0 0 7 0 0 
70 0 0 0 0 0 0 17 16 0 0 2 0 0 7 30 0 0 0 11 15 10 0 0 41 0 0 0 5 0 0 0 6 2 13 14 3 0 0 0 8 19 3 0 0 30 46 0 9 0 0 
23 8 24 32 0 27 22 16 19 33 0 0 16 33 0 0 15 0 0 25 3 0 47 12 4 1 36 12 2 0 1 19 27 0 18 5 0 15 3 0 6 0 14 0 36 0 41 0 3 0 28 
0 50 14 0 18 0 40 72 4 17 7 2 0 36 0 23 14 13 0 0 12 0 14 30 14 20 11 0 22 0 0 9 25 9 0 11 14 3 31 0 39 35 0 0 17 0 0 40 0 0 10 
0 0 24 0 0 0 0 1 11 0 32 0 54 16 0 22 17 0 0 15 0 0 18 28 0 0 24 7 6 7 0 0 4 13 0 0 21 0 56 0 7 23 35 6 21 0 21 0 0 0 38 
0 22 36 0 13 20 3 21 0 33 0 7 15 0 11 1 0 2 20 13 29 15 17 0 18 10 21 16 1 8 24 16 10 18 0 0 0 8 3 30 5 27 0 0 0 5 26 21 41 0 0 
0 5 0 0 22 1 26 34 6 2 0 18 27 0 26 0 14 13 0 25 43 0 0 0 0 22 6 21 0 20 34 0 0 0 16 9 0 3 31 23 36 0 0 0 13 0 0 22 4 19 37 
