51 29
10 28 45 45 5 48 16 22 0 0 7 12 0 0 0 13 0 0 0 2 0 12 0 22 0 33 0 39 18 46 9 16 26 18 34 11 0 0 32 26 0 0 0 5 0 0 11 61 45 11 9 
9 0 0 0 57 0 0 0 0 0 0 0 13 0 0 35 0 13 10 8 8 0 15 19 0 6 0 10 16 0 13 0 0 16 0 24 24 0 0 0 0 0 0 0 0 0 0 0 48 0 73 
21 17 13 0 23 0 25 14 14 0 0 0 23 0 21 0 0 6 7 10 0 19 0 7 0 21 0 5 29 0 0 19 9 21 16 21 0 0 12 0 0 9 0 0 32 0 21 0 4 0 16 
75 10 11 22 3 0 0 46 59 0 1 39 9 24 0 0 0 0 0 67 0 0 0 0 0 23 1 19 4 4 0 0 9 15 8 2 0 2 0 3 12 28 23 0 7 1 31 0 11 0 18 
0 0 0 31 10 0 0 0 33 0 1 27 0 13 5 5 0 4 0 8 0 0 4 39 21 7 9 3 0 27 0 0 1 23 31 9 14 22 7 2 0 2 0 20 0 24 17 0 0 24 0 
0 0 0 3 0 40 5 0 0 0 11 10 0 17 5 35 1 20 21 5 0 0 0 0 0 4 0 5 5 0 14 11 5 4 0 12 1 22 0 26 0 6 11 1 19 40 0 19 4 15 7 
2 0 23 5 8 0 30 0 20 3 25 0 44 14 16 13 0 0 0 14 0 8 21 4 0 14 3 0 27 8 41 9 1 0 0 0 0 18 21 0 34 37 0 0 0 0 26 3 14 8 0 
0 36 0 18 0 0 13 7 0 0 48 11 0 0 0 58 0 2 1 0 0 17 11 0 0 13 0 26 5 4 0 0 18 0 17 34 2 6 19 0 0 0 0 27 0 0 0 0 53 0 0 
0 16 0 12 0 7 0 0 5 0 0 3 11 29 3 7 0 9 53 4 0 0 22 4 8 0 0 16 13 0 25 0 0 0 0 0 0 0 0 24 10 0 29 6 26 30 28 14 0 0 0 
44 4 0 29 29 7 0 19 27 1 1 0 0 6 20 12 25 11 26 21 20 22 5 15 18 3 0 15 33 15 14 26 28 31 12 12 0 9 76 5 14 7 0 6 44 28 0 42 0 38 5 
9 25 10 0 0 21 6 5 30 44 0 39 9 3 6 25 3 9 12 0 3 3 14 24 14 0 21 26 1 26 0 0 0 0 10 20 18 0 6 0 0 0 0 40 38 11 4 24 5 0 46 
0 48 45 3 7 13 12 35 7 0 7 0 0 0 9 0 0 16 15 10 26 0 7 3 0 2 0 8 5 0 1 7 2 10 0 1 9 0 0 0 8 0 35 0 24 0 3 45 0 37 16 
43 12 6 0 3 0 0 0 26 4 0 23 20 26 18 0 0 0 16 34 0 0 8 0 0 0 17 19 0 20 0 5 21 0 39 15 7 0 2 26 26 4 0 43 0 4 9 0 0 37 0 
10 0 0 0 0 2 6 0 27 0 20 0 5 66 5 13 12 5 8 44 0 6 5 23 1 0 26 0 3 11 20 0 40 14 0 3 1 0 9 49 0 0 0 12 56 15 33 39 48 11 34 
1 1 24 0 13 36 16 12 10 2 0 5 12 0 0 0 5 9 10 0 0 20 6 27 11 8 8 11 21 0 5 0 10 0 5 3 0 32 8 3 10 20 13 26 0 5 3 0 0 21 27 
0 0 13 0 66 0 0 4 25 0 0 10 0 0 0 0 19 28 0 0 16 0 0 52 0 9 3 0 0 0 0 0 0 0 16 13 13 35 0 4 32 0 6 4 0 0 0 6 38 0 17 
10 19 0 40 29 3 2 28 26 0 3 0 0 0 0 34 0 21 8 2 30 6 28 0 5 0 10 0 14 0 0 3 16 4 0 35 0 13 14 0 0 9 0 0 22 42 0 0 22 27 39 
20 8 45 72 21 11 43 51 8 23 11 2 5 13 7 30 41 0 13 19 0 0 0 13 0 39 0 3 18 0 6 5 22 0 27 0 0 4 0 38 0 25 0 27 0 26 11 39 9 43 8 
0 0 25 31 63 40 0 2 85 0 0 13 0 29 57 70 34 17 8 1 0 0 12 7 13 14 20 0 14 8 26 27 25 32 4 5 0 1 25 14 6 8 34 28 18 30 63 0 0 45 34 
34 33 4 0 0 19 4 17 0 0 16 5 42 6 5 0 3 0 0 44 0 0 0 22 0 5 0 0 16 0 16 0 0 0 7 0 0 0 8 29 10 29 0 0 0 1 20 0 0 3 0 
0 6 1 0 3 2 0 1 37 0 43 9 0 14 0 4 20 36 0 25 11 13 7 20 22 27 0 0 0 0 0 2 0 0 13 0 29 3 10 0 0 0 0 0 29 36 0 3 38 8 8 
36 9 0 0 6 2 35 2 36 38 31 0 9 0 13 59 0 0 22 3 0 27 7 25 0 0 1 1 0 0 0 12 15 0 0 9 57 6 3 30 0 2 0 28 0 11 17 22 16 9 0 
3 2 4 2 24 0 0 22 7 15 0 5 37 48 0 5 13 0 0 16 0 22 3 36 33 17 0 13 6 4 7 4 0 20 0 21 0 1 9 0 13 0 4 0 0 32 34 49 8 6 37 
0 0 30 0 29 0 37 8 0 20 27 0 14 9 0 0 0 0 10 7 0 0 0 0 0 39 0 1 17 0 0 0 30 0 30 29 2 31 0 0 0 0 0 5 0 0 10 0 0 0 0 
0 28 0 0 0 0 0 28 5 0 29 6 22 12 5 53 8 0 21 0 0 24 0 0 9 11 0 1 0 20 0 0 6 0 39 28 4 13 34 28 25 0 0 0 2 8 2 22 0 1 0 
11 13 0 17 23 0 0 0 25 26 0 0 3 18 0 0 15 6 26 17 20 3 9 28 8 0 3 25 6 0 6 6 21 0 0 50 15 0 0 28 0 0 0 12 27 13 7 0 17 10 33 
0 16 0 27 11 0 0 1 8 0 0 16 0 0 0 11 16 46 0 0 6 0 0 0 0 0 0 27 24 0 27 2 15 22 27 28 0 27 0 0 0 0 5 0 0 0 0 0 31 0 0 
0 5 0 27 35 0 98 0 0 0 34 0 26 0 7 14 0 0 28 0 14 7 7 7 22 7 0 14 0 17 27 10 11 0 0 0 1 33 20 0 0 14 38 0 38 0 6 0 5 43 16 
25 28 13 0 6 0 5 46 0 0 0 5 0 5 10 0 0 27 31 0 0 0 20 0 18 18 0 0 6 0 0 2 1 14 20 0 26 0 2 0 0 0 4 19 0 77 6 0 0 0 8 
