51 29
17 31 13 40 40 25 16 25 66 8 35 1 38 34 9 0 0 12 14 0 0 0 23 5 26 16 15 15 0 21 26 15 46 12 40 2 0 0 0 0 13 35 38 32 0 83 37 34 21 37 62 
16 0 22 0 4 0 0 0 12 0 0 6 21 45 0 0 16 0 20 22 0 0 0 5 22 31 0 38 0 16 17 0 0 19 10 12 27 0 24 0 30 0 0 24 31 0 20 26 2 16 0 
27 0 28 46 0 0 40 0 35 0 10 62 0 28 33 0 0 13 0 0 6 0 36 0 17 0 3 0 22 24 37 0 0 0 0 5 0 0 7 19 5 23 0 35 4 34 0 17 19 46 8 
24 0 0 42 0 0 24 48 0 1 0 2 2 0 0 0 0 31 6 30 29 28 0 0 21 1 13 24 7 9 4 0 6 0 20 5 12 10 17 0 19 12 13 1 0 4 17 10 19 14 0 
0 15 17 32 0 28 9 0 0 54 24 9 5 19 0 0 11 5 18 24 6 0 0 3 0 18 17 0 32 25 7 0 21 0 28 36 26 0 10 29 0 0 26 77 0 0 0 0 0 22 0 
35 47 29 0 12 0 0 18 0 36 0 41 36 0 23 34 0 1 0 29 40 14 0 0 26 0 1 0 0 21 0 36 4 0 8 14 32 16 18 20 7 0 41 12 4 22 34 0 22 34 61 
77 0 0 32 5 0 34 19 0 26 13 0 0 0 0 24 0 0 0 0 0 37 9 0 31 0 0 27 7 0 0 0 24 0 0 13 0 0 9 21 34 0 10 0 4 0 14 0 0 11 67 
0 16 0 0 22 36 39 0 23 4 0 20 6 0 10 12 0 44 0 0 17 6 14 18 6 16 50 36 0 7 0 3 10 3 11 35 8 10 0 20 0 9 18 26 0 20 2 9 13 0 17 
23 50 0 9 0 0 31 32 0 27 0 0 0 32 0 0 0 0 7 0 10 0 19 0 0 5 38 19 17 9 10 5 15 0 0 5 33 28 2 2 0 0 13 61 0 27 3 25 0 3 0 
3 13 0 0 7 0 0 6 0 41 28 0 0 0 0 0 0 0 0 16 2 0 5 2 4 0 0 8 14 0 7 0 3 0 6 16 0 19 35 1 20 7 0 0 0 0 2 16 0 17 3 
47 44 28 33 11 7 15 0 35 41 22 23 2 34 30 0 0 17 2 11 6 0 6 20 0 32 0 15 0 15 28 0 6 21 20 13 2 0 0 0 9 27 30 35 0 0 0 112 31 7 58 
2 27 0 3 49 23 50 0 60 4 13 0 8 0 0 0 0 6 7 0 19 0 14 4 22 10 8 0 55 0 22 0 4 0 3 0 18 3 32 19 8 0 0 0 0 0 38 0 6 45 0 
38 43 2 16 0 0 11 6 0 43 0 0 0 5 0 29 0 6 5 21 3 0 0 19 30 0 0 0 19 0 0 0 0 2 0 5 55 0 37 0 26 0 0 8 29 0 23 4 0 0 7 
0 0 35 0 0 0 34 0 33 10 3 0 0 0 0 0 0 0 0 0 15 0 8 0 4 7 0 0 0 19 23 5 0 0 0 13 0 0 5 4 34 33 5 18 0 0 0 2 0 2 0 
28 14 0 2 28 0 6 0 0 23 10 30 16 26 0 1 31 18 14 1 7 0 21 0 0 0 17 14 43 6 2 0 20 18 0 26 24 0 0 0 13 30 0 17 22 9 3 31 0 36 0 
94 0 0 4 0 0 32 0 10 0 0 3 14 8 5 7 3 12 0 31 10 8 3 9 4 0 9 0 0 9 0 1 0 5 0 6 0 37 70 0 0 0 25 0 0 14 20 0 0 16 0 
8 0 0 45 37 0 0 23 0 0 5 0 12 0 0 15 0 11 2 0 0 0 8 18 12 16 0 0 8 0 15 13 0 0 0 10 0 4 0 0 11 11 0 0 0 31 31 4 0 46 0 
42 0 0 35 39 0 0 0 42 4 0 28 22 2 25 20 0 0 7 0 30 0 6 0 11 25 20 42 0 17 8 15 12 0 42 33 9 26 8 25 0 0 1 40 36 2 14 0 0 0 30 
37 0 0 74 9 0 0 0 18 0 27 10 58 13 0 3 0 1 9 0 22 9 0 10 0 7 25 0 9 0 16 0 17 0 31 0 13 11 12 3 0 6 2 0 2 0 52 0 0 0 18 
74 61 2 0 32 0 42 0 31 58 13 0 1 0 0 15 4 1 26 0 0 0 30 5 25 0 22 22 0 3 3 2 10 9 18 10 9 49 0 0 43 0 1 0 1 45 38 21 37 22 13 
11 46 37 1 1 0 14 0 29 0 0 18 0 15 0 0 0 20 16 0 0 0 3 24 4 19 0 0 24 2 0 0 0 0 0 0 0 19 0 11 38 0 5 0 39 0 0 24 47 20 0 
0 1 0 30 1 2 11 2 27 0 5 14 33 6 0 7 0 15 0 11 11 25 8 40 0 11 13 10 18 20 0 11 23 0 28 10 0 0 0 7 0 5 25 0 0 0 22 1 49 17 0 
7 14 65 0 0 0 0 0 4 0 4 9 4 0 14 2 0 2 0 28 9 0 0 0 0 23 0 0 0 0 16 1 0 0 0 7 8 4 3 0 19 4 47 0 0 0 0 29 0 0 20 
15 0 3 27 0 16 16 0 0 4 12 0 0 23 0 15 10 0 22 0 0 11 13 4 0 0 18 0 18 0 4 0 11 0 0 0 0 0 0 0 4 35 2 0 2 23 6 0 0 0 0 
0 41 3 37 3 5 53 15 24 26 15 0 23 0 0 2 0 2 0 20 23 24 37 3 4 31 6 2 0 24 5 0 4 0 0 3 0 0 0 15 20 2 46 22 0 0 0 0 0 41 13 
6 22 0 0 0 0 51 19 0 25 0 0 32 0 23 0 0 30 12 6 0 19 0 22 19 0 0 39 0 31 4 25 21 21 4 2 2 23 19 0 0 7 17 0 4 63 0 61 47 0 0 
13 0 43 2 0 0 0 0 11 10 21 0 27 3 6 5 24 0 0 19 6 0 27 0 0 12 0 21 0 0 39 17 0 14 0 0 16 0 0 57 5 2 9 0 0 0 0 45 5 16 0 
0 19 3 0 0 25 24 28 9 0 5 22 8 13 4 4 9 19 0 4 39 2 18 16 14 0 22 19 17 19 0 15 0 0 0 8 29 0 23 8 1 11 0 19 33 0 15 1 55 0 17 
0 1 1 7 28 0 1 0 0 41 0 7 14 0 0 0 0 24 0 31 0 27 19 12 0 4 23 0 25 0 0 0 4 0 0 16 6 33 0 0 0 35 0 11 0 4 25 0 43 0 68 
