51 29
31 13 43 67 34 1 3 67 36 8 21 29 10 4 31 0 14 0 18 0 18 16 15 32 17 21 7 14 20 0 41 17 28 27 5 0 2 30 40 25 35 38 6 18 55 52 0 47 9 46 0 
40 0 30 1 50 0 0 35 36 0 14 0 0 27 0 2 44 0 0 0 2 0 7 0 0 21 0 13 0 0 3 12 54 0 10 0 0 3 1 6 3 25 38 1 75 0 13 7 21 0 0 
8 12 0 52 29 0 13 9 26 10 40 10 0 2 0 0 44 32 0 1 22 8 0 0 14 9 18 35 0 25 0 0 0 15 4 23 2 5 4 38 0 5 5 58 0 0 3 4 9 1 6 
52 43 8 17 34 72 0 0 5 0 14 36 0 11 0 10 0 0 0 0 18 13 16 8 17 22 40 3 28 4 3 0 29 24 0 0 32 0 33 0 0 14 16 0 48 0 0 44 10 0 12 
48 36 15 18 0 0 0 0 0 41 14 0 0 24 5 0 0 0 9 0 0 12 9 49 9 25 0 19 0 15 6 0 0 28 0 0 7 26 0 0 11 7 26 0 0 0 0 14 0 0 41 
0 0 0 2 0 0 12 60 0 7 12 0 14 13 0 0 8 0 12 0 0 5 0 0 25 14 0 0 12 0 0 0 29 3 31 21 1 26 0 14 0 6 33 7 0 6 0 0 0 42 0 
17 5 0 26 38 0 0 2 12 11 1 0 0 4 0 25 4 13 5 25 29 14 19 29 0 19 8 11 7 34 11 12 0 0 11 3 3 6 15 27 26 19 26 0 13 29 0 19 0 39 16 
25 40 0 0 33 0 0 0 0 20 0 0 13 21 7 0 5 0 0 0 5 0 28 0 14 21 14 0 0 27 0 0 0 0 13 0 0 0 0 0 0 31 15 21 0 2 3 0 0 3 5 
0 45 33 0 0 0 13 41 5 0 0 8 0 49 16 18 2 0 4 0 0 21 0 4 6 0 0 14 0 0 0 0 7 53 13 0 0 21 31 0 16 0 0 7 0 0 34 18 0 0 16 
21 2 0 27 0 11 0 0 5 0 6 0 0 19 2 0 5 10 0 30 18 0 0 21 0 0 0 0 3 0 0 0 0 0 0 32 0 24 0 0 18 7 19 0 0 2 0 0 0 30 22 
65 51 0 40 24 40 36 3 15 0 9 0 32 35 15 5 0 0 1 25 0 0 0 0 0 0 36 13 5 0 15 0 14 7 23 0 0 0 0 38 0 0 64 30 39 0 0 42 0 52 0 
43 23 7 0 0 39 0 0 0 7 0 0 0 35 0 0 0 0 0 20 8 30 0 25 14 9 0 6 10 12 0 0 32 0 43 4 0 1 33 20 0 20 0 0 0 0 0 8 31 0 0 
24 58 0 19 5 36 0 12 18 16 10 35 62 0 57 3 13 0 7 12 20 0 1 4 21 24 23 0 7 6 16 20 21 0 34 17 12 1 6 34 8 15 8 31 28 25 0 0 80 11 36 
0 40 0 0 12 0 15 17 2 0 10 0 11 0 0 0 0 0 9 0 40 10 19 5 16 0 0 0 9 0 3 12 0 0 3 0 0 1 0 2 4 0 0 15 0 0 0 0 31 3 0 
0 0 0 0 0 0 0 0 0 0 0 2 45 39 31 0 0 0 6 0 13 0 0 0 14 0 12 12 0 0 18 7 0 48 0 2 9 0 0 0 25 46 0 0 0 0 67 35 15 0 2 
0 0 0 10 19 2 12 0 40 0 21 37 0 0 0 30 6 0 19 19 0 0 4 19 0 11 0 20 6 19 0 0 1 0 0 4 11 12 8 13 0 0 0 0 0 64 12 20 57 9 16 
29 9 30 11 36 23 20 6 2 0 7 39 0 1 12 0 25 14 4 0 12 6 9 17 6 18 0 0 64 24 3 4 9 20 0 17 0 12 12 0 0 25 10 15 0 0 0 0 37 6 0 
8 11 2 17 0 6 0 0 9 5 12 10 0 0 43 13 0 0 10 0 12 17 13 0 1 7 15 30 14 18 2 17 0 4 0 13 33 9 17 6 13 0 5 0 4 0 53 0 39 26 39 
5 0 0 0 0 8 0 47 0 0 0 0 15 13 2 0 8 10 24 0 2 16 0 0 15 18 0 19 0 0 13 11 11 8 0 2 5 1 0 15 0 0 0 18 37 0 4 0 12 3 4 
10 16 15 0 10 0 14 0 0 41 0 0 17 0 5 3 31 16 0 19 0 0 16 14 0 2 5 0 4 0 0 30 0 0 8 0 10 8 0 0 0 0 9 17 0 4 21 44 7 5 14 
7 0 4 13 19 5 27 0 0 0 0 0 12 0 2 0 7 0 0 12 22 7 0 14 2 0 0 0 11 0 17 0 1 16 29 0 0 21 0 11 20 0 8 0 0 8 0 17 7 0 27 
0 0 0 53 0 0 7 19 0 10 21 0 33 44 2 10 4 10 12 0 0 25 0 17 33 7 0 21 15 5 0 11 0 26 13 0 24 24 0 0 16 0 0 0 13 0 21 0 0 11 0 
22 68 17 16 12 0 0 0 0 0 2 26 1 12 0 14 0 33 14 17 52 0 12 1 0 21 20 2 23 25 0 0 31 0 15 6 0 11 0 20 39 0 20 17 5 25 7 0 21 15 11 
51 42 0 2 33 0 40 0 12 23 0 0 12 24 0 0 0 23 13 0 8 3 0 0 18 1 12 19 8 12 0 16 0 0 33 0 22 57 26 16 34 0 0 0 0 5 34 0 0 9 0 
41 5 35 55 0 0 40 0 5 0 0 0 1 0 36 0 4 0 6 9 22 0 11 0 33 17 14 0 1 44 0 0 2 0 0 25 12 47 2 4 21 0 5 37 49 4 0 0 0 8 0 
15 3 0 0 0 59 0 9 0 13 0 0 3 0 0 0 3 0 0 3 26 17 1 0 24 6 0 0 25 0 0 0 0 0 33 43 0 0 8 0 0 0 0 0 0 40 36 0 38 0 0 
29 0 0 43 78 0 10 0 0 0 32 0 6 0 33 0 6 0 21 1 24 0 0 69 0 0 0 12 10 34 13 3 24 49 1 0 35 0 11 0 0 0 30 13 24 27 51 94 13 0 27 
26 0 0 0 8 6 34 14 0 0 1 34 0 33 0 0 7 23 0 33 14 7 0 0 22 0 23 9 7 21 0 0 0 35 15 1 1 26 0 0 61 31 0 0 4 34 22 23 12 23 0 
59 0 2 8 12 1 9 0 0 0 0 0 0 32 0 23 8 0 18 20 25 27 0 0 8 1 0 0 0 0 0 0 0 5 0 0 16 35 16 37 37 28 14 0 0 71 0 0 19 0 5 
