51 29
0 90 26 23 0 47 28 6 0 0 0 0 8 6 0 70 15 0 0 0 0 39 25 0 19 10 51 21 0 0 39 0 0 0 32 25 50 0 20 1 24 24 0 15 52 24 31 0 0 28 49 
32 1 135 35 5 21 17 2 0 4 0 0 13 37 19 22 0 0 9 16 0 0 8 9 1 15 0 2 14 0 3 0 13 3 21 35 6 22 35 23 18 0 57 0 2 27 4 45 39 0 0 
0 0 6 0 0 0 17 45 0 0 0 0 1 11 0 0 0 4 21 18 0 12 61 17 0 0 0 0 42 0 0 0 0 26 0 0 0 0 0 12 17 20 0 21 16 0 43 0 0 0 4 
0 47 0 28 37 22 0 45 40 32 0 0 0 61 0 0 0 0 0 0 39 3 44 0 7 31 0 22 5 25 0 22 10 5 10 0 31 0 9 0 0 32 0 0 24 2 36 34 59 0 43 
0 0 29 3 0 8 0 19 0 0 0 23 20 0 2 0 0 0 2 0 23 15 0 0 0 22 0 12 6 27 13 0 0 0 27 0 15 0 0 9 9 0 0 17 0 0 0 0 0 9 0 
0 39 0 0 0 34 0 65 30 8 13 0 38 0 4 50 17 28 36 9 6 13 12 0 0 0 22 5 12 19 0 0 0 29 16 19 0 9 37 15 0 34 18 0 1 60 28 6 78 10 68 
28 18 59 0 6 21 21 86 0 0 63 6 19 20 2 33 0 33 24 44 3 32 0 0 12 0 5 0 17 0 0 0 0 20 0 36 1 0 11 16 17 0 64 14 38 0 0 12 51 0 0 
0 0 14 18 2 25 2 24 0 3 13 0 5 0 0 6 14 18 0 0 0 18 2 32 19 18 0 1 1 0 25 0 0 0 13 4 31 0 0 4 0 0 19 23 0 0 0 49 0 37 0 
0 33 36 0 72 24 0 0 0 0 9 0 35 5 23 16 0 0 16 4 0 41 5 0 0 0 17 0 0 27 4 27 0 4 18 20 0 8 28 0 28 0 0 29 23 6 0 21 5 45 0 
0 44 15 0 7 15 0 0 0 0 18 32 0 28 31 11 8 3 0 0 0 16 16 10 12 0 32 11 40 0 0 0 9 0 0 0 12 11 3 0 0 36 0 30 4 53 18 0 0 0 18 
40 0 4 7 0 45 4 30 0 6 0 8 0 5 0 4 9 0 28 38 27 24 8 5 17 0 12 0 0 0 10 0 9 0 0 0 0 37 10 0 12 0 0 21 25 0 3 0 28 12 73 
0 41 0 55 1 26 79 9 9 0 0 35 0 0 0 26 0 9 12 23 21 1 0 8 9 0 17 0 10 11 2 26 19 0 0 0 13 0 17 0 11 0 40 31 8 1 10 6 0 0 56 
47 32 1 1 72 8 0 0 0 0 0 34 16 32 0 0 0 18 0 0 20 9 0 11 8 21 0 42 0 16 0 0 8 1 2 0 26 3 7 23 0 0 0 0 0 3 10 1 44 0 8 
3 0 28 0 41 28 58 2 10 10 35 0 0 0 0 0 0 0 0 1 7 20 19 0 0 0 0 0 0 5 28 0 0 0 20 6 0 0 38 1 3 27 22 0 3 76 0 9 13 0 0 
28 5 0 0 0 3 5 9 6 32 18 0 0 9 18 11 9 8 8 8 0 0 0 0 0 0 15 0 0 0 0 0 0 36 14 0 21 0 38 27 7 0 9 0 1 39 7 0 0 0 0 
0 0 26 3 68 9 8 18 0 0 12 29 7 12 0 0 11 26 25 0 0 17 1 0 40 6 9 0 26 11 0 15 11 0 13 0 13 4 0 0 29 4 18 54 4 0 57 18 0 45 6 
0 23 18 2 0 0 1 27 0 31 0 0 0 9 31 27 8 0 15 0 22 0 10 0 32 6 1 1 7 7 12 3 6 3 46 0 7 2 13 2 3 5 34 34 0 5 0 9 0 7 11 
23 36 30 0 52 5 1 0 0 0 9 1 1 22 14 2 9 25 0 0 0 0 21 3 0 8 6 12 8 0 11 0 14 18 6 2 32 69 0 5 48 47 0 6 2 0 0 0 0 8 0 
0 5 44 35 0 0 0 3 0 6 34 5 0 26 0 0 9 0 0 17 0 6 16 0 0 13 0 0 7 5 17 0 0 0 0 0 33 0 13 37 0 31 0 0 0 0 0 0 0 5 0 
0 0 4 2 46 38 29 0 0 0 0 6 23 0 0 2 0 0 0 2 4 2 0 8 6 0 0 0 16 0 0 6 0 3 0 23 19 1 8 6 0 36 0 0 14 0 9 0 0 0 46 
10 0 69 55 0 0 60 0 7 0 0 44 7 0 5 11 26 0 0 40 0 0 27 3 1 5 6 0 16 0 22 28 0 0 0 0 0 35 0 0 0 27 26 0 33 11 5 0 0 20 22 
2 14 0 0 0 0 0 0 18 9 24 0 20 0 36 35 0 0 26 0 0 0 0 20 0 15 13 21 13 19 0 30 22 0 0 0 0 0 0 3 0 33 0 0 0 0 16 0 0 0 17 
25 44 0 0 4 9 9 77 0 10 0 0 25 0 9 8 0 0 0 10 24 0 19 26 0 0 31 0 0 43 0 0 19 0 9 0 0 18 0 0 12 9 35 0 31 41 52 0 0 34 0 
3 2 0 77 24 50 24 35 33 0 9 35 2 0 8 0 14 5 30 1 25 11 1 0 32 2 21 27 24 24 10 7 0 9 0 9 0 13 8 0 16 59 37 40 0 21 13 46 0 8 45 
48 0 64 10 0 61 23 0 15 6 20 5 10 23 10 16 19 8 0 0 0 36 22 7 8 2 22 20 0 0 36 0 0 15 6 59 12 4 0 2 35 21 28 0 42 27 3 0 23 49 0 
43 0 16 0 0 1 0 0 10 0 23 36 0 3 4 0 0 49 7 47 12 14 34 25 5 0 0 29 39 3 8 6 0 15 21 11 0 0 0 18 0 14 35 62 16 25 0 36 71 0 5 
103 29 0 0 0 2 43 0 34 0 15 0 6 10 0 22 0 0 0 23 0 28 0 12 33 7 9 0 13 17 1 31 0 0 0 18 29 0 3 11 8 20 120 0 29 21 13 24 8 69 29 
0 10 19 4 1 34 54 46 20 52 0 25 0 9 1 1 0 7 0 2 41 8 25 0 0 20 0 0 1 15 0 18 0 0 0 0 7 0 4 86 0 3 19 0 0 0 0 0 0 22 0 
13 0 2 9 2 30 58 0 19 51 13 28 41 17 14 7 31 11 0 0 0 0 25 0 0 1 8 18 2 0 11 22 0 26 21 30 39 0 0 28 4 0 11 0 0 28 13 6 0 0 0 
