51 29
2 33 6 26 34 0 60 10 0 19 25 4 0 0 0 0 13 6 0 11 29 2 8 4 0 0 0 26 0 27 4 31 0 0 7 23 9 20 26 5 0 28 11 0 38 0 0 25 2 28 15 
7 4 19 0 17 6 38 0 5 36 28 0 0 3 0 0 7 45 0 0 24 8 1 20 0 0 0 0 0 0 0 0 0 0 1 20 0 0 0 4 15 0 0 23 29 36 36 0 46 0 0 
0 29 14 0 0 12 13 0 51 36 0 6 5 0 13 35 0 25 21 2 7 0 9 11 0 0 9 0 0 28 0 0 0 23 21 0 0 0 0 31 10 7 27 0 2 29 0 0 8 0 0 
36 0 0 24 0 17 18 7 24 0 0 0 14 8 12 19 16 23 72 0 0 0 0 0 18 13 11 0 23 16 0 0 0 0 18 18 0 0 0 21 0 1 6 32 0 11 0 1 4 25 21 
48 7 46 0 0 4 49 11 9 2 0 4 12 0 0 48 0 39 27 2 20 16 36 0 13 21 0 13 48 12 0 0 21 27 0 0 0 48 7 0 5 15 82 0 21 41 0 7 46 0 0 
17 22 18 0 0 24 3 0 9 10 0 0 35 0 14 0 0 9 11 22 19 0 0 8 0 0 0 0 3 24 0 0 0 0 7 15 0 29 18 1 0 30 0 3 0 0 0 11 0 0 3 
0 6 0 0 11 0 23 9 0 4 5 18 30 29 0 0 10 16 5 10 0 16 44 0 0 15 10 0 0 19 8 21 10 23 0 0 0 15 16 0 15 20 1 5 6 3 16 0 13 0 40 
13 46 77 0 17 12 0 0 57 0 1 0 4 23 0 17 0 0 8 0 20 17 0 3 28 12 33 0 0 0 10 5 0 0 0 3 0 24 0 19 28 0 34 0 21 21 0 46 1 0 0 
12 48 0 0 45 12 0 0 1 50 39 22 5 5 12 23 29 43 16 0 5 30 0 2 1 22 12 6 25 9 36 0 0 16 17 4 1 37 9 9 10 11 9 13 14 38 16 0 8 93 21 
72 0 0 0 28 0 14 0 25 0 8 0 30 2 1 39 0 2 8 19 21 0 9 2 0 0 15 9 17 7 0 0 7 58 20 0 36 0 11 0 0 47 30 39 0 28 0 0 0 12 13 
45 0 0 0 0 0 33 0 0 10 0 0 9 0 0 0 11 0 32 0 21 4 11 0 0 4 0 6 0 16 0 0 9 0 51 0 0 4 0 31 0 21 0 0 15 0 0 0 0 0 33 
0 4 41 0 0 34 84 0 0 35 5 0 44 16 25 5 0 0 8 13 0 12 9 2 0 23 0 0 37 8 15 0 23 2 17 12 3 0 17 33 1 16 0 46 0 6 0 0 7 0 38 
0 22 25 9 0 0 0 0 2 12 2 16 0 20 24 23 0 0 16 0 25 8 7 26 0 20 22 0 17 18 18 14 2 0 7 0 0 0 24 35 10 0 4 0 0 42 44 8 25 34 27 
9 19 0 0 0 0 11 9 0 0 6 41 7 0 28 0 25 6 1 0 8 14 28 12 0 0 0 0 0 3 0 30 3 9 0 5 0 36 0 0 10 33 12 8 6 34 5 0 0 0 24 
37 2 0 0 59 3 36 0 0 21 0 6 0 11 9 15 21 25 0 0 0 0 18 19 0 11 8 11 0 7 4 0 19 33 12 13 5 44 0 10 48 0 5 11 0 71 0 0 21 0 18 
53 0 3 8 0 0 4 18 6 49 0 10 0 7 0 0 0 3 5 0 0 0 0 3 11 54 0 0 1 23 0 0 0 22 25 1 0 0 4 0 0 13 9 34 0 0 0 47 0 40 0 
0 10 40 0 27 0 80 26 0 7 0 10 12 19 34 5 0 47 8 50 24 10 3 40 5 14 30 20 1 0 0 0 49 11 6 48 0 19 24 14 19 18 30 4 15 20 2 0 7 16 0 
0 39 0 5 20 64 44 12 4 0 10 0 12 3 0 0 0 29 0 12 3 19 7 2 12 1 4 13 0 19 4 5 18 11 0 15 0 11 0 0 58 0 35 0 28 0 53 0 5 0 43 
11 6 4 31 0 0 20 0 0 0 14 9 0 8 0 16 0 1 12 0 6 0 5 11 14 0 9 13 0 18 1 0 10 16 21 1 0 10 0 12 0 0 12 0 0 0 11 6 0 0 0 
36 0 66 43 0 0 0 0 0 32 19 1 8 4 0 0 17 15 0 6 2 19 16 31 0 0 3 0 0 0 1 0 0 0 0 0 0 0 3 0 0 1 12 0 6 11 93 0 0 15 27 
2 0 26 0 20 15 29 7 10 48 0 3 56 0 6 17 32 31 45 0 41 13 10 18 25 9 0 0 12 9 2 20 32 1 4 14 0 20 11 10 7 20 2 0 0 0 28 35 27 15 30 
0 0 21 0 0 14 0 0 28 0 0 17 0 1 0 0 0 0 0 14 31 1 33 21 0 0 0 0 0 0 1 0 0 22 0 20 21 0 0 9 0 0 0 0 21 25 5 0 0 12 0 
27 3 0 2 17 74 18 0 33 38 6 0 0 35 19 19 0 27 0 6 5 38 0 0 7 0 26 0 2 0 7 6 0 0 28 0 0 2 5 19 32 0 0 29 1 0 2 42 0 0 4 
2 0 0 8 28 9 14 0 3 17 0 26 0 6 0 15 7 1 46 6 0 0 0 17 0 0 0 0 35 31 0 9 0 0 0 24 0 0 0 22 38 0 2 0 16 0 0 0 30 9 23 
0 1 0 38 7 36 16 11 35 0 0 27 0 25 46 17 15 16 50 8 0 0 19 0 14 0 19 22 14 0 0 7 0 13 6 0 0 30 32 0 0 2 0 38 1 7 45 0 30 22 0 
2 20 0 38 0 18 6 16 0 0 0 12 0 3 0 0 30 17 23 6 0 0 5 3 0 11 0 0 15 0 0 0 0 9 7 3 0 3 0 33 0 15 0 9 35 39 31 12 0 3 15 
0 43 0 0 0 33 0 0 11 2 9 13 0 14 0 0 0 0 0 0 0 0 20 18 0 0 0 0 24 0 29 0 0 0 35 0 12 0 26 19 0 41 7 2 3 13 0 21 0 0 4 
19 0 23 0 11 29 0 7 21 7 0 3 3 0 0 23 0 0 0 16 13 0 9 0 0 23 24 0 0 24 6 9 0 0 45 27 30 0 0 27 5 16 0 0 0 0 0 0 0 0 24 
39 4 0 6 27 0 0 18 0 4 50 10 28 9 18 0 0 27 0 0 3 11 33 5 20 2 6 0 17 9 0 9 23 0 18 0 6 3 28 41 18 39 13 6 20 0 0 0 0 4 38 
