51 29
12 4 0 6 4 0 22 19 52 0 9 8 0 3 0 6 57 0 3 6 14 0 31 0 0 0 0 29 23 15 0 0 56 6 21 0 0 0 0 33 0 16 0 0 56 6 19 6 1 0 34 
21 0 33 87 11 0 17 0 0 11 0 24 23 3 30 35 0 0 43 1 11 0 0 7 0 4 13 0 1 0 0 15 18 23 0 7 0 0 0 56 21 0 6 5 41 1 23 0 7 6 0 
32 0 19 56 13 0 0 0 0 0 56 26 61 0 0 15 13 13 0 31 12 3 0 7 4 21 15 0 28 10 0 19 0 23 8 0 33 3 23 2 28 0 0 33 0 15 0 0 0 0 0 
0 0 0 29 0 21 0 0 0 18 0 0 0 8 23 0 0 0 0 20 0 26 0 0 0 0 21 0 0 0 18 5 42 0 0 0 9 70 3 6 9 0 0 0 0 0 16 0 0 0 0 
22 9 20 21 0 0 0 30 0 12 9 0 15 3 7 4 8 22 0 0 0 26 2 0 2 0 0 0 0 0 34 5 0 18 0 0 0 0 0 0 0 9 6 0 21 0 4 0 0 18 0 
0 3 31 84 20 4 0 21 17 0 10 7 7 31 0 12 0 0 6 3 15 0 0 10 47 3 2 26 21 1 0 0 0 41 6 15 12 7 0 0 0 0 8 19 73 0 27 0 12 0 2 
0 1 4 6 38 16 3 6 6 0 22 2 2 22 0 7 22 0 12 0 0 14 9 0 4 1 1 0 2 0 0 21 17 18 19 35 0 2 0 13 0 0 44 11 0 16 0 19 8 4 0 
38 2 0 0 18 0 0 14 8 0 2 0 2 0 7 11 5 6 19 0 0 16 9 17 0 0 0 0 0 3 0 20 0 29 0 0 19 12 38 0 0 0 0 0 14 0 23 0 0 9 0 
4 0 0 0 4 0 27 27 0 31 0 2 12 16 0 8 2 0 0 0 0 0 6 7 12 7 0 6 9 0 20 9 0 18 0 6 0 0 8 0 0 0 0 0 0 0 12 0 0 15 0 
37 7 0 44 0 29 48 0 0 50 16 0 0 0 0 0 14 15 0 0 0 0 0 0 17 16 0 21 21 21 0 0 3 27 60 0 8 14 11 7 18 4 0 34 7 44 0 0 0 16 21 
0 0 19 13 36 0 3 0 4 25 0 0 1 0 4 0 7 6 17 0 0 21 11 26 8 19 4 4 13 18 24 2 13 24 19 50 0 48 35 0 16 3 2 20 43 11 24 15 34 3 53 
27 14 34 14 43 25 28 56 40 6 2 43 21 0 6 0 0 9 0 0 0 0 0 11 0 45 0 23 23 0 10 20 8 32 63 0 76 75 0 0 9 0 5 3 0 20 7 52 0 13 30 
0 0 10 18 0 3 0 4 0 0 0 0 6 0 4 30 15 24 0 0 0 0 0 12 21 0 0 0 16 15 0 7 0 13 5 0 0 0 8 22 9 0 9 22 42 22 0 0 15 0 0 
22 23 0 0 6 23 3 18 12 32 21 35 0 0 23 26 7 13 0 15 12 11 10 1 17 3 21 21 0 0 0 35 1 0 0 4 0 3 0 4 2 6 2 0 10 0 30 13 0 0 0 
0 29 0 36 4 0 0 26 0 12 21 0 0 0 7 2 0 3 0 0 17 20 2 0 3 3 25 7 7 39 0 7 3 26 0 31 6 10 21 5 0 28 0 23 26 17 1 4 0 29 0 
14 0 47 0 0 0 0 18 8 11 0 15 11 0 0 14 13 0 0 4 9 11 0 7 0 18 53 0 0 0 7 4 0 0 18 0 0 22 0 0 0 0 2 0 3 8 4 21 0 70 8 
0 39 12 41 0 23 0 0 0 44 11 16 25 2 5 8 12 0 32 0 0 0 10 20 3 16 0 12 27 18 3 8 21 1 17 0 0 4 13 0 9 22 15 0 4 10 0 0 35 3 11 
8 0 0 8 5 0 11 0 12 6 2 0 5 0 28 7 0 62 0 15 36 1 20 31 36 21 6 7 16 15 26 6 11 5 17 18 0 6 16 10 1 20 16 2 13 21 17 24 0 18 10 
0 4 0 72 0 0 8 4 20 0 4 0 6 0 0 0 34 21 6 2 0 27 20 0 23 0 13 15 2 16 0 0 4 0 1 3 13 13 0 0 13 0 23 2 2 5 36 2 40 12 32 
8 0 0 5 0 42 0 9 0 0 4 16 18 0 9 4 15 0 6 4 23 21 9 1 2 0 2 1 13 0 0 11 10 5 0 1 0 5 0 0 0 0 10 0 16 10 65 62 13 0 0 
0 47 0 0 45 43 0 32 0 0 0 22 0 15 0 26 0 0 0 0 0 8 0 10 0 0 0 0 0 8 19 12 0 0 13 27 1 0 0 10 0 33 0 34 0 0 0 20 11 55 3 
85 10 0 34 18 0 0 0 0 4 77 0 3 9 20 0 36 26 13 25 33 4 0 0 0 13 14 13 7 0 7 35 22 7 14 5 26 47 5 6 40 25 3 42 11 27 16 27 0 0 13 
9 31 0 0 0 12 42 33 0 3 0 0 3 0 0 0 12 0 9 0 0 0 4 17 0 16 0 17 0 0 3 0 26 6 15 0 24 0 0 4 5 11 6 4 27 0 38 1 36 15 0 
3 0 22 25 0 34 0 0 0 33 0 23 0 18 0 31 5 0 0 0 19 19 17 11 0 51 0 18 6 0 17 10 14 0 0 17 14 23 0 15 2 0 2 18 12 8 0 17 0 15 22 
0 19 0 14 0 0 0 0 0 16 0 5 23 26 20 9 0 7 0 0 0 2 0 0 10 1 9 6 4 0 5 0 8 17 0 0 0 19 1 0 0 2 1 1 1 0 0 4 20 28 32 
0 0 0 9 65 0 41 0 46 0 34 0 0 5 23 0 0 0 24 0 0 0 8 25 0 0 0 0 7 0 16 0 0 2 0 12 22 29 16 0 0 0 28 0 12 0 0 60 0 29 42 
35 2 0 0 0 0 0 100 0 0 11 0 11 0 16 3 15 19 1 19 12 11 19 0 0 0 9 13 0 0 0 18 18 0 14 0 1 46 0 0 16 0 1 0 0 38 0 40 0 25 0 
8 27 0 0 17 0 9 0 14 0 0 3 31 0 3 47 14 0 10 0 38 40 27 0 0 0 0 0 22 11 0 2 0 15 0 20 0 24 3 0 7 3 1 0 13 0 0 0 28 37 0 
0 0 3 41 0 39 63 41 2 0 36 0 0 4 43 0 15 19 0 0 1 6 9 27 23 0 19 0 18 0 0 0 0 23 0 9 22 0 0 27 10 35 11 0 2 0 0 0 0 0 4 
