51 29
0 49 0 0 57 34 0 2 42 22 1 42 35 0 0 3 7 0 0 28 0 6 0 4 13 0 0 21 0 0 17 20 4 3 20 5 0 27 0 7 19 25 0 39 22 0 6 0 50 10 7 
0 0 39 17 33 0 0 15 11 6 1 0 8 0 1 0 0 0 19 3 18 0 0 3 45 0 0 17 20 25 0 0 0 0 0 0 0 0 0 27 0 39 0 0 0 0 12 0 0 0 0 
24 0 0 30 123 12 15 0 23 7 5 0 3 23 42 18 24 12 0 14 1 18 28 20 2 25 0 23 17 42 61 44 28 31 5 32 31 0 30 10 1 1 3 4 0 29 0 25 17 0 21 
0 24 0 0 43 0 28 4 38 1 31 30 27 27 46 0 24 1 0 0 12 0 2 0 0 21 0 5 0 0 0 33 11 0 7 39 0 54 2 25 67 35 1 8 32 9 39 39 0 0 0 
0 19 0 47 20 8 15 0 24 0 0 0 3 14 9 11 1 10 0 0 0 11 13 16 0 20 13 0 0 0 0 0 6 17 0 17 0 0 7 0 4 0 38 0 23 5 0 0 0 0 41 
0 3 10 52 14 0 3 30 32 13 31 0 26 66 4 0 17 9 6 0 0 28 1 32 0 12 10 12 0 0 4 4 4 24 27 29 2 18 62 21 2 6 37 19 26 13 0 13 75 28 34 
0 24 0 12 24 0 36 10 20 0 0 18 0 13 0 51 6 0 0 0 0 0 14 0 17 24 0 17 3 1 8 0 0 0 0 0 6 0 0 0 3 26 0 2 2 30 6 0 19 0 12 
0 13 0 44 25 0 0 50 37 0 4 20 0 9 4 2 0 0 0 0 0 6 2 10 0 39 12 0 0 0 0 5 28 12 0 12 3 36 31 0 0 2 41 0 17 37 43 12 0 0 0 
0 29 40 3 4 2 0 0 3 14 25 0 0 2 1 17 11 0 3 2 0 11 0 14 15 0 0 0 0 6 36 12 0 0 0 0 14 0 0 0 0 16 40 11 16 0 0 9 0 39 14 
0 47 0 1 0 44 6 12 29 13 0 0 24 7 1 2 9 0 21 0 3 0 3 0 0 9 1 14 14 5 15 3 8 0 10 9 30 0 35 0 48 1 8 0 78 12 0 0 0 0 0 
0 0 0 86 15 50 44 0 11 8 23 4 2 6 15 6 15 4 0 13 0 0 4 19 8 4 0 4 0 9 0 25 13 3 0 29 2 0 29 0 5 0 6 0 17 0 43 3 37 36 6 
0 30 1 40 0 12 20 35 0 0 41 8 7 0 27 5 2 11 7 36 0 13 0 0 0 1 0 20 5 0 10 0 7 31 13 0 0 9 7 6 15 0 23 11 0 11 0 30 29 19 0 
23 0 0 0 19 0 0 0 23 5 0 12 0 2 0 34 0 0 16 0 0 3 0 44 28 0 24 17 3 25 0 37 0 0 16 0 0 0 23 0 0 0 10 0 6 0 0 0 0 25 24 
9 4 0 5 6 0 0 33 0 9 4 0 8 0 19 36 40 4 0 0 2 6 0 8 6 0 0 10 19 4 16 8 0 18 0 12 0 0 0 9 33 0 1 27 0 10 28 19 42 0 0 
0 6 0 0 7 14 0 1 0 0 5 0 0 37 0 21 32 37 0 0 3 0 4 0 7 17 6 0 0 0 0 31 0 0 5 0 19 0 7 0 0 0 0 18 0 0 0 31 0 0 37 
53 3 37 9 13 20 10 16 68 35 14 0 0 13 0 0 7 6 17 0 10 0 2 33 14 0 14 23 20 0 4 2 0 0 0 25 5 0 7 26 26 0 2 16 24 10 7 0 0 0 9 
15 0 8 0 3 34 41 26 29 16 22 0 29 6 0 6 0 0 0 10 0 46 19 11 6 15 20 21 0 14 0 12 3 11 0 0 1 12 0 16 20 35 4 9 0 31 0 23 0 6 0 
0 15 0 14 8 0 45 20 0 0 4 0 32 0 13 0 15 12 0 26 17 0 20 15 0 15 0 8 0 0 13 27 0 0 0 0 0 17 10 0 14 0 1 37 8 0 9 9 12 0 31 
32 26 31 0 18 0 36 0 15 0 0 0 0 32 13 0 0 24 0 0 20 1 1 15 18 0 2 13 5 1 0 25 0 39 0 6 0 0 3 0 20 0 4 0 0 19 0 17 55 0 0 
1 15 0 51 11 0 32 5 0 43 0 26 0 3 20 11 16 6 0 20 9 7 9 43 9 0 31 0 22 15 0 0 0 12 22 15 40 59 0 0 3 6 33 21 4 23 23 0 2 1 0 
47 0 16 73 17 11 16 32 0 31 5 47 0 3 0 0 0 0 3 47 0 0 0 0 13 25 26 0 11 0 0 20 10 26 16 2 0 1 0 21 8 0 6 0 0 34 0 81 0 0 56 
0 18 19 17 7 0 0 0 68 64 1 0 35 0 0 0 0 30 10 0 0 17 9 17 1 6 0 23 20 5 0 6 5 6 4 0 15 6 3 0 24 5 0 34 6 0 0 20 30 27 42 
0 8 0 17 18 18 77 19 0 22 0 6 0 0 20 0 20 0 4 0 0 0 0 15 20 14 19 0 5 0 0 0 8 0 0 0 0 0 11 0 11 0 15 0 20 39 28 0 0 3 0 
43 3 0 17 0 12 14 22 18 0 36 0 0 26 4 0 0 9 3 0 30 0 0 0 31 0 0 14 10 0 10 0 0 13 0 0 8 0 0 59 4 0 10 43 0 20 36 0 5 25 0 
0 0 40 75 0 9 76 40 2 0 16 5 14 0 0 15 28 37 29 5 0 10 19 0 0 0 0 0 0 0 40 13 20 21 26 18 24 0 2 0 0 59 0 1 31 11 0 7 36 0 47 
48 43 0 0 38 0 7 11 7 0 0 3 0 0 24 0 0 0 15 0 0 0 12 5 0 0 0 0 21 0 0 18 28 0 8 12 0 0 24 0 0 0 7 0 75 0 0 3 48 16 19 
19 0 0 5 1 5 3 6 0 27 0 0 0 24 11 18 0 0 0 10 0 11 7 21 0 0 17 0 0 15 0 23 25 42 0 3 0 0 3 65 1 0 0 0 2 1 10 5 0 0 36 
0 5 27 47 25 17 0 6 60 7 0 20 22 0 10 21 33 13 0 12 0 25 0 0 20 0 0 13 0 28 6 3 0 11 0 0 21 51 0 0 10 0 0 0 22 1 0 39 0 25 37 
0 0 33 0 0 0 26 12 4 58 17 16 2 0 9 0 0 42 0 16 0 0 2 0 32 0 23 0 11 1 30 0 26 22 10 14 0 0 0 18 9 23 0 0 17 3 37 4 31 18 0 
