51 29
62 0 73 25 21 0 55 70 22 0 19 0 4 0 24 0 7 19 0 2 37 18 3 14 0 0 0 27 0 42 31 15 0 1 0 35 6 25 0 7 18 14 32 43 0 0 0 6 42 0 0 
6 0 46 0 2 0 3 26 0 0 0 5 1 0 0 0 0 0 7 0 24 18 0 27 15 0 0 0 0 26 0 15 0 1 0 22 0 20 2 4 0 0 14 0 33 0 0 0 0 24 0 
0 0 0 46 0 16 32 0 14 3 20 15 22 28 0 19 18 0 7 12 0 0 12 0 16 0 9 0 0 0 20 7 0 33 27 0 16 0 41 0 17 6 7 0 0 5 0 0 17 97 12 
5 25 26 2 12 23 19 35 0 41 0 0 0 20 20 8 28 4 30 34 16 6 0 2 8 16 0 12 13 13 0 0 18 37 1 0 0 0 0 0 0 3 6 0 11 0 13 0 31 21 52 
0 19 0 72 64 15 16 19 18 0 10 22 0 20 11 0 6 11 21 0 4 7 0 0 12 0 7 0 0 0 27 6 0 20 0 13 22 24 0 0 0 0 19 24 0 0 21 0 91 1 5 
63 0 0 45 5 40 0 31 25 31 0 19 46 1 3 23 13 0 6 22 0 0 36 9 14 5 0 15 20 0 0 22 0 27 18 0 0 0 9 0 5 6 15 0 0 38 0 102 1 35 0 
14 0 12 0 31 24 0 0 21 13 5 22 19 12 13 0 0 24 0 5 0 19 12 24 17 0 13 2 0 7 6 0 5 9 30 11 9 3 5 26 20 26 0 6 0 11 12 0 0 0 19 
0 21 0 0 1 38 6 0 18 0 5 21 0 32 0 0 0 0 0 0 0 19 40 6 0 17 0 0 0 21 0 0 20 5 12 0 1 8 0 4 18 23 31 0 39 25 12 6 19 0 0 
45 20 36 32 0 0 0 0 22 19 0 0 0 0 7 21 2 41 0 0 0 6 0 0 0 18 0 0 11 6 22 11 17 0 0 32 20 5 30 22 9 8 21 0 0 13 0 0 0 9 67 
8 31 44 0 0 31 16 20 0 28 0 0 4 0 27 13 0 27 0 0 9 12 8 0 0 0 24 0 0 0 24 21 34 21 0 3 23 30 2 0 0 37 6 5 27 2 5 0 19 9 11 
27 0 10 0 0 0 0 4 36 0 20 7 13 19 5 26 49 26 0 31 2 7 2 0 0 8 0 12 8 0 12 10 25 4 0 0 8 20 3 0 5 7 25 31 0 14 9 0 12 0 65 
43 0 0 0 17 0 43 0 29 12 0 58 5 26 0 17 1 15 60 0 0 0 18 0 25 0 9 0 1 3 0 3 28 8 13 4 0 39 7 18 40 0 0 0 22 3 3 23 0 33 32 
46 0 9 0 0 0 43 7 35 9 43 25 19 7 0 16 8 0 0 0 0 0 8 19 0 0 2 6 0 0 5 20 8 22 0 10 2 4 12 0 0 69 21 10 0 1 14 0 7 0 0 
9 0 0 0 37 0 2 35 8 0 21 0 0 0 24 15 0 0 0 0 0 0 0 18 0 0 22 14 0 0 0 21 0 17 0 0 0 0 0 0 10 8 35 0 18 0 0 0 0 35 18 
66 49 0 0 10 11 0 13 1 0 0 0 0 19 0 0 12 4 0 8 0 0 5 9 0 0 0 0 5 9 7 6 5 4 6 0 2 21 6 3 12 0 6 0 0 23 3 47 0 0 55 
0 22 0 6 0 25 0 37 9 5 1 0 0 0 4 4 15 10 0 0 0 27 13 15 0 0 0 23 27 8 34 0 0 0 27 4 2 0 0 11 8 7 10 4 1 5 0 0 58 0 42 
0 48 0 0 7 28 42 0 0 8 0 0 9 0 0 0 0 12 0 13 29 25 25 0 21 1 12 10 0 2 0 17 14 34 1 0 12 14 3 2 0 0 8 9 5 0 12 25 42 77 2 
3 8 14 0 33 3 0 8 6 0 0 13 0 0 29 15 22 0 5 0 0 21 0 0 2 20 0 0 43 10 11 1 0 0 0 24 0 0 0 0 0 0 17 3 19 4 0 0 0 4 0 
30 40 0 0 0 0 0 0 28 23 25 0 9 3 29 1 24 8 12 15 0 1 24 0 0 0 0 30 0 12 42 0 23 9 0 0 5 0 28 0 24 45 1 0 17 4 24 33 0 9 0 
11 20 0 0 33 0 0 45 13 0 0 16 0 0 23 1 2 0 68 0 4 27 19 0 0 0 0 29 5 43 7 1 3 26 30 2 0 19 16 8 41 7 10 0 6 0 0 9 112 0 35 
14 0 4 0 30 0 2 0 77 0 7 38 16 0 10 34 15 7 0 0 14 0 8 0 0 0 0 0 0 0 18 21 1 0 38 0 2 29 0 14 7 0 2 0 18 13 6 0 0 72 42 
29 0 16 3 0 0 4 51 23 0 0 0 0 0 0 0 23 15 0 3 0 0 2 22 0 0 0 0 0 0 0 35 50 7 0 0 13 15 16 23 0 16 0 6 28 2 30 0 0 13 0 
6 39 38 5 38 32 9 26 3 27 35 19 2 27 0 2 15 1 5 17 0 5 0 3 17 0 21 0 0 0 19 0 0 1 11 7 8 16 32 0 5 0 56 0 0 37 0 0 9 0 0 
0 2 0 2 10 11 9 0 11 33 10 4 0 11 0 15 1 30 0 0 17 0 0 0 0 0 17 8 0 0 0 16 0 5 5 3 0 0 0 12 13 31 19 17 0 0 19 46 0 0 0 
0 0 40 12 26 0 11 27 13 2 0 41 28 19 0 17 20 21 0 19 0 0 12 0 0 0 0 6 4 0 26 0 19 12 4 0 20 25 19 0 0 17 8 0 37 43 0 0 0 0 9 
0 40 0 36 0 0 0 32 13 30 0 0 6 0 35 3 0 0 15 0 0 37 0 16 2 0 2 0 20 28 4 16 0 14 19 2 0 0 24 49 0 7 28 4 2 0 21 0 0 0 2 
30 0 36 0 36 18 17 25 7 31 0 16 3 7 8 11 4 13 0 2 0 38 14 17 4 11 15 13 17 17 27 0 1 1 13 0 8 0 16 32 28 41 17 0 4 12 73 0 17 0 0 
17 13 0 0 11 19 2 53 8 19 0 0 0 0 13 0 16 0 0 13 0 21 8 0 19 2 0 25 1 36 1 22 13 0 2 1 0 0 4 5 27 0 15 0 0 0 0 0 0 0 0 
1 65 0 0 25 0 0 24 16 0 0 2 0 0 9 17 27 8 0 18 0 0 22 9 0 0 0 9 4 0 0 7 18 22 27 0 0 31 0 17 0 0 0 17 0 2 0 0 104 1 3 
