51 29
4 20 0 44 4 42 0 10 18 46 0 5 0 3 0 0 29 1 0 31 0 0 17 0 1 0 15 0 20 0 0 13 5 0 0 22 0 11 0 11 5 44 31 12 0 34 4 42 37 40 26 
2 21 2 0 0 0 1 8 18 0 16 0 36 33 7 0 10 1 0 0 0 4 14 0 0 6 16 16 28 21 0 0 4 35 0 1 31 24 24 0 0 0 14 0 0 18 15 5 26 32 14 
28 0 18 0 10 0 15 23 0 57 23 0 26 41 10 0 8 1 0 0 4 37 12 1 0 0 0 18 26 0 8 0 12 0 5 0 0 21 29 0 0 0 29 22 0 0 0 0 39 0 0 
32 20 2 0 0 0 18 6 8 7 3 26 0 15 0 0 13 2 0 10 8 33 6 12 46 0 0 0 20 0 32 14 2 0 27 0 5 0 0 0 0 15 23 0 0 14 0 0 0 8 20 
41 3 17 0 46 0 34 11 15 0 0 0 27 0 65 28 15 0 12 19 1 1 0 15 19 0 15 23 0 16 0 0 2 21 0 0 0 23 0 0 62 30 5 28 0 17 8 5 1 0 33 
0 0 0 0 40 14 60 20 0 6 20 0 2 0 30 0 0 0 0 36 27 4 36 0 0 0 0 0 4 11 19 0 2 27 0 0 14 3 0 0 3 0 7 0 21 0 27 85 1 5 5 
15 2 24 10 0 44 6 1 0 12 29 0 48 26 0 31 19 0 0 22 0 16 16 6 21 0 0 0 0 21 0 0 2 23 0 0 7 5 3 26 0 16 0 26 5 2 10 0 1 62 21 
0 7 17 30 2 39 15 25 11 3 6 17 25 0 2 8 3 19 0 7 21 15 0 8 0 24 25 22 0 12 3 0 7 0 41 28 4 0 0 0 0 7 0 0 39 7 35 0 47 32 21 
2 0 33 7 21 0 21 0 8 34 7 0 14 0 1 13 6 24 0 0 2 30 0 14 0 21 10 0 0 15 17 0 0 0 0 13 0 0 12 18 1 24 3 29 0 36 42 19 40 20 8 
0 0 27 7 39 0 5 19 4 0 0 5 4 0 0 0 0 13 40 6 21 21 18 3 25 18 14 2 23 4 0 0 12 0 0 8 8 0 0 0 20 0 4 46 20 14 0 29 11 0 2 
71 0 0 15 13 0 2 10 12 9 35 0 13 0 0 0 2 11 36 11 5 17 9 0 24 15 6 15 0 2 0 2 0 5 0 35 26 4 100 0 15 5 3 24 0 3 4 37 13 0 0 
44 24 0 0 12 0 34 2 2 15 0 8 2 0 13 5 0 0 1 2 5 14 0 0 12 24 0 0 2 0 0 0 0 0 0 0 44 0 0 0 0 0 69 0 44 0 0 0 44 0 10 
2 0 0 45 0 0 0 0 0 0 55 21 11 0 0 15 12 0 0 11 9 30 12 0 9 10 26 0 5 0 0 0 0 16 0 0 0 0 0 0 11 0 22 0 57 34 0 2 45 29 8 
20 15 0 0 0 38 0 2 0 0 27 0 2 10 0 0 18 0 0 0 16 20 0 8 32 5 0 6 38 9 0 44 0 10 18 0 8 14 3 0 0 0 28 24 0 0 0 1 7 0 0 
0 0 64 0 31 0 24 5 0 0 15 22 15 47 0 0 6 4 21 8 0 0 19 27 0 15 0 0 0 8 42 0 0 12 32 66 0 8 0 22 5 8 0 0 0 6 18 0 37 23 27 
33 0 43 0 0 1 0 45 0 23 0 9 27 0 3 8 0 0 0 14 0 9 0 4 2 0 0 8 2 0 0 0 21 0 0 3 0 0 38 28 0 23 5 1 42 3 0 0 0 7 0 
0 32 5 3 44 32 24 0 0 28 24 10 0 0 6 0 42 0 1 6 0 15 12 2 16 2 6 0 0 11 0 3 0 39 10 0 0 41 11 21 7 0 0 7 0 7 3 1 44 33 0 
80 0 9 10 55 0 2 7 9 0 0 0 30 9 0 15 0 4 39 27 2 0 3 10 6 24 20 6 2 0 26 31 10 5 0 8 0 0 1 1 0 0 0 43 44 24 69 0 0 24 0 
0 28 3 37 24 0 13 0 9 1 32 0 0 27 2 25 9 9 0 17 0 0 13 10 4 2 30 0 15 12 2 14 5 0 0 0 34 0 0 26 11 0 32 18 0 0 0 0 28 0 85 
17 0 14 24 0 4 0 0 0 0 0 9 1 1 0 22 19 15 3 43 0 28 2 0 13 0 15 2 0 27 11 0 15 17 5 0 17 43 0 5 0 0 18 0 14 0 5 20 0 28 62 
0 36 30 131 0 3 0 0 0 0 9 0 0 0 0 6 19 0 0 0 0 0 6 4 13 0 0 0 38 0 0 0 18 8 13 0 0 47 0 0 0 6 7 0 41 0 100 6 0 7 40 
6 17 40 0 3 0 73 16 53 0 0 26 0 23 0 14 10 4 0 0 9 18 0 7 0 9 19 16 8 0 16 16 0 3 22 27 0 24 9 3 0 0 63 4 10 26 17 52 42 41 44 
12 27 44 0 22 42 0 36 6 0 38 22 9 0 6 0 0 50 40 11 0 0 38 14 19 4 31 9 38 29 11 0 0 0 0 23 10 11 21 0 0 12 24 39 0 8 0 3 32 32 0 
41 11 0 18 13 17 0 0 0 12 0 0 22 10 35 32 0 13 0 11 0 29 40 1 18 12 5 4 22 15 0 5 6 25 33 14 9 11 2 18 11 41 0 0 0 19 8 81 16 35 20 
0 38 0 0 4 0 53 13 4 8 0 27 0 0 13 33 7 8 22 20 19 0 20 27 0 0 10 0 21 0 20 0 0 1 0 2 30 2 35 21 0 34 20 0 0 0 0 0 33 26 20 
0 1 40 43 22 13 17 19 3 0 23 13 0 0 21 5 31 18 45 19 0 14 0 23 22 0 30 0 12 1 0 0 0 0 15 8 39 24 52 24 17 1 0 58 0 1 47 0 0 0 0 
14 0 7 0 0 0 0 31 0 0 0 0 14 0 0 6 4 0 9 0 24 0 0 11 13 0 0 15 12 0 8 0 0 14 29 0 0 0 18 18 0 1 23 21 0 0 2 0 0 0 0 
0 23 16 9 1 18 0 16 9 2 0 22 0 0 0 8 40 0 0 0 15 35 10 30 44 18 0 1 1 0 0 6 6 8 0 0 0 0 0 1 1 0 7 0 0 22 6 11 27 39 21 
0 15 29 0 17 38 50 0 28 0 0 34 26 37 68 0 18 0 0 28 21 41 0 0 0 8 5 37 25 2 0 0 7 3 0 30 4 0 79 25 0 0 24 7 17 0 2 1 33 19 104 
