51 29
17 0 0 48 0 19 0 0 25 0 15 5 0 46 0 0 14 32 9 14 2 0 9 0 0 8 0 0 0 33 0 11 15 1 0 0 18 0 25 0 0 17 2 34 0 18 20 27 0 10 47 
0 46 4 0 18 0 4 11 10 5 34 34 16 26 2 0 0 0 23 0 0 0 0 0 2 14 17 26 4 11 0 11 6 1 5 7 0 10 7 13 1 8 0 0 14 7 22 46 27 16 0 
0 41 0 0 0 6 7 43 4 26 18 0 22 0 0 3 0 12 0 0 2 0 25 0 0 5 6 8 0 0 30 1 5 24 19 11 6 20 11 8 1 0 35 11 0 16 0 0 0 17 77 
26 9 18 15 71 0 0 0 35 0 0 0 4 42 36 0 3 0 0 0 29 0 0 0 26 0 27 0 0 0 9 38 19 0 0 6 12 0 2 15 7 0 11 35 18 5 11 0 33 2 28 
6 35 8 33 4 0 37 0 9 0 0 34 0 0 21 0 27 0 28 1 2 0 0 0 0 5 0 7 9 0 0 0 8 1 14 21 64 24 0 0 2 0 0 37 0 20 30 20 0 33 0 
29 0 10 25 0 0 0 0 0 0 0 3 0 4 3 0 46 15 0 2 10 0 17 2 0 0 9 0 26 29 10 9 0 21 0 10 41 0 0 17 3 0 21 0 0 23 0 5 0 0 0 
6 59 0 34 13 34 0 33 4 0 0 0 31 0 0 4 18 6 0 0 37 15 0 0 8 0 8 0 13 1 18 0 6 15 31 0 15 40 5 34 38 41 12 0 25 7 63 0 13 1 4 
37 0 3 0 0 32 0 9 23 0 0 2 7 7 6 12 10 5 0 7 0 0 20 6 5 6 4 12 0 4 0 34 0 19 15 0 0 37 0 5 9 0 0 0 16 11 0 36 0 34 0 
4 33 0 16 0 29 0 0 0 5 6 6 5 28 4 1 39 17 17 0 0 16 22 15 19 24 3 8 3 0 13 3 29 0 17 14 0 13 38 9 32 2 8 83 14 0 17 2 26 1 13 
2 38 0 0 2 0 15 0 0 0 22 0 0 14 0 15 0 11 17 3 0 0 0 0 6 12 18 0 0 12 1 4 8 9 0 0 1 7 7 33 13 8 0 9 10 3 0 0 3 43 21 
2 7 21 0 0 0 8 0 24 14 0 46 8 0 11 14 0 30 2 0 0 13 0 0 0 0 0 7 6 0 4 2 7 6 2 0 0 0 26 25 6 30 2 22 2 0 0 0 0 22 5 
8 0 42 3 8 0 34 0 14 36 10 22 8 22 13 1 11 26 0 4 0 0 0 0 0 0 0 1 17 0 16 6 0 38 1 27 11 10 27 0 34 0 8 15 42 36 18 0 3 16 8 
64 9 0 13 0 28 0 5 0 0 39 0 14 35 0 18 0 5 0 13 0 0 20 0 1 21 0 0 12 4 4 0 2 28 21 0 0 12 14 0 0 0 10 3 0 0 12 0 2 85 25 
0 0 9 22 41 0 4 0 39 5 79 13 0 52 0 0 0 0 0 28 0 8 0 12 1 0 0 0 29 11 10 15 0 30 0 8 9 0 0 0 18 4 8 11 5 5 2 28 14 39 51 
0 6 0 43 34 0 55 0 27 14 0 2 0 7 13 21 0 0 0 14 0 7 1 8 30 0 15 23 6 7 8 3 0 3 10 27 5 16 34 18 13 17 11 33 4 0 43 0 3 43 0 
0 0 0 88 27 0 13 0 0 0 22 0 0 28 6 0 0 0 0 0 0 8 0 7 0 11 13 0 0 0 0 5 28 11 0 0 0 7 9 8 0 28 0 40 0 52 0 0 0 10 13 
0 10 0 6 37 61 32 0 9 6 32 16 32 21 35 6 0 9 5 9 6 7 0 0 0 0 40 8 12 0 8 8 0 28 0 18 0 25 43 26 30 37 0 17 0 23 0 0 2 59 1 
0 0 0 28 2 0 32 5 2 0 51 1 16 0 0 9 0 2 0 13 0 20 0 14 1 0 0 8 17 0 0 6 13 5 0 8 0 18 5 2 5 4 0 0 34 15 6 39 6 10 15 
0 47 0 15 0 0 0 0 41 29 0 9 7 7 0 29 0 18 22 6 2 0 0 0 1 6 18 0 2 0 0 37 6 19 8 0 0 0 29 0 22 0 0 0 29 34 0 0 0 32 49 
29 0 15 1 18 21 0 2 3 39 0 5 10 10 2 16 27 0 18 21 0 0 0 6 5 8 1 0 0 35 0 16 0 0 0 0 18 0 8 1 0 0 3 27 5 47 11 0 39 6 0 
79 59 4 19 6 0 4 0 0 0 40 0 26 15 6 0 0 3 12 0 0 0 19 0 23 0 12 0 0 0 20 0 32 0 0 0 0 0 26 19 1 1 0 0 43 0 0 61 0 0 30 
0 0 0 8 0 50 0 12 37 0 0 2 0 8 0 0 34 9 0 14 15 2 0 6 0 12 21 14 0 0 0 8 16 19 29 5 18 21 0 6 7 18 0 0 19 63 0 0 0 0 62 
14 6 20 0 48 1 0 0 9 0 0 5 0 2 44 27 0 9 0 10 6 0 0 5 28 0 0 0 25 4 16 0 25 29 19 21 18 0 0 0 13 16 4 4 0 0 33 1 46 17 36 
42 0 4 29 13 23 1 0 33 0 0 3 7 33 12 12 0 19 11 0 0 0 0 36 16 0 20 0 8 11 6 23 0 9 3 18 8 23 21 0 7 24 6 0 31 0 52 0 3 0 0 
48 0 0 20 7 43 94 16 0 51 3 12 12 17 23 10 21 0 0 12 0 14 0 3 0 0 10 10 12 0 0 0 7 24 8 23 0 10 23 0 0 6 36 6 23 19 0 50 91 6 5 
2 0 0 12 84 11 0 31 39 14 23 0 0 10 8 6 11 0 15 1 6 0 7 0 0 15 17 2 5 7 0 30 24 5 0 0 0 6 47 20 0 37 0 11 0 36 14 0 44 0 15 
32 22 16 0 73 0 14 0 0 0 8 27 22 11 0 2 15 0 22 20 0 0 10 13 20 0 23 0 16 0 0 3 63 3 3 0 29 0 16 20 0 37 22 0 2 0 2 0 1 39 40 
0 0 4 104 0 0 0 6 0 13 9 5 0 11 0 0 14 13 0 38 0 0 18 3 25 0 0 23 15 0 31 2 0 0 2 25 2 0 11 6 37 8 19 40 2 22 0 35 15 33 0 
0 1 2 0 3 40 27 0 18 4 23 34 0 4 0 18 0 4 0 5 9 0 0 13 0 9 25 6 6 17 0 23 0 4 0 16 25 0 18 1 0 0 0 0 18 40 9 0 27 1 31 
