51 29
10 28 25 0 0 4 0 0 0 0 28 0 0 0 0 0 1 18 10 17 30 0 13 6 25 1 9 25 10 42 0 0 3 0 0 6 35 0 28 0 0 0 0 0 0 26 4 0 0 0 19 
24 33 0 48 0 0 25 39 19 38 32 0 19 1 0 23 3 13 27 16 20 1 0 7 27 1 16 24 0 13 22 6 0 26 1 21 0 0 0 0 4 7 32 0 0 0 50 0 3 79 17 
0 25 0 43 49 44 38 0 0 20 15 0 0 32 25 0 0 0 0 30 25 53 9 18 0 15 26 19 15 0 0 13 0 7 0 26 0 31 0 68 11 0 0 0 21 24 0 14 0 66 45 
6 36 0 0 33 24 0 0 0 0 0 3 6 0 52 32 16 35 0 4 3 0 12 4 0 0 16 23 11 13 20 23 9 0 2 7 3 19 27 13 3 0 41 1 20 36 8 8 27 0 13 
49 14 0 0 31 85 0 0 11 21 32 62 58 0 0 0 27 16 26 37 12 9 0 24 8 20 0 22 9 4 0 13 27 0 0 28 24 37 33 0 29 0 32 27 85 0 14 2 3 16 4 
38 0 0 0 8 1 10 31 4 0 7 16 1 37 0 2 4 9 0 21 0 0 0 4 0 0 0 23 16 17 7 30 0 0 29 0 19 17 38 0 15 0 12 0 11 23 16 24 0 0 14 
0 0 43 0 1 0 5 0 6 0 0 5 4 1 6 15 10 35 0 0 0 0 13 0 0 0 13 2 0 0 34 0 15 17 5 13 21 33 0 0 28 0 0 39 17 6 22 2 0 3 17 
0 0 0 0 0 2 49 2 10 41 1 0 0 15 20 9 3 2 27 0 20 0 0 2 0 0 7 0 3 0 0 5 0 10 0 1 21 20 6 25 6 2 0 2 17 27 46 0 4 40 0 
5 0 0 15 0 38 0 30 0 10 0 0 7 0 0 16 0 0 24 13 16 6 19 0 25 0 0 8 0 20 0 4 17 0 2 20 0 30 0 40 3 0 43 61 0 0 0 3 13 76 0 
2 0 15 0 21 0 25 12 0 0 21 13 41 0 18 16 0 0 0 3 49 19 0 2 18 0 19 0 0 0 0 17 0 0 0 14 13 0 0 35 0 0 17 0 29 0 11 35 0 4 30 
13 82 0 12 9 0 0 0 0 0 17 14 0 0 5 11 33 0 0 30 29 30 6 0 10 0 27 16 3 0 0 16 7 0 27 0 0 0 39 13 15 4 0 0 0 0 27 0 7 25 14 
0 15 41 17 23 4 0 0 14 0 0 13 27 1 20 21 1 15 0 72 15 13 5 19 0 0 14 42 5 19 0 4 0 0 0 15 31 0 19 27 12 27 22 57 11 0 2 0 4 5 31 
71 2 0 0 13 8 0 0 0 0 33 2 5 13 9 15 1 26 0 14 35 0 7 7 0 0 10 11 0 0 0 18 6 23 11 18 21 0 15 0 1 18 0 0 0 0 0 0 0 37 0 
13 0 0 9 35 10 2 6 0 6 0 0 20 13 13 10 2 3 0 23 0 0 10 15 18 13 19 2 25 0 4 0 28 0 0 0 2 23 21 7 1 0 0 0 22 14 32 0 0 8 0 
4 21 0 31 45 38 20 0 0 0 0 10 33 0 49 0 10 11 0 4 9 8 40 27 18 0 0 0 0 0 19 0 14 0 15 0 2 0 0 0 0 7 0 67 0 38 14 0 0 45 22 
0 25 27 0 0 7 48 22 74 9 0 3 38 0 23 8 11 43 0 18 0 11 36 23 0 21 42 0 0 27 0 15 7 8 15 4 11 8 0 3 0 0 0 0 36 0 35 13 36 14 0 
0 0 37 0 14 0 0 0 9 0 6 35 0 0 3 0 0 8 16 3 7 3 6 21 0 0 0 0 8 0 0 0 0 0 0 7 0 0 13 3 12 0 0 0 15 10 34 11 0 0 6 
10 16 0 23 0 0 15 0 10 34 0 0 20 4 0 0 0 51 0 13 14 11 0 0 0 17 0 27 0 26 28 6 38 24 15 21 14 0 0 22 0 0 2 0 6 5 13 0 26 0 0 
45 8 19 5 0 15 8 0 42 3 0 36 0 2 36 3 4 28 10 0 3 7 28 21 5 0 0 0 0 14 0 0 4 0 1 0 0 0 9 0 0 7 0 4 0 8 0 27 24 0 25 
48 0 0 29 19 6 0 6 0 19 0 3 4 0 2 11 0 9 0 20 6 0 1 17 0 0 25 0 6 0 10 19 31 0 2 20 7 0 14 20 0 41 2 0 0 2 20 35 1 6 19 
0 0 0 0 38 8 0 23 0 0 21 1 5 24 0 0 5 29 3 20 0 29 0 16 14 0 37 5 22 6 23 21 5 0 0 19 6 0 14 51 0 0 38 0 0 0 15 26 23 0 22 
28 0 0 10 0 18 15 0 0 20 0 17 29 0 18 0 0 29 0 0 8 5 0 14 7 4 0 30 14 4 16 30 0 0 0 0 15 0 0 0 0 36 14 20 19 28 0 0 1 0 0 
0 65 20 19 2 0 20 0 0 29 18 29 0 0 0 0 0 0 0 21 28 12 7 0 12 0 14 0 27 0 0 3 4 0 0 0 0 0 29 38 3 21 0 0 0 11 0 0 0 0 0 
0 36 0 0 28 0 0 0 7 0 0 0 4 9 10 1 0 5 0 0 0 12 14 0 9 4 0 0 17 0 0 0 28 9 19 9 23 24 0 3 7 0 27 0 3 5 3 0 0 12 0 
45 0 0 0 18 15 38 0 14 0 0 0 0 0 26 39 2 8 0 0 11 0 25 23 11 0 4 0 0 9 16 1 12 11 5 30 15 3 0 26 6 0 42 0 55 8 6 0 0 23 14 
0 3 36 0 20 0 7 0 5 11 0 16 38 0 31 0 3 27 0 0 6 11 21 13 20 8 4 0 0 0 27 4 0 0 7 8 28 1 49 0 17 32 16 16 27 31 25 0 0 11 38 
0 1 37 28 43 36 14 0 0 0 5 20 25 37 0 12 2 25 0 2 14 0 15 0 26 0 24 10 0 0 0 50 0 0 6 0 1 10 19 37 6 36 18 0 0 0 0 43 0 14 63 
14 25 0 22 0 0 23 0 0 12 21 8 33 1 1 14 27 6 0 0 47 0 29 14 18 4 26 5 13 17 32 10 12 0 0 0 0 13 15 0 8 0 32 64 0 3 2 0 47 17 20 
21 3 12 20 7 12 25 32 0 5 0 21 0 28 12 1 1 5 55 0 31 50 3 46 1 13 1 19 8 11 10 0 14 0 28 20 2 9 0 83 26 32 0 7 24 23 12 0 7 32 2 
