51 29
44 26 0 25 8 0 28 0 11 31 0 0 26 0 8 13 17 0 43 0 0 0 8 8 0 9 0 6 0 0 0 0 0 17 37 8 0 0 26 31 31 0 0 0 18 0 25 0 0 0 17 
49 12 0 106 0 0 0 13 0 0 7 0 17 12 0 0 0 0 3 16 0 0 9 0 25 12 26 17 20 3 5 0 7 27 0 16 0 8 0 1 1 0 5 0 35 16 0 5 20 3 0 
0 0 8 0 0 0 18 8 13 0 0 0 0 0 0 0 2 0 0 13 0 46 0 0 0 0 0 0 9 0 9 0 3 0 8 0 0 10 21 0 5 19 0 2 0 32 2 0 0 17 0 
0 24 20 26 16 0 10 0 15 0 0 16 28 0 27 23 16 0 0 0 0 0 20 12 0 0 0 10 0 17 0 0 0 19 31 0 0 0 48 6 7 0 26 17 3 6 73 0 0 12 23 
24 0 2 0 0 38 18 54 0 0 13 15 29 0 0 28 20 0 27 23 0 0 2 25 46 12 16 9 24 0 0 8 0 0 10 23 0 39 20 21 0 0 24 36 0 6 7 0 30 0 0 
0 20 65 0 33 0 0 27 0 0 0 2 16 6 24 24 0 0 12 30 17 17 1 0 7 0 0 24 0 10 12 4 5 9 32 33 3 35 0 21 0 0 32 44 30 26 0 0 0 8 16 
0 24 30 0 19 0 11 18 15 5 0 9 0 33 2 21 0 42 14 19 0 4 1 31 3 6 0 6 22 0 17 14 14 0 16 18 14 0 13 9 23 0 0 0 0 3 36 3 0 11 19 
0 4 3 0 0 0 0 48 10 0 9 0 0 0 15 0 0 0 0 13 0 9 39 0 0 0 0 3 0 12 4 0 0 0 19 5 3 1 16 7 33 7 1 0 11 0 7 0 0 5 5 
8 0 8 5 8 0 13 30 41 7 0 0 0 10 26 15 12 0 0 12 10 20 21 4 18 0 24 6 12 17 24 12 0 0 3 1 2 31 2 29 1 0 29 56 23 0 5 0 0 0 24 
24 0 28 1 16 11 4 17 4 0 39 31 0 0 0 30 11 0 10 24 22 12 0 0 47 0 16 1 0 12 0 0 0 0 10 7 8 33 0 18 0 1 65 24 0 1 7 2 0 0 0 
0 0 0 45 17 6 7 52 0 0 0 13 0 10 8 6 4 0 0 0 35 23 9 0 17 0 21 3 8 0 16 0 17 6 8 4 3 0 0 29 0 10 1 0 20 0 24 21 86 5 0 
0 44 0 3 0 0 10 0 0 64 33 0 0 0 3 12 4 12 0 20 28 3 19 0 9 21 9 0 0 25 0 0 0 0 11 15 8 7 3 0 8 0 1 33 24 0 21 0 0 20 52 
12 0 22 25 12 22 3 44 36 25 33 27 20 0 13 21 26 0 0 29 7 0 0 0 0 35 16 24 41 27 23 14 10 0 22 26 9 4 27 14 0 0 17 32 42 0 21 0 29 5 5 
0 13 3 14 30 11 39 0 10 26 25 7 4 5 4 17 1 15 10 0 0 3 0 0 12 0 19 17 12 11 41 6 11 16 6 42 0 0 33 2 0 13 0 8 6 55 1 37 0 20 12 
37 0 0 8 0 0 16 7 0 0 0 29 5 0 2 0 9 6 0 0 0 0 22 25 26 14 15 14 21 0 0 0 0 1 28 7 0 18 3 14 0 0 0 0 0 0 23 0 0 0 3 
47 0 0 3 1 5 30 11 7 33 9 15 0 15 0 18 0 0 14 22 2 3 2 7 18 0 0 0 0 16 6 0 0 19 2 0 30 3 1 0 3 0 33 0 0 0 0 47 0 12 0 
37 0 3 30 0 2 4 14 0 0 1 0 94 1 0 10 7 0 23 0 0 0 7 18 7 5 2 6 4 0 5 27 0 69 1 0 7 10 4 3 28 29 34 0 0 7 10 43 0 16 19 
0 2 34 8 0 4 11 13 7 26 26 12 3 12 0 13 0 0 44 1 12 14 0 15 0 0 2 20 15 0 0 0 16 16 16 54 34 0 15 8 45 8 0 0 16 27 24 0 0 0 23 
29 15 0 23 0 37 0 5 84 0 5 0 22 8 0 1 1 62 32 0 0 4 0 0 5 4 23 0 15 5 0 0 0 0 5 4 21 6 0 31 35 0 37 13 0 13 38 30 0 32 32 
6 0 4 0 16 6 0 0 32 34 3 31 24 32 14 0 1 0 0 0 9 2 17 9 0 0 2 0 0 8 18 3 0 2 0 5 0 4 5 6 32 32 31 0 9 32 0 0 0 17 0 
4 0 8 37 6 23 7 28 17 16 1 0 9 9 9 7 3 23 16 0 4 0 0 46 0 16 0 9 0 12 6 1 28 9 8 34 11 0 22 21 34 12 0 57 0 0 23 30 0 0 35 
0 0 0 0 46 0 12 11 4 10 4 6 3 0 0 3 6 11 6 0 0 12 0 0 0 0 5 0 12 12 0 15 0 0 16 4 2 0 0 15 6 0 0 0 6 0 10 2 0 2 24 
0 15 6 16 49 5 0 20 33 0 25 0 0 9 0 0 26 0 10 25 0 3 0 7 0 0 0 6 7 4 26 0 18 12 5 3 0 8 0 0 36 0 5 6 0 17 16 0 15 98 7 
0 0 4 0 0 1 41 0 16 0 0 13 25 0 6 5 20 0 0 21 9 0 0 26 0 21 0 2 0 9 22 1 0 6 5 18 29 43 6 0 0 0 5 0 6 5 21 41 0 26 4 
0 13 0 0 14 1 10 41 2 13 23 2 4 2 22 0 25 0 0 7 18 2 0 15 0 7 19 0 9 19 24 24 16 23 10 21 25 0 33 10 0 0 3 4 10 0 0 0 3 13 0 
15 10 33 9 3 18 15 0 4 27 4 0 44 24 10 17 33 14 3 36 1 45 1 6 16 8 0 3 2 14 0 19 0 45 0 20 19 62 0 29 19 0 0 4 0 0 21 0 0 33 29 
24 26 0 24 8 0 4 0 2 9 16 12 0 0 28 20 20 0 9 0 0 0 4 13 53 34 0 24 3 2 0 13 18 0 0 73 1 21 13 7 3 0 0 0 9 8 0 0 11 24 6 
45 7 0 0 57 52 18 23 7 5 17 0 0 20 22 10 11 0 6 5 0 0 8 5 10 3 10 4 11 8 23 8 27 16 0 0 9 23 0 38 0 0 14 0 22 45 6 42 11 3 0 
15 0 0 36 20 0 0 13 15 37 0 21 0 0 0 5 33 15 0 5 0 25 14 0 20 0 14 25 35 3 9 0 13 27 0 15 47 5 23 21 21 13 0 10 0 0 80 0 2 37 0 
