51 29
0 0 0 0 0 0 40 0 0 54 0 3 0 15 3 0 0 37 0 25 1 0 0 2 1 15 8 5 1 0 0 0 15 0 9 13 31 20 0 0 0 0 0 10 28 17 30 11 0 0 0 
6 85 11 0 0 0 0 0 0 16 9 3 0 43 0 3 4 17 14 9 4 41 23 16 1 31 3 0 0 3 16 0 0 13 0 0 0 0 1 24 17 11 30 46 2 12 6 0 9 0 5 
0 21 25 20 3 0 1 1 0 35 0 0 0 72 0 0 19 0 29 1 25 62 9 7 2 20 0 0 0 11 44 0 10 0 13 19 0 25 17 0 12 0 3 26 19 25 35 28 24 47 0 
0 0 42 0 2 22 16 38 0 0 0 38 0 34 0 0 0 0 0 6 3 25 37 0 0 0 0 1 5 0 0 12 17 2 14 14 16 6 11 0 0 13 7 41 40 38 25 0 23 77 0 
0 0 0 13 21 45 14 24 32 0 0 36 49 0 28 13 0 29 6 0 14 19 2 0 0 37 14 6 0 22 3 18 15 0 0 0 0 4 0 25 51 29 0 0 0 0 0 40 0 0 45 
0 19 6 15 40 0 14 22 22 0 25 4 0 47 0 0 17 0 6 6 19 0 3 48 7 13 0 0 15 0 14 8 2 10 15 37 28 18 38 17 2 0 15 6 0 49 3 38 0 22 0 
48 18 0 0 40 31 0 0 41 0 43 0 0 0 36 0 1 5 0 23 0 0 1 27 22 0 24 4 14 0 0 29 1 22 3 0 36 3 5 31 9 8 4 7 13 38 0 0 3 0 87 
6 8 6 10 2 21 0 38 0 0 0 0 32 0 6 35 28 27 0 36 0 14 11 0 0 0 0 0 0 17 0 0 2 5 10 0 0 0 0 0 10 0 0 0 5 47 31 0 28 1 17 
38 33 3 3 0 6 0 3 0 10 3 0 3 51 9 42 31 53 0 3 30 14 9 10 26 1 0 3 0 18 7 0 5 0 26 22 19 2 33 23 17 19 39 12 3 1 0 48 0 0 0 
3 7 20 10 14 64 0 4 0 9 0 0 17 0 28 11 0 0 22 0 0 23 41 0 2 9 11 0 18 35 0 0 8 0 8 18 0 1 0 0 7 0 28 0 16 35 18 20 0 2 13 
0 0 35 0 0 6 0 9 0 0 0 0 0 30 3 7 0 15 0 0 0 0 32 23 18 14 12 0 0 10 0 0 0 12 0 0 3 35 0 29 0 14 7 49 0 8 10 0 26 5 0 
16 0 0 0 0 0 23 44 0 0 22 0 11 39 8 16 0 31 6 0 0 26 0 8 12 13 0 14 0 23 0 18 15 0 0 20 8 0 7 39 0 20 7 3 44 23 10 9 0 0 2 
10 11 2 0 0 11 19 0 6 0 6 0 12 0 0 4 0 18 0 0 0 0 5 0 3 28 0 0 0 1 17 0 0 0 39 0 0 0 12 0 0 9 2 1 10 0 15 30 0 0 12 
0 0 54 10 0 29 0 29 0 44 26 8 1 24 27 20 4 9 0 13 6 17 0 0 8 13 2 21 22 7 0 1 12 0 39 8 37 15 1 1 11 0 12 33 14 0 18 18 14 2 1 
19 0 0 34 0 39 4 0 8 4 8 13 35 15 0 0 0 0 14 8 20 0 12 0 25 28 0 3 3 15 0 9 7 0 0 0 5 14 0 11 27 0 2 27 0 5 30 23 28 0 45 
43 34 0 0 0 11 0 0 13 0 8 0 27 13 9 0 20 30 0 1 27 10 5 0 1 0 0 26 29 3 10 0 8 17 6 5 15 0 0 32 15 0 0 36 23 0 39 33 0 3 43 
0 0 0 43 37 45 31 0 22 31 0 65 18 0 9 21 59 0 0 17 16 0 0 0 16 0 0 11 0 15 53 0 7 28 9 0 54 0 6 0 16 58 11 1 13 31 78 2 0 0 0 
47 121 1 41 28 5 8 2 0 9 29 30 29 7 3 2 19 10 27 19 16 15 29 8 24 4 9 1 4 0 16 9 73 40 2 31 10 8 0 21 2 3 1 22 32 48 37 20 0 0 53 
8 0 8 51 0 11 29 13 0 22 58 16 0 0 0 10 25 3 1 0 13 8 31 0 1 1 0 0 0 30 10 0 0 0 0 32 0 0 0 33 19 25 30 14 0 0 11 0 0 0 21 
49 84 11 3 39 0 38 9 7 19 61 37 0 50 34 2 7 0 19 28 6 0 26 24 21 0 18 0 0 13 21 25 6 0 0 10 19 0 25 29 26 0 9 36 0 8 55 86 14 23 0 
0 11 0 30 0 2 0 22 0 25 0 2 24 14 7 0 9 8 0 0 9 9 0 25 0 9 0 14 0 19 0 14 3 0 0 0 0 0 0 0 0 2 0 9 0 0 0 0 18 37 7 
33 0 0 26 0 5 13 0 0 0 64 2 0 22 2 34 2 4 21 31 0 26 0 10 0 0 5 16 5 26 19 25 0 39 4 0 0 0 16 23 34 6 9 33 19 35 0 16 15 44 35 
5 37 33 20 31 4 0 0 0 5 0 0 0 30 9 0 7 44 8 0 26 27 1 0 1 43 12 0 0 0 0 2 0 0 3 42 5 0 0 38 3 28 29 2 0 15 55 22 35 0 13 
28 0 45 44 0 11 44 18 0 0 35 2 0 13 0 27 0 15 0 28 0 25 1 0 10 0 11 0 28 0 0 22 2 3 13 0 5 9 0 22 0 6 37 37 11 0 38 130 6 18 0 
10 2 0 4 0 0 0 0 0 24 3 33 0 0 0 0 19 4 26 0 0 0 0 7 0 0 0 0 0 17 0 0 0 24 0 0 0 0 0 0 0 0 0 0 59 0 0 0 0 0 17 
2 1 5 37 16 0 2 1 0 5 14 0 6 14 10 0 0 0 0 0 22 0 12 0 0 0 0 0 0 10 0 0 0 0 23 0 0 0 22 17 34 9 0 24 0 0 7 0 0 0 28 
36 3 11 0 0 0 0 0 20 1 0 17 0 11 0 0 0 0 10 0 32 0 1 5 0 13 5 32 47 13 0 0 0 0 0 0 0 0 18 0 11 16 0 18 0 0 17 12 13 0 0 
34 13 20 64 0 12 0 0 0 34 0 0 20 0 50 0 0 10 31 0 0 25 20 0 21 0 19 24 0 0 11 0 0 0 0 0 19 59 24 27 13 46 33 0 35 11 15 0 0 31 0 
33 0 20 21 0 21 24 17 13 0 38 38 0 0 33 0 0 18 0 13 7 5 44 0 26 8 0 7 0 0 0 10 0 46 31 0 3 16 11 0 14 0 0 41 28 21 24 33 26 38 0 
