51 29
1 20 0 0 13 0 8 31 0 0 20 31 21 0 14 0 0 24 6 0 6 3 5 11 3 75 0 19 10 17 1 23 21 5 0 26 11 0 26 7 0 12 9 0 27 0 5 11 22 0 0 
17 61 4 42 0 22 65 0 10 11 20 35 34 5 0 0 27 0 0 18 0 0 0 2 0 9 4 22 6 2 4 2 17 1 0 29 12 9 42 25 7 0 18 0 0 42 37 0 25 0 4 
26 51 0 0 10 0 28 0 0 12 17 0 0 7 11 0 5 5 6 0 0 8 9 0 6 11 17 17 0 9 37 24 0 17 0 7 1 10 1 21 23 0 45 0 0 17 0 2 0 0 0 
0 39 0 11 13 40 1 0 0 0 0 29 19 0 11 4 0 0 0 0 9 2 0 2 0 29 15 55 0 0 0 16 0 0 0 7 12 38 11 21 39 39 25 0 1 1 0 25 23 0 0 
21 61 0 0 0 0 1 53 0 10 22 9 0 0 0 0 0 20 0 7 13 0 0 14 0 0 0 12 9 0 0 3 6 11 0 15 10 7 0 21 21 0 10 32 0 38 0 0 0 0 0 
0 12 17 12 0 0 0 0 0 7 0 0 0 0 0 12 0 0 12 17 0 25 8 9 0 7 0 18 12 0 8 0 0 22 6 0 0 2 1 2 12 11 20 0 1 0 0 3 0 0 3 
14 0 4 28 0 2 0 22 0 30 0 6 19 22 47 12 0 6 0 0 13 8 0 0 0 8 0 19 14 27 5 47 0 0 25 0 9 0 1 0 0 14 0 0 0 9 0 18 0 19 12 
13 59 0 27 27 0 17 0 28 10 0 28 0 23 13 16 11 0 0 0 19 9 0 0 0 2 0 49 0 0 27 28 0 14 2 0 28 2 0 28 0 0 0 0 6 14 9 45 0 20 49 
0 13 54 0 0 0 36 36 16 33 10 7 0 7 14 32 0 8 19 23 5 6 18 21 46 2 0 0 10 5 0 0 0 0 0 22 0 14 10 18 0 22 8 6 25 2 0 9 0 0 9 
0 22 39 0 31 0 0 0 0 0 0 0 26 26 25 12 0 7 22 0 0 1 3 3 33 3 0 12 0 9 0 0 0 0 0 6 0 0 17 22 49 0 0 41 0 0 42 0 9 7 43 
81 9 0 14 11 0 0 8 0 0 0 0 3 1 0 9 10 4 17 24 5 23 0 18 23 29 0 15 16 0 7 2 0 0 27 23 0 0 1 2 5 15 2 66 44 24 16 31 48 0 10 
1 0 0 45 40 10 10 18 2 6 0 2 0 0 22 10 0 4 0 0 0 6 9 10 0 13 0 2 0 9 0 17 0 22 0 8 0 12 0 8 0 0 0 0 40 34 0 36 45 1 1 
10 3 0 18 30 17 0 37 0 0 7 46 0 0 0 12 24 24 18 0 5 10 7 1 38 2 9 6 0 14 0 2 17 0 0 0 14 37 0 11 0 3 27 0 47 0 9 44 0 0 33 
19 0 14 39 20 30 11 0 0 18 0 0 0 1 9 14 0 32 0 3 7 22 0 9 10 16 16 19 5 19 0 0 0 0 30 46 12 0 0 0 0 8 42 22 14 43 0 0 0 32 0 
0 0 4 0 0 8 16 0 13 2 0 9 41 34 0 3 24 27 10 4 14 6 14 1 0 11 18 6 13 0 12 6 0 18 0 12 19 11 9 0 75 0 0 16 35 0 37 26 0 6 0 
7 8 1 0 0 2 3 13 0 41 0 14 16 0 18 0 0 4 40 0 32 0 13 14 0 0 0 0 0 20 1 2 18 11 0 16 8 22 0 4 0 32 2 6 0 10 12 61 0 0 0 
41 84 1 4 10 8 28 16 15 0 5 0 14 38 14 7 17 3 0 0 8 0 0 1 5 0 29 12 0 0 0 0 0 0 33 29 0 1 0 4 0 20 29 0 0 44 9 9 0 7 8 
27 3 2 55 15 10 8 0 0 1 1 11 0 0 8 5 13 0 30 19 5 0 0 0 0 15 23 2 12 7 7 0 8 2 0 0 0 38 0 15 0 0 2 0 0 0 0 9 15 0 0 
0 14 4 14 0 0 7 8 0 14 9 0 0 0 0 0 0 10 0 0 14 0 0 31 0 19 0 0 0 5 0 3 15 16 5 7 27 4 13 15 9 0 0 7 6 20 0 0 0 7 1 
0 0 0 0 0 23 0 15 0 36 7 7 0 0 19 9 0 20 15 6 11 5 4 0 9 12 8 19 23 0 0 11 8 13 17 0 5 9 1 4 0 35 18 0 30 12 0 5 23 40 0 
24 1 0 0 4 29 34 4 0 0 0 20 0 0 0 0 33 0 0 0 12 13 15 14 5 0 0 21 11 5 12 20 14 0 18 0 17 13 1 0 43 0 27 0 5 0 0 11 0 33 3 
19 0 0 40 4 0 33 0 11 0 26 21 0 0 10 0 0 0 0 28 0 21 0 14 17 0 0 8 4 15 21 35 0 2 0 0 36 14 0 7 0 22 0 27 0 19 9 0 0 43 9 
32 2 1 0 6 8 17 0 1 33 31 0 19 0 0 17 0 20 14 0 0 0 0 1 6 0 2 9 6 1 0 21 16 17 0 12 0 16 0 39 0 34 22 34 0 0 0 19 0 26 0 
0 17 18 31 29 0 0 16 41 16 37 0 0 31 28 17 25 17 42 0 20 24 5 23 4 13 0 40 10 0 0 15 13 61 77 21 8 30 34 31 19 0 0 0 51 34 0 53 1 31 0 
3 2 30 22 0 20 40 2 0 0 2 11 0 0 0 8 0 10 12 8 10 9 22 32 3 0 0 13 0 0 21 1 7 0 13 12 3 22 8 7 4 20 0 0 10 0 14 2 0 0 3 
6 41 11 0 0 0 0 36 0 14 0 0 0 32 19 17 32 30 28 0 12 0 23 1 5 21 17 16 28 3 0 16 17 10 9 12 10 12 2 15 43 1 40 20 11 43 51 63 27 19 0 
0 27 15 0 0 2 0 0 27 0 8 38 16 16 0 13 31 0 0 3 11 36 0 12 32 43 15 14 14 5 11 24 0 12 4 29 0 0 0 49 6 9 3 0 0 0 17 19 23 28 21 
44 7 7 21 0 73 0 0 7 0 12 20 0 0 0 0 0 0 0 0 6 4 12 0 20 49 26 0 5 0 12 13 13 0 0 0 3 5 0 0 8 0 27 5 91 25 32 0 5 89 0 
11 5 10 1 18 16 46 0 0 24 0 0 45 0 14 10 6 0 0 0 0 0 2 0 0 19 0 5 14 21 15 0 7 24 0 18 0 0 1 1 0 0 11 0 23 15 28 83 48 0 28 
