51 29
4 0 0 8 0 0 6 0 0 0 4 8 15 0 0 24 0 17 17 0 0 0 0 2 0 6 0 0 9 0 11 25 9 0 0 0 0 0 0 0 0 0 0 13 0 0 40 0 0 0 0 
0 26 0 7 13 0 22 0 14 0 0 0 0 0 19 17 9 0 0 1 0 6 30 27 0 2 0 16 38 0 7 0 7 23 0 0 0 28 0 7 0 2 0 2 29 0 2 6 1 0 52 
27 0 0 0 15 0 6 29 0 29 0 14 6 0 0 0 23 0 33 9 0 0 0 7 0 14 0 14 22 23 0 4 37 13 5 0 42 0 43 0 0 0 13 0 15 0 15 0 7 0 22 
24 3 0 26 14 25 25 15 10 24 0 11 52 25 12 4 0 0 50 16 0 0 9 16 0 0 3 0 0 0 0 22 0 53 3 6 0 0 0 0 0 8 24 4 32 0 0 7 25 0 17 
9 3 0 0 3 0 6 0 0 18 0 0 5 0 0 33 0 0 4 0 0 4 1 0 8 18 0 0 14 0 19 0 37 11 12 19 0 22 0 4 0 2 0 39 0 0 0 0 0 19 0 
0 37 47 0 13 0 0 0 36 0 0 0 0 17 29 17 0 51 24 16 0 8 0 9 0 10 9 15 0 8 17 0 14 0 0 26 0 5 0 0 0 0 24 29 36 58 0 2 0 0 45 
14 0 44 0 7 0 22 3 0 19 0 38 33 8 0 11 0 0 8 31 2 0 18 0 0 28 13 0 1 15 18 5 0 27 0 2 10 0 16 0 0 0 7 0 0 0 0 0 10 1 107 
10 0 0 0 21 0 0 0 22 0 8 0 3 0 18 14 0 27 5 14 0 8 0 18 0 0 5 0 1 0 19 0 0 25 12 0 0 3 5 3 4 2 0 4 27 0 11 0 0 16 0 
56 0 34 66 0 0 3 0 7 7 1 0 3 0 0 0 6 0 7 0 17 8 8 12 5 25 2 0 2 28 21 0 14 0 16 0 48 0 18 55 3 0 0 13 0 0 43 32 13 0 69 
39 0 3 37 22 0 34 32 61 31 0 0 5 0 0 5 0 7 0 0 0 0 11 22 17 0 28 0 10 27 5 0 15 0 0 20 0 40 1 16 28 9 0 0 0 37 0 0 31 49 21 
2 0 0 0 6 61 35 0 12 0 0 0 7 12 0 22 0 18 12 0 1 11 4 19 21 0 16 5 13 25 11 0 6 0 0 29 0 2 5 0 0 0 16 0 0 2 0 0 8 27 70 
0 0 0 0 26 0 15 0 0 6 0 0 11 0 0 0 0 0 0 0 12 29 17 3 19 0 0 0 7 0 0 14 0 0 5 2 0 0 34 0 34 5 0 16 0 0 5 13 0 0 45 
0 8 13 15 44 11 1 1 17 0 10 12 0 2 36 6 18 32 24 40 5 0 3 0 0 0 16 0 21 8 0 19 0 8 0 19 15 30 7 24 0 0 0 24 43 0 6 0 44 32 77 
61 0 13 23 0 14 0 0 0 0 8 0 0 12 9 14 0 0 19 28 0 0 9 9 29 2 11 0 9 26 0 0 5 0 0 9 13 22 0 0 0 17 0 43 14 0 15 72 8 0 47 
5 0 0 26 52 41 0 12 5 0 31 0 4 11 0 0 27 0 14 8 2 10 2 0 50 0 18 29 14 26 13 0 16 0 8 0 4 7 28 19 0 6 0 8 0 4 34 30 22 0 0 
0 18 0 4 30 18 0 0 11 0 7 14 7 17 18 0 0 7 15 18 26 8 17 0 0 12 2 13 14 0 0 0 0 14 2 31 0 5 18 0 8 5 24 2 2 4 26 0 11 4 0 
37 0 14 1 0 11 0 0 17 0 0 0 0 0 0 0 7 11 0 31 1 0 8 25 0 11 0 0 16 9 0 13 2 0 0 7 10 16 14 0 0 2 0 0 0 0 8 0 25 0 31 
37 0 0 3 7 7 23 41 33 15 19 7 24 5 5 38 0 17 47 15 8 2 0 5 43 0 23 0 10 29 0 0 9 6 2 11 8 19 60 2 4 26 30 35 0 48 6 0 71 0 7 
5 5 52 0 0 5 26 0 0 16 0 6 0 58 7 13 32 25 0 0 18 4 0 0 26 39 1 36 7 18 0 25 21 12 0 0 20 1 6 4 0 10 15 0 0 0 6 28 55 36 10 
0 0 0 24 0 0 9 33 12 6 0 36 13 28 0 16 0 14 0 0 2 15 11 0 3 23 52 28 13 15 0 20 0 9 8 0 8 10 46 11 46 24 0 0 13 0 18 13 4 9 12 
5 8 47 0 17 0 0 32 0 0 0 0 0 3 7 0 2 44 0 0 19 7 1 13 9 17 0 0 0 1 13 12 0 30 0 0 6 3 2 13 1 0 44 5 0 3 0 30 0 47 0 
10 16 0 3 0 0 0 12 2 0 35 35 0 9 21 14 0 9 27 19 0 11 28 24 4 8 0 4 0 15 1 0 15 3 0 23 0 7 0 0 14 0 0 20 0 35 29 15 13 14 13 
44 43 11 23 37 5 1 0 9 58 2 0 0 23 21 27 18 0 0 0 6 0 0 0 0 0 24 0 0 0 0 3 0 19 0 22 25 0 2 46 0 5 0 5 1 0 10 2 0 46 11 
0 0 20 14 0 0 0 0 0 3 2 11 4 26 0 0 18 14 0 0 0 5 13 16 24 14 18 0 33 0 0 0 0 9 37 7 23 0 8 14 0 13 0 0 0 6 19 0 24 16 13 
0 5 0 52 0 17 20 0 0 11 2 14 0 28 0 23 0 0 0 22 5 5 45 0 5 0 8 0 0 0 16 0 5 0 0 0 17 13 29 36 0 33 27 0 0 15 20 41 0 0 6 
31 0 39 38 35 0 0 0 7 4 1 0 25 28 3 27 3 33 16 26 11 12 4 44 0 0 0 4 56 0 0 23 0 5 30 26 8 1 29 35 19 103 3 21 12 7 23 2 24 0 33 
42 12 0 20 45 12 15 15 4 5 30 0 27 32 1 0 0 0 0 29 0 8 0 5 21 0 23 0 9 22 21 7 0 17 10 28 19 9 0 45 0 5 30 24 0 4 39 0 19 68 50 
44 24 0 13 30 17 0 17 25 1 1 0 9 13 0 3 0 18 13 0 22 0 15 0 1 24 18 0 0 0 8 0 22 13 14 4 13 1 0 9 25 29 5 16 0 26 0 0 9 0 54 
0 54 97 20 60 5 57 44 10 20 0 0 14 0 13 5 26 18 4 38 2 0 21 42 22 14 24 6 14 3 4 0 4 22 11 39 0 12 13 6 0 6 14 24 21 32 25 15 19 67 45 
