51 29
0 16 0 36 37 6 27 0 41 20 0 18 23 0 0 0 0 0 0 0 0 0 0 13 31 20 17 13 3 0 10 0 0 49 42 22 13 7 0 51 3 37 0 47 3 21 2 0 9 19 15 
24 0 9 42 0 25 0 0 40 5 19 0 0 0 5 9 0 26 0 0 8 0 0 0 3 0 0 3 7 48 0 31 0 0 0 0 36 0 35 0 0 0 0 53 12 62 0 0 23 11 38 
24 36 0 27 0 2 0 0 0 2 46 0 0 0 0 0 21 0 19 0 0 22 1 22 21 0 34 33 28 3 30 4 12 3 0 0 1 26 0 43 17 32 26 0 9 4 36 0 0 25 29 
0 65 0 0 0 2 0 11 0 0 0 0 14 14 15 3 0 18 15 2 2 0 4 0 0 16 8 0 17 10 0 0 0 20 33 0 30 0 2 7 0 0 41 0 0 22 0 17 0 37 16 
39 0 0 14 79 9 0 17 14 0 0 35 9 29 41 64 11 9 19 18 0 15 6 0 3 0 15 4 27 2 14 3 35 34 23 7 6 18 35 64 0 7 35 7 12 3 0 3 75 0 0 
9 0 0 0 0 8 0 0 24 0 9 29 7 14 0 0 33 3 0 2 1 0 0 0 6 0 0 0 0 24 6 22 24 0 20 6 20 0 0 0 4 5 0 5 33 0 0 0 6 33 19 
0 48 0 17 38 0 0 19 0 29 0 0 20 11 0 25 0 0 0 1 20 0 10 0 6 0 54 0 17 9 14 9 0 24 14 11 50 0 25 13 21 0 0 0 9 4 48 0 39 45 28 
0 0 0 35 13 32 25 0 3 5 24 0 4 0 32 18 1 1 0 0 7 0 18 0 0 0 6 0 29 0 10 11 27 0 29 21 5 0 0 5 36 2 2 0 37 14 26 7 11 0 47 
3 46 3 0 25 23 0 0 0 0 0 0 0 0 10 7 0 0 0 9 0 8 40 0 3 0 0 6 28 24 25 17 0 0 0 0 0 3 0 0 20 0 0 0 0 0 0 75 9 16 28 
48 0 37 0 17 0 14 15 3 12 44 1 2 33 1 2 1 2 27 0 9 17 23 0 19 13 0 0 0 14 0 5 22 0 9 11 18 0 31 48 25 0 4 9 0 55 36 47 0 7 0 
14 0 2 22 17 44 0 0 0 0 8 15 9 15 27 25 1 7 19 4 0 17 17 8 11 19 15 5 20 23 42 1 2 9 0 1 0 0 3 9 5 2 9 0 0 5 0 5 1 59 0 
1 2 0 12 68 27 0 13 0 17 0 4 2 0 20 4 0 3 17 0 2 0 0 12 0 6 16 0 0 0 5 0 27 7 0 9 0 42 0 0 36 16 0 29 17 0 0 0 7 0 15 
0 38 0 0 0 11 9 0 3 1 10 27 16 0 4 4 14 0 0 0 9 11 8 9 0 0 6 0 4 15 19 7 26 2 0 0 14 18 27 0 0 0 0 12 15 52 6 0 0 19 0 
9 12 36 23 2 0 0 4 4 9 0 4 4 0 9 7 0 1 10 0 0 0 35 5 0 0 16 10 19 21 0 17 0 0 47 8 0 70 0 4 1 0 12 17 32 42 0 25 17 48 21 
0 2 0 0 0 11 0 0 15 30 9 0 6 0 0 23 0 28 13 0 0 0 0 29 0 0 8 0 2 0 14 13 22 0 8 0 0 14 23 27 13 0 3 3 27 0 0 0 4 0 0 
0 40 0 9 0 0 0 0 3 7 0 18 4 0 10 11 10 1 19 0 20 0 0 0 10 0 0 0 10 9 0 0 2 21 8 34 0 0 4 0 20 5 0 0 0 0 0 1 0 11 12 
2 10 0 0 24 10 0 2 3 6 13 9 0 9 40 0 0 0 0 0 17 0 0 28 0 16 6 0 33 13 0 11 0 4 0 0 0 0 0 0 0 0 12 0 0 0 0 0 0 30 0 
0 0 8 42 0 1 11 0 0 11 13 82 9 13 7 0 0 15 11 22 11 0 0 0 16 26 15 7 3 1 8 27 14 3 6 34 18 10 0 28 16 5 0 30 15 11 0 10 46 14 0 
2 0 12 1 71 0 0 20 0 6 0 27 36 17 34 7 8 0 1 11 0 0 0 8 0 0 3 0 10 0 2 0 6 26 0 5 0 1 10 7 0 0 0 0 0 48 0 36 61 74 0 
0 0 6 25 12 40 25 0 34 0 0 0 0 10 23 0 26 0 10 2 0 20 3 11 0 0 0 0 0 16 3 25 0 0 20 0 9 17 16 23 0 44 6 0 8 3 0 0 0 27 18 
43 12 0 0 12 0 0 30 0 11 23 0 19 20 30 0 0 8 13 14 10 2 24 5 0 5 17 3 0 0 0 6 11 23 19 0 10 26 34 14 3 17 6 29 25 8 24 6 0 69 18 
0 14 18 41 0 17 3 0 35 28 0 35 59 0 7 30 0 5 0 0 49 44 2 0 4 0 0 0 27 6 6 0 0 3 7 7 15 36 14 4 0 29 8 31 23 45 0 50 0 75 59 
44 0 0 44 0 0 0 23 38 13 5 0 0 0 3 1 1 19 0 0 0 7 0 6 3 16 18 0 4 0 23 23 4 14 0 0 23 0 0 11 0 11 3 0 59 0 0 36 0 4 0 
39 32 0 53 20 4 3 45 0 37 14 29 0 0 15 51 40 10 19 8 0 0 0 0 17 0 0 3 21 2 0 35 0 23 11 4 0 0 0 39 20 0 0 10 41 4 37 32 14 23 0 
2 7 4 34 0 0 11 19 5 40 3 0 0 7 0 0 39 0 9 4 0 18 0 15 2 4 9 0 17 0 0 0 0 10 0 9 19 10 0 18 10 0 1 25 0 20 31 1 14 78 29 
0 0 0 18 0 18 7 12 0 2 40 48 13 53 9 13 0 11 0 9 9 37 12 9 7 5 23 0 32 0 5 0 0 0 15 0 0 0 0 0 0 31 16 21 5 23 34 0 0 36 0 
3 42 4 0 27 27 7 0 0 18 0 0 39 0 39 0 0 22 0 0 20 23 0 0 6 3 0 54 13 48 42 4 0 6 0 31 0 7 0 45 28 5 0 31 3 23 24 27 13 15 0 
17 24 0 0 0 35 0 20 9 0 3 9 7 22 0 11 16 1 0 0 0 4 0 9 1 18 3 14 0 19 0 0 7 21 4 0 0 30 26 0 35 0 0 0 0 9 0 22 23 0 12 
16 0 0 0 4 40 15 0 0 40 0 0 0 5 8 15 0 9 10 5 39 13 35 0 17 0 3 0 0 9 1 0 12 0 28 4 21 0 29 10 20 8 41 10 0 11 0 69 0 5 28 
