51 29
33 6 60 28 23 14 0 0 56 25 13 0 0 0 4 0 0 0 12 16 0 28 0 4 24 47 2 23 21 0 0 55 19 9 0 12 46 12 0 0 0 0 17 12 0 0 44 0 19 36 0 
0 0 0 0 12 0 19 0 0 37 0 0 29 24 0 13 3 0 2 0 2 11 0 0 9 0 0 3 16 6 7 18 24 3 0 19 1 47 23 7 0 29 0 0 16 25 27 0 18 0 0 
0 0 15 23 51 0 0 24 0 0 3 14 6 1 34 24 0 0 16 0 62 8 0 25 1 8 0 0 0 9 0 0 0 35 5 0 27 2 0 0 0 0 0 0 0 0 36 0 42 0 27 
0 25 9 0 0 0 23 14 2 0 35 0 1 11 8 0 26 0 2 0 9 22 22 1 7 0 0 22 18 8 0 0 0 0 11 12 23 24 0 0 4 3 26 0 15 0 0 10 0 22 0 
0 5 10 0 0 45 22 0 31 0 8 0 10 0 17 18 30 0 0 0 0 11 17 0 10 0 2 4 0 19 9 14 2 15 26 24 31 0 13 52 48 21 0 19 0 0 30 0 4 0 0 
18 45 0 28 41 0 0 0 22 0 0 1 0 0 13 0 12 13 33 0 65 0 0 2 15 16 0 0 0 9 0 0 0 0 5 10 5 0 38 0 20 30 13 42 20 0 0 13 30 5 0 
42 0 9 35 2 6 30 8 8 0 9 24 0 24 4 13 7 22 17 0 0 0 15 0 0 0 0 16 0 0 15 16 14 0 7 43 47 10 35 5 0 31 31 6 34 36 0 0 0 6 2 
0 33 0 0 3 5 49 5 0 0 3 33 3 0 1 6 8 8 18 5 0 0 0 21 3 0 3 3 16 0 19 50 0 0 7 17 13 0 2 10 2 2 0 0 12 0 0 0 42 51 9 
19 31 23 41 0 23 0 23 5 0 0 8 5 0 8 0 16 16 32 2 0 6 3 0 26 23 3 34 14 28 23 13 17 0 0 35 4 0 12 36 0 20 0 16 18 21 0 7 0 17 15 
0 20 43 0 15 9 0 3 0 0 32 0 5 0 0 9 11 0 13 15 4 20 0 28 46 0 39 0 18 0 0 0 0 0 2 0 0 0 5 34 10 0 8 0 0 0 0 21 0 0 0 
18 37 0 5 16 0 0 16 5 0 17 0 8 55 4 11 12 13 10 0 0 0 22 0 2 0 18 3 16 0 8 15 0 0 18 0 17 31 0 15 4 11 4 3 43 0 38 1 0 7 0 
0 1 0 0 21 0 1 0 0 9 47 3 11 2 0 2 10 0 0 0 0 20 0 0 7 6 13 0 0 4 0 0 0 22 0 3 1 0 10 0 8 20 29 0 0 0 0 1 3 4 0 
0 8 33 0 0 0 27 0 0 36 10 0 30 11 30 0 0 15 12 29 3 0 20 0 0 0 25 0 2 11 0 6 0 3 0 0 5 6 8 25 1 2 28 2 24 36 83 0 0 23 0 
27 46 0 44 0 5 6 0 12 31 0 16 13 5 4 35 0 18 0 0 0 9 0 13 34 0 3 0 12 2 0 10 9 0 36 2 0 13 0 0 26 9 4 0 13 14 15 80 0 11 55 
17 0 44 18 14 0 7 13 59 16 13 93 27 11 14 27 6 30 44 3 17 1 9 5 9 45 0 23 2 0 2 4 14 14 23 29 14 3 3 2 10 73 23 0 85 70 3 22 0 0 33 
30 25 14 30 25 4 0 39 15 3 37 1 13 6 34 31 5 9 0 10 1 4 11 33 3 19 13 30 2 11 17 5 5 31 0 21 6 37 3 18 9 2 19 0 19 0 3 12 32 16 1 
13 7 0 0 0 0 12 18 0 0 0 11 0 11 5 0 13 0 8 11 12 13 0 11 15 0 8 0 0 0 0 24 15 18 27 0 0 0 11 38 1 0 8 11 0 0 0 0 14 2 0 
0 12 9 0 22 0 22 32 5 0 19 0 10 4 31 0 0 15 0 0 0 16 4 0 0 0 10 14 3 9 0 9 15 7 0 3 0 18 16 30 17 11 18 0 29 1 3 19 0 4 12 
0 17 0 9 0 25 50 26 0 0 0 0 28 2 6 4 33 12 17 14 0 5 6 14 0 0 5 2 0 10 0 8 0 44 16 32 0 0 26 34 14 13 6 0 6 0 4 0 0 8 21 
4 0 0 0 17 0 41 0 0 0 6 0 0 0 16 0 0 11 8 10 0 15 4 0 18 14 0 0 0 21 16 27 19 3 0 17 4 0 13 0 3 1 0 14 0 0 0 29 18 0 0 
21 49 34 0 29 0 19 0 6 15 1 0 7 14 0 11 19 29 0 8 19 19 9 14 0 18 0 0 13 0 6 23 0 44 2 41 43 43 6 25 0 0 3 26 1 1 10 0 40 6 49 
64 0 0 0 0 35 0 2 12 0 7 0 0 18 0 31 19 0 54 27 42 3 4 26 21 0 6 4 0 0 3 10 1 0 23 19 0 0 0 24 10 8 25 43 0 36 27 0 1 0 40 
0 37 0 0 42 0 0 13 20 0 27 0 31 21 0 18 0 0 32 13 3 5 2 0 13 4 0 2 15 0 26 4 50 25 2 6 32 6 42 0 0 10 12 22 0 13 0 0 2 0 32 
0 0 9 23 0 0 0 4 41 17 0 25 5 0 4 0 0 0 21 0 0 27 0 0 0 0 14 8 0 0 0 0 0 0 16 0 42 0 0 14 0 0 0 19 0 0 0 0 27 41 0 
0 0 32 0 48 10 0 9 0 0 2 0 10 8 0 22 31 0 34 0 0 0 14 0 0 0 18 2 0 0 17 0 0 0 10 0 0 0 9 0 0 0 16 5 34 0 0 10 9 0 0 
0 0 0 23 41 0 0 9 12 27 48 0 0 2 7 50 9 18 0 0 4 22 0 0 0 0 16 0 3 29 0 31 24 0 21 0 3 19 0 10 8 21 0 0 24 6 0 0 10 34 0 
0 12 0 10 0 10 1 12 0 23 0 12 19 10 18 4 0 34 22 0 0 14 3 20 20 20 0 0 0 7 6 12 18 15 0 4 7 20 2 0 7 0 30 49 10 13 0 0 0 0 41 
0 1 18 0 0 0 34 4 22 2 55 20 0 17 31 0 0 15 12 30 14 0 3 0 14 9 0 21 0 7 12 20 4 0 20 0 34 0 0 12 0 13 0 6 7 13 0 0 39 0 7 
0 25 0 23 12 0 0 0 0 2 22 14 14 0 3 1 0 22 11 9 16 55 0 15 18 0 17 0 9 0 0 20 0 10 5 41 3 1 3 0 37 43 6 26 3 0 0 3 14 15 0 
