51 29
6 74 8 0 35 10 27 8 49 0 34 0 0 0 10 43 0 16 23 29 0 21 0 6 9 0 0 22 5 0 8 9 23 7 0 22 35 0 18 47 39 39 34 24 0 35 4 0 24 0 14 
0 0 1 0 0 0 0 7 0 29 22 28 38 0 6 0 36 0 21 0 4 20 21 0 26 0 19 0 18 2 0 0 16 16 4 0 0 0 0 50 0 17 0 14 0 0 0 21 0 18 43 
0 0 0 0 0 0 0 10 7 0 24 15 26 0 34 19 24 10 1 0 10 0 0 0 6 0 25 10 2 16 16 25 18 1 0 14 16 0 0 7 46 26 0 10 0 0 7 12 0 0 8 
0 24 0 0 0 0 16 1 23 20 3 6 3 0 6 0 0 6 6 0 0 22 5 12 6 24 28 0 0 20 0 19 10 0 22 20 5 0 0 1 0 25 0 21 0 2 0 2 0 0 23 
25 13 7 0 36 60 15 59 12 7 0 36 22 0 22 4 0 0 8 18 0 10 3 17 17 3 0 15 0 28 0 10 13 0 33 0 0 18 1 1 36 34 0 25 0 53 0 7 0 0 0 
0 0 0 2 18 42 0 0 34 5 0 0 4 8 0 6 12 0 3 7 0 2 15 0 3 0 0 17 13 5 0 9 0 0 16 32 21 16 7 0 21 8 0 2 0 0 6 86 1 0 7 
0 0 0 0 32 7 31 28 0 15 2 0 35 9 0 8 0 0 17 14 0 10 11 0 29 2 8 22 0 16 20 0 0 0 16 22 0 47 5 0 0 15 2 0 45 10 20 3 31 21 19 
65 9 63 0 0 0 0 9 0 17 6 11 0 0 0 33 14 0 18 0 29 19 4 0 12 0 17 0 17 14 0 0 9 0 0 0 3 0 0 0 0 9 0 0 0 0 36 0 69 29 0 
11 0 14 25 8 40 1 33 5 38 0 19 0 11 22 0 25 0 6 0 16 5 1 0 6 22 0 4 49 24 0 4 13 0 0 0 26 0 29 0 9 30 8 9 10 0 0 0 26 2 34 
19 49 6 0 29 7 1 21 31 17 0 55 7 6 6 2 2 0 15 12 0 43 9 2 8 21 27 2 21 18 0 9 0 26 9 36 20 4 17 7 3 1 0 13 11 23 3 14 7 44 49 
28 22 0 12 46 37 10 6 0 5 0 23 1 1 6 0 0 0 0 2 0 1 11 12 14 0 22 0 1 5 8 4 33 2 23 11 1 1 6 7 15 16 17 0 1 8 13 4 0 0 2 
48 0 75 0 31 0 33 0 5 3 6 0 0 0 39 0 35 13 10 19 0 0 0 0 13 9 25 10 10 9 26 0 24 0 44 39 12 41 3 23 10 0 4 13 8 43 51 64 35 38 0 
22 26 38 0 0 4 39 16 0 0 0 9 58 49 0 14 5 0 1 0 0 2 0 5 27 15 38 23 0 16 0 15 0 12 0 0 0 13 5 0 38 29 36 19 1 25 8 0 6 4 12 
0 27 17 0 0 0 9 0 0 0 0 12 13 7 0 9 0 0 0 0 0 35 7 24 7 7 0 5 27 4 0 4 15 0 0 0 0 0 34 4 0 18 0 13 0 5 1 0 0 28 3 
0 34 0 29 3 0 27 48 7 40 5 7 0 8 0 2 13 15 0 9 1 9 5 3 3 22 0 21 14 0 10 0 0 5 29 26 15 22 17 10 10 0 7 8 0 42 8 24 0 47 8 
41 0 0 14 20 0 30 0 2 5 26 0 31 8 15 23 12 7 4 0 25 10 0 6 6 21 14 13 4 2 13 45 0 4 2 0 24 26 16 23 2 47 24 31 0 20 24 6 32 0 5 
0 39 14 9 0 12 67 44 0 30 0 0 11 0 0 0 14 0 31 36 10 0 21 11 0 24 0 0 0 0 0 6 0 0 28 1 16 0 0 27 0 0 0 0 2 16 5 0 36 36 14 
0 31 12 0 0 3 0 0 24 15 0 11 6 12 0 34 3 2 35 0 0 0 9 18 8 0 0 10 0 0 0 8 31 5 2 0 0 22 5 0 2 0 0 16 3 17 0 3 0 30 0 
0 0 0 4 4 0 6 0 16 10 23 3 2 0 0 0 0 0 0 0 4 27 18 0 0 13 3 19 0 0 0 0 0 23 9 3 0 0 0 9 2 17 0 1 9 5 25 0 0 0 6 
7 7 0 0 32 11 0 5 0 27 0 0 5 0 0 0 21 0 0 0 0 10 6 27 12 0 8 33 18 0 3 0 0 21 12 1 32 21 0 0 0 0 33 0 0 7 0 8 0 2 34 
74 0 47 70 0 0 11 42 0 0 0 0 0 13 0 0 29 0 1 10 0 13 5 12 21 25 19 14 0 28 6 0 0 16 0 11 6 0 0 4 0 20 0 17 9 25 3 0 3 2 0 
42 0 0 12 0 40 33 1 16 23 32 3 0 19 0 21 7 0 4 8 10 3 0 21 0 0 9 0 10 0 11 21 8 11 28 40 0 5 0 0 13 46 6 0 15 35 23 0 15 5 0 
0 0 35 33 5 32 0 8 3 4 8 0 0 0 0 0 8 0 8 0 0 7 12 9 8 0 33 39 7 16 0 0 0 0 4 22 0 47 0 0 26 17 0 0 41 0 0 21 0 12 18 
0 0 67 0 18 0 0 8 49 45 0 0 0 4 0 21 12 23 39 2 12 0 3 0 8 0 14 0 0 0 0 10 4 0 0 17 40 2 0 17 21 0 0 2 0 19 13 0 39 47 0 
27 0 0 0 0 0 0 32 2 0 10 12 12 0 0 0 0 13 15 0 0 6 0 14 16 0 6 29 9 0 9 2 3 0 15 18 0 0 0 31 30 0 21 13 8 0 5 0 24 57 24 
0 9 0 1 37 31 40 36 0 0 2 7 0 16 0 0 16 21 3 9 0 26 15 16 7 32 5 0 0 0 0 5 24 0 7 0 2 27 0 15 9 37 17 0 0 39 0 0 30 14 0 
0 0 0 1 3 45 0 1 9 25 24 10 22 35 2 36 11 0 5 12 0 10 0 3 5 1 24 0 0 17 0 8 23 0 8 0 0 11 0 0 0 7 0 0 0 12 17 15 28 30 9 
0 0 0 4 22 5 7 4 0 0 5 0 0 12 0 23 10 13 0 15 11 3 0 0 30 37 22 7 13 0 13 24 4 0 11 0 0 5 24 13 0 30 0 6 0 14 0 0 0 24 0 
26 0 0 0 0 12 0 0 25 17 13 17 26 14 0 0 0 0 0 18 26 0 5 46 23 0 43 23 13 12 3 11 13 3 14 11 0 0 0 27 23 29 11 0 0 3 11 23 21 0 0 
