53 30
0 0 26 0 4 67 0 10 11 0 0 37 0 0 3 0 0 0 0 11 0 0 0 0 23 25 1 22 12 11 17 41 0 0 7 0 0 0 2 0 0 53 18 0 39 0 3 27 30 0 0 48 10 
0 41 20 0 4 21 33 0 0 26 0 0 0 11 0 0 19 0 0 0 0 0 8 0 11 0 22 0 0 0 0 0 10 14 0 33 0 0 0 98 0 12 51 0 0 0 1 39 2 19 0 16 53 
0 0 16 19 0 0 23 10 62 16 3 38 24 15 0 0 4 0 27 0 36 8 14 23 5 48 14 21 9 0 0 33 1 1 0 0 0 30 0 0 0 0 24 18 20 0 24 0 6 0 19 0 0 
47 19 17 0 0 0 25 23 6 70 25 0 3 4 3 1 25 0 30 34 14 26 0 28 0 0 13 0 21 3 24 12 3 27 0 0 27 11 36 0 40 0 12 2 1 2 3 7 55 18 5 0 13 
27 0 0 0 4 0 22 7 10 0 0 1 1 0 0 8 0 19 10 0 20 0 0 0 0 17 0 0 0 0 0 0 0 0 0 0 14 24 4 0 0 0 19 0 0 0 0 1 0 0 0 0 3 
26 10 0 74 73 0 21 0 13 0 3 3 0 0 15 0 28 11 18 2 46 23 1 0 20 0 34 22 11 0 21 45 12 2 0 0 18 20 6 22 23 14 0 0 19 25 7 0 0 23 6 20 0 
0 0 34 1 0 38 0 0 16 0 3 0 0 0 2 2 0 19 36 0 2 0 39 0 9 2 18 0 0 0 0 4 14 16 0 0 47 32 0 14 26 0 0 61 22 42 0 0 11 16 0 1 0 
4 27 0 37 0 60 3 11 13 15 32 0 26 54 12 5 0 0 7 0 21 13 34 3 15 27 0 0 33 5 0 27 0 28 4 14 0 19 21 15 25 15 19 0 43 14 1 22 35 22 0 0 12 
93 5 0 14 9 45 1 36 0 32 20 24 2 0 2 2 14 9 0 0 0 0 0 0 7 2 0 5 0 17 14 28 14 0 17 41 2 11 0 39 0 0 33 36 39 11 53 0 6 49 15 0 0 
11 36 0 40 17 5 0 0 0 0 7 0 7 7 0 0 10 0 0 19 0 50 0 6 0 11 9 18 2 0 3 10 0 4 13 0 10 22 4 12 8 0 4 0 11 0 0 26 24 17 0 17 0 
38 30 8 2 47 0 0 0 0 11 8 2 11 0 0 71 0 14 51 0 0 29 19 0 0 0 5 5 0 23 0 46 0 5 18 0 8 0 14 11 0 2 6 16 0 0 0 32 0 0 36 47 54 
4 0 0 4 0 0 0 0 71 0 3 1 24 75 0 56 2 7 11 0 16 0 24 10 0 0 14 14 27 0 1 0 28 9 19 39 18 19 6 36 48 0 18 19 4 0 62 0 28 1 23 19 0 
9 0 4 84 19 0 20 13 39 36 4 2 0 15 35 33 0 14 4 20 0 0 1 0 23 0 5 0 24 0 30 39 5 57 0 0 3 24 0 46 8 0 0 10 5 0 40 47 1 22 0 48 6 
14 16 33 0 2 0 31 8 0 37 5 31 0 5 20 10 2 16 0 0 0 14 1 8 0 0 4 0 0 0 0 26 33 41 8 14 0 7 7 1 1 12 31 12 6 0 40 0 0 18 0 0 0 
0 0 0 58 2 25 0 7 18 0 6 12 25 0 7 0 0 2 25 5 0 0 20 34 5 15 18 0 25 39 9 0 0 0 6 0 0 25 3 0 31 0 0 20 0 0 0 0 19 46 0 0 0 
3 45 0 14 0 21 0 0 0 24 0 6 0 6 0 20 0 6 0 14 0 25 17 10 7 16 4 8 0 6 19 3 5 19 8 2 40 0 16 10 0 5 0 2 0 0 25 9 13 1 0 0 0 
50 38 45 8 2 30 3 11 36 39 22 15 9 5 4 0 0 16 2 31 0 10 19 0 0 0 6 1 22 39 16 0 3 23 1 30 0 0 0 59 17 9 36 0 4 2 19 18 6 17 34 49 31 
2 11 41 23 48 16 11 0 32 0 29 0 48 12 7 15 3 0 7 5 2 38 1 2 0 1 34 4 10 0 14 9 9 0 6 0 24 0 9 0 74 0 0 34 0 20 0 0 17 1 0 61 31 
27 0 0 0 0 0 0 10 1 40 41 0 0 0 0 0 0 0 0 0 22 0 0 0 0 10 11 0 0 0 0 0 32 14 0 0 14 10 0 9 0 0 13 0 0 14 0 4 48 6 0 36 0 
0 12 0 0 27 36 0 17 0 16 14 30 0 12 16 26 14 27 12 12 0 0 0 0 31 2 25 0 0 8 18 38 0 12 2 8 0 0 0 0 0 62 25 27 18 11 0 0 8 0 0 0 0 
51 0 4 15 44 23 19 44 0 0 0 0 23 0 8 0 16 0 0 32 0 4 13 0 0 9 0 0 7 0 0 1 5 2 15 0 0 0 7 14 4 0 0 9 0 0 0 0 47 4 4 63 0 
33 0 0 4 0 6 0 40 0 0 0 4 0 0 5 0 0 0 0 0 26 0 0 0 0 12 4 10 4 0 8 0 0 33 0 12 15 9 13 1 0 0 0 5 19 0 26 38 0 0 0 4 27 
36 0 0 59 0 29 0 75 12 15 5 0 8 0 70 20 0 0 23 3 22 2 0 8 5 0 6 5 11 9 0 0 19 0 24 13 44 12 0 17 0 13 15 0 8 38 32 40 3 2 0 20 87 
51 0 0 0 34 0 6 0 26 21 15 0 0 0 0 0 0 14 0 0 0 1 0 0 16 0 2 13 0 3 9 17 0 0 20 8 0 0 34 0 3 6 19 10 0 0 0 2 17 0 0 51 0 
0 6 33 93 0 0 4 11 19 41 14 9 0 11 22 0 18 0 0 16 5 1 19 0 8 0 0 0 0 0 13 24 0 25 0 0 10 35 14 30 37 0 0 0 0 0 3 42 46 0 54 0 0 
0 0 22 0 0 0 0 3 0 0 8 0 0 0 9 0 0 6 0 0 0 21 0 3 0 25 3 5 0 0 12 0 3 9 7 3 0 20 0 0 0 0 24 0 0 0 0 0 8 10 0 4 0 
0 0 0 0 0 0 1 0 0 22 0 24 57 0 0 0 0 14 0 29 0 9 20 0 0 0 20 0 0 23 0 7 0 0 0 0 0 0 0 0 0 0 0 0 0 33 4 0 21 5 0 8 0 
0 0 40 111 0 0 0 3 25 0 5 0 7 0 0 6 0 1 0 0 0 1 0 0 0 0 0 58 0 26 0 0 0 6 9 0 8 0 0 22 7 0 40 49 8 0 0 48 1 0 0 24 49 
0 0 36 0 23 0 31 8 37 35 0 0 1 0 21 1 0 9 0 21 0 0 24 11 0 2 8 11 0 8 8 23 32 0 4 12 19 57 36 2 53 7 4 0 0 37 4 10 13 52 0 17 0 
50 19 26 29 0 0 55 42 0 1 33 17 21 22 31 31 5 23 0 37 11 20 0 1 26 8 23 0 8 0 11 21 0 30 6 23 12 0 0 4 2 52 0 37 0 61 0 0 0 42 94 0 0 
