53 30
27 32 0 13 59 5 32 0 22 11 13 90 40 41 21 48 1 33 1 31 30 28 0 0 0 29 64 0 0 20 6 16 7 10 19 1 42 19 19 13 29 29 0 28 3 36 29 32 18 84 107 14 52 
13 0 31 0 0 1 40 35 0 20 0 0 0 24 1 32 49 2 0 0 0 14 0 15 0 0 0 10 0 0 24 0 0 19 13 15 23 0 8 44 0 0 26 5 0 32 16 0 12 0 39 0 0 
73 0 0 11 0 0 0 5 14 0 27 2 23 0 12 0 7 0 0 0 0 0 0 19 0 0 12 0 0 0 9 0 0 33 0 24 25 0 3 0 41 0 0 9 0 0 46 16 0 37 11 0 18 
0 8 48 3 0 3 0 18 9 16 0 27 0 12 3 5 13 21 0 0 13 4 0 0 0 12 18 0 24 0 0 0 18 0 8 0 0 0 9 0 4 1 6 0 0 0 0 16 23 0 55 0 24 
0 0 3 64 0 0 0 0 22 20 0 10 31 4 51 0 16 0 0 0 17 20 0 0 0 25 4 0 0 0 43 0 18 4 0 15 11 0 0 0 17 20 9 0 0 0 0 3 34 0 11 22 0 
0 0 8 5 0 25 0 5 0 0 0 12 0 27 0 51 28 11 0 1 7 20 0 13 9 0 7 17 11 16 15 0 0 18 0 8 14 0 28 4 46 59 0 5 14 13 0 5 0 0 21 0 0 
0 17 25 16 0 46 8 31 0 0 1 19 22 0 15 0 0 22 22 16 0 23 2 5 8 0 0 0 28 8 17 0 0 34 20 37 1 12 26 11 0 31 5 13 50 21 41 0 3 0 3 3 0 
6 50 0 4 0 45 0 0 15 0 0 11 0 6 0 22 0 11 51 6 0 4 0 17 0 6 0 0 14 0 0 0 0 10 24 1 10 18 33 0 39 17 28 9 19 0 0 0 6 46 52 5 0 
4 1 50 0 0 64 0 37 11 26 31 0 10 39 27 37 0 0 19 8 0 16 20 0 9 24 7 0 0 32 0 14 1 1 0 10 39 42 0 34 0 19 9 31 55 29 19 0 28 0 0 42 75 
0 25 0 25 0 0 0 0 0 23 3 10 0 4 0 0 0 0 47 0 0 13 0 0 1 6 25 22 0 15 4 3 0 17 35 0 0 2 0 0 6 10 0 0 23 37 0 47 5 22 12 7 0 
27 0 16 24 0 0 0 5 8 11 16 0 0 0 36 38 0 7 0 0 0 0 14 0 23 23 19 53 0 0 8 13 0 18 16 52 33 0 13 0 0 10 7 0 31 18 9 23 0 0 12 49 0 
39 29 0 37 0 57 0 18 1 24 0 21 4 26 0 10 15 17 39 0 0 0 0 0 0 18 9 10 0 0 53 6 0 33 0 0 7 7 0 39 0 0 0 1 0 15 28 0 0 44 0 48 41 
4 40 1 0 0 10 22 0 5 12 24 3 32 0 8 0 2 0 0 0 0 20 20 13 33 0 19 0 26 3 0 22 0 7 0 33 0 0 0 0 46 20 23 0 12 49 0 29 0 0 9 50 26 
3 43 0 0 0 29 5 0 7 4 1 0 0 0 15 20 0 17 2 11 0 0 39 0 0 3 3 22 3 11 21 0 0 50 0 13 0 10 2 17 10 0 2 0 14 0 17 3 0 0 13 18 0 
66 0 6 0 0 0 13 0 0 0 5 14 0 0 7 9 37 30 0 0 30 14 0 0 0 0 0 9 0 0 9 0 0 0 2 4 0 0 0 0 0 0 0 0 33 0 46 30 0 0 1 0 36 
0 0 0 0 15 0 29 0 12 0 13 3 7 0 0 0 36 19 6 0 0 14 0 0 5 0 0 0 0 0 0 0 0 9 0 29 0 0 29 0 0 30 0 0 0 0 6 0 0 8 1 0 30 
43 31 0 0 0 4 33 6 0 35 16 0 0 16 36 15 9 0 12 0 37 12 6 10 8 0 0 12 19 0 10 0 34 16 1 0 27 2 0 26 5 0 0 43 3 12 8 0 0 0 45 0 32 
0 17 30 12 0 39 0 0 6 7 0 12 0 2 0 16 0 3 0 10 3 18 0 0 6 1 44 7 0 0 3 0 11 0 7 0 38 0 0 2 0 0 0 11 39 2 1 12 0 23 0 6 0 
2 5 50 0 22 11 6 44 0 0 13 11 30 9 4 0 22 0 18 0 0 0 8 19 17 0 8 16 15 15 21 21 19 26 7 0 7 21 4 0 6 1 5 6 18 0 0 16 0 0 20 47 50 
29 31 0 48 33 4 9 25 12 62 7 0 39 16 0 5 1 0 0 19 12 0 0 22 0 0 23 0 6 29 0 0 2 0 0 0 8 80 25 36 8 10 4 5 32 25 31 9 55 0 3 35 12 
2 0 0 0 9 32 0 23 8 0 0 0 7 0 18 0 9 11 0 16 0 36 0 0 5 0 17 0 0 0 0 0 0 19 0 0 29 32 34 0 0 10 0 0 15 9 0 0 0 0 0 0 49 
93 9 0 0 0 0 0 0 39 5 12 0 30 0 17 9 0 6 43 28 2 2 17 4 0 0 7 15 20 38 4 0 0 0 0 0 0 29 0 12 7 0 30 10 0 0 0 69 0 0 0 33 0 
0 9 7 20 0 14 8 0 39 42 18 0 32 17 8 17 0 31 0 0 0 8 5 0 5 0 4 5 18 8 10 13 8 0 0 0 4 8 25 37 10 0 0 0 19 2 0 37 31 0 0 42 0 
0 14 0 0 0 1 4 0 0 0 11 9 0 0 9 7 0 0 0 0 2 0 0 0 14 0 0 0 0 15 0 21 0 0 0 24 0 0 18 0 0 1 1 0 15 0 0 1 15 10 0 48 0 
0 0 0 0 43 36 0 0 33 15 0 0 20 0 25 30 0 0 2 4 8 14 0 3 18 0 0 0 20 0 2 0 2 28 1 15 23 0 0 2 6 43 0 0 0 19 0 24 28 0 15 0 0 
0 0 7 37 18 0 2 35 14 7 23 0 0 0 31 0 0 0 15 0 11 0 22 0 0 0 23 0 5 0 18 11 9 38 0 15 0 16 0 0 0 11 35 0 16 42 18 0 0 0 10 48 0 
1 26 37 21 0 0 9 70 37 0 7 1 0 5 22 1 15 6 13 18 26 3 0 10 0 2 0 0 0 0 0 2 0 15 24 21 9 0 0 23 21 31 0 37 0 9 33 0 0 0 0 0 6 
10 0 0 0 0 24 15 0 1 17 3 67 0 8 0 13 0 0 0 0 2 23 18 0 5 25 4 0 0 24 9 2 11 9 2 0 6 22 0 0 6 0 0 13 23 40 0 6 0 0 0 0 41 
23 48 41 3 0 22 13 0 38 4 43 28 17 32 15 4 0 0 14 23 0 0 9 23 2 9 20 0 7 24 0 0 3 11 9 0 0 1 0 0 0 0 0 74 14 0 38 0 19 65 0 0 0 
0 0 0 0 9 33 0 0 0 29 27 6 21 0 0 22 21 14 0 0 0 9 4 0 0 0 0 2 0 0 0 0 0 39 0 8 29 32 0 7 29 0 0 38 0 9 7 0 11 0 0 0 0 
