53 30
9 0 0 0 0 0 34 0 16 17 8 0 8 3 9 43 0 4 25 4 7 7 14 0 0 23 24 5 22 7 3 3 43 0 7 0 0 2 0 1 0 0 0 18 0 13 15 19 25 0 50 0 34 
0 0 0 12 0 2 0 0 3 36 0 0 40 34 0 12 24 0 24 8 0 14 6 16 0 15 7 19 19 7 2 4 0 6 18 32 0 0 7 3 0 23 3 0 10 15 2 34 0 0 0 0 0 
17 0 0 0 0 0 0 19 44 0 0 0 0 0 19 0 0 0 26 19 0 0 24 0 9 0 19 9 0 0 0 2 0 0 0 1 0 15 0 0 15 1 0 0 4 0 24 27 4 3 0 0 101 
32 51 20 6 18 0 34 70 31 0 18 8 8 3 10 12 0 6 9 0 2 17 18 18 11 0 0 1 0 12 10 24 14 33 0 21 11 0 36 34 28 1 2 7 25 26 1 10 11 0 0 16 51 
15 16 0 15 0 0 19 0 0 31 17 31 2 0 29 19 0 44 1 3 7 0 0 0 6 0 0 7 11 20 24 0 0 19 19 0 0 6 24 38 0 0 19 0 0 19 6 3 0 32 29 6 6 
0 58 59 0 24 27 0 15 0 17 1 2 5 18 9 0 3 0 15 6 0 0 0 44 13 0 0 5 8 17 18 0 29 4 49 0 8 35 15 16 35 0 0 4 0 0 27 0 0 26 6 0 62 
16 0 0 1 20 0 0 11 3 5 14 40 0 18 0 16 0 9 0 0 7 14 0 1 0 0 0 26 0 0 0 16 0 4 0 35 0 0 0 0 19 0 0 0 3 0 19 0 0 0 0 85 0 
0 46 20 0 10 0 3 0 5 7 11 0 13 0 12 17 22 3 34 3 1 10 42 1 0 10 11 0 9 0 0 0 2 0 5 0 0 12 0 0 0 0 0 7 0 0 0 41 0 27 7 35 34 
14 37 25 21 0 0 27 18 0 4 14 6 0 0 26 4 0 3 0 25 0 3 12 19 21 0 8 2 12 14 16 0 0 6 12 5 5 0 66 0 14 35 4 15 0 0 50 28 0 0 0 0 33 
24 0 14 27 22 0 38 0 6 7 0 0 0 0 26 20 0 6 12 8 27 0 0 0 24 0 24 0 0 18 0 25 28 0 1 0 0 0 0 6 35 10 0 13 0 0 0 27 0 9 0 0 0 
37 32 19 1 0 0 0 2 10 0 0 33 6 0 1 0 5 0 9 0 0 25 0 20 0 2 17 12 0 1 0 3 27 39 18 24 0 11 0 9 24 0 0 11 15 16 0 7 9 15 0 24 0 
17 0 0 12 0 14 0 16 0 0 0 26 11 36 31 0 0 42 0 1 15 11 15 37 0 0 5 3 16 18 0 3 0 14 32 6 0 7 47 0 0 0 30 0 0 2 8 31 5 0 6 6 0 
0 3 0 0 0 54 6 13 23 15 24 10 0 0 61 60 15 0 23 16 31 2 7 4 14 25 21 0 19 16 0 21 0 0 35 0 0 6 14 0 0 59 27 12 39 9 0 23 33 18 0 11 38 
31 0 12 12 0 0 0 4 0 0 21 12 0 0 17 60 0 0 3 0 0 0 24 0 0 0 0 0 0 0 0 39 13 0 0 2 30 25 10 1 7 0 0 2 0 15 0 32 5 0 0 0 0 
10 2 0 0 6 0 10 0 0 10 6 0 0 0 44 31 0 0 23 0 12 0 14 0 0 0 11 0 0 13 3 0 0 8 0 11 9 2 0 0 0 8 0 3 0 11 36 3 0 35 0 0 0 
5 1 0 0 6 12 0 0 0 15 2 0 0 18 0 0 0 0 0 0 14 26 11 0 5 3 10 4 11 22 9 31 0 14 20 0 0 0 12 0 0 0 12 0 0 14 0 3 0 31 0 21 0 
0 3 0 49 45 8 0 0 17 15 20 0 6 5 0 12 1 0 0 0 0 18 1 11 0 11 11 0 9 0 22 0 0 6 23 0 0 13 5 0 3 0 33 16 0 3 0 9 8 53 13 0 67 
7 40 1 14 25 25 0 0 0 0 34 0 0 0 0 33 0 21 0 6 0 5 3 0 0 10 9 0 12 9 10 0 24 0 20 1 19 0 0 0 21 0 2 0 0 7 9 37 13 0 10 6 7 
5 0 7 5 0 0 12 0 0 0 16 4 0 7 30 0 0 0 11 0 10 10 42 0 0 19 0 0 0 11 9 20 0 0 0 32 0 4 0 0 0 11 0 0 11 0 0 25 5 10 0 20 0 
18 0 0 75 30 29 26 16 14 0 13 0 44 0 0 0 0 0 34 4 0 3 13 31 17 13 0 22 4 0 27 1 19 27 57 13 0 12 38 1 49 38 37 0 0 0 50 0 0 44 38 0 51 
0 24 11 0 0 8 0 2 44 0 0 0 13 0 0 10 0 0 21 11 0 0 25 0 6 24 0 19 19 7 14 21 0 27 0 9 0 22 0 0 0 0 23 6 5 0 0 36 6 0 0 0 0 
16 24 0 3 26 0 0 0 14 0 39 8 0 0 19 56 16 0 0 19 0 8 19 41 0 24 0 0 10 27 32 0 0 5 10 0 6 0 33 0 0 19 0 0 10 0 23 0 33 3 0 0 23 
7 26 0 0 0 0 18 0 26 21 21 7 18 0 61 0 0 16 0 0 0 20 0 0 18 32 0 0 17 29 3 0 0 0 9 0 4 12 0 0 0 0 0 71 0 36 7 0 0 13 36 0 31 
44 0 0 34 66 2 27 29 0 19 0 0 28 0 0 0 0 0 13 18 0 0 0 14 0 0 6 2 4 40 60 21 0 20 0 31 9 12 0 2 68 0 38 43 21 0 4 12 0 0 47 21 21 
2 19 6 44 4 73 8 14 0 9 6 26 0 53 1 24 0 0 11 0 6 1 5 30 21 13 8 24 25 1 14 0 29 0 0 21 6 0 54 0 19 0 5 0 1 9 12 80 34 5 43 0 0 
0 20 21 0 1 3 1 71 2 0 10 0 0 0 13 0 14 0 0 0 0 37 12 24 0 0 22 13 0 0 6 0 0 0 10 0 0 0 12 37 5 19 0 0 47 0 1 0 0 7 0 0 0 
0 0 0 39 0 2 35 0 0 0 0 0 36 17 17 0 0 0 11 0 3 0 0 0 0 0 12 0 0 11 0 18 0 5 12 0 0 3 15 0 21 35 39 0 0 23 0 26 4 0 0 0 0 
38 43 72 15 0 12 15 1 25 26 0 17 0 0 18 0 6 0 23 0 0 20 10 0 16 1 17 0 5 48 0 0 18 34 0 1 0 29 21 23 17 0 76 0 12 3 20 45 0 0 32 0 0 
31 0 0 8 0 23 5 42 3 0 0 27 0 23 9 0 0 24 12 0 14 10 40 45 16 0 7 0 1 34 19 13 0 9 2 1 0 7 0 0 76 18 39 0 0 0 0 0 25 42 0 0 0 
27 0 15 6 6 0 36 21 8 0 28 7 10 10 0 17 0 0 16 0 18 18 0 15 12 0 11 14 24 21 0 31 8 0 14 2 0 25 46 0 8 10 36 7 0 11 0 27 0 0 0 30 24 
