53 30
25 40 0 27 41 0 0 0 0 14 0 0 0 10 7 0 0 0 7 0 29 21 0 20 0 5 23 0 0 20 33 10 0 16 0 21 32 0 0 4 0 53 0 0 0 0 0 0 12 57 1 0 7 
6 39 0 0 0 0 36 0 0 0 16 8 0 15 10 8 4 0 0 17 4 7 21 0 4 7 0 15 27 0 0 20 0 3 28 38 0 4 0 0 66 13 15 0 30 2 0 2 32 0 2 14 2 
36 0 13 69 0 0 0 29 0 49 16 9 0 0 0 4 0 24 17 14 20 24 28 0 26 12 15 47 0 0 15 16 21 0 0 20 63 28 0 55 7 24 0 6 21 25 0 44 0 0 17 0 0 
0 18 40 45 12 3 20 0 5 4 0 4 1 0 10 0 7 26 0 51 0 16 0 5 0 0 37 16 25 18 15 0 1 14 0 0 3 1 11 0 0 0 25 30 0 1 0 25 0 14 24 0 0 
0 0 18 1 25 0 0 0 0 0 1 0 0 0 0 20 0 0 33 0 0 0 0 0 0 14 0 0 24 0 0 0 26 0 0 0 0 0 14 22 0 0 0 0 0 2 0 2 33 1 0 69 14 
0 20 0 7 29 14 0 3 0 7 17 0 8 9 0 27 13 0 0 18 0 20 9 0 4 12 8 19 0 0 0 0 17 0 12 0 14 0 21 0 0 47 65 9 0 11 0 32 7 7 9 0 5 
37 0 11 0 0 0 22 0 48 0 0 0 22 42 23 0 26 33 0 6 7 0 17 0 0 0 0 7 27 0 0 31 0 0 0 0 0 0 12 9 0 0 26 0 0 0 0 8 0 0 33 0 0 
0 34 26 0 0 4 7 0 0 33 5 0 1 27 6 6 0 0 10 0 0 25 12 0 0 0 0 3 49 21 8 4 0 4 6 34 0 21 0 0 2 0 20 18 0 0 42 12 14 0 21 11 17 
42 0 45 0 30 18 28 0 0 43 37 13 0 0 0 4 4 0 25 9 19 0 11 7 25 3 6 4 24 0 22 11 0 15 27 0 20 0 0 0 20 0 44 23 5 4 0 82 14 4 17 8 12 
0 0 14 56 28 0 0 27 25 0 51 21 20 38 8 32 20 1 8 13 33 0 0 26 0 26 10 0 0 14 13 4 45 26 50 18 4 0 12 19 2 0 0 28 0 0 1 24 0 9 0 12 0 
0 0 0 2 47 24 3 0 4 0 9 0 0 55 8 30 7 30 8 7 0 17 0 0 7 11 15 4 17 24 19 0 13 0 0 11 1 0 9 0 27 0 26 0 0 64 6 0 35 19 0 4 65 
7 43 0 0 8 5 0 9 0 0 0 17 0 0 0 0 6 0 0 14 30 0 0 5 0 0 0 0 0 0 0 0 13 0 0 0 1 0 0 11 0 10 1 41 0 0 27 0 0 0 57 0 0 
6 0 0 0 0 10 68 0 0 12 3 0 0 7 2 43 9 11 0 6 28 34 0 11 0 0 11 1 13 0 0 12 0 9 0 18 17 31 2 8 0 21 0 8 0 2 0 0 6 0 0 8 17 
0 0 16 30 0 0 22 35 17 19 37 69 0 10 10 8 0 7 4 3 16 0 9 0 0 3 34 1 49 10 0 30 9 0 0 1 0 0 0 0 30 0 6 16 28 0 9 0 17 34 19 0 0 
0 24 0 21 0 23 7 1 36 35 25 0 0 28 22 5 11 20 7 0 0 0 0 16 22 17 0 4 10 0 3 0 41 0 9 26 9 10 3 5 18 2 6 8 28 32 14 6 6 8 0 6 24 
29 4 0 0 0 45 0 1 0 12 29 0 3 5 29 0 0 5 5 15 9 0 0 0 33 14 4 0 22 45 0 0 10 9 0 0 0 0 5 18 7 22 0 27 4 10 0 36 0 0 36 50 12 
0 56 43 0 0 0 0 28 28 0 0 0 7 14 0 14 0 0 0 10 0 0 15 4 20 17 0 2 0 0 0 0 0 6 0 5 9 0 12 1 0 0 17 1 1 20 12 0 0 0 47 0 79 
0 24 10 0 0 0 0 0 0 12 33 38 0 4 0 4 0 0 2 1 18 0 12 10 7 34 0 30 8 0 0 6 23 0 0 0 4 45 0 1 6 5 0 13 0 34 4 0 5 17 41 0 1 
0 0 0 0 41 0 34 0 0 0 14 38 0 0 4 46 0 4 0 2 7 9 3 0 3 6 10 0 0 0 0 0 0 0 3 29 0 0 8 28 0 0 0 0 0 11 0 1 10 0 0 0 0 
50 5 43 0 8 19 4 1 31 0 28 22 3 0 2 6 0 0 17 16 0 20 28 28 25 0 40 0 6 0 0 21 0 0 1 1 1 10 0 12 32 0 6 0 0 0 0 13 46 0 51 28 52 
0 0 18 11 0 0 2 9 0 0 0 8 22 11 11 0 0 0 0 0 8 0 0 17 11 0 11 0 11 0 0 3 20 0 0 16 0 0 0 0 0 0 30 0 0 0 11 19 1 0 0 10 19 
22 5 107 0 0 6 36 6 33 32 0 0 40 22 0 55 32 0 0 5 7 40 13 0 25 36 24 23 0 1 1 9 0 0 19 18 12 4 2 0 35 15 40 21 19 29 4 0 13 21 72 36 32 
26 0 21 0 23 0 32 0 37 0 17 25 0 17 22 8 0 16 0 13 13 4 20 18 3 1 7 20 0 12 22 0 17 0 4 8 47 37 0 0 0 18 0 3 0 43 0 0 0 43 11 1 0 
4 31 2 33 57 0 59 45 27 99 53 13 27 10 8 7 7 27 0 48 6 29 6 5 0 12 21 0 1 14 2 15 34 2 0 3 1 0 8 14 7 23 2 44 32 6 0 2 11 94 66 58 48 
0 0 1 4 27 0 0 0 18 0 6 0 0 53 0 0 10 0 24 0 0 0 6 3 19 5 13 66 14 16 0 0 0 0 23 11 0 10 18 37 0 9 3 8 6 0 11 0 0 0 11 32 3 
25 51 45 0 0 0 0 0 5 0 37 2 16 16 0 9 0 31 0 20 7 18 2 0 11 13 12 0 0 0 0 0 26 19 20 0 0 4 0 20 11 0 0 25 0 3 0 73 47 12 14 11 32 
0 0 23 0 0 0 0 0 0 0 0 0 0 18 50 0 14 0 13 11 6 0 0 0 0 1 0 0 0 17 0 21 16 0 4 21 0 0 10 11 0 0 0 0 0 3 0 17 6 35 7 0 9 
52 0 43 11 3 6 0 36 0 0 2 0 2 50 0 13 0 2 0 12 0 15 7 10 22 6 0 11 21 7 12 0 14 0 0 12 11 0 0 14 0 22 17 0 9 0 11 0 12 0 0 0 40 
7 16 0 15 13 17 29 7 8 0 11 8 13 0 0 12 0 64 60 33 20 9 24 2 49 2 0 21 14 0 38 0 0 13 0 29 21 36 32 0 18 0 25 0 22 35 42 25 0 1 1 0 1 
36 0 49 24 38 19 39 36 0 0 0 0 40 0 42 0 0 2 0 17 16 8 12 0 31 8 10 3 0 0 6 7 7 0 0 0 73 1 0 0 46 0 38 45 0 42 0 0 27 0 0 49 49 
