53 30
0 13 47 8 11 8 0 4 1 61 7 0 8 0 0 11 0 0 9 0 5 8 0 17 4 0 5 2 23 9 0 0 0 0 0 9 34 0 0 0 58 8 24 8 0 0 18 0 0 45 3 19 3 
0 0 40 6 36 18 0 28 0 48 0 6 5 19 0 48 28 26 7 0 16 0 1 40 1 15 0 14 13 0 21 0 0 0 0 20 0 0 0 23 27 13 40 31 0 0 19 0 0 0 24 42 0 
24 1 0 0 0 0 0 2 0 0 0 22 10 0 0 0 23 31 17 26 0 1 16 0 0 43 0 4 0 29 31 39 0 22 0 0 0 0 0 28 2 0 0 0 19 26 21 0 0 0 25 0 0 
0 20 55 6 42 0 24 3 36 6 0 13 0 12 25 0 0 0 47 0 0 0 0 0 19 2 0 5 0 0 2 0 18 0 1 0 0 26 0 38 0 0 0 0 0 0 14 7 0 0 57 0 50 
0 0 15 24 2 0 24 44 0 24 0 0 0 22 0 21 0 0 0 10 5 0 18 0 0 0 0 18 6 0 1 5 19 0 6 34 18 0 0 19 9 2 1 5 0 0 24 38 0 8 0 16 10 
0 64 0 42 14 4 45 0 17 24 34 16 8 13 0 9 35 1 3 0 19 6 12 0 0 0 3 12 0 11 7 14 0 7 0 0 20 0 13 8 7 20 0 40 26 6 37 0 0 21 5 13 0 
25 0 2 2 14 39 0 18 0 0 19 0 0 20 2 1 7 0 14 27 0 30 0 0 7 8 4 6 0 19 4 0 0 3 15 8 0 0 0 0 27 6 37 0 27 1 46 6 0 33 0 28 11 
45 73 1 0 0 21 0 49 2 14 15 0 0 0 13 8 15 29 14 26 0 2 0 27 0 0 0 8 0 6 0 5 0 0 0 35 0 0 12 0 33 0 0 6 0 31 28 37 0 2 11 0 51 
16 0 5 0 0 0 14 30 43 0 0 14 4 0 0 21 16 18 0 0 10 4 14 7 12 17 5 12 0 20 15 6 0 3 0 7 4 24 0 0 11 11 7 0 7 0 38 0 0 0 0 26 18 
0 56 0 30 40 0 1 10 0 0 17 4 53 35 0 33 0 8 5 22 19 0 0 15 20 8 0 14 0 16 0 2 0 3 0 2 0 0 0 0 35 10 12 15 40 5 23 0 47 0 11 9 40 
22 19 9 3 0 0 2 0 2 0 0 0 0 42 15 7 14 30 1 0 19 7 19 0 0 13 0 0 0 0 25 0 17 0 0 0 0 0 13 11 0 10 28 0 0 39 0 0 0 17 70 7 0 
0 10 13 0 28 18 4 27 3 0 0 28 0 25 23 48 0 16 32 11 23 0 6 35 0 0 13 0 0 9 1 12 47 16 21 0 18 19 30 0 51 0 3 0 3 25 8 8 2 38 11 26 0 
0 74 19 0 0 6 0 0 12 37 28 6 0 0 0 1 16 14 32 2 14 4 0 0 25 0 0 0 17 5 2 0 0 16 6 19 0 28 65 38 5 0 21 6 0 13 0 0 32 22 32 0 0 
0 56 0 0 0 0 36 35 13 24 0 33 20 3 0 13 0 15 0 10 12 0 3 3 0 0 5 17 18 0 8 5 34 9 2 0 0 2 0 0 15 33 74 13 33 0 14 0 0 48 0 8 0 
42 0 12 28 19 1 0 31 24 9 39 0 25 5 0 0 2 4 6 0 31 0 0 13 16 24 0 0 21 0 0 13 0 29 0 17 18 73 14 0 6 2 2 10 0 5 0 0 0 55 0 0 14 
33 3 41 4 77 8 7 21 20 20 0 5 32 5 7 0 21 0 30 3 4 3 0 23 0 13 10 34 1 0 1 0 0 33 0 12 0 13 7 0 0 0 18 3 35 10 10 12 0 31 0 47 15 
0 26 41 7 0 0 0 0 4 0 0 0 0 9 0 13 0 26 12 0 0 0 17 4 18 11 8 0 1 0 3 2 3 8 0 13 0 0 2 20 16 2 67 57 0 0 16 0 0 0 0 5 0 
7 45 35 0 29 60 0 0 0 2 33 0 0 26 14 0 0 0 0 0 0 0 11 0 4 0 0 19 7 10 0 50 19 40 12 0 27 26 0 7 5 28 1 34 0 0 55 8 43 0 14 26 41 
2 0 13 15 2 0 0 34 0 0 16 0 0 0 0 0 0 0 15 13 0 0 5 0 9 0 11 18 0 23 8 6 0 0 22 16 0 4 10 2 6 40 13 0 0 8 12 15 7 15 11 16 0 
5 0 24 0 27 0 0 14 0 0 10 0 18 2 0 0 0 0 0 0 0 14 0 0 0 0 0 12 9 0 0 27 0 0 0 0 0 5 0 0 0 0 0 0 0 0 0 0 0 0 0 0 0 
50 18 0 15 0 27 0 0 22 0 40 0 17 8 0 25 3 0 0 16 0 30 0 48 0 0 18 0 0 37 1 1 27 10 7 16 0 24 0 6 54 0 0 0 21 7 0 0 0 0 127 74 0 
0 31 38 0 0 0 0 7 18 9 0 10 0 0 0 0 0 0 83 4 13 23 0 0 0 7 18 0 2 0 0 0 7 15 15 0 0 0 0 36 40 0 58 0 24 0 0 29 15 15 0 21 0 
0 98 19 41 0 0 78 19 25 22 55 13 0 0 33 0 0 0 19 13 7 18 12 0 19 0 19 8 26 0 21 7 5 3 35 18 0 0 25 5 39 1 1 41 33 0 5 29 0 0 12 1 0 
0 38 20 16 21 0 0 0 0 33 38 28 14 29 27 0 0 22 0 52 24 0 15 11 1 21 1 16 4 0 13 0 9 5 11 5 11 0 18 22 14 35 77 0 12 0 3 0 13 6 8 3 42 
33 0 0 0 48 0 4 1 35 3 10 0 0 27 28 0 26 0 0 12 10 19 16 0 0 13 29 58 24 9 22 0 0 0 0 0 1 0 56 3 24 14 3 25 2 0 0 0 0 36 0 7 24 
19 18 0 0 17 35 19 2 0 0 0 23 0 0 36 41 0 12 2 4 24 39 0 0 0 37 0 7 4 5 22 14 4 0 30 1 11 0 7 0 0 1 71 30 0 0 5 33 7 0 37 8 0 
0 13 12 0 17 2 73 28 11 0 0 0 37 30 0 31 14 1 0 11 0 37 0 19 20 16 19 0 0 6 14 13 0 0 0 1 30 0 0 7 13 17 21 4 8 0 27 7 18 37 0 0 22 
0 46 0 5 20 1 35 0 0 21 46 0 0 0 0 14 12 0 0 1 0 0 0 19 21 0 0 0 0 33 0 25 0 24 24 0 0 0 0 0 36 1 0 37 0 0 5 0 0 0 0 17 28 
0 0 0 32 61 7 0 0 30 24 0 17 6 0 0 0 0 0 6 22 4 13 13 16 20 0 0 4 17 0 0 0 0 49 7 62 0 0 0 0 7 0 20 0 0 3 19 41 1 0 0 27 31 
0 0 13 28 24 0 0 0 0 0 8 0 0 20 0 18 28 0 22 0 0 6 26 0 26 14 0 0 6 20 9 0 0 0 12 17 0 0 0 12 0 0 0 18 0 0 0 4 26 0 0 25 0 
