53 30
0 31 24 23 0 47 0 14 0 71 50 28 0 20 38 10 48 22 2 6 0 3 11 42 0 0 0 10 0 0 0 0 33 33 29 0 18 0 0 35 0 0 4 39 19 2 0 38 0 0 18 35 0 
2 51 0 0 22 0 0 0 0 6 0 0 0 18 21 21 4 15 0 31 6 23 0 0 0 0 0 0 15 11 0 0 18 0 0 0 8 16 11 19 0 0 0 4 0 5 0 0 15 13 31 0 53 
0 51 11 0 5 24 12 0 0 5 0 27 21 28 57 14 31 19 0 0 14 36 2 0 4 11 0 1 4 0 9 26 0 0 24 0 13 0 0 0 20 0 0 0 0 0 36 50 0 0 4 30 51 
2 0 13 0 0 9 40 11 51 0 4 45 0 19 9 22 0 0 11 11 0 0 6 27 0 7 0 16 0 9 0 0 49 8 0 17 0 22 0 8 29 8 0 5 0 41 30 0 12 8 0 13 58 
16 41 0 13 17 12 0 0 0 14 0 21 21 17 25 0 25 27 17 33 8 0 0 0 28 23 0 0 22 42 12 0 3 21 22 0 3 1 0 0 18 36 38 0 23 0 16 23 3 0 10 0 61 
33 0 0 0 22 0 16 0 27 4 0 2 11 0 0 0 0 31 26 0 0 0 16 0 2 0 15 10 0 0 9 1 2 2 12 35 0 0 8 0 0 1 0 0 21 2 19 0 35 0 0 48 0 
0 0 33 10 0 9 0 0 22 0 0 0 17 10 0 0 16 23 5 0 4 7 0 0 12 9 26 3 41 20 22 0 0 0 29 33 9 0 18 13 0 16 25 30 13 5 0 0 22 23 0 23 0 
29 16 34 19 15 36 0 14 4 10 53 0 0 6 6 0 18 1 12 0 40 6 0 0 0 7 0 0 61 12 25 5 0 12 0 17 29 35 0 0 0 30 16 0 0 47 0 0 3 42 0 26 17 
0 0 0 31 18 0 0 0 0 0 0 14 0 0 0 0 0 0 0 13 0 13 0 0 0 0 0 11 1 14 8 12 0 13 31 0 0 0 11 2 0 0 0 26 0 0 0 0 0 0 0 3 0 
7 16 0 20 34 0 0 7 5 36 23 30 6 10 8 0 7 0 6 28 0 0 0 10 1 33 0 0 3 0 0 7 0 0 0 0 0 9 27 0 0 43 0 0 0 7 0 46 4 40 0 15 16 
23 41 0 0 30 65 53 2 10 35 0 59 12 32 26 10 8 4 14 0 0 14 0 15 6 20 19 3 0 0 8 6 10 15 63 0 23 6 15 21 4 17 5 0 5 89 28 36 27 0 0 0 63 
0 2 0 12 0 9 2 3 17 14 0 0 0 0 27 0 17 1 21 0 6 12 0 7 0 21 1 0 0 0 1 0 13 3 0 26 0 4 0 8 22 0 0 45 0 0 21 0 0 17 0 0 0 
0 0 22 0 5 0 2 11 11 5 25 0 20 0 0 16 0 16 1 0 4 0 0 0 27 15 0 0 20 20 0 0 14 13 0 0 6 0 39 31 0 7 0 6 0 0 0 0 7 0 0 0 0 
107 57 26 0 0 8 2 16 0 0 20 0 19 8 3 18 26 0 17 0 0 31 29 0 1 18 0 0 19 3 29 36 5 2 0 20 0 0 29 0 0 41 26 42 16 14 0 0 0 28 0 51 10 
1 79 22 1 26 44 40 9 34 0 0 57 8 3 14 30 0 9 11 0 14 0 7 25 4 32 0 24 0 0 24 11 0 6 41 0 0 39 0 6 3 0 0 0 18 2 12 4 4 0 35 0 41 
8 0 16 0 20 0 81 0 0 0 9 28 27 0 0 24 0 0 0 0 0 7 12 0 49 0 0 10 12 0 21 7 19 0 0 0 0 6 3 12 0 0 4 0 0 0 40 0 5 0 0 10 49 
40 4 0 0 0 6 0 0 42 16 0 41 11 7 38 12 13 0 9 6 10 0 0 0 0 0 0 0 0 1 13 14 16 6 0 0 16 6 42 4 40 0 34 0 8 0 41 0 0 0 6 0 22 
50 27 12 26 6 42 4 0 10 10 24 0 11 0 0 25 3 0 4 5 1 0 0 0 5 7 0 31 50 44 18 0 20 31 4 0 15 6 0 29 25 2 10 33 6 0 10 42 37 0 55 23 30 
0 36 0 0 5 53 0 0 0 2 0 0 0 0 15 0 0 0 0 5 11 0 0 0 19 0 0 0 14 0 16 0 0 8 0 0 17 35 0 34 13 0 0 7 0 0 16 4 4 0 0 0 1 
29 0 0 32 3 0 44 0 0 0 0 0 0 31 0 0 0 0 0 22 32 0 0 0 11 0 0 0 16 25 7 0 19 6 0 43 0 0 0 6 7 31 0 0 62 10 0 0 16 1 8 0 32 
0 0 43 0 0 0 0 5 0 2 0 0 0 0 0 0 0 0 0 9 0 5 0 20 0 0 5 0 14 0 0 0 0 12 0 17 0 0 0 19 0 0 0 0 0 43 16 0 0 0 0 18 0 
0 0 9 0 17 0 26 0 0 12 4 19 12 4 11 19 0 33 13 18 0 21 14 0 0 12 16 18 9 0 18 13 0 32 9 0 4 19 21 4 0 15 0 4 13 0 0 19 0 0 0 0 19 
0 46 7 0 49 2 54 0 3 19 0 0 11 19 4 0 10 17 2 24 5 0 8 3 5 16 0 23 25 18 0 18 0 43 0 22 0 4 10 12 16 13 0 16 0 28 0 27 0 36 49 0 0 
4 11 0 29 23 1 3 0 0 0 6 0 3 31 27 0 3 0 1 16 10 25 0 20 0 19 0 13 0 0 37 0 16 0 0 3 0 12 3 0 12 0 26 33 5 0 27 2 4 48 0 0 0 
0 0 0 0 5 0 0 0 0 0 33 9 0 0 24 0 0 0 21 0 0 3 3 1 2 23 8 0 0 0 0 0 0 4 0 0 0 0 13 14 6 16 0 25 0 0 2 0 10 0 0 0 0 
12 31 34 0 3 40 10 6 38 0 42 0 9 20 26 13 36 3 13 0 0 30 0 1 19 34 0 8 18 0 0 0 0 3 0 12 34 0 21 28 15 8 3 35 0 22 0 2 11 3 0 46 0 
16 51 3 5 4 31 26 10 0 0 69 3 14 0 23 0 35 13 0 0 0 13 13 2 2 3 25 8 26 20 3 29 40 0 2 13 0 4 36 1 84 7 6 4 27 20 43 4 20 46 46 31 51 
0 0 16 0 47 0 39 0 0 11 8 0 13 0 25 6 31 0 49 10 0 6 3 0 6 20 22 1 11 10 1 19 13 0 17 0 11 13 6 0 6 0 0 0 58 8 6 54 8 0 5 45 0 
21 23 2 0 38 26 12 2 21 5 12 20 0 14 11 52 39 58 0 43 22 0 12 0 0 1 8 0 0 0 28 24 15 28 8 34 35 0 0 22 9 0 0 0 14 0 41 19 47 30 0 35 37 
0 72 19 0 0 9 0 33 0 0 9 41 5 0 19 0 16 0 0 6 1 0 16 0 2 0 5 15 0 0 14 0 0 16 29 0 27 32 0 34 0 0 0 0 21 19 31 0 0 71 4 50 19 
