53 30
0 0 63 0 0 0 2 0 12 36 62 1 10 0 0 52 10 0 0 0 0 45 0 5 12 16 20 4 2 34 17 15 0 0 0 17 0 14 0 8 20 0 5 30 23 66 16 41 0 3 0 46 0 
0 30 97 0 0 0 4 0 36 0 17 0 27 0 16 14 0 16 0 0 28 0 2 0 0 27 9 0 26 0 9 0 0 0 1 1 0 37 0 0 24 14 0 16 28 0 0 0 46 0 2 0 83 
60 33 16 19 40 7 0 25 72 25 0 0 10 8 16 61 20 0 5 0 11 9 0 27 68 19 0 0 0 4 5 16 0 9 25 0 0 0 0 9 24 0 26 0 40 21 0 15 0 0 52 36 0 
0 0 37 0 0 0 0 34 15 0 36 14 21 10 0 0 4 22 0 0 0 0 0 15 0 0 0 0 0 0 0 0 0 21 6 0 0 0 0 0 25 19 0 0 0 0 35 22 9 0 46 0 0 
0 2 16 0 0 15 43 0 15 0 0 0 20 0 0 0 4 0 1 0 22 0 0 0 25 6 5 0 0 22 0 0 27 0 15 0 24 0 0 13 0 0 0 0 0 6 0 0 24 90 0 15 0 
0 0 0 40 0 0 40 0 85 0 15 6 22 0 0 0 0 36 0 7 0 21 24 0 0 0 0 7 6 12 23 0 28 8 0 0 30 1 32 0 8 0 23 3 18 18 24 30 2 41 5 22 0 
24 0 33 38 68 11 0 33 0 19 33 7 28 0 0 0 19 0 0 7 0 0 12 26 55 5 9 5 3 9 7 27 0 1 12 15 0 1 0 32 37 0 0 13 51 0 59 58 0 0 66 18 21 
0 27 45 21 22 31 7 45 10 0 18 6 18 4 5 7 29 21 7 17 17 13 5 22 0 0 11 9 26 0 14 14 0 0 0 0 0 0 33 0 0 16 0 24 11 6 26 27 4 0 0 0 57 
19 0 6 0 0 45 4 6 2 6 0 0 29 0 0 10 0 0 0 9 15 13 4 0 0 0 10 8 12 19 7 8 6 0 9 0 11 4 0 0 12 29 0 9 21 0 0 0 0 30 0 16 0 
0 0 48 0 0 6 0 6 20 0 8 8 11 13 17 8 6 0 0 15 8 4 12 1 0 0 8 9 0 0 0 0 4 4 2 0 0 16 0 0 9 39 13 0 12 0 0 40 3 0 0 3 0 
0 74 36 0 94 0 22 0 2 1 28 25 5 0 0 11 2 13 0 23 7 0 1 0 0 0 11 18 37 4 5 3 0 4 0 5 54 18 36 12 9 8 37 0 0 0 9 8 0 0 46 38 48 
23 4 111 0 18 5 0 43 11 3 0 31 0 4 37 3 1 0 0 5 0 0 42 28 0 5 0 4 6 10 0 29 14 0 0 0 9 0 0 3 0 15 71 0 42 0 0 0 0 0 0 11 0 
12 0 0 0 0 24 2 0 27 0 2 0 3 14 5 27 0 5 39 19 0 12 0 6 0 9 0 2 0 5 0 13 13 0 0 16 0 4 0 0 22 0 13 11 0 0 0 28 9 26 0 8 20 
10 93 13 27 0 47 0 11 1 0 21 0 0 0 22 13 16 23 0 0 24 0 0 0 0 5 0 0 24 5 39 0 0 33 0 0 0 7 0 49 19 0 0 0 18 6 2 46 61 1 0 11 32 
0 38 11 0 0 8 2 63 0 5 16 0 9 0 0 1 0 7 0 4 0 9 0 6 12 0 8 6 13 6 0 0 0 50 7 1 0 13 31 19 0 0 9 0 0 21 0 0 0 0 8 0 0 
0 31 20 14 0 0 0 16 0 29 0 15 5 0 0 0 0 0 11 16 19 0 35 26 20 0 22 0 1 0 3 0 0 1 9 23 13 7 17 11 21 14 0 0 9 3 15 0 0 0 2 0 14 
0 34 0 0 8 28 50 14 13 0 0 6 3 0 3 10 0 0 8 0 0 12 0 29 0 16 8 13 17 0 14 4 17 0 13 34 6 0 0 0 0 7 15 12 0 48 0 0 7 15 0 2 20 
15 34 34 0 0 0 0 0 1 5 18 7 18 17 27 27 3 29 15 0 2 0 0 0 0 34 0 4 12 3 7 5 20 12 15 0 34 43 0 0 4 46 0 11 7 0 51 22 0 19 0 0 51 
0 0 9 73 1 40 0 12 0 0 13 0 0 0 0 8 41 5 0 0 7 0 17 0 0 17 11 0 8 26 21 37 0 0 9 0 2 17 0 14 0 0 26 0 0 19 3 0 0 43 0 46 0 
32 0 0 0 0 15 0 0 15 0 17 0 16 0 17 0 0 33 16 3 0 23 0 0 0 0 20 17 0 0 0 19 48 5 31 0 2 0 0 0 9 0 14 0 13 0 9 0 0 0 33 10 0 
0 0 16 39 0 0 0 11 6 0 30 1 12 0 15 24 11 10 11 0 15 0 22 16 2 0 26 0 5 1 0 0 0 0 50 15 0 0 0 7 0 0 12 0 12 0 0 0 0 0 5 1 0 
0 2 0 21 25 0 7 0 21 0 1 0 0 4 10 11 35 0 13 0 0 1 0 0 23 14 0 0 0 66 0 16 0 0 0 14 16 0 20 15 0 7 0 0 0 50 0 34 17 0 8 68 23 
1 10 0 29 26 1 0 0 11 31 32 16 0 16 31 0 0 0 30 3 15 5 0 22 36 0 11 3 16 16 28 0 45 0 42 4 0 0 0 9 53 16 28 9 0 0 0 0 45 44 0 0 0 
10 35 0 0 0 16 0 14 10 1 21 3 31 0 3 3 0 14 0 33 0 20 5 11 0 19 9 3 2 23 3 24 0 25 0 0 39 39 12 0 0 13 0 0 22 0 0 0 4 6 0 0 17 
5 0 17 2 43 44 0 0 4 0 0 0 0 0 34 0 23 22 33 14 0 31 0 0 9 0 0 0 0 0 0 18 2 19 16 2 0 35 33 35 24 0 0 9 0 40 6 21 27 0 0 61 34 
23 0 0 1 0 33 0 17 5 0 0 0 15 22 0 0 25 22 36 0 20 0 0 0 0 19 29 5 23 0 18 13 15 15 0 0 0 5 12 0 24 6 5 0 7 24 41 56 1 0 5 0 0 
0 16 0 0 0 0 35 0 25 0 6 0 0 51 28 42 62 3 67 30 19 31 0 5 0 0 0 0 0 6 0 13 1 25 12 9 6 0 9 24 22 35 45 0 32 0 3 0 17 18 5 0 5 
7 12 41 25 0 30 44 16 11 27 0 0 7 0 12 2 23 0 0 0 15 13 20 0 0 31 11 0 75 33 5 38 0 0 1 1 12 0 0 0 7 64 0 0 0 4 0 7 0 13 0 32 47 
28 0 92 21 0 5 0 14 6 0 28 17 22 0 0 29 0 0 0 0 0 29 0 3 0 0 5 8 44 0 45 0 9 0 0 8 12 7 0 4 25 11 21 0 30 43 0 0 19 12 0 49 15 
36 0 33 22 0 0 0 0 13 0 53 0 34 0 18 2 16 0 17 21 36 0 0 5 0 11 7 0 18 12 0 5 16 10 0 62 33 0 0 6 0 29 0 0 29 14 55 59 16 0 17 0 24 
