53 30
16 0 34 21 0 37 34 1 0 9 1 0 6 4 0 21 30 15 8 12 11 0 13 0 17 31 0 12 0 0 0 22 18 3 0 13 3 46 0 49 41 0 0 0 47 0 0 3 0 44 21 0 0 
0 0 0 0 0 0 0 1 19 25 1 0 19 6 62 0 6 0 0 16 0 0 0 9 0 2 0 0 0 0 0 0 7 5 5 10 13 2 4 10 0 6 0 9 10 0 40 30 1 0 0 0 0 
15 49 0 9 14 15 75 0 13 25 3 23 13 0 0 0 19 28 31 3 7 35 23 0 0 0 24 6 0 4 0 11 0 0 39 0 24 4 19 2 12 4 15 0 27 67 19 13 11 31 83 0 14 
15 1 19 2 32 34 1 0 0 0 0 19 3 0 0 34 16 15 15 0 9 18 0 0 20 10 0 0 0 0 20 0 0 0 10 0 87 0 4 62 0 0 0 0 0 6 0 0 14 0 26 0 0 
0 0 0 0 37 36 15 0 5 31 0 8 0 4 21 17 0 43 0 6 0 0 7 8 6 8 0 12 24 0 11 0 0 5 0 21 0 4 0 16 45 10 0 0 0 0 2 0 42 9 0 0 24 
0 9 0 79 0 5 27 0 0 0 4 0 0 0 31 0 0 36 1 31 0 0 0 0 23 21 13 6 0 0 0 8 13 13 0 0 0 14 9 0 0 0 3 21 2 0 64 0 0 0 34 5 0 
6 15 15 3 14 0 4 17 19 10 0 0 17 0 0 0 0 0 23 35 6 0 3 0 0 0 0 22 0 1 0 0 0 5 20 0 0 0 0 19 36 23 8 9 12 0 17 0 0 42 0 22 0 
8 6 0 13 14 4 1 28 9 9 0 22 10 27 0 16 7 0 9 33 0 7 0 10 0 20 0 0 32 0 40 2 0 0 3 0 10 0 16 0 7 0 0 0 30 2 0 36 0 0 22 0 33 
0 1 0 0 0 0 0 0 18 0 0 2 32 29 10 7 3 0 7 18 0 0 11 0 43 10 25 0 0 2 20 35 3 0 1 11 5 2 14 0 0 10 0 6 11 21 6 16 0 23 20 25 2 
40 10 117 0 0 36 0 60 0 16 11 27 0 8 10 7 9 0 0 8 0 19 5 29 3 16 0 14 10 0 9 10 0 23 0 8 0 32 26 49 40 0 0 1 42 7 8 0 0 0 2 0 26 
0 2 0 47 8 64 39 32 0 27 2 19 21 32 46 1 4 4 12 59 30 30 19 0 16 5 2 10 18 36 55 17 12 30 2 17 17 20 4 52 15 17 14 56 14 33 0 14 42 0 2 15 47 
11 31 36 20 6 4 18 0 0 79 9 0 28 12 0 0 12 0 7 22 19 0 0 11 22 28 0 1 20 0 2 3 20 0 11 33 35 0 18 0 0 12 0 7 4 0 37 0 0 0 2 55 0 
4 1 0 0 0 5 0 0 43 0 25 0 0 11 0 0 0 0 1 12 16 20 24 49 0 0 0 0 28 5 0 20 0 29 15 25 13 0 0 11 0 28 3 6 23 17 24 0 30 6 0 84 3 
0 9 0 38 5 7 0 16 0 6 0 0 45 5 0 30 26 13 13 17 0 9 13 12 0 4 33 0 14 0 7 33 26 19 0 12 7 11 0 47 0 26 26 0 0 0 45 0 0 24 0 0 40 
20 26 0 0 19 30 0 0 30 0 31 5 19 3 0 0 0 0 18 0 20 10 11 3 10 18 32 0 10 7 0 37 0 35 11 30 0 44 56 11 4 0 0 24 0 0 38 0 11 11 11 10 26 
0 72 0 0 31 0 0 1 29 0 0 8 4 0 5 0 48 26 0 47 0 0 5 7 25 0 0 0 9 16 0 20 0 0 0 31 8 0 0 4 0 4 0 3 7 44 22 0 0 0 0 55 33 
30 0 12 3 10 16 2 12 33 9 26 11 31 0 12 0 0 12 33 13 0 21 1 15 0 13 18 10 3 23 41 0 0 0 1 1 32 0 0 9 0 0 29 21 0 5 0 0 10 10 21 33 0 
35 4 0 0 6 29 0 0 0 17 0 9 0 0 0 15 4 12 22 39 0 0 0 22 15 7 10 9 3 29 6 0 18 7 16 16 7 0 12 11 0 6 0 0 0 0 35 0 7 3 6 57 0 
43 0 0 0 0 0 14 35 0 0 38 0 0 0 17 0 0 43 5 0 0 0 0 20 4 32 10 0 18 0 0 0 0 8 20 9 0 18 0 17 0 31 45 10 3 53 38 0 0 56 0 0 10 
33 18 68 0 0 0 0 4 16 0 0 13 0 14 3 0 3 0 24 22 0 0 0 0 16 0 1 9 0 35 0 13 0 33 0 6 13 0 0 20 0 6 24 0 34 0 6 0 13 0 0 15 4 
45 37 0 30 2 0 2 6 0 26 29 39 27 7 0 13 0 2 51 7 25 0 5 0 24 0 30 1 0 14 0 1 31 15 8 26 0 0 9 0 0 0 0 8 5 13 0 0 2 49 39 8 0 
0 15 15 14 51 20 24 17 28 0 21 14 28 32 39 21 2 2 1 0 0 18 15 0 11 12 0 0 18 1 0 1 0 20 0 20 26 0 28 15 25 29 3 39 0 11 0 0 34 0 8 0 0 
4 5 42 0 0 0 16 0 53 37 39 0 18 0 3 0 35 12 0 16 0 0 6 0 7 0 14 0 20 0 0 22 0 25 0 0 0 5 0 0 0 0 11 0 42 0 37 0 4 39 0 0 36 
20 4 0 22 0 0 0 17 19 0 36 12 12 5 0 14 27 3 5 14 20 4 0 0 20 38 0 14 6 2 20 0 12 8 15 16 4 0 5 5 31 26 21 16 21 0 49 0 0 0 7 48 0 
19 29 0 0 11 24 42 11 0 1 4 0 0 0 19 0 22 0 0 19 0 0 0 0 0 0 0 1 0 12 0 0 0 0 0 34 0 0 0 9 0 0 0 19 0 0 0 0 2 0 0 45 0 
0 0 0 0 3 0 0 0 19 23 0 2 10 5 0 9 21 0 11 6 0 0 11 5 24 2 0 0 12 0 0 0 0 17 0 0 0 21 0 16 0 12 0 0 5 50 0 3 0 0 20 0 0 
69 18 17 45 10 20 42 0 2 2 4 8 0 0 1 0 18 0 21 0 0 1 0 20 0 13 24 13 35 0 0 0 0 13 18 5 12 0 10 3 18 1 4 18 16 13 0 0 84 0 5 0 0 
0 0 3 0 12 3 28 11 0 0 0 0 0 26 0 0 20 0 0 0 0 2 2 23 2 2 0 3 0 8 1 1 15 0 13 0 0 0 0 25 6 0 0 4 4 0 0 15 32 0 0 15 0 
28 0 0 17 5 2 0 6 27 0 0 5 0 9 35 34 0 0 7 0 0 17 9 0 0 0 0 0 17 0 0 0 0 5 0 4 0 0 0 14 19 23 0 4 0 0 11 0 0 69 0 0 0 
13 0 0 0 0 0 0 18 0 0 6 0 44 33 9 19 6 19 14 12 8 8 0 14 0 25 11 0 6 0 0 6 4 21 44 0 0 25 1 10 2 0 0 0 0 0 0 0 5 10 26 0 0 
