53 30
25 26 27 63 13 4 4 0 28 11 4 0 1 12 0 11 0 4 19 0 7 0 3 2 0 22 0 6 0 0 0 17 13 0 0 11 0 14 11 0 0 38 20 0 0 13 57 44 39 0 47 0 0 
71 13 0 5 1 0 15 7 1 0 27 0 26 0 5 22 0 11 0 15 17 15 0 0 0 4 2 6 22 39 5 0 13 33 0 21 0 49 26 10 0 43 42 21 0 0 0 27 20 5 0 0 28 
10 0 1 18 11 0 35 64 0 0 10 0 12 26 0 0 0 47 0 15 6 7 1 21 3 5 21 5 0 0 12 6 19 29 0 0 0 0 31 0 0 37 0 8 0 0 0 0 0 10 0 58 13 
0 0 32 30 0 60 0 23 5 3 41 19 4 0 2 23 12 0 0 0 28 0 9 0 0 23 4 22 0 21 19 0 16 0 82 23 0 1 0 0 10 0 6 15 0 38 34 35 26 0 17 33 0 
0 7 60 1 0 0 0 0 7 41 33 0 0 42 0 13 0 30 0 16 9 0 36 13 0 0 0 5 14 12 0 15 9 23 0 16 0 36 0 0 0 0 17 0 0 0 2 10 2 1 42 29 0 
38 0 17 10 0 0 0 0 27 0 2 23 0 0 0 22 0 0 0 17 0 0 9 0 3 3 4 0 23 0 0 0 0 0 23 22 6 22 43 0 4 8 0 7 0 26 16 15 3 0 0 23 9 
57 12 52 42 14 0 10 29 4 20 0 7 0 0 0 0 0 0 6 1 1 5 28 31 0 0 10 3 1 15 1 0 0 0 12 33 23 0 16 5 0 0 13 0 49 0 24 0 1 4 0 13 0 
24 0 0 10 7 0 27 42 0 35 15 38 0 44 0 0 0 0 0 0 0 26 0 16 24 0 0 12 3 16 0 20 4 30 0 20 43 8 3 0 0 0 0 0 35 6 0 21 0 4 0 13 0 
51 1 21 33 0 3 44 8 3 29 31 13 12 0 0 0 14 6 0 0 29 0 20 8 13 29 0 23 22 19 21 13 0 0 0 0 33 0 0 0 0 19 20 2 0 15 4 41 0 49 1 57 30 
0 0 0 0 0 2 33 0 15 0 15 40 39 0 0 0 0 17 31 19 34 21 17 6 0 14 42 3 19 3 0 20 6 19 15 0 0 4 37 33 10 16 21 0 0 0 0 11 23 55 19 77 0 
0 15 0 7 48 22 0 21 14 11 5 0 0 3 9 3 0 12 0 18 0 41 9 0 17 0 8 0 0 14 47 0 0 4 47 0 0 4 22 0 35 39 0 9 0 0 0 43 14 28 0 3 4 
0 0 3 0 6 0 7 0 0 0 4 0 0 18 0 17 0 0 15 18 0 0 9 46 0 0 0 0 0 0 0 0 38 0 8 16 0 6 31 12 11 0 17 0 0 0 5 24 0 0 18 45 3 
0 2 13 0 0 37 0 0 0 0 0 0 7 0 19 0 0 0 0 2 0 0 8 0 0 0 9 0 0 8 29 19 31 5 0 5 22 0 0 0 4 12 0 25 0 15 0 0 0 7 19 16 47 
12 0 31 0 0 30 0 41 40 0 9 20 3 0 0 0 23 5 0 8 11 14 0 0 0 12 34 0 26 16 0 0 34 0 0 1 0 12 36 45 2 7 30 15 16 51 2 5 44 10 0 0 0 
0 1 33 9 0 37 40 9 0 8 0 0 23 21 11 0 9 6 0 28 0 0 2 0 5 0 0 0 0 25 0 7 30 3 21 15 0 0 29 0 0 10 37 0 0 0 55 21 0 9 0 0 0 
0 0 0 36 48 38 47 0 25 34 26 37 9 0 36 0 22 0 8 0 0 16 12 0 19 0 12 15 0 19 0 0 0 25 0 29 24 6 20 40 0 31 28 0 0 33 0 0 37 1 1 5 5 
14 13 0 0 9 0 10 19 7 2 0 10 0 0 29 6 56 1 0 17 0 15 0 16 0 0 10 0 0 0 0 0 0 0 17 14 14 3 0 0 23 0 21 4 0 0 0 0 0 14 0 21 0 
0 8 0 70 35 7 36 0 0 11 0 14 7 0 32 0 0 6 11 0 16 5 13 20 0 0 13 0 0 0 0 13 0 62 30 0 0 12 0 0 12 4 39 0 0 3 9 4 15 0 0 6 12 
25 0 0 0 27 46 0 19 0 0 8 0 0 0 2 0 0 8 0 6 0 31 0 15 0 25 16 2 14 0 0 0 6 7 0 0 0 14 10 0 0 0 0 0 40 3 8 0 0 4 18 38 45 
0 1 0 0 19 7 81 51 27 10 34 0 0 0 16 0 0 12 19 33 13 31 0 19 6 0 0 0 0 0 16 9 3 0 2 18 17 6 0 0 0 0 3 0 38 38 26 19 16 50 0 0 28 
3 45 3 0 42 0 0 7 13 0 23 0 24 0 6 6 22 3 10 48 9 47 5 5 47 0 6 6 13 8 11 0 0 33 0 0 3 0 0 29 11 12 42 19 0 25 56 31 53 47 17 13 28 
7 0 7 0 0 0 48 0 42 11 0 0 0 19 0 0 0 15 18 13 8 0 20 0 0 4 0 0 0 7 0 17 32 0 0 7 26 6 0 0 0 35 43 16 8 0 9 0 0 0 43 7 0 
19 44 11 0 0 3 25 4 17 0 0 43 48 10 30 0 14 0 0 19 0 0 16 0 0 22 17 7 16 0 1 19 0 21 13 0 17 18 26 0 0 0 0 4 46 39 9 22 11 38 5 4 0 
7 49 8 49 42 4 56 22 49 32 36 3 0 19 9 35 0 1 32 23 10 0 16 7 0 7 22 23 6 13 30 20 11 42 0 22 3 15 18 0 7 0 59 6 0 18 74 26 21 6 25 38 95 
21 0 0 0 0 0 35 8 0 9 0 30 0 0 0 0 9 32 0 26 0 45 0 0 0 0 10 1 0 0 0 5 0 0 21 19 17 0 1 0 0 55 0 22 0 50 0 5 0 17 0 0 0 
0 2 50 0 0 49 16 26 17 0 36 0 7 12 6 0 28 0 20 14 18 3 6 0 0 18 8 0 20 6 23 21 1 33 0 0 0 12 14 0 27 24 0 8 28 0 0 0 4 35 0 0 0 
12 38 16 0 0 0 9 0 0 0 17 9 22 0 0 23 7 17 0 13 0 0 0 7 21 0 0 0 26 0 20 0 1 14 0 38 0 2 0 38 17 26 3 8 0 30 0 23 0 0 0 4 0 
6 44 27 0 32 39 0 14 0 23 17 14 0 23 0 0 0 0 0 22 0 0 1 1 0 0 0 17 0 13 11 0 15 20 0 0 2 0 17 3 0 29 13 0 0 29 19 0 43 8 0 0 0 
49 32 0 33 21 24 0 43 17 50 0 8 9 6 0 22 0 16 0 0 0 6 0 3 21 0 3 10 63 2 0 14 9 52 34 21 0 20 14 11 0 5 0 48 0 55 5 27 0 0 58 81 5 
0 0 16 0 0 0 0 0 24 43 41 0 0 10 7 18 0 0 23 0 30 15 0 23 22 0 20 0 14 0 12 15 0 0 0 7 23 0 0 0 2 30 5 0 0 0 24 17 6 0 0 41 38 
