53 30
26 0 49 7 35 0 28 25 15 9 0 33 0 0 16 25 21 0 4 4 9 0 9 4 0 24 0 0 0 3 0 9 31 3 25 15 36 0 6 71 11 0 0 28 6 44 41 47 0 0 10 47 55 
0 0 75 0 33 0 40 16 19 0 98 64 28 0 3 13 6 0 18 5 0 0 2 6 0 9 5 11 0 19 0 35 3 0 2 0 2 11 16 42 30 12 23 0 0 22 68 37 46 14 39 67 0 
36 0 1 0 20 18 0 0 0 15 0 63 0 22 16 9 0 0 0 0 0 32 11 0 22 0 0 0 0 17 3 0 12 7 36 17 26 58 0 0 0 0 15 10 21 0 12 18 11 6 3 2 0 
0 34 1 8 0 0 25 0 0 0 22 8 0 0 18 0 0 11 33 0 0 41 3 11 1 14 2 6 0 0 0 0 3 12 24 16 0 0 0 14 3 0 0 1 0 23 0 15 0 0 30 18 20 
37 0 0 0 0 34 0 0 0 0 0 0 11 0 7 0 0 0 3 0 0 16 0 11 0 0 6 0 0 0 19 0 16 0 0 8 0 21 0 34 0 3 6 1 8 0 18 0 0 37 2 0 29 
20 0 21 0 0 9 81 0 0 0 0 25 15 8 14 0 3 0 4 0 17 10 22 12 3 0 0 0 0 0 0 17 0 21 22 5 18 0 10 10 24 0 0 7 0 0 40 0 7 0 50 48 0 
39 0 20 34 0 0 19 0 8 0 0 0 0 4 0 0 0 7 0 16 11 13 29 21 0 19 0 0 0 9 0 7 3 15 31 28 19 0 8 22 3 0 0 0 8 0 23 34 0 0 0 67 0 
0 6 24 0 55 1 4 0 24 14 0 0 0 13 36 0 25 6 18 7 0 5 9 22 2 0 17 4 16 0 8 21 16 0 0 0 18 20 0 4 36 22 11 2 0 8 0 1 15 0 36 10 0 
0 0 0 0 15 32 25 0 0 0 30 8 51 7 0 0 0 31 0 26 3 0 14 13 15 0 7 0 10 0 7 1 0 0 0 10 0 20 54 9 31 0 36 2 32 16 4 0 0 0 0 0 46 
0 43 70 3 28 29 7 47 43 5 8 19 0 2 30 22 7 15 16 0 11 0 0 10 14 0 21 41 2 9 6 0 67 23 85 6 26 30 0 0 26 3 0 0 8 41 3 0 0 25 39 1 0 
3 3 26 22 0 14 0 0 0 27 8 0 8 20 0 0 16 0 5 11 0 0 27 15 44 3 0 0 22 2 0 12 5 8 1 5 32 0 0 0 0 8 8 0 0 0 11 0 26 0 22 0 0 
0 0 0 0 0 21 4 0 11 31 15 2 0 2 7 2 9 29 8 35 0 8 8 0 3 0 24 4 11 15 10 0 0 38 9 11 0 0 0 0 31 1 3 14 11 11 48 16 39 7 0 0 0 
0 17 0 41 0 12 5 34 14 0 42 0 0 0 15 0 13 12 30 0 0 32 0 29 3 0 0 0 17 61 20 23 5 0 9 0 0 28 0 5 24 37 0 13 21 0 3 11 30 11 49 0 42 
24 3 19 31 8 0 5 27 0 0 52 9 0 6 18 30 0 0 0 17 30 64 12 0 35 38 5 0 0 25 15 16 12 0 19 11 18 5 0 0 4 13 27 1 24 45 39 46 0 30 25 2 5 
15 35 8 2 17 2 0 5 43 1 37 38 8 38 37 28 10 87 0 0 0 37 0 18 22 5 26 14 2 0 2 0 0 2 16 20 49 0 6 2 1 21 19 23 11 0 0 37 7 9 30 114 14 
32 8 0 32 22 0 0 0 7 1 0 0 18 0 15 14 4 14 5 19 0 8 18 0 0 0 22 14 0 7 1 14 29 0 0 17 0 3 19 10 23 0 13 7 0 4 3 0 0 15 0 0 0 
50 41 32 0 0 0 0 10 21 0 0 40 14 19 0 0 33 10 0 0 0 0 0 0 5 0 0 18 22 38 0 5 19 0 24 14 11 1 0 27 0 0 33 0 0 11 17 0 0 42 70 40 16 
0 6 28 19 0 27 0 35 0 15 4 20 0 0 0 0 0 23 16 0 0 21 16 0 8 24 16 16 0 0 0 4 27 0 0 0 0 5 13 9 28 0 2 16 0 4 44 0 0 24 0 3 0 
0 0 0 57 10 0 0 0 0 7 32 2 8 2 10 1 0 13 0 0 0 0 22 23 21 0 18 9 0 8 12 8 0 0 0 0 0 19 11 24 0 0 32 5 40 0 0 1 12 37 2 15 5 
0 0 0 0 0 12 0 6 0 0 21 0 9 18 14 16 19 0 0 24 0 17 16 21 0 18 0 0 9 26 15 17 0 25 15 0 0 0 4 9 0 0 6 2 8 13 0 2 24 1 14 0 11 
0 0 0 0 0 0 10 0 0 0 12 0 0 13 29 0 10 7 5 0 22 0 23 0 7 0 14 11 0 5 0 0 10 20 17 0 11 4 0 25 14 19 28 21 14 0 3 27 31 8 0 0 0 
0 0 50 0 0 16 51 42 9 0 0 0 40 0 0 0 0 14 20 8 0 7 18 10 5 0 0 1 0 15 15 5 14 17 18 20 5 0 5 0 0 0 0 10 0 16 20 2 0 37 44 20 97 
7 0 0 44 37 21 6 0 28 12 41 20 22 17 8 0 0 29 18 0 50 12 1 23 0 2 0 0 0 27 2 8 18 12 22 4 42 17 0 0 18 0 70 14 0 0 93 27 0 49 0 41 58 
46 56 57 48 25 19 84 28 19 0 3 0 8 33 0 0 0 0 4 0 14 13 4 32 4 2 6 0 16 30 0 0 6 27 0 28 14 0 11 0 32 39 0 68 0 48 86 22 0 15 0 48 52 
47 41 18 0 7 12 0 91 0 44 12 12 38 0 15 6 10 0 0 0 0 0 12 0 0 32 0 23 0 0 19 0 0 45 15 28 0 0 29 0 2 0 41 22 37 23 18 47 0 37 4 0 0 
0 29 0 0 0 0 0 0 0 0 22 53 23 0 12 6 0 0 0 11 0 2 0 35 18 0 0 33 9 8 32 18 0 0 0 21 19 0 0 28 0 0 0 0 0 0 0 0 0 9 48 0 21 
0 0 42 0 0 0 41 0 37 13 35 25 36 0 7 0 34 29 0 29 4 7 0 12 17 0 0 0 20 0 0 0 8 15 0 12 0 28 0 0 23 45 0 3 27 2 0 86 9 5 0 49 0 
0 0 0 5 20 0 19 0 0 0 6 0 1 0 50 0 6 0 23 0 0 0 22 0 0 14 0 18 0 0 0 13 5 0 0 2 9 5 4 12 0 23 28 24 13 2 0 0 13 4 1 11 7 
0 0 0 0 0 0 55 1 0 49 0 0 36 0 0 0 17 0 11 0 0 15 0 0 18 0 17 0 0 8 24 0 26 0 0 0 3 0 0 24 18 33 14 35 22 1 1 0 0 37 0 0 0 
0 1 1 0 11 0 0 29 0 0 10 0 15 27 0 28 0 18 38 11 11 27 22 22 15 12 0 12 17 0 11 11 0 0 27 17 26 44 0 26 17 0 27 11 0 1 50 0 3 10 0 5 0 
