53 30
9 50 0 46 6 15 0 0 17 23 6 17 0 20 17 47 0 12 14 23 0 0 14 0 0 17 21 0 20 0 4 12 0 2 0 26 0 0 0 0 0 0 50 0 9 6 0 38 0 14 0 66 0 
19 0 0 15 0 0 0 21 0 12 0 0 0 36 0 7 0 35 58 0 6 0 0 0 0 5 0 23 9 0 0 0 0 0 12 20 0 0 0 20 0 1 0 0 0 11 54 0 0 36 8 18 67 
24 9 0 29 0 0 0 10 17 0 3 25 79 3 0 43 13 7 5 6 8 29 9 17 24 6 18 17 0 0 14 3 8 0 30 19 9 34 0 28 0 25 0 6 46 43 1 25 0 0 0 8 61 
0 0 0 0 0 32 30 26 12 10 0 22 23 0 0 13 22 20 11 0 16 0 25 0 26 0 0 0 0 33 20 26 1 10 5 0 46 39 22 0 26 0 13 7 9 0 13 25 0 0 7 26 15 
30 17 0 43 0 20 71 35 0 31 0 6 0 0 0 52 33 12 15 0 0 0 0 26 35 10 16 12 16 0 17 25 0 0 6 0 6 6 2 0 70 7 2 29 4 62 21 0 4 48 12 23 56 
0 5 0 0 0 37 19 0 0 0 0 0 0 0 0 1 1 23 2 29 5 0 0 0 4 0 0 0 23 0 3 0 1 13 0 8 0 0 0 0 23 10 37 8 21 0 0 0 29 0 0 10 0 
30 38 50 0 0 0 0 24 0 6 0 0 0 30 0 0 14 31 0 17 12 0 22 16 0 9 0 9 2 0 48 27 12 10 0 13 9 0 50 52 0 0 24 0 8 19 10 0 5 6 0 0 14 
50 0 2 23 32 0 4 0 18 0 0 31 0 1 0 4 6 13 14 12 3 0 0 4 8 0 6 18 19 0 0 0 8 6 0 0 21 0 5 0 0 24 32 0 1 0 18 22 0 3 74 34 0 
0 0 0 10 0 0 39 51 8 14 0 0 6 16 11 13 15 0 14 36 0 0 7 11 0 11 0 0 18 14 17 38 6 0 0 4 10 2 7 3 21 2 8 9 0 47 0 0 17 0 43 0 0 
0 0 0 7 34 0 0 17 0 0 3 0 0 0 0 7 24 41 17 13 0 0 0 0 7 0 5 0 7 0 0 6 6 18 0 28 0 6 0 3 31 8 0 0 0 0 11 6 0 0 18 34 2 
0 3 1 14 5 20 19 3 3 0 0 0 0 0 9 19 8 0 6 0 4 0 2 0 1 56 0 17 9 10 17 0 0 24 12 0 8 18 0 4 0 0 0 0 0 0 0 11 44 31 21 0 27 
32 11 81 0 10 0 27 32 0 0 3 26 1 6 8 29 1 10 27 42 9 22 0 29 3 4 0 13 22 0 32 8 9 0 6 18 0 4 0 26 14 14 0 0 29 0 25 0 18 47 0 0 6 
28 0 0 15 0 0 66 9 0 25 3 32 14 0 35 11 6 0 18 5 14 0 0 22 0 0 12 15 25 0 15 3 16 11 42 0 0 0 0 19 0 0 0 32 23 12 0 46 23 50 16 0 0 
0 0 8 28 0 0 0 0 46 2 0 7 17 4 7 25 0 0 5 0 2 0 28 0 0 26 1 0 17 0 0 33 0 21 0 24 11 25 15 1 16 0 40 21 41 0 10 0 0 37 0 68 0 
5 0 44 0 7 2 0 2 0 0 0 11 0 0 20 0 40 14 11 38 9 19 18 0 5 4 0 15 0 0 10 4 0 43 19 0 17 0 0 14 0 0 0 0 1 24 44 0 0 33 0 9 0 
29 8 16 40 23 54 2 5 21 0 0 34 13 0 0 53 0 0 16 19 0 0 29 2 0 11 0 43 0 13 30 0 0 0 5 0 0 36 0 29 28 0 56 40 21 45 3 0 29 0 23 0 0 
15 0 6 15 6 9 10 0 43 11 22 28 48 6 0 2 2 0 6 38 6 0 24 8 13 23 22 21 0 0 12 3 34 24 15 14 12 9 8 28 0 0 1 0 0 14 53 0 10 3 0 14 0 
0 11 10 3 0 0 2 42 0 6 0 0 13 51 35 5 0 8 24 0 0 1 0 2 3 17 23 0 17 5 0 0 0 0 0 0 2 7 28 3 0 0 10 39 7 0 0 5 0 14 0 2 0 
10 3 88 17 0 14 19 0 5 8 68 5 0 0 0 37 5 8 0 12 11 14 22 0 29 19 9 7 0 14 0 11 27 1 1 6 10 16 17 0 16 62 0 27 0 40 33 2 10 42 0 0 22 
8 0 27 40 73 0 0 0 2 0 0 8 0 0 1 0 0 8 45 0 12 1 11 0 7 0 0 36 0 0 38 0 2 6 31 31 0 9 2 0 9 6 0 6 0 13 42 0 41 0 10 29 9 
53 0 9 0 0 0 0 1 1 7 0 20 0 0 0 0 0 9 2 12 30 0 12 0 0 0 0 16 0 12 0 31 18 0 0 0 0 0 8 0 0 0 0 16 0 23 0 0 10 20 30 0 0 
26 1 14 0 10 0 27 43 0 25 0 0 0 0 0 0 1 2 0 21 10 5 0 2 12 6 26 34 12 15 0 0 0 15 0 20 32 0 9 24 0 4 0 0 8 25 0 0 0 0 93 0 8 
0 73 6 0 51 0 22 21 0 12 0 5 2 15 0 47 34 0 16 1 0 0 9 0 23 0 25 9 37 19 0 1 6 8 18 0 5 54 0 0 0 17 0 18 0 10 3 55 14 5 0 0 3 
3 0 57 35 0 0 0 14 5 2 9 0 19 6 0 0 6 24 0 15 0 0 15 30 0 0 0 0 0 11 65 19 0 0 0 0 6 0 35 0 11 1 0 0 0 4 0 0 4 47 0 29 15 
3 0 0 46 0 0 0 0 0 3 0 0 0 0 0 8 25 10 0 9 0 0 0 8 10 9 0 21 0 0 0 11 16 0 9 0 0 0 0 15 0 28 0 16 0 22 0 0 16 0 0 10 25 
0 0 0 13 16 16 52 0 23 2 10 23 18 0 0 0 13 10 0 0 14 0 0 0 0 15 10 17 2 2 10 6 0 3 15 0 16 2 0 11 0 30 21 0 65 0 0 18 15 8 0 9 0 
0 0 0 0 9 0 10 0 0 27 1 0 9 0 0 13 0 8 14 0 0 0 0 0 0 8 18 23 3 0 13 24 10 0 0 0 0 0 0 0 12 0 0 0 25 10 0 0 0 0 0 23 0 
23 3 0 5 18 0 17 8 0 17 12 14 0 1 12 0 18 24 0 0 0 0 33 0 12 6 30 13 10 10 17 0 5 0 11 14 31 0 10 18 0 9 0 0 43 0 24 67 20 14 0 71 20 
0 11 36 0 0 43 43 0 2 1 0 0 12 0 17 13 0 64 49 0 14 0 0 0 0 0 0 0 4 15 0 1 0 0 0 0 0 74 59 10 0 0 28 6 0 27 0 30 43 0 0 14 9 
0 0 0 0 31 0 0 61 0 13 0 16 28 0 0 50 21 0 10 27 0 0 10 17 3 0 35 18 0 0 18 4 0 0 10 17 24 0 0 1 36 5 35 0 4 19 27 0 5 0 0 50 14 
