53 30
51 0 0 20 0 0 0 0 0 2 0 26 10 0 0 0 29 53 53 7 0 0 0 14 2 3 0 4 4 24 14 0 0 0 0 0 41 22 0 0 31 0 0 0 13 0 17 28 0 2 0 51 13 
0 23 55 17 38 0 3 0 0 0 14 0 1 0 0 0 1 0 22 13 0 0 5 22 9 25 11 0 0 21 0 0 0 0 0 25 6 30 5 0 22 0 5 0 42 0 0 0 0 0 2 0 0 
27 0 7 24 0 4 15 27 3 23 0 0 15 24 35 3 4 30 4 0 0 24 0 0 0 22 8 2 26 5 21 0 27 0 26 8 0 51 17 0 0 0 9 37 30 41 0 6 7 0 41 9 0 
3 26 4 3 0 25 60 1 0 12 0 7 2 0 0 0 25 32 13 0 0 9 0 74 20 3 10 34 2 20 25 7 4 2 0 33 0 0 0 0 44 11 22 0 0 0 13 0 10 6 33 26 0 
39 10 0 1 2 10 2 1 0 0 0 0 0 9 0 2 17 16 0 0 14 30 14 20 0 15 0 17 0 28 0 0 0 4 18 10 0 0 18 4 13 0 0 0 0 0 6 0 1 22 24 39 0 
35 0 0 19 0 0 0 0 0 27 40 0 15 8 24 27 0 0 0 16 5 0 0 12 0 17 18 2 2 12 0 0 0 30 11 44 27 11 11 0 0 12 0 5 0 0 11 1 23 0 40 0 0 
16 27 27 0 0 40 28 0 0 2 0 40 1 16 0 0 14 0 0 19 0 11 5 17 10 0 0 31 23 11 13 0 11 10 28 0 0 0 5 0 0 11 0 0 11 52 0 12 0 9 0 0 11 
33 34 79 28 0 0 36 21 0 0 47 0 6 2 0 0 3 8 0 27 7 21 21 16 22 19 0 1 18 0 21 39 24 0 9 0 26 7 0 45 0 0 12 7 42 1 45 46 0 0 3 0 39 
0 0 23 0 18 0 0 35 0 2 0 17 6 34 0 0 30 0 0 0 31 0 4 0 3 23 0 29 0 5 0 11 0 17 0 0 20 0 0 0 11 10 49 3 0 4 30 34 0 33 17 41 10 
42 0 4 44 13 0 8 0 0 33 31 41 0 32 4 0 33 16 4 0 15 0 32 0 22 7 4 5 0 5 0 0 8 16 0 15 8 14 9 0 7 29 67 4 33 7 3 33 7 33 8 18 12 
0 46 0 30 22 0 18 0 12 27 19 30 0 18 5 0 5 11 0 9 6 0 21 0 25 7 52 7 7 12 1 9 0 27 0 10 0 25 0 0 14 0 18 17 5 11 39 0 51 6 9 0 0 
16 13 0 0 0 13 0 18 0 0 0 0 0 24 12 0 21 0 21 0 0 0 0 7 1 0 12 0 0 10 0 21 0 0 0 0 12 14 6 21 8 0 0 3 3 0 17 10 4 5 0 20 0 
0 2 0 0 0 31 18 12 1 6 0 0 0 22 0 0 0 0 15 15 39 0 0 0 13 22 0 18 0 0 0 12 37 0 0 38 15 0 0 0 16 0 0 3 24 9 0 22 9 0 0 1 20 
0 0 4 71 0 11 0 4 0 22 6 0 9 5 0 7 20 0 26 33 0 9 0 23 0 0 0 16 23 0 0 0 16 0 0 4 0 8 0 4 7 0 0 0 12 2 19 2 0 46 0 10 35 
0 10 13 0 0 0 13 0 0 0 0 0 0 0 0 0 0 0 0 0 3 32 2 3 24 21 4 0 0 0 10 18 0 0 4 0 0 3 0 0 19 0 0 0 0 3 28 0 14 18 17 0 0 
0 42 30 85 0 0 0 27 0 0 11 4 0 37 47 2 0 13 21 0 18 0 29 0 14 9 19 0 35 0 8 0 40 2 25 14 36 0 55 25 25 31 0 13 0 14 0 2 20 22 98 13 2 
0 1 0 11 7 13 9 5 0 0 0 0 1 0 32 0 4 0 0 0 24 0 37 0 23 9 0 0 0 0 0 6 0 0 19 0 0 0 0 0 11 10 8 0 22 31 4 5 0 0 2 11 25 
0 1 0 42 0 44 0 5 0 0 23 0 0 18 1 1 1 35 0 0 10 0 0 0 40 5 19 0 5 20 8 3 0 45 0 0 8 10 0 0 4 17 0 13 15 26 67 75 14 43 0 0 35 
29 45 0 2 62 6 10 0 39 34 0 17 0 0 6 6 39 0 18 5 8 0 0 0 0 8 0 35 17 29 0 30 8 8 0 17 0 0 0 0 1 0 15 39 0 0 0 39 0 4 0 0 0 
0 4 0 5 1 8 0 0 22 32 0 0 0 0 0 0 0 2 0 0 28 0 0 0 0 7 5 0 0 2 7 0 15 8 0 3 0 0 3 0 6 61 38 9 4 0 16 13 32 0 0 0 10 
15 50 7 20 1 0 13 5 0 0 39 0 11 13 0 0 14 5 0 31 0 0 30 11 0 10 24 0 0 0 0 3 0 0 0 0 0 16 0 7 0 2 0 5 3 0 25 8 6 27 3 48 0 
0 0 44 4 8 0 38 4 0 8 14 36 0 9 0 20 0 21 0 3 2 0 2 0 0 0 0 15 0 11 0 0 4 13 1 25 1 14 16 0 0 5 0 0 38 0 38 40 0 0 0 14 0 
0 0 15 9 57 0 19 20 32 0 0 0 30 0 0 9 0 3 25 12 15 36 0 0 10 15 0 20 17 15 12 0 0 12 12 10 0 13 18 29 10 9 0 25 15 8 1 15 21 25 9 71 48 
42 0 4 8 7 0 36 0 21 0 16 8 28 0 12 16 0 15 23 10 1 0 7 39 11 2 21 1 9 11 0 29 0 3 0 0 3 0 0 0 7 0 65 0 13 0 56 0 0 0 10 0 0 
15 60 2 53 14 1 11 32 0 3 0 24 0 5 1 33 0 8 18 39 16 0 4 30 9 27 5 6 4 30 28 12 7 29 0 34 0 0 0 0 0 0 0 0 4 0 7 0 10 26 0 2 50 
62 49 0 32 23 0 18 1 20 31 0 17 0 0 0 0 0 23 10 12 0 0 0 0 24 0 9 9 20 0 3 28 8 0 0 44 1 37 0 0 14 5 38 0 15 0 0 0 0 0 49 7 0 
22 84 13 14 14 24 19 39 23 8 25 54 0 2 2 13 2 0 0 2 11 11 27 19 17 19 5 0 21 42 10 0 43 1 1 30 29 14 5 35 0 10 0 32 0 0 14 40 22 1 0 5 4 
37 0 0 1 3 25 3 0 12 14 0 0 14 0 25 22 10 0 0 76 0 0 10 0 0 0 31 0 0 7 8 23 2 0 2 5 0 42 18 0 4 0 0 41 0 0 0 0 7 46 40 23 0 
43 0 43 0 0 10 46 38 0 0 0 0 7 11 43 23 28 0 44 7 0 0 1 42 17 0 0 0 0 6 0 13 0 0 0 6 20 10 25 12 28 4 33 52 0 40 41 25 6 99 24 4 122 
27 0 0 0 0 25 22 6 0 10 19 36 1 0 0 9 0 0 9 0 0 5 5 17 14 35 5 11 3 17 13 0 17 0 0 0 29 27 0 0 0 0 12 0 34 0 38 36 0 21 0 0 0 
