53 30
10 0 0 8 33 0 0 18 0 0 0 4 15 0 0 0 0 0 0 7 8 9 0 38 9 18 5 0 23 0 42 0 0 21 0 28 1 3 0 0 29 0 6 0 0 22 0 0 0 0 0 23 0 
0 49 30 30 0 4 21 2 0 0 11 6 1 3 19 14 3 16 0 0 0 14 0 0 12 0 0 16 12 9 15 0 39 3 0 14 1 0 0 38 14 9 0 25 11 23 0 0 4 0 0 0 9 
2 0 21 0 0 22 2 0 2 7 0 0 0 0 0 0 0 0 11 0 0 0 0 0 0 16 10 6 0 0 3 0 0 3 0 0 17 0 0 1 0 0 0 0 0 0 0 0 0 0 0 0 0 
0 33 0 14 9 1 0 66 18 0 17 8 6 26 17 17 21 15 25 0 15 14 9 9 11 14 17 41 11 18 9 14 37 0 60 19 0 39 10 21 37 15 0 75 12 21 0 61 5 10 0 14 45 
46 0 0 8 0 18 60 24 0 21 0 40 0 0 0 0 0 0 21 0 0 0 15 29 11 0 15 0 0 6 0 0 0 16 0 0 25 13 0 29 4 0 0 37 0 24 125 0 0 6 27 0 0 
17 40 3 34 0 65 7 69 0 0 14 11 7 0 18 0 11 0 0 40 15 19 28 0 2 0 0 0 8 14 1 27 43 17 3 17 0 3 19 13 7 40 0 0 11 0 6 3 2 3 28 0 2 
8 53 37 16 0 0 43 14 2 39 0 16 0 0 20 0 0 0 0 0 0 0 0 9 21 11 4 0 16 0 0 0 0 36 0 26 5 0 31 37 0 22 6 0 24 3 0 0 48 0 19 0 0 
0 0 0 0 3 13 0 4 2 0 42 0 36 0 46 9 44 13 0 0 19 0 0 0 2 15 14 0 0 17 14 0 10 14 0 0 0 27 0 11 0 10 8 0 0 8 0 16 0 12 28 10 0 
29 0 16 5 27 59 0 0 41 7 31 0 8 9 6 18 24 0 7 4 10 0 18 4 11 12 0 35 29 7 11 42 0 13 40 35 36 13 0 0 0 64 0 0 0 0 0 18 9 0 36 46 4 
17 28 0 2 0 0 4 1 35 34 5 35 35 5 0 12 0 12 0 10 0 0 8 1 10 7 0 0 18 6 0 30 4 0 10 0 0 7 11 31 0 0 0 0 10 5 1 46 26 0 41 0 0 
46 32 42 31 44 0 1 1 1 52 15 29 0 29 11 0 3 19 23 18 0 1 0 16 0 15 0 0 24 8 10 13 0 20 61 11 15 13 0 29 23 23 38 32 39 11 7 19 0 9 17 0 0 
6 0 49 6 32 61 72 7 0 23 7 73 0 0 56 13 0 4 16 0 0 0 0 21 10 22 0 23 27 4 36 26 0 0 0 29 22 0 17 31 13 0 3 15 3 31 44 30 6 43 39 0 0 
25 0 0 4 16 0 2 17 26 1 5 31 0 14 0 9 10 0 14 0 27 0 0 0 41 8 12 9 23 0 2 0 16 0 0 7 32 0 25 0 0 33 24 0 38 0 8 35 0 0 0 0 0 
46 0 0 55 13 0 0 0 28 17 28 0 4 0 31 0 0 0 11 0 0 11 0 0 0 16 6 0 12 9 0 0 59 6 0 21 8 16 38 0 0 70 3 43 2 13 0 5 0 10 0 0 11 
1 7 43 34 9 0 0 0 68 0 2 5 0 0 29 66 1 15 15 0 0 11 11 17 0 0 0 23 15 7 0 19 26 0 0 0 0 40 37 0 42 0 28 0 0 73 45 0 0 0 65 0 0 
0 0 44 4 0 0 1 0 0 19 0 0 0 0 5 49 16 20 0 21 0 20 0 28 13 13 13 0 23 29 12 0 0 11 0 9 14 2 11 0 21 8 22 0 1 24 44 7 9 16 38 28 9 
0 0 0 2 37 31 0 0 0 0 37 0 0 5 0 0 11 0 5 0 0 0 0 0 0 0 0 0 0 0 6 0 0 0 0 0 0 6 0 0 0 24 3 0 1 0 0 46 0 0 0 0 0 
0 0 0 0 0 0 0 2 39 40 6 0 0 0 3 0 9 0 0 0 0 31 0 0 20 0 0 0 4 0 0 4 11 3 0 0 0 0 0 3 1 0 15 0 7 6 0 24 0 15 0 0 31 
10 0 0 11 1 3 3 40 1 23 0 0 0 0 11 21 33 8 0 25 0 0 0 18 3 18 0 0 0 0 12 7 23 17 0 5 5 0 0 3 24 0 10 0 3 0 15 8 1 1 14 5 0 
0 46 2 13 33 0 0 0 30 0 14 5 0 0 0 2 21 30 0 0 0 0 0 0 15 0 22 24 19 41 0 0 0 6 3 3 13 27 0 31 36 0 0 6 13 1 0 73 2 1 5 42 0 
0 0 0 1 0 23 14 26 27 26 0 0 0 0 14 16 0 0 0 7 13 0 0 6 0 0 0 0 0 5 0 1 0 39 2 60 0 0 4 17 0 44 0 0 0 0 23 8 0 8 1 0 0 
0 0 25 52 10 2 92 0 23 0 9 32 29 2 4 1 7 0 0 5 18 15 14 0 9 23 3 9 3 0 14 0 0 28 2 31 15 31 48 36 0 30 4 0 9 39 11 92 0 16 44 27 17 
18 35 10 41 0 41 69 3 27 11 13 16 6 0 30 0 6 3 8 13 15 0 0 0 0 4 0 21 0 12 6 0 5 0 27 42 35 13 35 0 5 0 4 0 10 40 40 5 0 0 11 0 38 
0 0 42 4 0 2 37 2 15 39 2 0 31 2 33 0 37 0 26 3 0 0 11 15 6 0 21 24 27 13 0 3 5 1 12 0 9 0 18 19 0 8 13 45 0 0 13 14 22 1 8 13 0 
46 17 16 20 0 13 78 67 42 14 32 7 0 1 1 1 69 0 19 0 0 29 0 64 21 0 26 29 3 22 9 0 4 0 0 9 0 0 0 11 30 35 42 0 2 0 44 24 1 37 52 5 111 
0 0 5 0 43 30 0 20 0 25 0 0 7 4 15 9 0 0 21 7 26 2 0 13 0 23 26 0 12 19 0 0 9 0 0 19 0 0 0 8 12 1 0 18 19 0 67 10 21 0 17 0 26 
0 0 16 0 16 0 11 0 0 27 2 15 0 22 0 18 6 23 28 28 0 0 0 0 0 22 5 19 18 0 0 0 0 0 0 38 27 0 21 21 5 1 4 0 0 20 31 39 0 0 11 32 0 
49 21 0 47 0 44 0 0 0 14 0 0 0 0 29 0 0 0 0 37 0 0 0 0 0 0 23 0 0 0 0 15 0 7 0 7 0 0 11 0 7 0 0 29 21 0 0 0 0 36 0 0 0 
2 19 25 53 0 18 0 0 43 0 0 0 2 8 0 55 7 9 14 18 0 12 23 0 0 0 13 10 0 17 17 0 46 9 0 30 13 0 17 13 18 46 9 16 41 17 33 0 4 8 33 43 27 
44 0 2 35 0 0 13 12 0 0 16 0 22 0 8 10 0 0 14 0 0 14 0 20 14 16 23 21 37 0 0 0 52 0 0 15 0 23 47 0 0 0 0 0 0 0 46 74 0 17 37 19 0 
