53 30
0 25 0 0 0 0 37 26 27 3 19 14 0 10 0 0 7 0 4 0 0 17 2 10 0 19 0 0 0 19 0 1 1 0 0 0 22 29 27 25 0 0 14 27 0 23 0 13 0 0 0 0 24 
29 0 0 1 29 5 22 1 1 0 10 1 0 10 0 23 0 11 0 3 7 28 9 3 0 0 24 0 0 29 11 19 0 3 10 18 10 0 0 0 0 0 0 0 26 0 0 1 10 8 24 19 5 
2 0 0 11 0 42 0 0 0 24 9 5 0 0 80 32 0 0 0 17 0 17 20 0 5 22 0 8 4 3 27 4 6 35 1 0 50 23 0 0 0 24 48 53 0 45 0 111 0 17 14 52 38 
0 0 42 0 0 35 0 45 0 32 0 7 0 8 0 0 0 32 7 30 13 8 0 0 0 10 0 10 0 0 0 0 12 0 1 0 0 0 0 0 35 32 16 17 42 0 24 0 0 83 2 0 0 
39 0 4 41 29 1 13 1 31 4 0 0 4 19 17 0 0 2 0 0 0 0 0 31 20 0 8 12 0 0 41 0 20 0 40 4 4 1 4 18 0 8 0 0 51 0 23 0 5 36 10 0 0 
3 47 4 0 0 0 18 0 0 19 0 0 9 0 30 0 14 26 0 0 9 9 0 11 0 0 0 23 37 9 0 0 4 13 0 0 14 0 0 43 0 0 4 26 10 11 0 0 56 0 17 0 0 
0 13 71 0 10 0 0 29 17 0 23 4 0 0 43 0 0 6 0 19 5 0 0 9 12 12 18 7 26 0 0 0 18 7 7 16 55 12 0 0 2 0 20 0 6 16 18 0 47 7 24 25 7 
1 6 45 0 1 38 25 0 42 0 0 0 0 0 0 0 0 10 0 0 15 29 0 0 0 0 13 6 15 10 13 21 4 0 6 27 7 0 0 9 7 5 3 51 0 5 8 50 4 0 12 0 0 
24 25 100 26 47 0 41 10 0 26 0 11 21 37 26 0 27 22 27 0 12 3 29 1 14 1 32 23 0 0 14 21 29 13 0 9 1 0 24 0 6 0 0 49 33 0 24 22 4 16 33 49 2 
0 6 0 0 13 0 45 0 0 0 42 0 0 0 0 0 0 33 0 15 0 7 7 18 0 0 0 0 0 0 14 0 4 0 7 0 4 0 0 0 3 2 27 0 0 0 0 0 0 8 0 45 42 
0 0 1 0 0 0 22 0 0 14 0 34 0 0 9 2 40 0 0 46 14 8 0 14 0 10 0 14 0 0 21 0 1 0 0 21 0 18 0 0 24 4 0 0 46 34 0 0 9 0 25 21 33 
0 9 69 1 27 34 30 0 9 0 22 5 12 21 8 14 14 26 27 13 30 0 21 0 23 15 27 0 22 4 0 17 12 0 2 0 6 26 42 25 0 0 3 15 0 6 0 22 35 14 16 0 50 
10 29 1 0 26 0 45 0 3 0 10 16 13 2 29 2 0 10 0 0 6 0 0 19 0 0 1 16 24 0 4 0 0 0 0 47 0 0 0 0 34 8 0 39 0 0 0 0 0 0 0 0 0 
0 2 0 0 0 40 2 3 0 0 12 7 0 0 0 0 0 0 0 0 0 8 0 2 0 10 0 22 1 21 0 0 0 0 0 7 0 0 3 0 0 0 11 0 0 58 0 9 9 20 0 0 0 
0 0 0 7 30 0 7 0 0 0 23 14 0 9 28 17 0 0 0 0 9 0 0 0 0 17 0 0 0 21 0 17 0 15 15 25 0 0 34 0 8 0 24 0 30 0 0 0 0 15 2 0 2 
0 6 0 0 20 0 9 0 3 0 38 7 0 0 15 9 8 0 0 24 0 19 0 0 33 0 4 0 0 0 0 9 30 2 0 0 0 0 0 10 27 4 19 7 7 5 8 0 38 0 8 0 0 
0 4 30 0 10 0 0 37 1 64 16 0 3 2 47 0 0 0 0 21 0 19 0 10 0 11 0 7 0 0 10 0 30 19 12 6 7 14 44 14 7 1 0 0 43 27 0 3 0 0 30 0 0 
2 41 89 20 10 0 6 0 39 6 27 11 0 0 18 0 0 0 0 1 26 28 11 0 6 0 18 0 0 0 6 0 23 30 8 14 6 23 11 7 10 3 41 9 5 38 12 40 0 28 0 0 59 
0 0 35 0 0 0 35 0 0 4 5 0 7 25 32 0 0 0 0 25 25 33 10 16 0 24 29 0 7 11 0 8 0 14 0 8 16 31 24 24 0 14 29 8 25 25 15 41 0 15 24 0 0 
0 13 0 42 16 45 3 24 42 37 36 0 10 1 38 0 0 42 0 6 26 14 8 0 7 26 0 9 0 0 10 3 0 1 5 2 28 0 2 22 6 1 68 0 0 0 1 0 2 45 17 20 31 
6 33 4 12 28 0 27 29 33 3 23 7 16 6 44 38 0 0 33 0 31 11 0 10 32 0 9 16 20 55 0 0 28 5 33 2 2 0 11 34 16 5 0 36 0 26 36 0 22 14 0 14 44 
0 0 0 0 0 0 0 3 3 11 0 57 112 0 39 0 0 0 37 8 8 0 12 0 13 0 0 32 11 0 0 0 0 5 23 7 18 17 0 0 0 0 0 31 0 0 0 30 35 35 38 0 15 
28 9 0 40 0 0 0 19 41 8 0 25 0 3 0 12 36 11 15 29 15 0 6 0 0 3 3 22 73 0 6 3 18 7 0 35 20 15 35 8 8 0 15 5 0 16 0 1 30 20 7 0 60 
0 42 19 33 15 0 67 0 28 0 41 1 0 1 28 0 33 23 0 11 16 0 0 17 10 0 5 0 0 6 14 17 2 0 7 4 16 0 12 0 18 0 0 33 28 32 0 0 0 38 0 1 0 
0 0 49 0 47 0 0 3 29 0 17 32 39 5 16 22 0 19 18 10 0 33 54 0 19 0 9 25 1 0 0 18 24 1 45 14 15 0 6 0 1 25 45 34 0 0 5 23 0 41 13 58 23 
0 35 31 0 27 0 18 19 10 2 0 8 25 22 0 37 7 21 9 35 13 15 2 0 9 19 4 0 3 0 0 0 3 51 0 13 4 6 0 34 0 0 35 0 20 4 8 25 11 5 3 6 33 
32 28 0 59 6 15 8 26 8 0 48 0 0 0 8 0 32 15 0 0 0 1 21 0 19 0 0 0 0 23 27 0 15 18 9 0 0 3 38 0 37 0 0 13 16 0 0 0 19 15 0 0 2 
0 0 0 0 0 0 24 0 15 27 27 6 50 0 0 0 14 17 31 0 0 0 8 8 0 13 18 0 0 0 3 0 10 0 0 21 18 1 20 0 10 0 20 2 50 0 0 0 0 3 0 0 0 
0 0 0 0 0 7 0 28 0 0 49 0 46 0 22 0 0 0 17 0 0 1 11 0 0 0 0 17 22 0 24 0 3 0 0 48 12 2 0 0 0 0 35 0 0 0 0 0 4 5 0 39 4 
21 38 23 12 28 0 14 0 0 72 21 6 49 27 4 3 0 26 12 14 30 24 0 0 0 13 6 0 0 0 0 0 0 20 0 0 0 29 54 32 22 6 0 6 23 0 20 2 0 0 62 0 0 
