53 30
0 32 0 32 0 0 0 6 30 0 0 0 0 20 35 0 20 33 0 7 1 0 35 0 9 0 1 5 0 0 15 0 18 7 12 32 12 0 26 0 0 0 4 0 8 25 41 28 0 4 19 0 20 
0 0 0 46 0 16 3 4 2 19 12 10 26 14 0 14 4 0 17 0 26 21 15 0 0 40 0 0 4 11 0 3 20 5 0 25 25 0 46 28 0 12 58 14 20 2 0 0 0 21 7 26 0 
0 13 0 0 0 19 0 0 10 2 0 2 0 5 0 0 11 14 7 0 0 0 0 0 0 0 0 11 60 0 0 0 0 0 0 0 0 9 69 0 9 11 0 3 0 1 0 1 20 7 0 0 0 
0 45 27 0 0 9 0 20 2 0 0 0 17 0 7 13 0 12 0 0 0 12 20 0 27 22 0 0 24 17 23 2 10 0 32 0 21 0 17 15 9 57 0 0 0 1 45 16 1 8 14 0 0 
0 42 0 0 0 21 0 0 0 0 42 0 40 3 0 18 0 35 0 9 0 0 45 0 0 0 0 21 13 21 8 10 0 0 18 4 0 0 9 0 12 0 5 63 19 24 0 35 20 43 0 37 31 
25 114 47 0 29 0 5 0 81 13 66 37 20 1 20 0 0 0 4 0 0 11 0 0 0 14 0 5 15 32 7 24 20 29 9 0 26 29 24 0 0 2 0 9 4 0 2 46 10 28 0 26 51 
0 26 17 0 37 34 6 0 16 0 0 5 0 8 10 19 0 44 22 0 23 1 0 0 24 0 0 26 13 4 0 50 0 2 23 0 8 0 0 0 0 13 0 0 21 28 19 3 24 0 12 40 0 
24 0 0 0 0 3 0 0 0 22 14 15 0 0 0 18 0 8 0 28 5 0 0 0 14 0 11 12 27 1 4 0 0 0 0 0 12 0 0 2 0 15 0 6 0 7 0 29 20 3 0 15 3 
0 0 2 47 8 0 10 39 4 0 57 37 14 3 0 54 2 10 0 0 22 16 0 11 0 0 0 6 0 6 0 9 0 6 0 0 3 0 10 24 41 0 22 28 32 34 44 4 40 18 43 0 0 
45 10 26 106 14 44 0 0 3 35 0 7 0 0 9 26 0 2 18 0 0 28 2 0 9 8 0 0 14 0 0 38 0 0 31 0 0 6 34 7 0 13 19 0 19 45 2 6 6 75 47 5 3 
32 0 48 12 0 0 18 8 0 42 0 5 0 0 0 8 45 0 49 0 0 0 23 16 23 0 0 0 12 11 23 0 22 18 2 0 27 0 21 13 15 2 12 19 2 0 28 0 30 28 37 27 33 
12 0 0 32 0 35 26 14 0 2 15 0 31 16 0 11 0 24 0 13 25 19 28 43 12 11 17 0 18 5 6 8 13 5 0 64 0 15 0 4 54 0 0 7 5 25 29 0 0 18 37 0 0 
0 71 0 7 0 9 0 42 0 30 0 26 10 7 0 10 40 0 32 9 45 20 7 0 11 8 12 0 0 0 3 6 42 7 0 16 0 10 5 20 29 20 26 4 3 0 0 0 13 50 57 0 8 
0 12 14 0 0 7 9 9 10 0 38 0 22 0 0 10 0 14 0 13 19 6 3 0 8 13 13 6 20 0 0 6 29 16 11 0 13 0 35 0 6 11 4 0 43 5 23 37 0 0 5 32 0 
0 14 0 0 0 0 42 3 32 12 0 40 0 9 7 28 0 35 0 0 1 14 0 0 0 5 0 0 14 26 0 21 0 0 0 0 0 31 0 0 47 0 0 16 0 3 12 4 0 9 14 6 21 
43 12 18 21 12 41 18 32 64 0 0 3 0 0 18 10 25 69 14 16 18 19 5 2 17 5 4 22 6 0 50 9 19 17 5 24 0 9 13 0 47 3 6 22 24 38 12 41 4 19 5 49 0 
2 32 0 48 0 5 33 0 7 0 12 11 7 63 30 0 10 7 6 0 0 15 6 0 0 3 14 0 0 13 0 26 2 1 12 13 5 0 0 40 13 41 13 4 55 0 30 6 0 36 0 66 6 
10 9 36 5 30 11 5 5 1 0 0 8 11 37 0 0 0 0 7 0 5 30 0 27 0 39 0 8 33 0 3 31 16 0 15 4 8 10 28 0 5 14 0 11 23 14 20 8 17 0 44 0 0 
32 37 0 38 0 0 3 0 0 0 10 0 0 17 0 14 0 2 0 0 0 0 0 24 3 0 0 0 0 0 0 14 14 6 17 7 0 0 25 0 0 2 7 2 0 0 0 37 0 0 12 3 0 
12 6 0 65 0 5 20 0 0 0 0 0 0 0 0 3 0 35 0 0 25 0 22 0 0 5 20 2 0 0 0 0 0 9 0 0 0 0 10 39 0 0 0 7 0 25 2 0 0 0 0 0 84 
0 18 0 0 2 0 33 12 0 0 17 0 0 20 8 6 0 5 30 4 0 2 12 28 0 15 22 0 21 0 5 9 0 0 20 0 0 0 53 19 14 0 19 18 0 26 6 0 30 30 0 69 14 
0 0 0 23 23 0 5 0 0 1 1 5 0 15 0 18 5 0 15 39 0 0 0 0 1 5 23 4 11 6 0 2 24 7 4 3 7 0 0 0 0 18 6 2 0 20 6 0 0 16 0 0 0 
34 22 0 0 0 0 79 13 16 20 43 0 21 23 1 34 0 11 0 9 0 21 13 15 34 11 0 0 21 37 0 13 5 23 38 1 20 0 23 15 0 33 29 0 34 0 40 5 0 0 0 15 0 
18 35 0 0 5 0 0 20 23 13 21 0 0 3 0 0 8 0 18 0 22 0 30 0 27 0 0 0 0 0 0 30 11 0 4 0 0 0 4 0 0 7 0 0 0 0 0 17 0 3 0 0 0 
0 0 0 0 8 0 7 0 7 2 41 2 8 2 0 9 0 31 0 0 0 14 30 22 24 0 0 0 6 17 0 0 0 8 0 13 0 0 0 0 26 8 0 0 20 22 41 7 31 25 5 45 0 
85 36 16 0 0 0 0 27 20 16 0 0 11 0 0 0 0 23 0 0 0 0 0 7 1 6 0 0 0 40 7 0 0 0 56 35 18 0 24 0 19 1 1 0 4 0 19 0 0 0 50 0 0 
18 19 0 0 45 8 9 0 0 55 24 0 37 10 26 0 24 10 29 7 0 2 31 44 0 0 11 10 0 22 1 0 0 0 8 0 28 0 33 0 24 19 0 0 0 4 61 37 0 85 0 27 43 
1 0 36 0 1 39 0 35 49 23 1 10 0 0 0 34 23 9 37 0 6 1 30 0 0 0 33 14 27 0 2 7 29 2 1 0 5 1 17 54 18 14 16 17 41 0 0 18 40 21 30 0 0 
24 0 0 0 0 27 13 0 0 0 21 0 0 10 0 2 0 0 26 0 0 0 18 0 0 0 0 22 15 0 0 0 0 9 0 0 23 2 0 2 0 0 0 33 26 0 0 0 0 0 0 0 0 
18 22 8 0 0 0 58 2 0 20 0 0 22 0 0 0 0 0 11 0 11 15 0 40 18 0 0 0 4 5 0 2 0 8 27 14 0 0 30 0 53 18 20 5 0 0 3 0 51 51 27 0 0 
