53 30
0 15 0 0 0 14 5 0 30 30 19 0 17 32 0 0 0 8 0 0 19 8 0 5 13 10 0 0 8 0 0 22 24 29 28 10 23 5 0 32 25 4 19 0 17 8 0 0 0 0 0 43 0 
0 0 0 25 39 22 9 72 9 0 5 35 32 81 3 29 0 0 21 0 10 9 0 24 1 0 55 18 10 17 0 0 13 0 2 15 2 9 0 5 27 0 2 20 29 13 82 0 25 18 11 44 29 
0 0 5 0 11 19 0 23 0 0 4 0 3 0 9 13 0 10 0 0 30 14 0 0 0 0 25 0 0 0 35 10 14 0 20 0 60 0 0 3 0 0 25 0 2 7 3 1 0 4 30 0 0 
23 2 8 22 9 0 0 0 60 0 36 9 0 0 17 0 0 0 0 2 17 2 40 13 42 14 15 0 1 19 25 0 0 24 44 0 0 0 0 0 21 0 5 18 81 0 0 13 55 0 0 0 44 
0 0 0 0 0 0 0 24 48 15 47 35 2 0 47 7 0 10 0 0 0 0 22 36 21 28 7 0 4 0 0 18 0 8 8 29 0 23 0 0 0 0 10 32 33 22 0 0 0 55 15 9 48 
0 44 15 0 0 0 0 0 0 14 24 24 22 0 5 0 0 0 0 22 0 0 48 0 18 0 0 0 17 0 0 0 0 1 24 0 17 27 16 0 4 11 47 0 16 65 0 0 0 0 9 9 0 
37 0 0 0 0 0 19 0 39 0 26 8 9 6 5 20 30 7 3 20 0 0 10 0 16 0 10 0 0 16 15 5 0 0 6 20 5 31 0 47 13 41 8 18 3 1 29 30 5 0 0 0 0 
0 0 0 46 0 2 0 0 25 39 38 27 1 0 4 34 22 0 0 0 0 29 14 0 0 0 0 0 0 10 0 17 13 0 4 1 0 2 41 10 0 0 0 0 9 21 1 0 37 59 29 0 0 
0 0 21 30 0 1 0 31 0 25 30 0 47 0 29 19 0 6 11 16 0 8 18 26 2 0 16 0 4 0 0 10 24 39 0 15 4 0 42 27 69 30 7 29 0 13 0 0 0 0 12 4 14 
20 9 33 0 1 0 16 13 0 0 19 3 0 0 0 29 34 0 30 4 13 0 11 0 0 0 3 0 3 0 0 18 0 0 0 33 10 20 4 0 4 0 4 4 46 14 2 4 39 27 0 18 0 
4 0 0 0 23 16 36 7 19 3 0 6 20 14 8 45 41 0 0 0 9 17 12 12 6 9 31 0 17 5 25 19 1 28 9 16 12 5 17 41 0 0 20 0 0 29 0 8 0 10 42 4 0 
11 0 8 0 47 10 9 0 13 35 23 2 10 9 13 19 0 0 19 13 0 0 19 0 4 8 0 1 11 0 5 15 11 2 7 13 0 31 2 6 0 0 20 13 59 41 5 8 19 0 0 1 18 
2 0 0 22 14 0 0 32 0 0 18 23 1 0 9 0 0 0 16 16 0 19 0 9 0 33 0 17 11 0 0 4 0 17 25 15 0 0 14 45 32 4 30 30 19 0 0 0 21 31 21 4 0 
17 19 0 0 11 0 3 0 33 40 1 7 20 0 20 35 33 46 1 3 38 0 0 5 14 0 0 0 5 0 13 4 16 14 28 4 0 0 33 25 8 16 0 27 0 0 6 79 12 68 28 9 9 
46 0 18 72 0 12 2 32 2 0 3 0 0 27 53 0 24 7 8 45 19 1 0 0 3 5 11 0 0 0 7 3 5 15 31 0 17 6 0 54 51 0 47 0 10 0 0 4 63 0 45 0 0 
49 15 0 11 17 0 8 0 0 34 0 6 4 10 21 8 35 0 22 0 1 0 9 0 9 0 14 9 16 0 18 12 19 0 0 14 6 24 0 8 9 0 29 34 19 17 0 40 18 49 32 0 0 
0 25 20 17 0 15 0 3 0 0 3 1 0 11 0 26 5 0 0 0 40 0 31 0 7 0 11 0 0 4 20 0 0 0 0 0 19 0 0 0 0 4 0 3 0 0 34 0 5 29 0 0 0 
95 0 0 0 0 7 0 22 1 1 13 0 17 11 10 21 0 0 1 4 0 29 14 0 4 0 0 0 16 3 16 10 18 0 0 0 0 32 0 7 8 0 3 1 19 0 4 47 42 0 29 0 24 
0 38 46 29 0 0 4 0 0 8 0 12 14 0 0 0 0 0 0 0 0 17 0 6 30 1 1 0 3 0 9 0 9 0 0 8 0 0 0 72 0 0 3 0 0 16 6 4 37 35 0 0 0 
7 0 0 7 8 0 1 0 17 26 0 0 0 36 10 21 0 15 0 4 0 0 22 0 0 17 13 0 0 1 0 4 15 5 8 0 10 0 0 0 13 5 19 0 0 0 3 0 0 18 0 0 0 
44 0 15 0 17 0 0 20 0 0 0 0 0 0 52 0 8 19 0 10 0 3 0 0 8 0 12 1 17 10 9 3 0 3 0 0 4 0 10 8 0 42 6 19 39 0 0 0 0 3 0 37 22 
0 23 0 18 38 33 0 16 38 3 14 8 47 20 7 0 22 0 0 0 28 18 14 28 23 17 16 9 9 0 5 0 0 20 0 0 16 0 30 0 0 0 16 18 0 27 1 3 28 81 3 0 0 
11 49 0 0 24 6 12 41 0 0 8 34 0 23 1 5 35 0 12 8 16 20 3 10 14 12 0 25 0 0 0 27 0 0 39 0 6 1 27 0 0 20 4 0 1 0 30 0 41 0 49 35 25 
5 0 0 0 24 13 0 3 0 0 0 16 0 0 3 11 0 35 0 4 2 21 0 0 0 0 22 12 40 0 0 3 19 33 0 7 0 0 0 20 0 47 21 9 2 14 2 3 1 0 0 29 44 
0 0 0 13 14 7 0 0 3 40 20 0 0 30 34 17 11 0 0 0 0 30 55 10 16 20 0 16 0 0 17 0 41 2 0 0 0 0 16 0 16 5 20 15 0 0 31 0 26 0 38 30 0 
0 0 14 0 3 0 23 3 1 11 4 0 6 0 23 6 2 0 0 0 2 0 20 0 44 0 4 0 0 19 0 21 0 0 0 29 0 0 13 0 12 0 8 4 5 1 37 19 12 0 0 0 21 
22 0 0 31 88 0 2 29 22 1 23 20 9 32 10 0 15 22 0 0 24 29 0 0 10 0 10 0 13 15 23 28 0 0 0 0 6 6 0 8 0 0 8 14 39 86 33 8 42 42 2 9 48 
31 0 50 3 43 9 73 5 0 0 68 0 5 27 0 19 6 27 0 33 0 26 24 1 6 13 19 0 27 0 0 8 15 21 0 0 0 32 13 35 30 62 25 0 38 22 40 0 0 0 0 5 122 
2 13 26 32 0 0 2 24 14 0 19 0 33 0 13 8 0 0 0 4 0 14 9 0 14 0 0 5 13 0 4 21 0 0 53 32 0 0 0 10 0 20 0 0 0 60 3 0 24 22 0 0 15 
20 8 54 0 30 36 3 45 40 2 0 6 0 17 2 80 22 0 0 0 0 0 17 0 26 0 26 43 8 0 17 17 10 31 0 12 30 25 2 0 0 21 0 0 105 0 0 12 33 0 0 24 68 
