53 30
4 3 0 34 4 0 14 0 0 27 0 26 25 15 23 0 0 0 0 0 3 0 50 0 21 26 0 0 0 0 0 15 31 0 0 9 0 72 0 0 19 0 29 0 36 71 11 13 0 36 7 19 0 
27 1 0 101 27 0 0 28 0 54 14 0 0 0 0 28 0 0 0 12 31 0 29 6 14 19 0 52 1 40 4 5 25 38 13 28 20 18 42 7 0 8 0 28 0 2 22 0 0 0 0 50 16 
0 50 10 17 0 0 0 3 22 0 0 35 0 0 0 0 0 26 25 0 17 0 14 38 24 0 0 0 0 0 22 0 0 0 0 0 0 0 0 0 0 25 0 26 43 1 0 25 0 26 18 0 0 
0 0 0 37 24 4 0 18 26 0 0 8 0 3 0 0 0 4 0 17 16 26 0 0 26 5 0 17 0 0 8 0 1 15 34 0 0 7 0 14 37 34 2 0 41 40 0 0 4 0 42 30 43 
2 0 2 25 18 43 7 20 4 38 3 1 0 1 51 67 23 18 14 0 18 11 8 7 3 11 23 17 18 0 15 8 42 5 13 23 10 18 21 43 17 3 0 0 8 34 44 99 1 4 60 36 7 
22 0 25 0 0 41 0 3 0 15 0 20 16 18 18 0 0 22 0 20 0 0 13 0 0 0 0 12 7 0 0 11 13 3 0 9 15 0 0 2 13 29 5 0 0 0 24 47 0 15 8 0 0 
18 21 12 33 7 11 0 0 37 1 0 0 28 58 0 0 16 17 0 16 3 0 11 3 0 3 0 0 0 0 10 0 2 0 0 0 33 8 3 20 47 28 8 0 56 37 38 0 0 0 8 7 50 
12 0 0 0 0 19 10 0 3 0 11 5 2 0 9 37 11 0 0 11 0 40 0 0 10 1 5 0 0 0 10 0 0 19 0 28 0 22 3 0 0 0 0 22 0 31 0 12 15 0 7 0 18 
80 24 3 12 36 77 0 27 40 0 30 0 4 0 15 24 0 19 0 53 0 0 41 0 19 22 0 19 0 17 0 0 19 3 18 0 24 15 13 4 30 12 9 0 44 44 42 0 80 0 5 37 56 
24 0 31 35 12 0 5 76 0 19 30 0 1 1 1 1 0 0 0 0 13 0 0 20 16 37 0 25 3 0 10 8 0 31 12 0 0 0 4 39 32 0 6 0 0 0 21 0 6 0 0 44 37 
0 40 4 25 2 10 2 0 22 11 0 0 14 0 0 40 0 5 0 0 24 0 0 0 0 0 0 1 0 0 22 40 0 11 3 4 3 3 0 0 0 10 5 0 0 5 31 0 0 48 19 19 18 
6 22 0 59 49 1 6 2 0 0 19 6 0 0 26 1 0 0 15 0 0 0 0 0 10 5 22 1 0 0 0 3 0 22 34 25 2 0 0 0 26 0 0 0 10 41 43 0 22 0 12 0 0 
23 9 10 2 34 8 51 27 8 0 0 5 4 5 12 1 0 0 17 0 30 3 0 0 0 20 5 0 11 0 0 0 17 13 23 0 9 0 25 8 0 0 0 5 0 7 0 0 9 43 0 0 0 
51 0 0 99 6 9 0 5 0 7 0 37 0 3 34 22 26 0 0 0 0 0 0 0 0 1 1 0 0 0 0 9 0 30 3 0 5 30 2 35 0 0 0 40 0 0 0 0 14 46 3 33 2 
0 0 41 0 48 0 14 5 0 14 32 0 0 0 17 0 3 0 13 3 0 25 43 25 7 3 33 0 21 0 20 1 19 13 13 0 0 2 12 0 14 10 0 41 0 10 8 16 25 0 0 10 48 
0 21 25 51 0 42 37 25 0 0 0 0 37 25 0 12 29 1 0 20 17 11 12 12 0 22 1 25 12 0 3 18 10 3 0 0 0 0 0 20 0 0 0 58 0 17 54 42 10 63 7 0 30 
65 0 0 7 0 0 0 0 0 15 5 0 0 27 0 0 22 0 0 0 32 25 14 0 0 5 8 5 0 29 8 0 1 0 0 0 36 0 0 0 0 0 6 0 0 37 0 3 28 16 40 3 0 
0 20 0 18 0 11 38 19 19 0 6 9 34 0 32 0 2 9 2 10 0 45 5 26 26 0 34 19 13 13 24 0 7 0 0 0 0 0 0 7 0 13 18 0 6 0 62 26 0 26 50 0 0 
0 69 64 0 11 0 0 23 42 0 0 7 13 10 3 3 14 0 17 16 21 21 0 2 17 8 2 14 0 14 80 0 0 0 29 35 0 0 36 9 0 3 8 14 0 0 0 46 28 41 0 6 17 
14 11 6 0 51 0 0 15 40 0 8 31 0 12 0 0 0 0 0 0 2 0 11 0 14 0 0 0 20 0 0 23 25 0 0 0 6 0 17 0 0 0 2 0 36 15 0 5 20 0 8 57 0 
56 58 42 50 18 28 6 42 0 84 7 17 0 5 47 11 7 15 0 9 7 19 20 2 44 17 21 25 0 0 19 20 32 12 4 30 0 11 15 26 6 1 39 0 5 5 44 101 38 14 23 0 0 
10 1 30 0 15 0 20 0 1 33 44 17 11 16 15 0 25 0 0 0 8 0 0 0 0 1 9 4 44 16 3 0 35 0 12 15 8 11 18 10 31 25 4 6 23 0 0 4 0 27 4 0 0 
19 24 5 52 46 35 0 49 8 0 59 44 12 17 0 0 10 1 32 28 17 0 9 20 21 39 0 0 9 32 0 1 0 0 0 32 6 34 44 3 0 31 31 0 19 1 0 31 33 44 106 30 13 
16 12 0 13 1 16 0 3 41 1 24 0 0 0 18 0 7 9 0 11 0 0 13 0 31 0 0 3 11 0 16 21 0 0 0 41 18 4 10 0 0 11 0 35 0 23 0 2 27 0 26 0 11 
4 1 3 0 2 3 0 5 21 0 23 0 16 0 23 28 0 0 0 12 0 0 0 8 44 21 8 10 27 0 23 27 0 0 0 4 0 14 0 36 6 0 29 0 0 0 4 5 0 0 13 39 0 
36 0 0 5 0 0 0 0 7 0 2 23 0 1 0 33 0 0 0 0 32 0 0 0 0 27 0 12 2 0 0 0 0 18 15 2 7 26 0 5 0 0 0 0 0 21 0 2 31 39 0 0 50 
21 3 0 31 72 6 6 14 28 30 3 0 10 8 0 0 0 9 0 0 0 0 10 2 45 81 15 0 17 18 21 3 4 29 0 0 15 0 0 20 20 15 33 0 0 17 42 0 23 0 0 6 0 
0 0 0 18 1 0 0 0 0 27 0 0 8 0 0 0 4 0 2 0 1 3 27 7 3 0 0 7 0 26 0 17 24 0 24 0 0 39 0 29 0 48 0 6 27 0 0 25 0 0 0 0 0 
3 66 65 27 0 0 0 32 8 8 9 21 0 0 0 21 15 0 0 14 18 28 14 0 0 0 0 27 0 23 38 5 21 13 15 20 21 0 0 43 0 0 0 0 0 12 13 0 47 75 34 0 41 
0 0 0 32 0 38 0 5 0 0 27 0 0 0 0 0 10 0 0 3 33 0 0 0 26 0 0 0 18 0 0 24 0 0 0 33 16 0 0 0 0 0 17 38 0 0 0 4 0 0 0 0 0 
