53 30
0 6 4 11 31 47 15 22 14 0 28 0 35 0 27 36 12 1 7 0 4 12 14 17 8 15 13 0 0 22 5 21 0 12 18 79 0 0 28 27 16 6 0 0 0 0 0 64 12 0 0 36 65 
0 0 10 0 10 0 3 15 68 24 5 25 12 0 41 0 11 8 26 1 0 0 11 18 20 39 0 19 0 21 11 4 18 9 0 29 17 19 13 35 7 1 4 0 40 22 16 0 8 57 20 26 8 
23 0 47 0 15 25 6 0 14 10 0 25 6 0 0 12 0 0 0 38 16 9 38 0 24 14 1 7 6 0 25 1 0 0 3 0 16 22 2 0 0 0 0 35 19 0 15 47 0 48 2 0 0 
8 0 15 0 0 0 45 0 13 0 13 28 0 19 0 0 0 34 1 0 34 12 0 0 0 0 0 0 0 0 0 19 0 0 0 0 23 19 0 34 0 5 0 0 0 0 26 0 0 3 0 11 0 
3 9 4 0 0 0 50 43 0 0 20 0 0 0 10 0 0 23 21 0 18 19 22 0 30 17 0 0 17 0 0 0 0 0 38 0 0 0 3 21 23 0 0 0 0 11 0 0 14 43 64 0 0 
3 15 0 30 5 0 19 32 0 2 24 10 8 4 30 0 0 0 18 26 22 0 0 4 1 19 0 10 6 0 10 0 2 37 10 16 0 0 7 0 40 34 7 0 30 33 17 0 0 2 16 18 0 
15 12 12 0 0 29 0 0 43 8 8 0 0 3 12 15 0 20 29 0 12 40 16 26 3 20 21 0 4 0 0 12 18 7 29 6 0 0 0 8 1 23 10 0 0 28 5 21 20 54 10 0 54 
31 29 41 10 0 15 0 0 1 24 15 0 0 0 0 2 0 0 3 0 5 12 49 23 42 21 0 0 25 0 0 0 0 18 0 17 0 16 3 6 0 0 0 84 7 18 33 0 0 0 22 56 17 
0 9 43 38 0 0 0 8 37 6 7 0 28 25 0 6 0 7 0 0 0 8 2 0 2 0 16 32 0 7 0 21 5 0 0 0 19 0 42 2 28 31 35 0 0 44 0 0 0 0 8 13 0 
0 26 0 19 0 19 0 6 30 6 0 29 17 3 0 0 0 0 11 21 39 7 0 0 25 17 11 7 13 17 20 0 7 0 0 0 0 11 17 13 8 1 0 0 24 0 33 0 1 27 0 9 20 
56 52 14 0 11 0 0 40 40 5 6 7 16 14 9 0 2 0 44 23 0 17 16 7 54 0 2 0 21 13 0 6 2 15 2 6 2 3 21 17 8 3 5 0 43 37 0 40 41 0 0 4 0 
10 15 13 29 18 17 0 19 1 0 73 38 25 21 15 1 5 0 16 0 14 17 5 0 0 17 44 17 26 0 17 24 0 16 0 0 5 29 2 2 18 37 32 29 0 7 36 17 0 24 7 93 0 
0 19 3 4 0 38 6 19 0 4 7 11 11 7 11 4 0 7 6 7 5 29 11 0 8 24 8 0 13 0 29 10 6 7 0 28 10 35 0 0 25 3 0 55 0 0 0 7 12 15 10 0 0 
0 62 0 9 8 16 36 0 12 0 17 0 37 3 0 31 31 32 0 0 10 11 7 0 5 0 13 28 0 2 13 0 0 0 0 11 9 0 2 2 28 3 44 0 0 1 35 38 0 22 0 24 51 
0 32 38 32 0 35 46 0 0 1 0 0 0 14 5 9 0 1 0 3 16 0 19 0 10 24 0 24 0 24 11 0 0 10 0 36 20 0 19 0 17 0 0 16 7 0 0 0 11 0 0 23 52 
0 0 0 43 0 1 22 0 33 0 0 0 7 0 27 2 0 0 40 17 0 9 0 9 0 0 0 10 3 5 0 0 8 0 0 44 17 0 24 2 5 13 36 0 0 18 43 0 0 0 36 0 0 
43 23 0 0 30 0 0 84 10 42 0 0 23 0 0 7 0 0 4 19 2 0 14 0 20 15 0 0 27 0 0 24 0 7 19 27 0 0 0 1 26 3 0 36 0 36 0 50 0 24 12 0 0 
53 22 0 52 29 0 0 5 0 0 0 0 8 63 0 45 0 4 0 29 0 0 15 22 0 0 51 8 21 6 30 1 13 2 0 4 0 0 23 3 10 7 0 30 0 10 89 0 18 35 6 10 0 
10 0 0 0 0 43 2 0 10 0 40 37 44 16 3 0 5 5 10 7 0 0 0 24 0 14 31 0 3 13 14 8 10 7 0 37 4 0 10 0 0 0 55 32 14 9 17 0 43 37 55 7 47 
30 35 0 33 0 0 6 34 0 0 87 0 0 23 0 0 0 5 0 0 25 0 16 5 0 1 0 0 11 16 18 0 0 10 5 11 29 4 45 21 2 34 0 5 3 20 4 3 4 39 8 0 0 
0 0 27 0 10 43 0 0 4 22 0 37 7 0 4 0 2 0 13 0 20 0 0 4 0 0 0 0 12 27 6 19 0 3 3 5 18 0 0 0 19 0 0 0 21 10 7 0 37 0 0 0 47 
80 5 0 0 0 13 0 0 0 5 18 2 11 1 5 0 0 24 70 29 0 0 0 11 0 9 0 0 17 1 0 31 0 0 14 0 0 0 0 36 2 7 8 25 2 8 0 0 29 0 28 3 16 
15 25 51 12 0 6 0 0 0 18 34 0 0 0 0 44 0 1 9 27 28 0 35 0 15 1 79 52 13 1 0 0 0 0 29 7 35 16 0 2 15 5 0 28 10 19 44 21 8 0 13 0 0 
12 0 1 49 10 0 0 41 0 9 10 11 49 16 8 0 0 10 19 21 0 3 0 0 29 6 0 12 0 13 0 5 8 14 21 11 0 16 0 29 3 0 1 5 9 0 0 0 35 37 24 56 0 
19 17 36 45 67 66 0 0 0 23 0 9 17 1 23 15 0 2 0 22 24 0 0 0 8 3 37 13 12 17 15 0 26 0 10 23 3 0 17 1 5 0 0 6 10 44 42 15 44 6 0 50 10 
0 36 0 0 0 0 0 0 52 28 0 0 0 0 0 0 0 1 30 15 16 0 0 29 9 2 0 10 10 0 0 0 0 7 0 9 12 26 0 0 16 0 0 23 0 4 0 0 22 0 30 9 7 
20 0 18 0 2 3 0 0 0 0 0 0 0 0 0 0 26 0 2 0 0 5 6 8 0 0 9 32 0 0 6 0 0 14 5 0 0 15 0 8 3 0 18 0 0 45 0 26 0 33 0 0 15 
1 0 0 0 48 0 13 0 0 11 0 31 0 23 27 0 0 0 0 19 70 0 0 0 0 2 0 0 0 9 0 0 0 14 0 0 39 0 0 24 10 0 0 16 0 9 0 0 28 0 2 10 48 
0 0 0 0 81 0 0 0 0 0 0 0 0 3 21 20 0 10 23 0 14 19 18 0 9 22 4 0 0 18 0 5 0 0 0 21 0 6 34 0 0 30 12 6 0 0 4 12 0 0 8 47 3 
3 0 57 25 37 4 21 7 0 16 0 2 3 15 7 28 12 21 16 23 18 27 4 0 11 0 11 21 25 0 33 9 36 7 24 49 0 0 21 26 20 0 33 0 13 0 0 44 0 15 2 0 3 
