53 30
20 33 4 23 31 62 4 45 0 18 0 0 25 6 17 9 1 18 0 4 28 0 24 0 10 0 0 6 0 7 56 4 0 24 30 1 7 0 0 0 5 0 0 0 22 23 0 0 3 0 50 32 30 
0 0 0 10 0 0 4 0 0 0 38 0 0 7 26 9 0 13 0 0 32 0 18 48 0 10 0 0 2 0 15 0 8 19 0 17 26 21 18 21 0 0 28 0 0 0 40 0 73 0 0 0 49 
0 39 24 34 3 28 0 30 0 48 0 23 0 32 0 18 32 8 0 0 1 15 0 0 8 0 25 0 33 0 0 0 0 28 11 7 3 31 0 11 0 3 0 41 8 21 6 19 0 85 0 48 48 
0 0 54 0 0 0 7 0 0 0 0 20 26 0 5 0 14 29 7 1 25 0 11 5 0 7 0 24 0 0 45 0 2 11 3 0 19 0 9 16 0 0 0 5 9 0 26 0 5 4 0 0 4 
1 4 35 4 3 23 18 3 1 8 13 0 35 0 30 0 0 0 0 1 17 0 0 13 18 4 34 4 24 19 4 1 14 0 8 9 0 97 0 10 0 0 1 0 12 1 16 33 0 37 0 25 18 
0 78 0 0 0 0 0 0 51 0 0 13 0 22 0 28 1 0 0 0 0 0 20 0 16 0 15 0 0 0 0 0 0 5 33 11 0 0 17 36 1 0 55 40 14 0 45 0 0 19 20 0 0 
0 0 0 6 0 0 71 0 0 0 0 2 2 52 13 2 6 22 0 15 0 0 6 0 16 9 2 0 9 3 0 0 0 7 52 27 5 0 0 22 15 0 0 0 0 16 41 0 0 43 0 0 0 
11 4 26 28 0 0 35 6 0 32 0 0 0 12 0 0 0 0 0 1 0 0 2 29 2 0 0 0 0 0 0 3 6 0 15 2 4 2 35 0 3 24 0 44 14 0 0 16 0 4 0 0 65 
63 74 36 25 21 12 9 2 22 9 0 8 16 12 8 21 0 21 12 23 0 9 0 14 13 4 26 4 30 12 2 29 13 33 23 0 16 42 13 13 15 0 0 41 44 14 35 16 22 24 50 23 69 
10 0 46 0 7 50 15 0 19 31 62 21 0 0 3 29 4 17 0 0 4 10 0 9 0 1 35 19 0 0 1 0 13 0 84 15 0 0 3 0 41 4 32 0 29 31 19 0 0 0 8 0 1 
0 40 0 75 0 0 16 0 12 3 0 2 0 2 69 4 18 15 0 6 0 1 29 4 26 28 0 2 0 0 3 0 15 1 13 0 12 21 0 0 19 40 20 0 0 0 0 0 7 33 13 2 0 
0 0 0 10 28 36 2 18 9 0 0 2 18 0 43 2 22 15 0 0 0 25 0 14 7 2 0 7 9 21 2 0 28 0 13 7 5 0 31 0 7 33 8 0 19 17 14 8 0 0 36 0 0 
22 0 0 28 0 35 1 0 0 28 0 33 15 0 18 13 0 25 0 43 0 14 17 9 17 8 4 25 13 12 0 7 23 9 0 35 0 44 13 0 0 26 31 0 16 0 0 0 0 0 0 29 0 
1 33 6 7 3 0 31 35 6 24 4 8 2 5 9 2 8 7 0 0 0 4 0 14 34 0 16 0 11 20 0 0 0 12 14 49 46 11 35 0 0 0 68 0 0 0 45 0 59 0 0 0 0 
0 0 17 0 10 0 0 14 0 0 0 0 13 8 53 12 4 2 0 19 4 5 10 0 0 2 17 26 12 3 0 0 0 6 0 0 11 2 0 21 0 18 0 29 0 0 13 6 19 23 0 0 38 
9 0 0 14 12 0 13 23 11 40 9 0 0 0 10 0 16 14 0 3 1 0 0 13 7 0 5 8 0 0 0 0 0 0 0 28 0 0 3 0 0 3 0 0 0 0 0 38 0 0 23 0 0 
33 26 0 6 7 0 3 4 0 3 0 77 5 15 2 8 0 6 6 11 0 3 0 1 0 2 0 0 28 1 4 0 5 33 3 11 8 5 37 8 0 0 0 0 0 0 0 36 0 0 39 0 0 
19 43 3 0 12 16 14 12 0 51 1 1 0 0 28 28 0 0 5 7 21 47 2 11 20 0 0 11 0 0 0 0 5 0 10 0 21 0 5 0 7 0 0 12 0 0 32 9 7 0 0 25 31 
13 4 0 43 0 0 0 37 16 13 26 3 0 0 5 0 13 18 0 0 4 0 6 0 47 10 0 19 8 0 5 0 0 0 12 5 26 0 13 0 0 0 0 0 0 0 0 0 0 0 43 63 0 
39 0 33 0 0 38 29 0 0 25 0 24 26 2 36 37 2 0 16 57 14 0 0 18 0 0 11 14 23 10 0 22 0 16 62 21 6 11 35 55 0 32 8 38 32 1 0 9 0 35 35 34 33 
9 13 44 0 78 0 0 3 25 0 0 1 0 0 13 0 7 15 16 5 0 19 6 0 17 0 29 0 9 0 0 0 0 25 0 7 18 0 17 0 14 39 0 61 0 0 0 0 0 0 0 47 0 
0 18 0 5 0 0 0 0 3 7 0 18 19 17 0 0 0 10 6 5 0 26 21 9 30 11 0 0 2 0 38 3 0 0 0 12 6 2 0 2 39 0 12 0 14 0 22 19 0 3 20 0 0 
8 0 67 10 0 26 39 8 2 42 0 11 0 14 24 0 2 18 0 0 19 0 5 0 11 0 7 0 0 0 0 26 0 0 0 7 0 20 45 15 27 0 6 0 22 16 0 0 6 0 0 87 50 
5 51 42 0 0 0 27 0 0 0 0 23 34 14 0 15 0 0 0 0 0 25 0 22 0 0 11 26 0 4 29 0 0 0 10 5 3 16 16 0 0 5 9 0 80 8 56 16 0 12 0 0 0 
12 35 0 5 0 0 15 2 0 1 0 20 0 0 0 8 4 0 9 16 7 0 0 2 14 14 5 12 22 0 0 15 0 24 15 0 37 0 0 19 2 5 2 36 0 0 18 5 0 22 0 44 0 
0 20 0 0 26 1 0 0 0 32 63 23 25 27 0 29 0 0 8 46 0 14 0 14 0 0 0 6 9 30 0 6 0 23 37 22 11 0 1 11 38 0 2 34 4 16 0 13 38 0 20 0 33 
6 18 0 0 48 68 31 0 53 0 2 0 0 34 0 0 10 20 1 9 0 0 29 0 0 5 21 36 17 18 3 2 15 0 28 13 0 0 4 0 0 0 9 0 0 0 13 23 0 0 10 20 95 
5 13 0 0 22 6 1 0 0 3 0 38 10 0 100 29 0 0 1 0 0 0 0 1 15 0 33 18 0 0 27 0 0 0 19 1 27 11 0 0 16 0 13 7 29 0 0 33 1 37 0 0 0 
47 29 25 0 4 0 0 12 24 0 0 17 0 8 6 4 45 2 7 8 28 1 5 4 8 2 12 2 58 0 24 25 7 5 0 7 14 0 14 23 15 0 27 5 17 18 0 7 5 0 12 16 42 
0 0 4 45 23 0 6 16 23 28 10 34 1 6 10 0 0 36 1 4 21 0 0 0 34 32 2 15 1 1 3 12 0 18 0 0 19 28 4 0 15 15 80 0 23 13 4 14 0 25 0 7 45 
