53 30
29 37 0 3 0 0 55 0 0 0 4 29 0 19 51 0 0 0 4 18 11 0 8 3 0 25 15 0 0 22 0 18 0 28 0 2 4 13 9 0 0 0 4 0 0 0 0 0 1 30 19 0 0 
0 1 0 32 38 12 0 0 0 0 5 0 0 24 0 27 0 0 0 0 5 17 18 27 0 1 0 0 0 20 0 8 0 10 0 32 0 14 1 6 7 0 11 0 15 6 0 0 4 32 0 0 3 
3 2 48 5 0 2 5 17 0 0 28 21 4 0 0 22 0 17 0 0 0 0 0 0 19 0 0 0 0 0 0 0 7 0 0 34 43 0 70 0 1 1 0 2 13 0 0 0 27 16 48 2 16 
12 0 0 0 21 19 0 30 67 2 27 0 20 0 0 26 0 0 10 0 21 20 3 0 0 0 3 0 0 12 0 3 20 6 21 15 0 8 20 10 12 24 0 23 0 0 4 0 13 0 12 43 12 
0 13 0 44 45 0 6 29 0 3 0 27 14 0 6 0 17 1 0 1 15 30 0 12 34 2 14 0 8 20 0 0 0 5 0 0 24 1 1 0 0 0 0 9 13 0 0 41 0 86 41 54 3 
29 0 47 22 0 2 20 0 0 7 38 39 4 32 35 0 0 0 11 17 5 18 0 0 0 19 0 20 11 48 10 0 8 0 14 0 0 0 0 0 18 2 0 0 0 32 0 20 24 26 11 0 20 
17 8 19 0 16 0 15 42 0 7 5 0 4 6 0 6 2 19 0 17 21 4 0 7 24 0 12 0 0 1 7 31 11 0 0 18 1 16 22 0 0 0 15 11 0 0 0 0 0 25 8 1 10 
0 0 0 27 0 84 6 11 38 2 9 5 85 7 7 24 10 13 0 35 28 24 0 0 30 11 9 2 19 14 11 0 29 40 2 7 4 0 28 0 9 48 35 0 3 0 23 55 46 41 0 51 37 
56 0 24 49 0 7 8 0 13 0 0 8 19 4 33 52 0 4 0 0 0 24 9 0 0 21 24 0 9 4 22 0 17 33 12 0 0 0 0 0 0 0 13 0 20 24 36 25 0 0 0 7 65 
60 0 0 5 16 0 0 5 8 0 3 35 4 0 0 0 22 0 8 10 28 3 4 0 4 0 12 2 8 29 9 8 0 33 17 0 6 0 0 0 0 0 18 0 7 0 35 0 0 31 0 0 0 
36 0 10 0 12 8 74 0 0 0 49 40 0 36 17 32 28 53 1 1 1 6 16 32 6 0 0 0 0 40 32 13 1 3 22 0 55 0 22 0 9 5 0 0 42 0 15 32 0 17 0 64 46 
24 0 0 0 8 0 0 0 0 0 39 0 0 20 0 0 0 0 0 0 0 17 28 13 1 10 0 0 0 0 0 7 0 26 9 2 29 0 0 11 0 0 5 50 14 9 1 0 0 50 41 0 2 
34 29 17 21 23 3 0 41 1 0 0 11 38 0 16 0 0 0 0 10 0 10 27 0 9 0 23 23 21 10 12 0 0 8 0 0 0 0 0 10 11 27 7 0 5 0 38 0 0 41 54 2 55 
21 8 0 0 0 25 33 0 40 49 30 0 3 0 10 0 0 7 37 3 8 7 0 0 7 0 7 27 0 9 0 27 11 25 0 0 0 0 26 6 16 0 0 0 0 27 0 0 2 1 80 0 0 
0 0 20 49 0 11 0 0 14 0 25 0 51 0 28 7 40 26 11 0 1 0 11 0 0 0 16 0 0 24 10 0 15 13 16 0 24 0 0 23 10 29 50 0 0 0 10 7 0 35 5 0 0 
12 0 3 0 0 31 1 1 0 19 0 0 7 0 0 34 0 25 0 0 32 3 0 0 0 0 22 0 19 17 0 0 13 11 0 7 9 0 12 0 5 0 12 41 21 0 44 0 34 34 12 39 0 
28 0 0 1 0 0 1 1 0 0 27 0 8 0 0 20 0 0 0 0 0 6 25 0 6 18 16 0 17 0 0 0 11 11 0 20 33 15 0 13 0 0 0 1 3 0 0 32 1 2 21 0 13 
22 50 11 17 8 0 0 2 15 13 8 0 0 6 4 0 20 25 7 11 32 4 48 0 5 0 0 8 34 0 0 4 0 25 20 2 10 0 12 0 0 9 0 0 0 42 0 13 27 29 3 10 0 
10 0 44 0 25 5 53 1 0 0 9 0 11 7 14 0 0 0 0 0 7 20 27 0 0 0 0 0 10 0 9 30 9 29 0 8 4 31 10 7 11 27 40 4 0 9 7 4 0 28 5 0 0 
40 0 50 35 32 0 29 0 5 38 20 1 24 16 0 0 16 31 30 0 38 0 24 0 18 33 0 3 9 49 7 9 12 16 12 5 3 2 3 0 20 29 27 0 5 13 0 38 0 9 50 2 0 
1 39 24 37 0 0 19 3 3 0 5 37 1 12 0 0 35 15 27 0 0 13 4 0 6 26 8 14 0 4 6 0 15 12 8 0 0 39 4 38 45 0 24 0 16 5 35 0 13 0 28 35 8 
1 32 0 5 0 8 11 0 3 0 0 16 14 0 4 7 0 17 4 0 0 21 4 3 9 25 10 0 3 17 0 0 0 32 18 2 21 1 1 0 0 0 6 0 0 8 21 7 0 0 0 0 8 
0 0 35 0 12 11 1 1 32 39 13 38 0 0 42 14 24 10 5 0 0 13 0 0 1 5 0 12 0 14 0 4 18 0 0 23 3 45 13 0 56 20 0 0 0 3 14 10 39 73 0 13 0 
0 34 0 30 26 0 14 0 0 0 0 16 0 27 10 0 68 12 0 0 6 18 0 0 0 3 10 3 10 20 39 2 5 32 0 38 0 0 28 4 27 25 21 0 0 6 6 0 37 2 0 6 37 
96 0 3 43 0 0 13 0 0 0 6 19 0 0 0 34 0 8 0 1 21 4 20 3 14 48 0 2 3 0 12 0 32 0 35 0 22 21 0 37 0 41 20 2 0 8 10 0 3 13 5 0 50 
0 0 20 0 8 13 20 0 0 0 5 20 18 25 11 0 17 11 10 1 55 0 2 0 17 3 0 30 0 14 5 0 4 31 7 30 25 4 0 47 0 12 37 14 53 0 19 0 10 29 11 0 33 
0 0 0 0 0 19 23 0 12 0 0 5 40 0 0 0 0 0 7 2 17 17 18 0 0 16 0 44 0 23 14 10 0 0 17 0 0 5 0 27 5 7 5 45 14 5 0 2 0 12 10 26 25 
68 0 0 0 0 39 27 0 0 2 0 4 2 0 3 0 0 0 20 21 0 14 0 2 19 0 12 0 0 4 0 0 21 8 23 0 22 0 32 14 14 0 13 2 0 0 0 47 0 25 27 0 0 
6 0 0 18 22 0 1 0 21 0 0 5 0 0 19 18 0 22 0 0 49 0 15 3 21 4 30 0 4 29 18 0 8 12 4 0 0 8 10 19 0 18 0 0 17 13 17 0 0 0 0 45 29 
21 0 9 0 38 0 20 45 2 2 12 7 0 0 31 0 0 28 4 0 0 0 0 1 22 10 26 19 24 0 0 14 4 22 0 7 6 0 12 0 0 27 11 4 1 36 23 0 27 0 8 15 63 
