53 30
0 28 9 0 8 0 21 0 28 0 6 32 5 2 38 0 32 0 0 3 14 0 0 15 50 0 0 27 0 0 0 0 18 0 0 8 0 20 0 0 28 12 0 0 0 21 0 0 0 0 18 35 38 
0 41 23 57 0 29 9 0 30 0 0 17 0 10 5 4 8 0 21 5 16 0 0 0 0 0 0 40 10 2 5 0 5 0 29 2 28 0 21 21 22 0 19 0 0 18 25 0 20 0 104 0 0 
0 1 64 0 0 0 1 23 15 16 7 10 0 12 0 27 12 0 16 37 0 0 14 14 0 42 15 25 16 1 69 0 13 1 15 5 6 12 29 0 5 39 6 0 0 0 0 18 0 0 0 0 0 
29 0 36 1 11 45 0 33 32 37 9 26 0 43 4 34 20 9 20 0 19 17 0 0 22 0 21 5 20 41 13 12 0 15 27 17 0 0 28 0 49 56 8 29 24 5 37 0 48 33 52 3 0 
0 9 0 19 42 31 24 49 39 0 34 40 17 0 13 35 8 12 17 26 0 0 0 22 16 34 0 1 2 33 2 39 0 6 26 0 0 7 4 29 16 35 17 7 0 4 62 15 28 1 1 40 18 
0 1 28 0 5 0 0 0 0 0 0 0 9 0 0 2 0 13 0 0 6 9 0 0 1 16 0 27 5 0 11 9 0 16 0 4 16 3 21 0 23 21 10 0 0 0 0 5 0 0 0 0 1 
0 45 35 49 0 15 0 5 0 0 39 10 23 0 0 0 36 9 8 0 33 31 8 5 0 22 0 26 26 15 7 0 0 32 10 10 0 40 0 0 0 0 5 33 0 0 0 27 11 29 0 0 133 
28 0 2 17 38 0 21 20 28 84 41 39 0 28 0 2 0 2 17 17 42 0 13 0 40 5 0 15 0 0 18 0 3 14 0 17 28 13 29 0 0 0 24 24 0 8 26 37 35 0 72 0 0 
1 55 61 0 0 0 1 4 0 12 17 34 0 0 13 0 0 0 8 10 0 0 18 14 14 0 0 3 21 28 0 0 6 20 22 0 34 13 6 0 18 0 0 5 6 38 0 0 0 0 6 24 3 
0 7 18 0 0 22 14 0 0 0 7 6 8 0 3 4 0 17 17 5 2 11 15 11 0 0 0 38 13 20 0 0 11 0 5 0 0 15 0 18 18 0 29 21 0 4 12 0 0 21 0 9 0 
0 24 2 13 35 41 0 4 0 34 0 4 19 0 0 5 0 25 30 39 9 22 28 0 0 31 0 24 3 1 1 26 16 10 0 2 0 10 0 24 0 6 25 22 0 4 68 44 0 21 28 24 0 
0 9 14 14 41 1 11 0 17 0 0 0 34 20 0 31 10 14 0 0 17 0 0 5 4 2 49 0 23 0 7 0 30 6 29 15 13 3 0 0 15 13 2 12 0 0 3 7 11 0 14 34 6 
24 63 2 16 0 0 0 0 0 0 2 0 0 0 3 28 0 0 0 4 0 11 0 0 24 24 0 7 0 0 3 0 1 0 0 10 10 0 0 0 47 0 0 28 0 0 0 8 8 3 0 0 3 
105 0 0 0 0 11 0 0 13 0 0 1 5 0 0 30 0 27 13 25 21 19 18 8 0 0 4 0 13 0 2 8 12 0 0 0 0 0 0 18 10 26 32 23 23 7 0 0 0 10 10 36 0 
0 0 49 0 1 0 7 0 0 0 0 0 15 1 7 3 0 4 0 8 3 9 12 0 12 10 14 0 0 8 0 0 9 0 0 0 1 39 5 0 10 0 0 26 0 4 10 0 15 0 0 49 0 
15 0 34 28 1 33 0 0 23 46 0 9 0 2 6 20 44 13 4 1 9 0 5 12 0 17 3 16 0 3 19 60 9 0 18 0 29 2 4 17 0 3 70 11 1 3 0 0 0 0 0 0 37 
0 15 20 0 17 23 27 0 37 0 9 0 34 24 35 0 0 0 0 0 15 19 7 26 4 26 11 16 28 23 21 0 5 19 59 13 1 7 0 11 0 6 7 0 0 37 37 20 3 21 15 28 0 
0 14 56 6 0 0 0 45 7 43 0 12 38 0 0 14 0 0 0 0 0 0 12 0 0 0 56 0 0 0 0 7 7 1 5 26 10 0 0 0 12 0 30 0 2 0 0 21 4 3 0 0 5 
0 45 40 0 22 3 0 0 10 0 38 0 0 0 0 0 0 13 0 12 0 11 0 0 0 0 22 11 11 21 12 0 11 6 0 0 0 0 17 36 0 0 14 0 5 0 34 0 45 5 0 0 0 
0 0 5 0 5 0 13 0 0 5 23 0 59 0 14 9 33 23 0 16 23 0 0 25 13 13 0 11 14 0 0 15 0 21 10 19 0 0 8 0 17 0 0 15 0 0 25 0 40 33 38 0 0 
0 0 12 22 0 16 1 17 0 37 0 58 0 10 0 15 1 37 9 0 0 0 13 22 39 2 30 24 3 8 21 0 14 0 0 0 0 2 0 22 17 3 0 32 7 7 0 0 22 3 0 40 0 
17 82 35 32 13 0 11 14 0 8 0 0 0 27 28 8 26 18 0 17 37 20 20 27 0 4 0 10 5 15 17 6 5 33 33 4 2 35 0 3 2 3 44 0 27 32 0 0 19 42 60 0 17 
32 11 17 0 68 0 30 3 4 0 0 4 0 0 8 22 0 0 0 22 0 26 0 0 0 19 18 18 14 0 17 0 27 0 0 0 10 6 17 0 18 0 0 0 18 41 0 26 5 0 31 0 0 
52 48 15 79 0 0 5 30 0 0 18 54 7 0 18 1 29 0 0 7 6 28 7 21 18 25 0 16 15 26 31 15 13 30 9 37 0 9 0 16 6 19 0 0 26 0 0 0 48 33 24 51 17 
0 0 1 46 3 8 1 17 0 9 33 21 0 0 0 15 0 0 0 58 16 3 17 3 32 22 18 0 0 0 7 0 17 8 16 0 0 0 0 32 10 19 3 34 18 0 10 0 33 0 0 0 0 
21 3 13 0 0 0 0 0 24 0 52 33 0 0 0 0 0 0 19 21 0 9 0 28 5 3 0 21 5 43 22 0 10 18 0 0 0 0 0 6 0 0 0 0 33 16 23 0 0 39 0 26 22 
90 16 0 0 6 0 0 0 0 3 6 0 0 0 6 27 45 21 0 24 17 0 0 0 0 0 0 0 13 0 0 15 15 15 0 0 24 9 0 0 4 0 48 0 44 0 84 0 0 16 30 0 0 
34 13 0 3 0 6 8 23 0 28 0 6 0 0 38 14 8 18 0 0 21 6 18 18 23 24 0 9 0 9 0 0 16 10 34 18 10 28 17 11 13 0 20 39 2 0 2 0 5 0 0 7 38 
0 22 0 0 0 0 0 0 16 0 0 0 0 0 0 0 0 0 26 17 11 0 0 28 29 7 11 23 22 0 0 8 9 20 0 5 17 1 0 27 0 0 21 0 0 0 0 0 0 0 0 0 0 
93 0 0 7 26 0 0 0 0 25 8 13 0 0 0 27 0 23 0 0 27 25 26 5 29 25 9 12 3 8 0 0 2 0 7 0 0 36 0 0 20 10 30 5 0 0 71 27 10 0 13 29 0 
