53 30
0 50 47 28 0 0 0 22 26 0 30 0 32 11 0 0 0 0 2 7 0 0 9 20 0 23 15 0 7 0 8 29 11 0 16 22 8 2 0 0 34 0 2 33 7 6 45 0 0 47 20 6 2 
20 22 2 12 21 37 15 3 18 0 0 0 30 7 5 0 3 0 0 24 16 3 2 0 0 6 10 32 24 11 0 5 7 19 38 17 8 0 11 0 0 0 31 5 7 0 27 0 9 0 7 0 0 
17 7 33 0 16 0 0 33 0 63 0 0 24 4 36 2 7 2 7 19 18 0 0 35 0 0 14 0 11 0 21 0 12 13 19 29 14 0 0 41 69 0 12 0 35 0 0 0 0 0 11 5 39 
50 1 26 0 24 1 16 0 56 51 1 37 21 5 26 0 0 19 18 0 0 28 2 24 0 0 15 21 22 2 0 9 20 21 0 7 18 28 0 0 26 17 8 23 0 23 5 39 41 36 3 21 0 
44 2 13 2 0 37 14 16 26 58 58 30 56 0 0 13 0 0 9 0 9 26 17 16 21 0 12 9 0 0 26 13 4 0 19 0 70 0 3 18 0 24 0 0 44 0 37 15 0 0 24 64 0 
3 15 39 0 17 1 22 28 0 16 24 12 0 14 0 3 19 15 10 0 0 37 0 15 0 20 0 23 22 17 0 14 14 0 2 47 11 0 9 1 34 27 0 0 0 20 29 4 5 0 4 22 11 
0 0 14 19 39 44 0 0 0 0 0 26 0 38 0 23 33 0 0 63 0 12 41 2 0 0 9 9 23 0 0 0 0 15 30 37 0 8 0 0 0 0 14 0 12 8 4 16 43 0 4 0 5 
6 0 17 0 3 40 0 3 0 43 0 6 10 6 45 4 0 0 2 7 1 5 34 9 20 4 0 0 0 7 5 6 9 0 1 0 9 8 0 0 0 39 0 0 0 80 0 0 3 42 0 5 61 
9 0 0 41 46 17 41 1 0 40 2 0 2 3 0 33 9 0 3 21 0 0 56 8 0 0 64 0 0 4 14 0 6 1 8 0 21 7 38 0 10 0 0 34 0 0 37 0 2 0 109 0 0 
0 20 16 16 11 19 58 30 0 34 0 0 0 0 0 0 19 0 1 29 0 0 11 0 23 0 23 0 0 0 0 6 0 4 16 0 28 15 20 0 14 0 26 25 25 0 0 2 0 0 102 47 11 
19 22 32 0 0 0 1 14 57 6 0 0 16 18 5 22 21 0 16 0 21 0 2 7 22 0 0 38 0 9 12 1 9 0 19 8 0 2 0 0 9 14 0 8 0 0 46 0 17 9 56 41 25 
7 0 2 0 0 0 0 20 18 14 0 7 14 0 0 29 0 3 10 0 9 7 0 4 17 8 4 20 0 8 4 0 0 16 28 35 6 11 0 0 0 42 46 1 29 0 31 12 0 5 41 0 3 
9 6 24 6 12 5 13 6 4 11 0 0 0 0 0 26 4 4 55 3 0 4 27 0 0 0 0 1 0 26 0 14 0 10 5 0 0 0 30 0 0 6 57 3 0 14 2 7 0 58 4 0 53 
11 0 2 12 0 27 4 0 0 93 19 0 0 0 0 4 3 0 20 12 0 0 0 0 5 0 0 32 19 19 0 0 27 0 12 13 8 13 0 0 0 0 0 13 26 36 2 38 13 0 0 0 2 
52 0 3 49 9 3 22 0 0 0 33 0 0 21 0 0 0 24 0 14 0 0 27 0 0 0 20 22 0 0 15 0 11 0 0 13 0 0 0 13 0 0 0 31 13 0 0 0 42 0 23 47 114 
0 0 73 0 9 0 0 0 13 37 0 0 15 0 5 0 10 11 2 8 9 13 5 6 0 24 23 16 14 9 0 0 0 13 29 0 0 4 14 6 0 0 0 0 7 4 37 0 0 39 0 49 0 
0 0 0 53 1 0 0 13 0 33 0 0 0 0 0 0 9 0 0 29 18 18 0 9 0 1 2 24 3 9 7 5 9 30 0 16 12 0 0 29 0 0 62 7 18 0 2 0 29 5 0 15 23 
0 15 16 6 0 22 43 13 0 37 11 86 1 0 4 0 0 17 22 0 28 10 5 19 5 0 10 0 10 14 10 3 23 24 31 7 9 31 4 1 0 3 15 14 1 11 7 0 0 38 0 42 0 
0 0 0 6 45 16 29 0 25 22 14 18 0 0 0 0 0 11 0 5 1 33 0 4 12 0 19 8 0 4 0 22 0 26 9 21 1 0 0 0 0 17 15 0 0 0 2 0 0 0 46 8 0 
49 0 40 0 36 22 0 31 18 6 0 9 0 11 0 0 27 17 0 37 0 0 0 0 0 9 13 7 0 29 0 26 13 0 1 0 5 4 0 27 0 0 5 60 37 4 27 2 14 0 12 1 21 
0 0 0 18 35 48 6 25 0 0 4 0 7 0 21 0 28 35 0 0 7 0 19 9 9 40 12 0 0 0 0 0 0 0 5 0 0 0 2 13 20 38 61 0 35 0 41 22 0 0 8 0 33 
0 0 0 0 0 0 0 0 0 0 0 0 0 7 14 0 5 0 0 5 0 0 19 0 5 0 0 0 0 0 0 25 8 0 2 0 0 0 0 6 0 0 0 0 0 2 0 0 26 0 19 29 0 
3 31 7 77 17 12 0 18 20 0 4 37 0 12 8 15 0 40 0 0 0 0 0 22 3 38 13 17 0 4 3 0 0 0 0 56 7 29 0 18 0 0 0 3 10 6 0 0 82 0 0 0 17 
0 22 48 42 35 0 0 0 40 0 0 5 30 0 1 0 28 0 0 0 13 0 1 0 0 14 0 25 0 23 38 0 0 0 0 5 4 8 0 9 14 5 30 7 17 18 14 10 40 3 95 0 25 
40 0 0 21 0 12 0 0 38 0 0 39 7 0 0 0 0 4 0 7 0 0 5 14 0 17 23 0 0 13 4 0 0 5 0 5 19 14 0 0 68 0 17 0 0 5 54 18 0 0 39 36 0 
0 17 47 1 48 0 37 6 12 27 0 10 14 9 8 0 13 0 0 18 0 0 3 15 39 0 10 34 0 1 1 23 14 0 5 0 12 33 0 32 20 29 8 42 0 9 19 14 7 0 15 9 0 
19 0 0 0 0 0 48 11 0 3 40 8 22 3 9 0 3 0 0 1 14 0 15 0 0 21 10 0 0 0 0 52 0 10 3 0 18 31 0 0 0 0 5 23 0 0 0 0 0 0 90 0 0 
0 31 0 49 0 0 0 46 3 8 7 5 23 37 0 11 15 32 0 0 23 0 6 0 26 0 11 0 0 15 7 6 55 0 26 0 11 0 0 0 23 32 25 2 18 0 33 0 41 0 17 9 49 
0 0 24 36 27 2 0 0 0 1 24 16 9 25 34 0 0 3 0 18 0 0 12 0 17 0 9 1 0 16 20 34 0 0 15 10 0 0 7 26 0 41 0 0 42 6 44 0 0 0 0 0 0 
100 0 4 35 0 0 0 39 0 8 63 2 4 15 0 23 0 1 9 19 0 6 22 13 9 0 30 4 37 0 19 0 8 5 0 13 31 11 87 0 0 0 0 43 29 23 2 0 95 0 37 25 27 
