53 30
5 0 0 0 0 4 101 0 0 2 0 5 0 0 0 1 30 0 0 0 30 2 0 25 0 3 19 11 0 0 3 15 27 0 0 15 30 22 29 0 0 6 12 37 0 1 8 1 0 0 0 0 0 
0 0 0 0 34 0 0 0 0 25 6 0 0 49 11 0 22 0 4 0 26 15 26 0 4 28 26 0 4 0 0 9 28 0 0 47 0 0 26 0 8 35 17 28 30 1 0 0 26 0 0 10 26 
0 0 8 56 28 9 18 39 24 6 9 24 21 3 0 0 1 0 3 7 13 23 1 6 0 23 22 0 0 4 0 0 40 0 12 13 1 1 13 0 3 34 0 0 41 14 0 0 16 0 3 0 98 
22 69 28 1 25 0 11 0 41 0 0 0 31 0 0 6 1 37 17 15 2 0 0 5 37 3 0 1 0 27 27 0 0 0 34 1 15 25 0 3 17 0 12 7 0 0 0 25 18 89 59 13 1 
33 34 47 20 3 0 12 9 0 15 0 32 0 13 15 4 0 0 11 0 0 0 5 1 13 48 42 17 8 0 0 30 6 16 0 18 8 15 14 4 24 14 33 0 0 19 21 0 0 70 0 16 0 
0 0 40 0 0 0 0 0 28 0 10 0 65 18 2 0 2 14 45 0 8 0 0 0 0 0 0 31 0 20 22 4 0 16 0 23 44 7 18 11 3 12 40 0 0 0 0 12 0 20 11 0 14 
24 0 22 0 0 0 0 7 0 0 0 7 18 0 0 0 0 5 17 0 0 0 2 1 0 0 0 0 0 0 20 0 17 21 0 9 0 1 5 0 0 0 35 0 0 0 12 18 17 49 19 0 0 
57 15 0 0 13 0 21 0 0 25 6 0 30 0 0 0 22 13 0 0 7 0 17 0 9 0 0 27 12 0 38 0 11 0 25 0 6 1 0 6 10 22 10 13 0 0 16 15 0 0 0 0 0 
9 0 47 6 0 36 10 7 2 17 3 0 10 9 22 27 14 16 24 0 0 0 11 0 12 5 22 13 1 19 9 14 9 0 0 26 14 0 0 4 9 83 15 0 0 4 0 0 37 2 6 0 3 
0 1 1 0 0 0 0 0 0 0 0 0 22 3 20 4 0 0 0 9 2 0 0 0 11 2 0 16 0 14 0 0 0 0 28 13 4 0 0 0 4 0 0 0 0 31 0 13 12 0 11 0 7 
49 14 41 0 0 0 19 0 0 8 25 0 15 28 2 0 0 37 12 4 19 0 0 0 22 0 0 38 8 14 18 9 22 0 22 55 4 9 10 2 1 3 15 26 5 5 19 20 32 70 0 49 16 
57 19 0 0 3 14 0 4 0 9 0 2 2 10 0 27 0 8 9 4 69 0 17 24 0 6 6 6 28 9 3 43 0 17 4 0 0 6 3 0 36 37 10 0 0 0 0 0 4 34 35 0 6 
6 19 0 0 4 0 40 63 5 34 15 2 0 14 0 0 0 0 0 0 19 0 0 0 0 36 0 0 0 16 0 0 5 6 8 9 4 7 8 19 34 0 52 0 0 36 0 41 0 6 0 14 13 
0 61 4 0 10 19 22 19 0 0 1 17 18 29 7 13 4 0 8 0 0 7 2 0 37 0 19 16 21 0 0 0 0 12 0 0 24 9 0 0 1 25 29 0 0 12 9 4 3 0 2 50 0 
22 11 0 20 4 0 0 0 0 12 0 41 15 0 0 0 0 0 10 32 14 9 37 18 19 19 0 0 0 0 0 0 0 0 11 24 18 0 2 13 0 18 1 14 3 12 0 28 26 38 0 0 16 
0 0 32 27 49 17 0 0 29 34 0 20 9 0 18 6 29 21 1 7 14 16 5 0 37 0 0 4 0 0 14 4 18 3 1 12 12 39 0 25 0 4 31 25 6 36 13 15 5 1 22 0 5 
24 61 0 21 1 0 0 0 0 0 0 0 0 34 0 0 0 0 6 0 26 2 0 0 3 0 0 16 0 0 0 18 14 0 14 8 35 0 3 0 0 9 0 17 43 14 0 40 0 0 19 0 1 
0 0 0 15 0 36 20 0 8 16 12 27 0 37 0 0 0 0 14 34 10 0 18 10 14 13 20 12 0 10 22 10 0 0 6 0 0 0 3 0 1 24 7 0 27 0 6 5 35 1 2 0 16 
40 0 13 0 39 31 39 10 0 0 4 0 15 0 0 30 0 0 0 40 0 0 0 0 0 25 0 15 0 1 0 12 0 14 7 30 0 0 23 0 4 7 1 0 0 6 12 1 5 0 0 0 0 
0 0 47 0 23 31 57 0 4 37 2 0 25 0 28 10 13 22 0 0 9 0 3 0 0 6 22 9 0 27 0 0 30 0 0 0 38 2 0 38 11 4 1 0 0 40 40 6 0 0 3 42 13 
6 0 0 20 0 0 6 44 0 0 44 41 4 47 0 0 5 0 6 4 3 0 0 18 21 7 0 0 4 8 27 20 4 6 0 2 0 0 8 50 0 0 0 32 0 6 0 2 24 0 11 64 2 
1 1 0 24 45 3 33 2 1 0 0 24 15 0 0 15 29 39 35 1 15 20 26 0 0 16 14 2 8 5 0 0 29 0 0 15 22 0 21 34 6 14 0 4 23 39 6 3 70 44 10 5 0 
42 16 22 8 53 24 22 0 17 0 12 0 0 21 0 0 0 24 12 4 0 0 0 27 11 21 0 25 18 24 26 34 0 27 0 15 0 11 11 0 30 14 60 0 0 0 0 62 34 32 15 0 0 
0 12 5 19 34 0 37 40 2 0 0 23 9 34 6 0 0 0 29 0 6 32 30 0 46 0 30 0 0 17 8 0 7 0 12 0 2 0 0 0 19 0 20 38 0 0 18 52 7 42 46 20 0 
0 24 0 22 21 0 0 0 0 0 0 0 10 0 0 0 9 1 25 0 0 7 0 2 0 12 0 0 20 19 3 14 15 11 0 0 3 8 4 0 0 0 0 28 30 4 0 42 0 13 0 0 0 
72 0 40 0 0 8 0 0 0 0 0 0 22 29 0 2 8 0 0 3 25 3 7 11 21 13 2 2 23 3 0 0 0 29 0 22 33 0 14 27 13 0 40 4 0 0 0 30 0 0 11 69 0 
1 9 0 0 30 0 25 1 23 0 3 24 29 12 0 13 3 0 18 0 0 0 0 0 0 1 0 0 0 5 0 25 1 0 30 25 0 8 0 1 1 34 0 0 0 10 0 0 0 5 11 9 0 
0 0 19 14 93 0 12 0 0 11 14 0 3 26 0 0 21 27 45 12 40 42 1 0 79 9 0 21 0 21 16 0 0 0 0 0 0 0 18 17 0 5 15 7 30 0 0 0 21 0 48 47 34 
0 0 22 23 86 28 11 0 0 0 10 0 26 0 1 0 28 33 21 0 7 0 0 15 24 0 37 23 0 41 13 0 0 0 7 18 32 0 25 0 28 0 0 27 0 0 0 25 37 0 69 22 0 
0 0 0 0 42 15 37 0 0 39 9 25 51 8 21 8 3 3 0 0 11 8 0 15 7 1 2 0 2 21 6 0 0 0 25 0 4 0 1 1 0 0 0 6 21 0 76 41 0 0 0 0 27 
