53 30
4 0 147 33 26 3 9 14 0 35 0 8 16 100 0 3 19 38 0 0 0 10 4 24 6 0 0 17 48 2 20 4 11 0 1 11 55 16 36 22 24 5 0 0 19 120 22 45 7 46 2 38 28 
46 0 0 42 26 19 45 0 57 8 0 0 23 0 59 10 0 8 18 0 14 22 26 0 47 0 0 0 20 0 26 0 37 9 10 34 0 0 0 7 0 8 30 47 0 27 8 0 0 0 8 45 0 
5 0 29 0 25 44 0 0 2 0 14 0 0 0 0 0 25 2 4 2 38 31 16 5 0 0 0 3 0 20 0 0 11 42 0 8 0 32 0 11 0 2 35 23 0 0 5 0 0 0 28 6 0 
0 20 0 0 35 0 0 6 35 27 9 0 17 0 0 22 18 0 0 1 20 0 0 0 0 0 0 10 21 0 0 0 0 0 0 3 0 0 7 35 0 0 0 35 0 0 0 42 11 23 7 1 14 
36 0 2 0 0 25 9 2 42 39 0 21 0 35 0 40 0 4 20 0 0 29 27 42 0 0 9 0 0 0 35 0 32 0 33 0 0 9 27 0 0 26 29 0 0 15 25 0 0 15 41 0 40 
14 0 8 0 3 22 0 2 0 2 3 11 32 38 21 0 17 34 0 8 29 0 11 0 8 9 10 16 0 0 0 0 0 0 0 5 10 0 0 11 0 0 0 16 32 4 0 0 22 14 0 7 0 
4 0 24 18 42 0 8 0 0 1 1 0 0 0 0 7 12 24 0 0 0 5 0 13 0 13 24 6 0 0 0 8 17 18 10 10 0 0 0 0 0 24 32 0 0 7 8 0 1 0 0 9 7 
3 0 0 0 21 0 16 0 10 0 41 9 0 34 1 0 17 0 16 0 5 10 0 13 0 11 0 0 0 0 21 10 0 7 16 0 0 0 0 0 0 25 0 20 0 19 42 0 45 0 2 46 6 
0 0 0 0 3 12 0 0 0 6 16 0 22 0 0 30 35 1 15 37 9 0 0 24 0 0 13 23 5 2 0 7 2 0 16 11 4 0 33 7 0 18 7 24 0 7 16 0 0 34 0 38 33 
2 33 0 0 0 0 11 42 18 1 16 0 21 35 0 9 8 37 0 0 0 0 0 10 1 12 0 0 20 0 2 0 15 21 5 7 8 0 0 0 9 0 0 0 0 0 13 0 35 42 8 34 13 
2 0 47 23 11 0 3 0 0 24 0 34 0 6 21 10 29 0 11 0 16 3 0 0 0 22 44 6 0 4 0 15 4 2 18 8 22 0 7 0 6 0 0 32 6 74 2 0 0 0 7 11 17 
0 46 0 0 0 6 1 0 0 2 0 23 0 0 0 0 0 3 0 44 0 0 0 65 8 2 0 14 0 9 1 1 4 0 16 7 17 0 7 0 0 16 3 0 43 1 0 21 18 23 37 32 0 
109 2 7 79 42 24 9 10 6 23 22 0 4 12 13 7 15 19 0 0 20 2 7 12 12 6 17 15 23 0 30 40 8 20 10 3 35 5 14 0 17 71 52 0 0 42 68 17 0 30 0 10 2 
0 4 0 0 0 56 13 15 0 22 4 3 5 8 19 0 0 0 0 9 1 3 0 14 27 9 10 10 16 0 14 0 0 11 0 0 16 3 14 0 0 2 28 29 36 6 5 0 43 12 0 9 13 
0 14 21 0 17 0 0 0 42 16 10 0 0 0 0 0 15 23 21 0 10 5 0 54 0 3 4 0 0 0 40 13 13 12 13 0 12 0 0 29 0 0 0 20 0 0 14 5 36 0 42 34 43 
48 0 6 0 4 59 30 32 4 0 0 0 0 34 0 0 2 9 17 0 24 0 0 3 0 0 11 0 2 15 0 0 0 0 0 0 40 12 0 31 9 7 0 0 107 19 5 34 8 0 10 22 0 
0 0 0 33 0 0 3 0 0 0 98 0 0 0 0 0 0 0 0 0 11 9 0 0 4 18 0 3 0 0 8 11 0 0 10 10 33 0 4 20 1 14 0 15 16 0 16 0 0 39 2 0 0 
37 0 0 0 0 0 24 34 15 15 5 16 0 14 14 0 0 0 0 5 0 3 6 0 4 10 5 2 1 21 0 0 26 0 15 0 26 6 0 0 0 30 15 0 44 4 8 0 0 15 0 6 14 
20 0 1 45 0 34 0 31 34 4 0 0 0 13 22 15 8 28 0 10 16 31 19 26 5 0 18 20 3 1 7 20 7 0 2 16 3 18 19 26 24 14 0 9 15 28 7 29 0 34 50 5 14 
65 0 45 0 24 17 0 0 0 31 34 0 3 20 20 38 28 0 0 0 6 0 26 2 1 0 23 0 11 0 2 6 17 42 20 0 9 0 0 0 7 0 0 0 15 7 0 45 26 11 19 51 4 
0 21 25 0 41 28 0 4 0 17 18 4 17 15 30 0 2 23 0 0 18 20 0 46 5 0 0 11 10 9 18 5 2 5 0 0 5 1 14 0 50 29 0 0 30 31 10 17 25 35 0 0 0 
12 0 6 19 77 16 0 17 0 0 24 11 49 0 41 17 18 32 6 22 2 0 19 10 26 24 0 3 37 0 7 1 12 1 25 0 19 0 19 13 8 0 0 15 30 41 0 2 0 6 0 40 13 
0 0 0 0 26 0 10 0 0 0 0 0 0 0 26 0 10 0 0 0 19 28 7 0 6 0 0 20 0 10 24 0 0 0 10 0 0 0 10 0 14 22 9 0 0 0 9 0 0 29 22 0 4 
12 0 15 4 43 0 19 0 28 36 0 0 43 34 0 0 0 0 0 56 0 0 0 0 17 31 5 0 3 26 0 7 0 0 0 10 45 6 2 0 38 0 6 49 9 13 11 77 29 0 0 11 0 
0 38 0 18 1 30 0 21 0 34 0 0 0 0 0 0 26 0 0 0 17 0 0 20 0 4 0 0 15 4 4 0 0 0 0 32 0 15 0 38 10 0 0 48 0 0 0 0 0 9 0 0 0 
54 0 0 0 1 17 22 0 10 0 16 21 0 0 19 22 0 0 0 23 14 0 17 24 4 0 0 0 0 0 0 6 0 0 0 0 0 0 19 9 14 0 0 0 7 2 47 24 0 0 10 0 0 
0 0 16 47 26 26 29 0 0 7 0 9 0 0 0 0 31 8 15 3 7 0 16 0 0 0 17 0 8 3 24 26 14 10 0 0 1 9 1 0 0 14 25 42 0 0 0 9 0 15 39 4 0 
4 60 6 0 2 7 42 28 0 2 0 26 7 0 0 14 25 0 0 1 20 0 23 19 0 0 4 18 0 0 4 8 0 0 8 33 7 16 0 47 2 15 29 2 37 9 30 9 42 18 0 15 19 
31 1 11 2 0 16 0 11 41 25 0 0 0 0 16 11 0 0 19 0 20 7 0 0 0 18 28 0 0 0 17 31 0 0 25 9 9 23 36 13 0 4 0 0 1 0 0 0 0 69 17 0 0 
11 61 1 13 0 0 45 0 5 0 4 0 27 17 33 0 5 11 30 12 28 28 16 0 11 22 19 32 28 0 0 0 16 18 0 11 19 2 0 39 42 12 0 6 1 6 51 83 12 0 0 82 0 
