53 30
0 91 49 8 0 46 0 30 0 3 8 19 1 0 20 27 0 0 31 12 21 0 0 0 23 10 0 13 0 27 0 11 0 38 16 10 8 35 5 0 0 0 0 25 15 0 44 23 0 13 0 0 0 
18 14 3 21 0 15 0 0 0 0 8 0 14 0 0 0 0 0 0 16 26 0 0 0 0 0 21 0 31 27 0 0 0 0 0 16 0 11 18 29 0 2 0 0 0 0 0 0 3 29 0 17 1 
32 0 0 0 0 0 0 39 28 16 0 0 0 0 0 7 20 18 9 12 16 22 0 23 0 0 0 6 0 20 31 0 45 23 3 18 20 3 0 2 0 0 0 16 24 12 73 0 18 0 0 4 0 
24 0 1 49 0 2 31 9 0 3 25 12 28 33 27 5 0 15 21 0 3 0 0 33 0 16 0 15 0 23 1 16 27 2 14 0 5 25 0 22 28 1 1 32 0 1 33 11 0 22 47 0 42 
0 0 2 0 45 11 40 49 22 0 36 0 22 0 0 11 0 0 0 11 7 14 17 7 0 18 19 2 24 31 28 1 0 4 28 0 0 0 0 16 0 0 35 1 1 0 33 0 0 10 0 0 0 
33 36 0 17 12 30 0 0 23 0 7 0 0 0 16 17 0 26 3 3 12 0 0 23 0 15 18 24 0 0 8 24 0 56 12 18 22 36 38 3 0 16 2 29 2 9 23 0 0 5 33 9 0 
0 0 1 26 23 0 33 15 0 0 22 0 2 6 17 2 0 0 0 5 28 2 0 2 7 0 0 9 0 26 0 5 22 0 0 12 12 20 8 51 0 0 11 4 48 0 8 0 28 0 6 0 0 
9 0 12 9 38 20 0 0 0 20 24 4 25 1 3 11 0 17 18 0 0 0 0 0 0 0 0 2 21 25 6 17 6 0 0 0 0 14 0 1 29 0 33 0 36 5 0 11 0 21 0 5 0 
8 0 74 0 21 6 2 0 26 0 0 0 23 5 0 8 24 12 15 0 24 5 13 16 0 35 25 6 12 48 4 0 24 13 6 25 0 11 1 15 21 35 39 10 28 3 13 2 12 47 0 0 0 
0 0 4 2 0 10 1 37 30 10 13 0 3 0 0 15 0 16 0 23 27 0 22 29 14 19 0 21 29 0 10 3 11 22 19 0 0 0 44 0 10 1 0 8 39 0 0 18 14 29 0 0 29 
0 0 0 6 38 0 0 0 16 9 0 20 0 0 0 0 0 0 12 0 11 0 0 4 0 5 5 15 0 6 22 43 0 3 29 5 33 0 0 0 5 12 40 0 2 11 4 15 0 0 0 0 0 
0 0 12 0 0 0 43 23 3 9 43 4 23 0 32 0 28 7 18 1 16 0 0 7 0 24 32 18 10 0 23 34 0 18 1 41 47 27 0 6 0 4 10 0 5 24 22 0 0 30 0 4 0 
0 24 6 0 41 0 4 28 0 0 0 0 14 37 8 14 23 2 0 12 0 0 0 0 3 0 17 2 1 0 21 0 12 0 0 0 0 1 7 23 0 0 5 3 39 39 0 0 0 0 37 21 0 
61 13 25 0 8 14 2 0 0 10 20 11 2 0 0 2 25 16 0 2 32 0 11 23 0 0 16 3 24 4 13 18 0 12 0 4 0 6 27 7 51 34 0 39 6 44 11 16 0 31 0 4 79 
27 0 0 29 11 4 32 37 19 9 0 15 21 0 14 11 6 0 0 12 0 0 0 12 0 22 1 5 20 0 16 0 2 0 0 21 15 8 32 8 37 11 0 0 0 0 12 17 0 0 19 9 0 
42 33 12 0 0 3 0 0 12 0 0 0 0 0 0 34 0 23 0 67 19 31 24 31 57 28 19 28 0 6 0 16 12 9 0 0 4 21 6 15 16 28 42 24 13 26 24 0 3 0 0 0 58 
7 0 3 22 27 10 32 0 0 3 13 6 0 0 0 39 11 4 0 0 0 0 0 2 10 8 0 0 25 2 0 34 5 0 16 12 1 1 29 0 25 36 0 0 0 0 0 0 0 11 18 5 37 
59 3 0 0 51 9 55 0 23 13 0 0 0 21 14 0 0 6 5 25 27 0 13 69 5 0 0 0 1 0 0 36 0 2 50 22 0 0 0 0 0 45 49 19 27 80 0 2 0 6 30 5 46 
13 0 9 0 9 2 34 48 1 0 0 32 15 21 0 4 0 0 0 1 0 37 0 0 0 0 0 24 1 9 17 2 10 0 23 0 15 0 13 0 34 7 0 17 23 5 0 11 0 8 0 64 5 
18 0 0 0 0 42 18 0 0 78 16 0 28 0 0 11 0 0 22 5 8 0 0 1 28 0 19 5 5 0 2 0 0 12 40 7 19 0 35 1 3 28 16 0 7 6 37 59 0 19 40 0 43 
2 6 42 92 37 36 0 5 10 0 62 0 24 1 13 9 11 9 0 7 5 0 8 4 7 0 2 0 4 14 65 0 20 23 15 6 0 0 0 25 5 75 0 23 42 42 0 0 0 0 14 19 0 
0 30 0 4 4 53 0 4 0 0 0 0 0 0 0 8 0 15 11 10 8 20 8 34 0 0 0 0 0 2 0 41 15 9 16 5 0 0 13 16 10 20 2 13 0 0 0 0 0 0 16 0 0 
49 48 23 19 30 22 1 3 28 15 19 0 0 27 10 21 26 0 0 0 0 36 21 52 5 32 43 25 23 26 0 32 38 0 10 0 2 8 91 12 22 10 12 9 21 59 20 24 20 0 46 7 0 
25 0 22 40 35 32 1 0 21 0 0 65 2 22 0 3 4 0 38 2 0 6 0 0 0 34 1 2 0 0 1 0 0 15 1 37 0 15 9 15 0 0 0 64 3 13 0 12 1 0 39 0 0 
0 0 0 4 0 24 0 23 34 0 11 0 0 0 0 0 0 0 0 1 0 20 19 0 0 8 10 15 0 19 65 0 0 18 26 0 23 0 0 0 0 19 0 0 2 0 0 0 17 0 0 18 0 
0 0 0 8 21 35 31 0 15 0 0 3 0 25 0 0 0 0 4 6 5 0 11 28 17 6 0 7 0 0 0 7 0 23 10 12 0 31 14 0 41 12 5 25 0 0 0 27 0 43 0 1 0 
18 0 0 67 0 0 0 0 0 20 33 0 7 30 0 7 0 11 23 13 0 0 0 8 1 0 0 0 30 20 15 0 28 0 0 0 27 5 0 4 13 31 0 34 0 15 0 19 7 0 0 8 0 
11 38 79 0 0 33 0 21 0 8 0 30 28 0 58 40 0 1 24 8 15 0 0 0 0 0 5 26 15 0 25 4 0 0 0 0 23 0 0 63 9 0 0 14 0 0 0 75 0 14 39 42 50 
49 15 0 0 0 33 26 0 0 12 21 0 15 0 0 0 40 0 3 0 0 9 0 0 8 19 0 4 0 0 0 0 26 1 0 0 0 11 33 0 0 25 0 0 0 0 0 0 11 49 0 0 0 
37 49 49 0 24 5 0 0 42 4 13 6 16 0 22 0 0 16 8 7 15 6 8 0 14 0 0 0 28 4 0 38 9 34 19 0 4 0 24 0 17 23 0 26 10 14 0 16 0 31 28 2 0 
