53 30
0 0 0 0 82 0 22 0 77 24 40 0 12 0 0 0 29 2 18 0 21 0 0 0 55 0 0 29 0 0 0 22 24 0 0 0 0 23 0 0 30 7 13 0 20 29 42 23 33 0 0 0 0 
36 0 11 16 2 0 0 4 0 15 0 48 0 0 0 13 12 17 23 17 11 0 3 12 0 10 0 0 0 7 0 22 0 0 0 3 10 33 3 24 7 41 22 0 0 0 1 0 0 0 0 0 0 
8 9 26 11 7 0 24 55 74 0 23 13 6 21 24 49 0 22 3 0 5 0 23 0 5 0 0 22 16 0 0 0 0 21 67 33 1 36 26 31 23 16 0 0 2 23 56 19 7 0 0 43 0 
11 0 0 0 30 38 0 5 71 0 46 25 0 0 0 39 42 10 0 19 0 0 32 40 17 0 21 12 6 0 0 21 0 0 24 28 16 32 0 22 0 0 13 59 0 0 30 0 0 46 33 1 11 
0 0 0 0 0 0 0 23 0 0 19 0 12 33 0 0 56 12 7 0 0 0 20 0 0 0 55 20 41 19 18 9 0 5 11 20 13 4 4 0 19 0 4 14 0 11 3 20 20 21 0 35 0 
0 0 12 0 24 15 0 5 0 16 0 0 22 0 12 0 0 23 0 12 26 0 0 0 24 40 2 0 21 0 11 10 0 14 11 18 0 0 11 20 7 14 0 0 0 6 0 17 0 39 0 0 0 
7 0 0 0 8 15 0 0 0 0 0 3 20 0 4 1 16 7 16 9 0 20 0 0 3 8 2 0 9 5 14 0 0 0 0 0 8 0 0 0 0 20 18 0 20 0 3 0 0 0 0 7 21 
57 2 0 19 10 0 21 1 4 18 2 22 24 35 19 1 0 15 3 0 0 19 19 0 18 22 0 21 0 0 20 25 0 38 0 0 0 0 6 22 18 27 9 22 65 37 17 47 0 41 58 45 31 
29 32 0 20 27 1 21 0 20 0 13 0 0 12 15 0 0 24 0 0 0 5 1 9 47 0 8 2 2 12 1 39 0 0 0 0 5 18 6 5 1 0 0 0 6 0 39 37 4 0 3 38 4 
0 38 0 0 7 5 0 10 13 0 5 25 21 8 33 43 6 37 0 39 7 8 3 0 28 0 20 0 4 12 2 1 0 4 0 0 0 20 0 66 25 28 0 0 0 0 23 49 0 0 52 32 0 
29 0 0 0 0 0 0 30 38 0 13 14 0 0 0 13 1 1 0 0 21 0 11 1 0 14 0 14 0 0 0 1 0 6 6 0 13 53 0 0 0 29 0 3 0 1 9 0 40 8 0 7 0 
4 14 12 0 31 0 41 0 30 0 3 0 0 0 0 36 31 7 28 0 0 15 0 0 26 0 11 23 0 0 4 0 26 0 0 0 0 22 30 0 0 12 0 19 5 0 37 31 5 0 8 0 0 
0 0 13 0 47 4 0 0 11 21 12 0 12 8 3 34 0 12 0 0 13 0 22 24 0 7 17 2 7 14 0 0 7 8 0 8 8 13 0 0 23 0 0 3 12 0 0 26 0 0 7 36 12 
37 22 0 11 0 2 14 2 31 0 0 0 11 28 0 9 12 2 0 61 14 0 9 1 19 0 0 6 13 0 11 12 0 16 0 0 11 47 1 46 21 5 12 0 14 6 0 0 0 25 0 0 19 
70 5 0 0 8 11 0 41 20 11 0 31 11 16 10 23 5 0 0 0 18 0 0 0 20 13 12 0 26 0 16 0 0 7 0 24 10 7 0 4 40 0 31 14 32 0 0 14 0 34 50 0 0 
33 0 0 0 36 5 50 30 45 0 0 0 16 0 0 0 11 0 0 14 0 0 0 23 0 0 0 26 13 46 0 16 0 27 0 13 12 0 0 0 23 0 0 0 0 0 0 39 0 12 21 0 0 
0 9 0 18 28 0 0 0 13 6 1 1 8 0 15 18 15 28 0 0 1 6 7 6 0 5 0 23 0 0 0 17 0 13 19 0 6 0 0 0 0 0 13 0 0 4 13 0 5 4 0 0 9 
9 0 21 0 0 2 0 32 0 37 0 0 0 0 0 0 0 0 0 0 0 47 21 24 18 0 3 0 0 22 9 0 10 3 15 0 13 0 0 28 33 0 18 21 12 0 37 0 0 41 45 51 0 
0 0 0 0 0 0 1 12 0 28 15 0 10 10 26 0 0 0 13 3 13 3 21 10 5 11 12 15 3 0 0 0 0 24 0 0 0 33 0 0 0 16 43 15 10 0 0 14 0 0 0 26 0 
32 30 0 0 3 0 0 0 0 18 5 0 6 0 0 0 5 20 10 13 55 0 4 19 45 0 3 6 21 0 0 9 13 12 0 0 13 1 5 27 0 0 0 0 25 28 0 25 0 48 23 31 0 
0 118 0 0 3 0 30 0 24 1 0 5 0 56 1 9 0 31 16 15 6 0 3 15 45 21 14 5 0 16 22 14 0 0 5 22 0 0 8 0 0 35 0 38 20 0 22 1 47 15 7 50 39 
0 45 13 10 17 15 6 82 0 0 0 0 26 27 2 13 25 0 0 25 21 0 8 23 0 3 0 27 0 47 0 0 16 0 0 22 8 5 0 0 33 0 9 9 18 0 22 9 10 0 43 0 25 
0 6 18 0 3 26 22 37 0 0 40 3 38 13 0 0 4 36 0 18 0 29 20 6 17 0 11 7 23 0 11 5 16 0 0 0 3 15 0 5 16 8 20 0 15 4 0 20 18 4 41 0 0 
42 0 13 4 1 0 29 7 53 3 4 17 11 31 17 5 13 22 1 0 47 0 0 19 13 16 0 2 10 6 0 1 0 0 5 2 31 19 0 41 53 10 43 0 10 33 9 3 0 26 6 0 0 
0 4 50 17 0 18 0 15 52 33 0 4 19 20 0 34 36 0 0 0 11 0 21 0 17 0 0 43 0 3 0 14 0 17 0 0 21 0 33 0 0 18 3 0 0 0 30 39 64 34 4 0 86 
28 19 11 48 9 16 0 0 78 7 21 5 7 37 7 4 9 44 7 28 13 0 45 0 6 1 0 11 50 0 0 4 25 16 11 1 21 14 22 24 0 0 0 0 37 1 38 25 15 104 0 3 0 
0 0 2 0 0 25 0 0 40 0 0 0 28 5 0 0 0 0 11 0 0 42 24 24 24 26 0 20 13 20 29 11 0 10 13 0 0 23 0 0 11 0 0 10 0 0 4 24 66 0 52 0 0 
0 30 21 3 2 19 3 0 0 0 37 0 28 10 0 0 35 35 29 14 3 0 1 69 0 0 27 7 0 0 0 30 0 0 21 0 0 13 1 0 28 0 0 24 11 19 0 37 0 38 10 35 56 
49 0 24 29 7 0 0 0 24 0 5 28 11 0 18 5 0 15 38 1 12 0 6 11 0 23 0 3 6 0 0 2 50 0 0 0 1 0 26 0 0 10 5 2 5 14 1 14 23 44 0 45 0 
0 0 24 0 30 0 5 0 0 49 0 9 8 22 4 22 10 20 1 0 0 0 0 14 20 0 59 7 0 7 0 29 7 0 0 0 33 28 0 0 0 0 0 8 7 36 17 20 0 22 22 1 0 
