53 30
17 0 0 8 9 0 26 0 0 0 23 11 0 37 0 29 20 0 20 13 0 15 10 0 0 0 0 0 11 0 17 15 45 15 0 0 0 0 0 0 0 11 0 11 18 25 0 15 0 0 69 0 7 
0 0 61 19 46 34 0 0 0 11 13 25 0 0 36 19 0 0 48 0 27 14 0 0 0 2 4 0 16 14 11 5 0 14 17 24 10 7 8 88 7 0 0 0 0 0 20 7 30 28 82 0 0 
45 1 4 40 34 0 37 14 0 19 21 22 5 20 24 0 0 0 4 53 7 0 29 0 0 0 4 2 19 0 16 38 18 10 0 0 9 12 64 25 0 22 0 13 0 0 42 25 4 11 18 8 4 
44 0 2 16 19 0 22 1 30 0 17 4 0 0 22 0 12 5 0 3 0 4 0 0 21 45 18 0 0 13 0 0 29 0 16 8 0 3 14 0 15 4 30 48 1 21 36 0 0 28 0 0 0 
100 0 0 83 18 8 0 5 6 16 0 16 12 11 9 0 5 0 24 0 1 0 18 0 20 3 18 25 11 11 10 18 2 0 0 5 0 5 38 0 31 3 24 45 19 45 2 0 0 0 0 48 0 
42 0 8 2 40 2 5 20 0 36 24 0 9 0 0 17 0 19 0 0 5 9 0 0 0 39 8 2 0 4 39 0 7 4 19 0 2 0 0 43 33 2 0 0 40 36 22 17 0 20 17 0 0 
87 50 0 0 48 33 0 43 28 0 0 0 0 0 0 26 0 22 0 12 26 0 0 0 0 0 0 0 33 15 8 0 0 0 0 35 17 0 9 8 39 0 0 27 0 8 4 11 0 21 13 0 29 
10 14 0 0 16 6 0 38 10 0 0 3 62 5 0 7 0 0 0 0 0 37 15 0 0 12 0 22 0 0 17 0 3 0 0 5 0 13 3 27 0 1 29 0 8 38 0 0 13 0 17 22 32 
0 55 24 18 6 0 6 59 38 0 9 0 0 14 0 0 7 39 0 6 0 0 22 0 23 6 10 14 0 0 21 13 28 18 0 0 0 7 0 13 12 34 16 0 27 43 38 0 22 0 0 0 13 
0 0 0 0 13 23 0 1 4 0 0 0 2 25 17 13 2 0 21 0 0 0 2 0 0 23 6 0 0 15 0 7 0 5 0 0 8 0 25 21 0 10 16 0 0 0 0 0 20 16 0 0 0 
15 4 0 12 12 52 0 27 11 0 2 0 0 0 22 0 2 19 13 33 4 0 0 20 0 16 26 1 6 7 0 27 0 0 0 0 9 0 0 0 45 4 16 0 3 27 0 0 0 0 0 0 52 
0 0 6 58 0 2 26 0 0 0 0 24 1 5 34 0 16 20 15 17 15 12 25 0 0 0 4 11 34 17 0 0 11 27 0 25 15 28 36 6 0 11 20 11 17 0 43 1 37 0 0 41 0 
0 0 35 0 0 0 7 0 0 7 0 0 19 2 0 0 1 6 53 2 0 0 17 4 0 0 22 0 11 16 15 12 0 26 0 13 0 20 0 0 0 5 1 1 17 0 5 18 13 3 35 0 0 
0 0 1 44 0 18 0 0 16 6 0 0 0 11 27 15 35 0 0 8 0 0 0 39 30 25 4 32 5 13 19 0 0 0 4 0 0 8 0 0 14 27 0 2 0 1 0 0 0 46 26 11 1 
14 6 6 0 14 28 24 13 0 10 13 24 12 1 14 8 3 30 30 2 0 0 16 17 19 3 0 30 0 27 10 24 0 26 17 57 21 25 16 7 0 37 0 27 17 30 10 34 51 0 0 0 0 
0 0 17 0 21 49 1 0 12 0 32 10 36 0 1 1 5 0 0 10 18 9 0 0 0 44 0 21 0 12 0 35 0 0 0 6 5 0 3 0 0 0 32 0 0 0 13 0 15 44 3 11 0 
0 38 1 0 0 9 44 1 33 0 0 31 4 1 0 35 0 0 9 0 11 16 3 4 0 3 0 14 6 20 0 26 0 15 0 4 0 29 13 52 35 22 28 0 5 26 0 5 0 0 79 59 62 
7 7 40 0 0 33 0 7 12 0 7 0 5 19 4 12 14 4 0 0 6 0 8 0 0 11 1 10 35 0 8 8 0 0 29 10 0 6 35 37 2 0 14 42 0 2 0 91 0 18 0 0 0 
64 13 0 0 0 0 12 0 25 0 0 34 0 2 38 0 10 0 6 0 0 1 1 0 2 0 0 0 33 11 0 16 0 25 14 0 36 0 0 17 0 10 0 0 40 0 0 36 46 0 0 0 0 
0 29 9 0 49 32 12 4 10 6 0 23 17 11 0 0 44 0 14 0 0 0 0 0 0 0 0 0 16 17 15 0 0 0 7 8 0 32 16 23 12 26 3 0 0 3 0 0 0 7 9 0 0 
17 17 24 20 19 9 0 28 4 38 17 0 70 34 0 32 15 0 29 24 9 19 43 21 18 2 0 0 0 0 6 5 7 33 9 0 5 18 0 18 2 0 4 24 6 0 29 63 2 0 50 0 0 
0 37 16 13 27 27 0 7 0 0 0 4 35 0 0 17 0 9 12 17 18 0 46 8 2 24 9 9 0 14 12 37 0 0 12 0 26 7 15 10 1 20 0 28 5 20 0 49 0 0 25 1 123 
17 0 69 0 0 0 0 37 16 0 0 0 0 0 0 13 0 0 0 0 0 0 0 0 0 26 18 0 0 0 20 18 7 0 0 2 34 28 0 0 0 0 0 0 34 0 19 0 0 0 0 5 0 
0 0 18 33 19 13 0 24 8 0 2 21 15 38 0 0 8 4 0 21 0 3 9 0 23 22 48 13 0 12 4 0 19 14 0 6 63 0 5 35 0 18 0 2 0 8 13 1 10 2 0 36 0 
7 0 13 0 0 0 0 9 9 30 28 0 29 0 25 3 0 8 6 9 0 4 0 4 0 4 15 10 0 0 23 8 0 1 13 17 4 10 0 3 5 9 0 0 12 2 0 1 17 0 27 39 0 
26 42 26 0 0 0 39 0 0 33 9 36 11 16 0 0 14 15 16 10 3 0 0 2 0 0 0 0 8 4 0 13 6 0 19 0 9 1 6 0 0 11 8 19 39 29 0 31 0 36 48 0 16 
0 51 41 0 77 0 0 0 33 28 0 15 3 12 64 9 0 0 8 29 6 0 3 26 0 20 8 6 7 13 6 27 26 13 3 0 0 3 8 0 0 33 0 75 0 26 0 0 34 9 16 6 0 
15 0 36 0 0 4 0 2 36 0 25 3 0 5 33 6 0 38 4 0 10 24 0 0 14 0 14 23 0 0 9 0 0 13 24 0 19 18 48 18 13 15 0 6 36 25 16 15 0 0 7 39 6 
0 16 0 31 0 32 1 39 0 65 0 32 35 0 0 19 4 2 51 0 0 21 24 0 0 23 5 0 18 13 0 19 0 0 50 0 18 63 5 0 4 0 0 50 17 36 29 64 9 0 19 5 0 
34 3 13 0 3 98 0 6 55 17 34 0 36 26 0 69 38 12 16 0 0 27 0 2 0 3 18 0 0 23 21 0 29 0 59 0 19 0 4 26 0 6 0 36 14 4 0 0 31 28 45 13 10 
