53 30
22 0 8 29 9 0 20 0 0 0 0 0 0 12 16 0 0 3 18 0 0 0 0 0 12 2 20 24 0 11 0 17 13 0 0 32 0 0 0 0 25 0 0 1 40 0 0 0 0 9 0 0 7 
50 14 26 0 1 4 0 0 1 39 0 0 20 1 1 0 0 21 11 83 1 0 23 14 13 1 0 0 37 0 21 6 17 24 0 23 11 21 25 1 0 0 0 0 14 2 0 0 0 57 0 21 0 
60 29 22 1 0 0 0 1 0 82 29 15 28 1 0 17 0 9 39 35 27 6 22 0 12 8 6 0 0 19 47 0 47 16 0 40 19 0 8 28 0 28 23 4 34 7 0 38 0 0 6 0 20 
0 0 42 23 71 37 0 7 0 7 3 0 9 0 24 0 0 23 14 0 8 0 3 0 17 7 17 11 6 21 15 18 6 0 16 0 0 0 0 34 41 0 29 0 0 20 23 3 24 22 28 15 48 
0 0 1 38 0 18 0 11 20 0 40 0 0 8 0 32 3 2 28 3 0 18 16 4 17 13 8 9 5 0 0 15 0 0 0 13 9 23 14 2 0 15 19 0 4 0 54 3 0 0 40 0 0 
13 0 0 8 14 20 10 4 24 0 50 45 0 51 0 77 0 0 23 25 7 0 5 4 0 32 0 20 48 6 0 19 31 0 0 7 4 0 11 0 4 20 32 0 5 0 5 1 43 34 79 7 0 
34 0 4 34 2 3 3 0 1 2 0 34 9 0 0 32 0 0 3 0 13 12 26 0 0 0 0 6 3 0 7 0 0 30 15 0 0 6 0 19 0 5 13 0 0 0 30 81 40 15 0 0 37 
32 0 9 0 10 24 3 0 15 0 0 0 0 73 16 18 36 11 17 15 0 0 11 15 0 21 0 17 6 35 10 18 30 1 6 0 39 0 20 21 0 18 0 0 17 17 0 31 9 6 5 5 8 
48 0 8 0 14 0 0 0 22 0 0 1 37 0 6 20 0 0 0 20 0 21 0 0 0 0 0 0 0 0 0 0 0 0 9 7 0 0 6 25 0 1 0 7 9 0 0 0 12 0 7 16 0 
9 16 0 0 2 34 1 0 0 20 41 58 0 0 0 10 8 9 5 13 0 0 0 0 0 16 25 17 17 37 19 0 17 10 0 0 2 32 10 2 0 22 0 51 8 2 0 3 19 9 0 45 41 
0 0 48 4 0 4 0 37 0 18 0 0 5 37 0 1 18 1 24 0 0 0 0 0 0 10 2 0 2 10 3 18 9 11 0 7 0 0 3 0 0 0 0 25 56 7 5 38 0 3 64 46 0 
0 0 7 0 45 7 0 8 113 0 11 0 0 28 0 14 0 1 0 0 0 0 2 3 2 0 9 0 10 8 0 1 1 0 8 23 0 20 0 22 0 0 21 6 41 35 11 7 0 40 0 0 32 
0 17 18 0 3 0 0 29 59 19 84 0 17 0 0 27 17 39 14 3 8 6 35 0 18 13 0 4 32 20 8 19 0 10 0 67 9 5 14 9 5 0 0 43 19 0 1 10 0 32 42 0 21 
0 29 0 34 46 0 5 34 0 36 44 23 51 2 0 30 0 0 0 0 14 0 0 0 4 0 0 14 2 0 11 0 11 0 0 19 0 34 21 7 1 8 0 0 34 33 12 10 10 9 56 0 45 
24 0 18 0 7 0 27 5 0 33 12 0 0 23 0 0 19 10 14 9 22 0 0 0 13 10 10 11 8 0 0 0 0 27 17 0 0 11 16 24 0 41 0 5 35 22 0 0 2 0 9 68 7 
0 51 19 0 1 0 8 0 0 32 0 0 0 13 0 10 9 0 0 3 19 19 30 0 0 15 0 0 21 0 0 0 4 20 0 3 0 4 0 0 0 32 0 0 5 17 0 10 5 0 28 0 51 
0 51 8 0 0 0 13 10 44 0 13 0 13 12 39 6 0 0 0 16 0 0 0 10 0 12 0 0 0 0 0 0 0 10 0 0 0 0 13 2 8 0 0 0 8 7 0 7 15 0 43 0 7 
25 29 55 0 40 9 27 0 0 0 17 3 23 12 0 0 1 0 23 15 0 19 2 35 0 18 0 17 0 0 29 26 0 12 5 53 0 0 6 11 38 23 0 21 0 0 0 0 13 1 0 0 0 
29 2 37 2 0 34 85 20 2 16 51 0 5 29 0 0 10 8 30 0 29 35 15 0 0 31 0 3 1 20 0 0 19 8 0 0 0 7 0 0 0 0 0 0 87 29 45 0 12 29 5 29 0 
38 0 0 13 12 36 15 5 4 14 38 13 0 20 14 10 2 0 0 12 12 24 8 0 0 2 0 0 0 20 0 12 0 0 29 4 0 0 34 0 0 0 13 0 0 0 0 0 0 42 0 51 3 
0 10 0 0 21 0 0 0 32 0 2 18 11 1 0 0 0 18 10 19 18 0 0 17 36 2 0 3 14 27 0 0 4 13 1 28 0 35 0 0 0 0 19 0 0 0 0 0 9 41 0 23 0 
0 0 30 19 40 4 35 0 13 6 0 2 11 0 9 7 0 0 0 0 0 2 20 8 0 6 16 0 2 19 0 26 49 9 0 0 0 4 0 1 18 4 9 8 40 0 2 3 0 43 0 47 0 
0 0 43 0 34 11 0 2 15 15 0 9 0 4 9 26 0 21 27 0 0 2 15 25 20 4 0 0 13 21 0 0 3 0 3 8 1 17 18 1 0 26 0 13 0 17 4 0 0 0 0 0 0 
0 51 0 2 38 0 22 4 0 38 2 33 6 0 0 7 0 18 4 9 45 34 5 13 9 11 12 19 17 0 29 0 12 0 28 33 11 1 6 0 27 0 38 0 1 6 0 35 0 48 18 0 0 
0 0 25 0 0 0 0 0 11 9 1 0 10 0 0 13 13 1 0 35 22 0 22 0 0 0 14 0 18 23 21 1 31 0 0 0 0 10 0 0 0 0 22 24 33 29 32 3 0 0 0 16 22 
0 30 0 0 21 30 41 34 0 5 13 16 24 31 6 26 15 1 3 8 4 0 16 14 0 29 0 18 5 0 10 15 2 16 0 58 24 20 64 8 37 29 0 18 0 20 4 33 8 57 2 0 0 
0 0 0 7 13 37 0 10 0 0 64 38 8 37 0 0 11 13 0 21 11 7 0 0 0 0 0 6 0 2 0 26 0 14 0 9 24 6 0 0 12 0 0 0 0 0 36 0 1 38 21 5 7 
25 43 0 0 0 0 0 14 0 25 0 0 36 0 6 12 0 36 0 0 38 27 18 13 0 34 0 12 5 24 14 0 4 10 0 0 11 23 1 0 18 0 6 26 17 0 17 0 1 0 0 20 0 
37 0 0 46 47 0 0 43 67 39 25 15 31 0 9 11 32 54 0 0 28 0 0 0 0 26 7 0 20 13 7 0 19 0 30 32 10 30 9 8 0 0 25 31 0 20 15 0 88 41 42 5 17 
0 0 7 0 30 0 37 6 31 23 0 0 0 43 35 0 5 29 22 12 0 0 0 0 0 0 20 0 1 25 24 18 0 0 0 0 0 0 48 31 22 27 9 0 0 0 20 9 0 35 0 9 0 
