53 30
28 1 27 0 0 78 12 0 28 0 0 7 0 0 0 0 22 19 0 0 0 0 17 0 0 0 18 0 26 39 0 0 27 0 0 11 28 0 0 0 0 36 37 41 0 25 11 0 0 0 0 0 0 
0 36 0 37 12 12 59 0 65 43 45 8 38 21 0 0 12 12 26 13 28 0 0 0 0 0 27 0 5 21 20 0 9 13 0 0 35 19 0 0 10 9 19 33 0 0 0 0 28 20 18 4 236 
28 0 53 32 0 74 0 5 14 21 8 0 2 2 29 14 19 0 0 0 0 0 0 0 12 2 0 12 0 22 21 0 27 4 27 51 22 7 65 0 0 0 0 0 0 0 0 20 32 0 0 0 13 
0 0 11 2 27 77 23 20 26 36 3 1 0 13 18 1 0 64 0 0 3 0 10 0 19 51 0 0 25 12 0 27 0 0 0 0 19 13 0 0 0 27 25 36 0 36 0 0 10 0 7 0 25 
33 24 0 0 32 12 0 0 0 7 0 10 37 0 6 1 0 0 0 19 0 0 2 0 2 8 0 0 0 0 14 6 0 0 0 0 32 1 0 0 0 0 0 4 0 0 0 0 0 37 0 0 28 
0 0 0 11 16 0 0 3 0 6 10 0 21 60 0 0 17 0 0 0 0 0 10 22 9 21 20 0 23 0 7 5 15 2 0 13 0 0 0 0 1 32 0 0 20 13 8 8 0 0 37 0 20 
21 26 30 5 0 37 39 30 23 28 10 10 6 12 27 0 0 0 21 23 10 35 7 29 0 2 0 11 5 22 21 31 32 48 0 9 15 13 12 20 0 36 1 38 0 0 5 2 29 3 15 61 2 
45 0 28 3 21 6 5 21 0 0 6 0 34 0 19 26 0 42 12 0 10 19 10 0 0 8 0 0 25 0 22 0 10 15 17 0 11 0 10 0 15 9 6 28 0 45 34 28 33 32 50 17 47 
0 41 0 45 0 12 0 0 55 0 0 30 0 44 0 7 0 13 15 0 0 0 35 0 13 6 0 0 16 0 13 7 7 0 10 0 7 0 25 0 32 28 41 2 22 0 0 6 45 7 0 15 0 
31 44 21 10 26 11 0 4 0 0 0 6 0 21 0 0 5 0 3 22 0 5 0 21 0 16 0 0 0 21 26 31 0 0 0 0 9 0 0 0 0 22 0 1 6 53 0 0 0 0 18 6 4 
0 0 0 0 39 13 0 0 39 0 0 10 0 0 0 20 12 11 0 20 9 22 0 7 0 0 0 0 7 0 1 0 6 0 0 0 0 2 8 24 16 32 10 5 0 0 0 0 0 0 7 44 0 
0 4 0 8 43 75 6 13 8 17 27 8 6 5 0 10 11 26 7 0 13 23 0 5 0 0 0 32 0 11 0 10 0 18 13 0 7 19 19 0 0 5 1 26 13 0 5 0 44 14 19 5 0 
10 5 0 0 33 8 8 37 3 20 1 15 0 5 23 16 15 16 23 11 29 0 0 2 1 2 5 0 11 43 2 23 0 6 0 0 0 40 7 5 0 0 0 3 0 7 9 40 0 2 3 34 7 
0 39 0 0 8 49 34 14 36 0 9 0 0 18 26 3 15 0 11 0 6 14 28 3 17 17 3 25 0 2 0 23 1 17 0 11 12 0 17 32 62 0 88 14 0 13 8 63 23 15 17 46 41 
0 6 0 0 30 0 0 30 3 0 13 33 0 0 1 33 0 0 0 11 0 4 0 10 0 2 0 0 0 0 23 0 0 10 41 1 0 13 0 0 9 10 0 0 0 6 0 9 33 23 3 0 10 
0 0 31 0 27 18 38 48 0 0 0 10 0 0 0 0 0 0 33 29 11 31 6 17 0 20 0 0 5 3 0 27 22 4 0 9 0 0 7 0 0 6 1 0 0 5 7 42 29 0 2 33 72 
0 4 24 17 0 3 25 9 43 6 41 3 0 0 0 36 8 4 29 0 0 0 0 28 0 18 14 9 0 1 0 25 0 0 16 14 8 14 0 10 0 20 0 0 0 9 17 8 16 14 0 41 0 
7 5 0 0 61 3 0 114 0 34 33 33 0 5 34 0 0 0 12 33 10 28 0 0 0 15 0 7 10 0 12 0 0 0 21 0 0 5 10 0 0 7 14 96 0 0 2 0 4 28 10 0 20 
57 0 0 0 0 0 0 0 38 0 0 0 0 9 28 0 19 20 1 0 0 4 0 9 0 0 28 0 0 12 14 3 1 12 3 8 0 30 0 24 0 0 16 7 0 0 38 2 35 0 45 0 0 
8 50 22 123 0 0 3 34 57 3 0 14 0 0 42 22 3 19 25 48 7 0 4 15 19 7 10 13 0 16 1 9 2 25 3 17 15 8 0 4 0 34 9 0 0 58 7 39 12 35 2 2 47 
14 6 0 24 0 16 65 24 3 0 0 0 0 14 0 0 21 0 0 0 7 0 0 10 0 20 6 28 6 0 0 29 4 7 0 12 9 21 29 14 0 9 21 4 1 7 0 3 0 3 8 45 0 
104 0 14 42 8 0 0 7 15 0 0 0 0 0 16 23 9 0 0 0 0 0 18 6 0 25 0 5 0 0 25 0 19 33 0 19 0 4 0 24 33 0 11 0 0 44 40 0 8 17 15 0 0 
4 0 0 99 0 0 0 0 32 0 60 8 20 21 0 20 39 6 0 0 4 24 0 28 0 0 26 5 10 5 1 0 10 0 0 20 0 19 25 6 29 0 0 0 41 24 0 0 38 1 1 11 18 
42 0 35 0 0 13 0 0 0 0 0 9 9 0 0 0 21 0 9 11 3 9 0 0 0 6 7 0 0 9 0 10 0 0 1 6 0 35 0 0 22 4 66 3 0 2 0 0 0 3 1 22 0 
7 12 8 21 0 0 35 8 13 0 8 0 0 10 0 2 0 0 5 10 14 13 0 3 0 22 0 5 16 48 7 0 2 0 14 0 0 7 0 0 0 62 3 0 3 16 0 22 0 5 1 0 9 
0 0 22 0 0 44 13 1 1 14 0 11 0 0 19 0 0 3 18 26 15 16 7 12 20 27 2 0 5 0 16 12 0 39 11 13 1 45 14 0 12 6 12 6 0 23 33 6 9 70 8 0 1 
69 7 0 29 0 11 41 0 8 0 6 7 24 0 28 9 17 0 33 0 17 39 0 51 9 0 26 0 21 0 29 0 29 0 20 0 0 0 0 20 0 16 26 1 26 0 5 41 13 0 1 50 3 
0 0 0 0 0 38 0 10 23 0 0 0 0 42 0 14 27 0 32 14 10 18 0 17 25 0 0 7 1 46 18 0 12 23 9 0 0 3 14 28 19 3 7 37 36 15 6 25 0 27 45 0 26 
28 24 16 0 21 13 13 44 0 0 28 0 28 52 9 29 1 30 29 0 0 21 4 0 0 10 6 0 23 22 0 10 0 18 0 0 0 2 37 6 34 18 30 36 0 0 0 40 0 2 0 19 12 
12 50 14 0 0 0 4 9 13 0 0 38 29 36 3 3 9 36 12 2 0 26 0 27 16 24 6 39 7 2 0 5 10 5 41 0 13 5 32 46 22 23 23 0 24 0 0 35 14 14 74 23 106 
