53 30
25 0 0 34 65 3 0 15 4 24 17 34 63 22 0 0 0 13 15 0 20 0 24 0 0 0 0 0 23 0 0 0 0 0 0 38 15 9 0 39 0 3 16 4 16 34 0 0 10 45 33 68 1 
1 70 36 0 8 0 0 10 0 0 5 21 0 0 0 17 0 2 7 0 32 12 18 0 23 34 12 0 0 0 0 12 15 0 12 17 12 0 36 1 1 16 0 6 3 0 22 0 5 48 3 0 15 
20 0 45 0 0 10 0 77 0 0 8 33 8 0 20 6 0 0 13 33 25 0 0 0 9 20 15 6 9 30 17 18 0 0 9 22 0 8 19 0 38 74 24 0 0 27 0 21 18 0 52 17 30 
29 9 19 0 0 20 31 13 3 9 34 0 30 0 37 29 0 23 11 24 0 19 7 2 21 2 22 67 5 27 4 32 10 17 0 0 0 56 19 0 34 37 5 12 35 52 32 9 14 2 60 41 73 
0 5 0 67 3 0 40 0 0 0 21 8 20 0 11 0 0 8 0 0 0 29 0 0 0 0 0 0 0 0 0 0 0 0 0 0 0 0 0 0 0 38 0 0 0 0 0 0 14 0 32 45 0 
29 0 0 0 6 0 11 0 28 3 6 0 0 7 8 55 0 0 2 0 3 26 20 0 4 0 0 3 0 29 9 2 0 33 0 0 41 0 13 0 0 1 6 0 15 4 0 32 23 0 0 5 20 
7 39 50 23 53 16 42 3 76 53 53 15 8 26 8 5 6 0 22 0 0 15 0 13 0 0 39 17 11 0 13 3 12 1 0 0 0 22 0 33 92 0 0 39 53 0 30 20 9 21 40 43 128 
45 28 0 29 0 0 37 16 0 11 7 33 0 0 37 2 0 0 11 1 20 0 0 5 0 30 22 0 0 22 0 0 25 0 0 3 0 0 0 5 0 6 27 49 4 0 9 9 22 21 11 37 2 
1 0 0 0 22 35 0 0 0 4 0 16 0 4 23 10 0 1 1 30 15 0 0 0 0 0 22 19 5 0 25 0 15 0 8 0 0 23 0 13 0 33 5 0 39 0 0 0 0 30 0 0 0 
7 0 0 0 17 0 1 2 35 0 4 0 0 8 17 0 18 0 0 0 8 4 33 0 0 15 0 5 24 0 15 20 13 0 0 9 0 16 0 19 0 0 0 49 0 28 10 0 0 0 28 13 2 
0 40 6 1 26 0 0 10 27 6 0 0 9 4 27 0 26 27 9 49 17 27 3 0 0 13 0 25 0 3 0 0 0 29 9 19 50 0 0 23 0 110 14 2 2 25 48 0 4 0 9 10 0 
0 0 0 0 22 7 5 2 28 0 0 26 3 0 0 0 31 0 27 0 0 17 0 13 0 15 15 0 4 8 13 13 35 0 15 0 39 0 17 0 22 0 6 0 0 0 0 29 6 0 9 0 0 
0 0 0 2 0 9 3 29 0 0 12 7 7 0 18 3 3 5 29 21 9 3 0 0 5 0 9 34 0 0 7 11 30 0 0 0 26 7 0 0 12 0 0 0 35 0 0 28 0 0 43 24 0 
7 0 0 0 42 13 0 0 8 27 40 1 0 4 33 18 24 31 8 0 0 3 0 5 9 0 30 8 24 6 0 5 12 10 12 11 33 29 7 26 0 8 0 11 14 6 35 32 31 0 35 0 12 
48 12 8 3 11 0 0 0 0 1 6 29 72 12 0 11 27 10 11 17 0 6 0 0 0 11 0 11 0 4 16 10 8 0 0 0 28 0 8 28 1 11 0 27 0 45 42 35 0 0 0 0 0 
8 0 0 20 0 0 8 0 0 35 0 0 0 11 24 6 5 0 0 0 10 15 0 18 0 0 0 0 12 0 0 6 0 25 0 0 0 23 0 23 1 0 0 4 7 0 0 0 0 0 12 0 0 
38 24 0 11 0 0 0 0 7 0 0 0 30 0 1 0 4 18 16 51 11 30 0 5 0 9 0 0 35 0 16 0 31 0 6 15 0 3 37 8 0 2 28 15 16 0 25 13 4 0 16 30 33 
50 21 0 0 0 0 2 59 0 0 0 4 0 0 0 0 0 12 0 1 0 0 0 0 5 0 0 0 0 0 29 7 0 2 12 18 0 0 1 5 0 1 16 0 0 0 1 28 29 42 50 10 12 
4 0 0 16 2 34 14 2 42 0 0 4 0 32 7 6 8 20 0 19 0 0 0 8 8 0 0 0 0 1 7 2 0 0 0 37 0 20 43 6 14 5 0 41 0 5 0 0 14 0 31 36 10 
10 31 34 0 96 0 13 6 0 25 0 8 0 16 0 6 1 1 0 32 0 3 12 17 27 4 0 3 0 21 16 21 12 0 54 11 11 0 0 5 15 9 13 4 0 39 52 0 0 0 11 18 13 
31 38 27 0 34 0 0 0 14 0 0 23 10 34 0 0 17 7 0 0 0 4 0 0 0 0 13 20 0 11 0 49 15 0 41 0 35 33 0 0 19 0 0 0 23 18 3 4 0 0 0 35 0 
0 0 5 17 17 0 3 16 8 34 0 36 0 12 25 6 0 0 0 19 0 32 0 16 0 16 10 14 20 25 7 6 0 0 0 0 0 0 0 25 0 0 21 32 0 4 17 44 20 0 0 0 0 
32 16 0 39 18 19 43 0 0 53 10 20 1 32 8 11 0 31 6 29 0 27 23 0 5 12 0 10 13 0 14 6 17 20 0 0 22 0 29 0 0 20 33 0 0 23 0 0 10 43 0 13 0 
13 47 13 17 3 9 31 9 0 0 0 37 3 25 18 34 0 30 28 0 0 0 17 0 0 4 11 0 10 28 0 11 62 28 0 15 19 42 18 23 0 0 0 14 17 44 47 32 44 0 15 6 0 
0 0 91 6 24 0 37 0 6 58 24 0 31 30 0 0 9 7 0 31 0 0 28 0 19 6 0 28 19 0 43 7 21 2 7 12 0 0 36 7 0 1 15 19 35 15 8 45 0 47 26 0 22 
0 0 0 21 9 0 24 0 5 0 16 7 33 9 0 36 31 0 4 0 0 19 20 0 20 0 1 1 11 0 24 0 0 0 0 0 1 39 0 25 8 2 0 33 34 1 34 0 39 0 29 2 0 
0 0 37 0 0 13 2 49 0 0 0 0 0 30 9 21 17 0 0 48 0 35 4 2 0 0 2 23 0 14 0 18 16 39 6 9 0 16 1 32 21 0 0 21 55 0 16 23 29 18 0 0 39 
9 10 28 12 1 30 0 0 0 0 11 0 2 17 15 0 24 17 5 0 76 18 6 0 0 25 23 8 0 0 11 5 21 0 15 0 0 14 1 0 9 25 0 0 10 0 0 0 0 9 30 0 0 
1 1 19 8 9 0 5 0 0 19 0 47 0 22 40 0 33 31 0 9 0 19 4 0 0 0 13 13 13 0 1 0 0 23 16 15 15 22 0 13 12 33 32 0 0 18 16 0 54 50 11 0 22 
39 26 6 0 0 0 67 6 3 7 27 0 102 26 0 0 30 12 0 7 0 0 0 40 0 0 0 9 0 19 26 29 26 2 1 30 20 0 26 26 0 18 0 0 26 50 0 6 40 49 24 0 0 
