53 30
0 42 9 31 12 0 0 3 0 12 0 0 0 12 36 19 0 0 14 0 0 0 0 11 0 0 0 0 18 0 9 4 0 0 47 0 20 0 24 6 0 0 0 0 0 9 0 3 0 9 39 0 16 
19 0 24 6 0 24 22 0 7 38 23 8 0 27 9 16 4 0 25 0 4 0 1 7 24 16 39 0 39 0 0 22 0 0 34 29 0 0 6 42 5 0 0 17 6 25 0 0 0 0 3 0 0 
40 1 0 5 1 25 35 0 28 22 7 0 11 29 28 18 29 25 1 25 31 6 5 3 0 26 5 32 7 1 0 33 0 0 5 7 12 14 18 5 40 35 90 7 32 29 0 6 0 0 38 12 18 
18 30 17 37 11 10 9 11 0 0 2 5 34 0 20 1 17 18 9 0 5 0 0 10 4 0 20 0 21 13 11 1 0 25 13 0 2 19 1 23 32 0 0 21 0 56 0 18 7 37 0 16 25 
34 43 0 1 46 0 11 0 5 0 22 0 19 45 27 11 0 11 12 0 0 42 0 12 0 0 0 23 0 0 0 0 9 0 76 0 43 0 0 3 12 27 0 0 11 0 12 15 29 2 36 0 34 
26 70 13 1 7 72 13 0 53 51 7 0 3 29 4 12 16 11 17 0 8 20 25 41 20 0 0 21 7 12 0 52 0 19 31 47 6 4 0 9 9 22 31 20 27 32 38 28 43 0 48 66 66 
85 0 22 0 15 66 0 43 34 0 0 0 7 0 21 0 0 0 0 4 1 1 1 22 0 13 24 17 12 24 6 6 0 0 0 0 13 18 0 16 34 1 35 24 0 0 0 0 2 42 50 42 12 
0 35 0 6 73 27 0 22 2 0 0 25 5 32 5 31 0 0 4 19 9 15 4 0 0 0 0 0 5 0 0 18 4 0 3 13 25 0 0 0 0 36 0 7 31 0 42 12 0 0 19 36 0 
15 0 47 37 0 0 10 0 0 7 0 0 13 23 1 0 26 6 0 2 0 0 2 0 16 0 12 0 0 0 27 0 0 20 0 0 0 0 12 0 21 0 6 0 42 0 0 0 15 0 0 8 0 
0 0 0 2 5 0 0 0 5 0 42 20 12 7 29 0 6 5 0 41 3 0 1 17 31 19 8 14 2 18 8 6 0 12 5 32 16 6 3 0 16 7 28 1 34 3 0 16 1 10 0 0 74 
18 0 10 0 0 0 0 0 64 0 0 7 3 0 27 26 7 0 0 2 0 10 1 21 7 41 0 0 0 21 22 0 11 0 19 7 0 0 10 0 29 25 0 9 21 0 0 0 49 24 0 36 31 
35 0 3 43 37 12 16 7 58 39 10 0 0 0 45 19 0 0 0 0 10 0 24 0 20 0 8 5 36 12 6 0 16 1 10 0 0 0 16 8 0 21 0 11 0 0 0 14 84 34 42 0 0 
0 0 43 0 12 0 22 16 9 12 7 0 9 27 0 18 0 0 15 17 19 7 0 0 0 0 0 9 0 19 6 12 11 3 18 0 7 0 0 23 33 0 0 0 0 16 12 0 9 1 14 9 0 
0 17 9 0 29 7 36 4 4 0 12 7 4 61 0 0 0 0 27 0 6 0 0 15 1 20 0 14 0 0 10 25 39 0 0 15 0 0 0 23 9 22 11 0 8 0 5 0 35 16 44 0 0 
0 0 6 12 10 0 0 0 36 0 0 0 0 10 22 0 6 6 3 6 7 0 0 0 11 0 10 0 0 11 8 23 5 0 0 0 22 0 13 31 13 14 17 17 7 0 0 0 16 47 0 12 0 
0 0 0 0 10 0 23 0 0 2 0 8 35 1 16 3 2 0 0 0 0 0 0 6 4 18 0 0 6 3 2 0 6 0 0 0 7 0 0 0 0 10 9 9 0 29 0 56 1 8 0 1 9 
12 0 0 36 23 46 0 13 0 15 11 40 48 9 20 24 0 0 0 16 19 29 16 10 13 1 15 3 19 13 1 0 12 0 20 19 2 10 9 24 13 4 22 0 0 23 41 5 0 12 3 77 0 
0 32 0 0 0 0 13 36 0 15 1 0 35 17 0 21 11 0 5 8 22 0 0 1 2 14 15 0 0 0 0 0 0 25 0 7 0 0 13 0 0 12 22 36 5 0 0 35 22 0 0 0 0 
0 56 1 29 1 36 12 0 50 8 8 0 19 0 9 7 8 0 14 11 0 0 0 0 0 61 11 1 0 13 0 0 14 0 0 0 16 5 0 2 28 16 39 11 14 0 37 58 4 35 0 36 7 
11 0 32 32 22 2 21 0 5 41 0 34 38 13 3 6 31 35 0 0 2 6 0 9 14 2 10 3 0 19 0 0 15 0 32 12 0 26 0 1 37 0 0 1 14 1 0 43 39 0 10 0 35 
5 17 23 0 0 0 7 0 0 40 8 0 8 36 0 30 0 0 0 8 8 10 16 0 0 5 0 0 0 0 8 0 0 0 0 0 0 0 16 3 7 0 0 0 6 5 21 0 0 31 48 0 30 
38 0 0 28 7 23 53 0 5 4 0 0 0 6 3 0 0 0 20 22 12 0 0 6 4 0 23 9 4 6 0 0 19 0 0 12 6 0 20 39 0 12 5 15 0 39 0 11 0 0 0 19 0 
9 0 0 0 0 3 0 0 0 9 0 39 0 0 23 30 13 0 25 13 0 0 7 6 0 0 13 23 0 7 1 6 0 0 0 0 9 18 0 24 4 0 5 21 5 11 0 2 4 0 28 0 41 
59 0 8 19 26 27 26 0 0 18 8 14 14 10 0 4 5 0 15 0 0 21 41 0 10 25 26 27 0 0 40 23 52 0 10 0 0 11 0 0 0 0 1 26 53 13 0 17 10 20 0 0 0 
0 0 22 23 10 0 0 0 11 5 14 2 25 1 0 4 0 0 6 2 0 3 5 0 20 0 33 0 0 8 0 0 14 10 0 0 0 18 3 0 5 0 0 42 0 0 0 2 0 0 0 39 2 
67 20 7 22 0 8 15 0 51 4 14 0 6 12 34 0 0 3 0 16 3 0 0 20 24 26 18 21 14 0 0 0 9 0 12 4 16 19 25 19 7 8 0 23 41 0 7 16 0 0 13 37 7 
0 39 39 23 0 12 14 0 38 4 38 34 7 18 0 9 27 0 1 37 5 0 2 0 46 0 16 21 0 0 0 0 0 0 30 0 0 10 32 0 40 36 26 4 38 42 38 11 0 0 14 27 2 
0 0 25 1 0 0 31 40 0 7 4 0 0 6 21 4 53 0 0 1 18 0 0 0 0 0 16 12 25 32 0 0 3 0 0 0 0 0 35 0 13 0 6 0 0 26 0 40 6 0 34 0 0 
17 1 43 12 0 12 0 10 0 0 57 0 0 27 11 3 8 3 0 0 0 0 25 49 19 26 9 0 0 8 8 8 22 51 44 42 21 8 0 0 0 19 0 22 0 6 0 2 0 10 0 10 48 
0 22 47 0 0 0 0 22 0 0 29 25 26 12 4 7 0 35 46 0 29 0 2 22 0 9 0 9 0 18 0 0 16 0 38 0 3 6 0 26 17 0 0 8 0 26 14 0 16 57 0 0 69 
