53 30
32 71 0 7 12 0 46 102 43 24 0 17 10 2 20 0 16 18 19 18 2 23 0 24 7 16 46 0 10 6 7 12 25 13 5 1 19 2 0 22 0 41 12 0 15 5 64 30 0 27 78 0 0 
33 18 33 0 24 0 21 0 22 16 0 0 0 0 0 0 15 0 0 28 0 0 0 21 0 15 4 45 19 1 18 0 0 6 0 16 8 0 13 14 5 0 17 27 32 0 15 39 0 0 11 0 0 
20 0 0 0 0 10 29 32 0 29 0 10 0 3 23 0 0 17 18 0 20 0 23 19 2 23 15 20 8 0 0 18 26 20 21 0 22 23 29 18 0 0 6 27 8 0 0 0 23 0 22 11 0 
0 13 2 0 0 25 3 3 66 0 9 0 18 0 0 0 0 0 14 31 5 26 2 16 29 5 5 0 24 0 32 23 18 39 22 0 33 0 19 33 16 0 9 0 28 0 8 26 15 11 0 27 0 
15 0 0 0 0 18 23 0 38 0 0 8 0 32 0 0 14 0 0 0 0 25 0 25 22 0 30 21 10 0 0 18 0 2 29 2 0 0 10 9 30 6 16 0 4 71 38 24 4 0 0 0 0 
32 0 20 65 32 1 3 0 18 0 38 3 4 1 40 0 20 13 12 9 3 0 37 2 11 64 0 0 18 0 8 0 40 11 0 0 15 26 0 0 2 4 3 0 6 0 22 19 26 40 0 55 27 
0 8 51 0 0 0 0 21 0 42 0 6 28 21 0 0 0 15 37 0 21 22 6 21 23 18 14 16 16 0 12 14 0 0 25 0 13 30 0 39 14 0 1 23 13 11 0 29 3 0 12 0 29 
0 42 0 9 21 0 0 16 1 0 0 3 28 4 0 0 0 4 11 12 0 0 9 22 7 0 23 0 0 0 9 5 0 0 0 0 0 0 0 0 2 0 0 21 0 1 0 0 0 8 16 0 28 
21 3 0 24 4 18 17 17 0 0 0 35 0 0 0 0 18 0 7 0 0 24 0 17 10 0 5 24 5 6 0 0 8 5 5 0 0 3 4 0 0 0 0 1 43 9 0 0 0 0 0 0 0 
6 0 15 9 0 0 5 0 37 0 10 0 9 24 0 0 4 11 0 14 0 0 4 0 0 0 15 5 0 0 0 0 5 11 0 17 0 0 13 6 4 2 0 5 15 37 0 7 5 10 11 4 7 
0 8 0 50 0 31 0 0 10 17 0 5 21 0 0 1 1 11 0 0 0 0 0 0 5 0 0 0 1 0 0 0 0 0 0 7 36 2 0 36 0 0 0 0 0 3 1 0 3 4 0 3 0 
0 0 34 15 3 0 28 28 38 5 41 0 0 21 5 0 0 6 62 12 0 0 1 2 0 22 3 0 0 9 4 0 0 10 24 17 36 0 20 16 37 7 9 3 7 1 29 0 30 0 4 56 0 
0 0 1 19 0 19 0 28 0 22 9 3 0 7 3 0 14 0 4 0 0 0 19 6 0 0 0 17 0 20 0 12 17 9 0 44 12 5 1 3 0 0 11 0 9 10 2 0 18 14 5 42 11 
0 0 10 0 0 0 15 0 55 0 0 7 5 0 13 3 0 3 0 17 0 10 0 9 0 19 15 0 7 0 4 0 40 0 13 3 1 0 0 36 0 7 0 0 5 6 0 0 7 4 0 14 0 
28 56 0 53 15 0 0 12 0 14 19 0 9 0 0 11 0 27 4 15 14 27 4 24 12 0 11 27 2 24 0 11 1 0 50 7 13 9 3 13 7 0 0 2 27 10 0 46 5 4 0 12 0 
7 7 55 1 1 0 0 5 29 0 6 91 77 22 24 12 18 28 7 5 12 2 0 0 23 22 5 8 4 22 0 16 4 25 2 8 7 0 16 23 13 16 0 12 12 35 54 35 46 37 8 48 18 
0 1 0 19 41 0 0 10 0 5 0 10 0 35 0 27 0 0 0 8 0 0 19 29 0 0 0 0 0 6 3 0 13 0 19 3 23 0 0 0 36 3 0 0 0 15 13 7 3 0 27 0 0 
13 0 48 53 35 7 14 0 11 40 7 0 31 0 0 28 13 6 23 16 16 0 0 54 0 0 0 0 0 0 5 1 0 0 0 5 13 0 5 0 2 0 0 28 0 11 0 3 0 40 96 0 51 
14 26 0 0 0 0 0 0 42 0 0 9 36 0 0 0 26 13 0 24 0 0 12 10 0 0 25 0 18 25 0 0 0 7 22 0 0 0 0 24 11 2 37 55 0 3 18 0 0 13 57 14 0 
21 42 31 49 54 0 34 29 0 0 18 0 16 7 30 34 0 11 5 0 14 12 0 34 19 1 29 0 14 0 0 9 14 1 0 0 26 25 5 18 43 38 0 11 7 12 4 0 44 34 49 28 4 
0 13 65 8 0 0 3 50 0 0 0 0 0 0 19 13 0 2 9 15 1 0 14 0 15 0 4 7 12 14 10 1 8 1 12 0 0 0 0 18 16 5 33 0 0 44 1 0 0 0 8 0 45 
50 3 0 0 7 18 0 0 0 0 18 0 1 0 0 0 50 33 0 0 15 0 0 23 0 7 19 3 12 0 0 20 1 0 32 4 0 0 5 0 0 0 0 0 18 22 8 1 0 0 17 13 18 
0 0 0 0 0 0 0 0 25 9 0 0 56 0 19 0 0 0 39 23 13 0 0 39 21 12 8 1 16 0 0 10 0 6 0 2 18 14 13 4 28 0 9 0 0 13 28 17 25 31 0 0 13 
0 43 18 0 3 42 37 3 83 0 0 0 0 0 0 0 3 0 0 17 0 0 0 0 0 27 4 0 7 0 4 0 0 0 15 2 0 0 0 0 0 0 2 37 52 6 1 43 0 57 42 0 10 
0 10 5 5 5 0 0 64 44 24 0 0 35 0 0 0 6 15 0 2 0 33 8 12 12 21 5 25 0 0 0 13 19 0 27 0 26 20 0 23 0 8 0 0 18 9 0 55 0 42 24 19 89 
0 7 29 9 18 35 7 46 34 17 45 51 0 0 0 0 13 12 1 11 10 0 0 0 0 19 14 43 0 0 0 27 10 15 24 4 25 0 0 31 3 2 13 10 17 30 38 0 0 0 0 44 47 
0 0 20 0 0 21 0 0 0 33 0 6 10 11 13 18 6 8 24 0 0 3 21 52 22 5 47 0 0 0 6 9 1 15 37 11 1 15 0 4 0 10 0 7 26 0 14 0 7 0 21 1 0 
0 17 0 8 12 0 16 16 20 17 7 18 29 19 10 7 0 0 2 0 45 0 11 52 0 24 0 0 8 31 22 7 0 5 0 0 21 0 23 43 0 27 5 0 0 7 5 24 0 3 0 50 0 
0 49 16 8 68 0 35 0 25 0 0 0 0 0 0 0 0 0 20 21 32 4 0 0 0 0 20 0 0 0 15 0 16 0 10 4 8 0 2 0 2 0 0 4 25 12 0 0 29 0 38 0 16 
2 4 16 34 4 0 7 19 0 0 13 35 7 24 52 0 0 4 0 14 18 46 0 16 0 26 44 17 0 0 0 11 17 30 13 0 0 0 24 5 0 48 2 0 0 0 12 0 0 8 31 49 44 
