53 30
12 0 0 0 0 15 65 8 0 8 26 0 47 0 0 0 0 24 52 39 0 0 0 0 0 0 28 20 6 0 0 0 0 0 0 0 14 3 2 13 28 24 0 7 25 6 0 12 0 0 0 27 0 
0 33 6 20 8 27 0 27 41 0 3 3 10 1 5 37 0 16 23 4 0 8 29 0 15 21 16 23 0 3 21 41 38 6 7 34 22 39 0 24 0 8 6 0 17 20 14 16 0 0 20 19 0 
0 38 0 0 5 0 0 20 0 27 0 0 15 52 0 0 27 0 20 11 0 5 0 16 0 20 37 21 17 3 0 0 0 1 0 14 7 1 16 40 0 86 0 0 0 10 0 31 11 0 0 38 36 
35 0 15 18 0 0 18 0 33 0 18 0 11 0 0 0 0 33 3 9 0 3 0 11 15 0 6 0 7 25 0 2 0 14 6 35 0 11 0 0 0 33 18 0 22 0 0 0 1 0 24 0 0 
12 0 34 0 24 32 13 0 0 0 0 3 21 0 0 3 0 0 0 8 0 9 8 0 0 0 0 16 0 1 34 0 0 9 1 0 34 32 0 0 23 8 0 0 26 0 0 0 0 0 0 24 0 
15 0 88 0 41 0 5 36 37 7 0 0 21 0 0 71 29 0 16 26 18 14 0 0 15 2 0 2 10 13 31 3 0 0 4 0 0 0 20 17 4 2 0 36 1 44 6 7 0 8 77 0 0 
0 0 18 0 41 28 46 0 2 0 8 0 13 0 0 0 12 18 0 18 0 17 0 0 0 11 0 2 13 0 4 0 0 21 2 7 0 16 21 0 0 13 9 26 0 7 0 0 0 21 0 47 46 
0 0 0 14 13 0 0 0 24 21 0 0 58 8 2 6 2 14 10 0 0 11 19 0 0 0 9 22 0 0 1 0 13 0 0 0 0 7 0 0 16 21 36 38 1 13 25 0 0 30 0 0 0 
0 21 0 7 0 52 20 9 10 8 0 0 11 0 0 0 9 0 0 0 0 0 4 17 8 0 0 1 0 16 3 7 0 20 0 14 0 0 0 0 9 0 36 0 5 0 0 14 0 35 0 21 0 
47 7 31 40 34 31 51 21 2 14 2 4 23 17 0 12 0 36 0 42 0 0 10 0 27 20 0 8 5 18 30 0 13 33 15 0 3 0 0 0 35 0 0 79 4 28 3 47 34 0 25 0 28 
0 10 47 0 8 0 23 0 16 21 0 0 8 1 1 20 35 0 0 0 0 15 0 0 13 0 0 9 20 42 35 0 0 0 6 13 24 10 14 9 0 18 9 0 0 0 0 0 0 0 0 48 0 
51 44 21 0 3 0 0 7 0 0 5 29 9 0 0 0 19 0 0 7 24 0 11 21 0 0 14 0 0 7 0 0 0 14 18 0 0 12 0 5 29 0 0 4 38 19 11 8 2 10 0 49 0 
3 0 32 72 46 0 38 33 0 3 0 4 40 14 0 12 9 3 22 3 3 0 1 35 14 6 35 0 2 21 17 0 30 2 32 8 31 2 22 12 30 17 4 6 1 6 3 20 0 8 21 63 52 
0 0 13 0 0 46 30 0 54 4 0 39 33 0 3 6 5 0 0 0 0 0 16 0 0 0 20 35 10 13 0 7 0 0 12 20 0 12 16 7 10 0 4 0 9 24 12 20 6 6 73 59 0 
0 0 0 15 0 20 16 55 0 0 0 57 0 0 0 10 15 13 7 14 0 15 28 10 0 28 0 11 0 41 13 12 0 0 0 23 2 4 27 13 0 5 0 0 7 0 0 0 12 0 50 0 22 
0 0 2 7 0 3 26 0 0 40 1 0 0 0 25 3 27 0 3 13 23 0 0 10 4 19 3 24 0 0 0 21 63 8 0 0 0 10 9 22 24 7 10 14 23 0 0 0 0 0 10 0 23 
0 0 31 0 0 0 0 0 0 35 5 0 0 4 5 0 0 0 12 4 4 0 8 14 0 0 9 0 16 0 12 0 0 40 25 9 0 14 0 0 0 1 27 0 13 0 0 1 28 0 2 0 0 
12 8 18 43 0 26 0 15 0 0 0 22 50 0 0 0 0 16 7 0 18 10 0 0 0 7 8 19 7 21 4 0 3 10 8 12 5 0 2 0 12 0 8 1 11 0 30 12 0 22 38 5 5 
23 33 0 36 12 3 20 17 6 3 2 35 41 37 0 4 17 35 0 0 14 0 0 3 0 22 13 0 3 17 0 0 0 0 16 0 5 3 0 68 17 6 6 0 14 11 0 0 0 0 50 4 35 
44 8 37 0 3 2 31 3 4 0 0 9 0 10 0 15 1 25 55 8 5 27 0 31 7 20 0 0 0 7 9 5 4 11 0 0 0 44 2 30 28 2 0 2 49 6 0 30 0 9 0 0 0 
0 11 1 0 13 0 0 0 30 0 11 28 29 0 34 6 26 4 0 2 8 45 12 6 0 11 0 0 13 15 10 25 0 0 4 0 13 25 38 30 4 10 0 0 36 12 0 31 7 0 0 0 0 
0 51 0 18 0 7 0 4 23 0 0 2 0 0 9 1 0 1 6 14 0 0 0 0 8 0 0 3 21 9 4 16 0 14 15 1 0 3 0 0 1 0 0 0 2 37 0 0 0 6 0 6 51 
11 20 0 32 22 0 5 42 39 0 30 54 27 4 18 1 0 90 14 0 3 0 22 0 5 10 22 21 0 0 5 0 5 0 0 47 0 0 0 6 46 0 31 0 3 9 6 61 31 41 28 49 30 
40 23 2 32 33 0 7 25 4 0 0 9 0 14 0 0 0 10 33 0 3 27 3 0 23 14 3 21 10 0 19 0 21 7 2 40 14 9 18 35 42 0 0 6 0 4 6 0 0 1 5 28 31 
0 0 13 0 30 0 17 10 0 0 0 2 18 0 0 3 0 0 1 3 0 0 12 0 22 0 0 19 34 16 0 0 0 4 30 6 22 11 1 6 6 8 0 15 23 0 35 0 0 12 28 0 17 
13 5 38 2 0 32 0 1 12 27 0 38 9 0 0 0 0 1 4 0 0 15 21 0 15 23 6 11 6 0 2 19 24 14 0 0 27 36 0 23 33 34 27 0 0 0 0 0 32 54 24 0 4 
0 0 13 2 47 0 26 28 0 2 0 0 32 11 0 21 16 0 20 16 3 0 0 0 0 0 3 0 23 0 0 15 10 13 0 37 16 0 41 0 33 0 0 0 31 1 2 40 0 0 0 18 24 
0 8 0 44 12 0 0 0 0 0 20 0 23 0 21 0 0 46 20 0 0 7 13 1 9 0 8 1 0 0 36 0 8 15 0 3 0 19 0 13 23 5 0 0 7 3 4 44 0 10 17 32 0 
7 13 31 14 24 0 6 5 0 28 0 0 29 0 0 0 25 0 0 4 0 28 26 7 0 24 35 1 2 7 0 0 0 6 5 4 16 0 82 0 10 44 0 0 34 0 0 18 4 24 10 50 0 
13 21 0 15 30 41 0 23 0 0 0 29 0 3 23 0 0 9 10 6 0 30 9 14 0 2 0 0 2 19 1 18 0 0 30 0 0 43 17 9 0 3 23 0 25 0 8 29 9 0 8 30 27 
