53 30
0 0 37 14 3 44 0 15 2 5 0 0 44 0 0 0 9 0 20 0 0 0 0 0 0 0 0 0 0 0 23 0 0 0 0 0 0 7 0 36 7 0 8 4 25 26 39 0 19 47 0 2 0 
30 3 0 0 8 0 35 0 14 0 24 0 0 8 36 0 0 0 0 15 0 0 14 17 0 0 23 0 41 24 0 17 0 17 17 0 4 10 25 0 11 13 6 3 0 0 61 0 0 1 38 2 0 
26 15 3 0 31 0 6 20 88 0 56 9 27 0 0 11 0 11 7 0 12 6 7 4 10 0 17 16 0 11 0 13 0 0 19 6 23 0 0 0 9 31 0 3 0 0 38 39 0 0 14 0 19 
34 0 0 0 2 0 2 13 35 5 0 0 0 0 13 21 35 9 18 22 22 12 0 0 8 2 1 32 0 0 0 0 2 8 42 0 9 10 0 0 0 39 0 0 0 0 4 0 30 22 30 0 0 
0 3 11 0 0 0 0 0 27 34 33 11 12 22 0 15 0 26 7 0 0 0 0 0 12 0 0 0 15 4 0 0 2 12 1 17 0 0 9 0 17 0 5 22 0 2 0 16 0 13 6 0 0 
0 0 0 0 0 0 20 2 34 5 17 5 6 8 0 0 48 0 42 0 0 0 0 10 13 0 17 0 12 0 0 15 10 0 29 0 13 20 0 9 18 0 15 21 0 7 0 23 19 13 32 0 0 
5 3 0 0 17 26 0 0 0 0 5 35 21 16 0 5 0 0 0 27 30 0 0 7 0 10 0 0 17 0 0 5 12 21 3 3 0 14 9 10 0 6 7 12 19 25 81 7 0 0 30 0 0 
0 95 41 39 18 46 0 24 4 0 0 5 0 39 12 0 40 10 22 0 0 0 0 0 0 11 12 13 19 38 14 30 8 12 0 0 5 22 0 0 1 25 4 37 0 44 1 19 0 0 5 50 40 
74 16 6 0 33 0 0 74 0 12 0 12 0 27 13 12 0 45 1 0 0 8 0 0 0 5 47 16 0 0 1 0 32 0 4 17 23 49 0 0 20 0 18 7 0 0 0 0 0 19 0 34 32 
0 23 0 0 19 0 16 0 0 9 0 25 4 9 17 4 7 19 1 25 9 13 16 16 16 19 0 0 16 0 9 6 0 0 0 12 25 1 10 2 2 0 7 20 22 0 15 12 9 0 0 0 0 
0 4 0 0 0 3 0 7 0 0 24 5 33 1 0 0 20 30 0 0 70 18 8 0 12 0 17 0 0 0 0 11 3 7 34 18 8 23 0 9 0 0 0 2 0 6 26 0 9 0 4 25 26 
13 0 0 5 18 0 2 5 6 0 5 0 16 0 26 5 0 29 14 17 2 28 25 9 0 13 0 3 7 0 0 6 23 7 0 3 0 41 19 0 39 0 0 14 0 10 8 8 12 40 9 0 0 
0 0 0 45 0 0 0 2 20 0 24 19 12 0 0 7 3 0 0 0 6 0 0 0 3 0 0 19 23 4 14 16 16 22 30 0 4 7 0 0 0 0 0 15 0 9 0 62 45 0 19 0 0 
42 0 0 0 0 15 0 0 9 12 0 1 7 38 21 8 6 14 18 1 9 21 23 0 48 23 0 0 16 0 23 15 0 8 0 2 0 2 2 7 0 27 21 0 20 22 83 33 10 8 1 26 10 
0 37 16 14 3 0 24 29 20 0 0 29 18 0 0 35 0 0 5 11 30 13 0 0 4 0 5 10 3 0 47 20 31 6 19 0 0 9 27 3 10 0 45 0 9 0 0 17 11 38 46 89 6 
0 0 11 0 0 0 8 0 0 2 39 13 5 36 19 23 0 8 56 0 0 22 3 16 3 0 0 0 19 0 10 3 2 22 18 14 0 0 9 0 7 0 12 0 0 0 35 24 0 51 5 11 52 
0 14 48 54 2 46 10 0 5 0 27 0 0 10 36 1 26 0 18 0 0 6 12 23 7 25 0 12 0 23 8 0 19 0 16 0 9 9 14 3 0 13 20 6 0 0 18 10 45 35 34 9 11 
0 30 0 46 31 0 6 0 0 2 14 34 1 11 0 0 0 0 6 0 0 9 15 5 38 25 0 23 2 0 0 30 28 5 0 10 14 0 0 0 0 0 0 0 0 46 0 0 24 7 2 0 0 
17 0 2 1 45 16 0 33 0 0 0 33 0 0 24 0 5 0 0 15 6 22 10 9 10 11 0 1 9 2 3 8 52 7 0 10 0 57 25 0 33 11 3 5 33 13 0 0 24 7 0 0 15 
0 11 21 0 26 17 2 4 8 42 28 14 38 36 0 11 3 0 0 53 5 4 37 0 4 47 7 0 15 1 22 0 25 37 2 0 29 1 38 40 0 9 38 0 0 0 49 13 19 12 38 53 18 
2 0 0 0 0 0 0 9 0 0 0 5 0 27 7 11 9 0 20 0 4 0 4 0 14 26 13 0 0 0 0 18 0 13 10 3 0 17 9 7 27 0 0 0 0 14 0 0 0 9 0 7 8 
0 0 0 3 15 0 4 0 41 0 15 0 0 28 0 10 0 0 10 30 0 14 3 0 0 0 13 0 0 0 3 0 7 0 16 0 0 3 0 9 3 8 0 0 0 7 0 0 0 68 7 0 39 
2 0 11 0 15 0 63 12 41 0 17 10 9 11 0 20 0 11 0 15 0 24 0 11 28 19 3 0 0 0 0 0 11 25 0 8 0 12 12 0 18 0 0 6 6 0 0 2 0 0 71 7 2 
10 4 44 0 0 40 0 34 1 0 0 4 0 0 34 0 10 0 0 6 1 9 0 2 19 0 0 0 13 8 23 0 9 12 18 4 5 0 12 0 0 47 7 19 20 28 62 11 22 13 0 10 38 
29 13 1 37 16 15 6 34 19 32 13 31 51 0 0 33 0 13 11 27 1 14 15 25 3 0 16 14 43 0 11 11 3 9 0 41 0 11 46 5 6 85 28 6 3 7 19 24 19 9 116 19 20 
37 1 7 26 0 27 18 0 39 2 24 3 29 0 24 6 0 43 0 0 0 1 0 16 25 27 5 0 0 1 0 26 46 0 0 0 0 68 3 18 0 66 25 0 19 0 2 0 28 0 15 0 31 
38 0 0 0 0 0 10 0 7 8 25 30 0 30 0 7 0 7 0 19 0 17 0 0 0 11 1 18 0 22 0 25 0 0 0 25 12 19 82 0 0 50 5 0 0 7 1 0 0 0 0 38 0 
0 45 0 0 3 0 20 27 20 18 0 0 18 21 10 0 1 1 0 0 6 46 0 21 0 18 21 18 28 0 0 0 0 0 0 0 1 0 5 21 22 0 3 0 0 0 0 0 36 19 78 0 11 
0 32 0 0 0 53 15 0 1 0 12 0 0 0 2 0 26 33 3 8 15 18 1 3 0 0 0 6 9 0 0 16 11 37 1 9 16 0 0 0 0 5 0 60 6 0 0 0 1 12 24 0 18 
0 0 0 44 111 38 0 3 45 0 0 0 20 58 0 5 30 0 39 1 0 0 0 2 0 0 21 4 8 0 0 0 28 20 0 17 8 5 0 0 0 11 0 38 0 30 46 40 0 9 0 41 88 
