53 30
30 0 0 3 20 23 0 31 28 36 0 0 51 7 25 11 0 0 18 0 0 8 36 0 0 0 0 0 0 2 0 6 15 8 22 0 0 21 31 29 20 18 0 0 0 57 1 0 0 8 13 0 25 
47 21 2 0 59 48 4 18 30 20 0 0 45 0 0 3 47 10 0 20 0 9 7 12 0 29 10 0 5 16 2 0 0 36 0 7 13 0 0 8 0 41 38 9 0 0 4 10 0 5 0 2 3 
20 0 27 17 0 2 0 16 0 0 0 0 0 16 22 0 14 14 16 0 0 0 45 34 0 0 0 0 6 55 13 21 0 0 0 0 0 0 0 18 0 2 0 0 0 0 0 0 35 4 0 28 32 
0 33 23 0 1 20 50 0 1 0 0 0 6 1 22 0 0 12 0 0 6 7 38 0 0 34 11 0 7 7 10 10 3 0 50 15 34 0 7 33 14 29 0 17 6 2 0 17 26 0 10 0 0 
5 10 7 14 4 33 0 0 40 0 0 0 0 14 21 0 34 13 21 22 0 23 1 12 8 0 8 14 5 13 0 0 5 68 0 21 0 6 8 3 16 13 9 6 0 7 2 0 10 0 0 35 25 
111 0 22 48 0 31 0 36 66 5 24 0 5 0 27 8 20 0 23 0 7 9 0 8 51 0 0 10 28 21 14 0 15 0 35 20 24 98 44 0 35 12 0 0 6 38 0 30 0 58 0 0 11 
40 2 8 2 3 2 9 45 18 1 5 0 53 0 12 40 0 22 45 0 0 0 0 0 0 0 18 14 15 0 13 0 3 0 18 0 0 22 0 0 3 1 0 35 0 2 0 35 0 4 8 0 62 
0 0 1 34 0 8 0 0 2 0 0 0 27 25 0 18 0 5 0 0 5 2 0 0 0 5 12 0 0 3 0 5 15 25 1 6 0 0 5 27 0 0 0 0 0 10 0 0 45 2 7 10 1 
42 0 6 0 0 0 0 3 0 4 19 0 0 1 0 13 0 9 15 0 2 0 15 18 4 14 20 0 40 11 4 13 0 0 0 1 15 0 1 0 0 14 42 3 0 2 4 1 0 0 0 0 37 
13 0 0 0 5 6 3 25 20 43 0 1 0 7 38 31 0 0 10 0 12 0 1 1 0 0 0 0 28 6 0 0 30 0 0 12 25 28 0 2 4 41 2 2 0 2 31 0 10 10 0 1 5 
15 7 27 28 31 22 5 0 64 13 0 0 18 14 0 7 0 10 0 0 0 1 6 18 0 25 0 46 0 27 6 28 0 11 0 57 28 4 3 19 11 5 17 26 0 7 37 0 0 10 0 1 41 
41 43 46 0 22 80 3 32 0 36 21 0 49 14 0 26 9 0 11 13 0 9 18 17 6 10 28 25 0 5 0 21 13 0 0 10 7 2 20 31 1 73 2 7 1 7 0 55 18 0 12 41 52 
69 0 9 51 0 0 0 9 2 13 0 19 6 17 0 12 0 4 6 0 24 8 22 16 23 16 10 0 0 0 19 0 0 24 0 0 10 8 0 0 0 4 13 0 35 0 0 47 0 48 0 25 2 
12 21 0 0 13 9 35 0 18 22 3 27 11 16 16 14 18 0 25 0 2 27 21 22 28 11 0 0 8 1 40 0 2 19 13 0 0 0 30 0 8 20 0 12 0 31 6 0 0 0 0 0 40 
0 44 12 1 12 0 3 0 2 8 6 0 0 15 36 21 0 0 0 1 0 6 0 0 15 0 32 6 15 3 0 0 17 0 0 3 0 0 0 0 4 0 32 0 0 0 0 0 38 31 36 25 0 
22 19 0 12 0 57 6 0 0 1 2 14 0 15 0 12 9 6 0 1 7 0 12 17 0 3 0 0 0 1 4 9 14 29 49 0 36 0 3 34 15 2 0 0 0 20 5 0 4 0 0 0 19 
9 0 39 30 48 0 31 3 40 15 10 13 0 0 0 6 41 10 33 9 0 0 14 0 2 0 0 3 0 0 21 15 5 0 13 0 13 1 0 33 1 39 26 9 2 12 0 0 35 0 12 28 34 
0 7 43 0 0 24 0 0 13 0 19 0 12 5 0 0 21 9 6 0 0 0 0 0 0 0 0 0 0 17 1 5 5 0 0 11 7 5 0 19 0 0 0 0 0 84 11 12 15 0 5 0 8 
0 0 0 10 27 30 0 37 8 6 0 7 6 11 32 3 0 0 15 1 12 0 0 0 14 0 0 0 0 0 0 20 0 21 0 15 0 0 0 0 0 5 0 1 38 11 0 29 0 16 0 17 0 
13 0 0 22 0 0 10 0 9 38 7 1 0 6 0 0 0 0 22 0 4 15 0 0 4 5 21 13 4 14 33 0 0 0 0 4 0 0 0 7 32 11 21 14 0 0 5 11 9 1 0 7 0 
1 39 40 8 21 63 6 0 11 18 5 7 13 0 0 15 10 0 29 0 0 13 13 15 0 28 21 0 7 15 0 5 9 7 17 0 0 17 9 55 65 34 2 3 0 41 5 77 16 10 14 0 45 
26 13 10 30 0 20 18 0 20 27 0 0 0 8 13 31 24 0 3 0 0 8 0 1 18 0 8 10 28 0 8 0 0 30 0 12 0 21 0 0 34 8 0 0 5 21 26 4 0 0 10 1 3 
23 31 46 0 4 9 5 7 0 0 8 10 0 0 0 7 0 19 30 0 2 11 35 20 25 30 7 0 0 0 15 7 10 31 0 0 16 15 9 0 6 8 8 30 2 38 5 0 30 40 8 14 9 
38 0 3 0 0 14 0 37 12 5 0 0 0 29 0 0 22 0 3 0 16 0 0 0 0 19 17 21 5 0 0 17 12 24 0 4 21 0 5 0 20 5 66 22 50 12 0 0 38 0 12 0 0 
5 0 6 0 13 1 4 2 1 0 0 0 7 28 12 10 13 0 19 0 0 0 11 10 6 10 11 0 0 13 0 0 9 11 0 23 34 0 3 0 0 7 29 18 1 0 0 0 0 0 0 0 19 
45 0 19 0 0 7 3 0 18 0 3 35 0 27 47 0 23 24 24 9 14 19 8 16 0 0 0 27 0 23 0 5 0 10 14 0 19 0 38 9 0 0 71 0 0 0 0 0 0 0 14 0 66 
0 0 5 0 4 1 10 0 8 0 0 0 18 23 24 0 15 0 34 10 15 0 0 0 0 0 0 15 0 16 7 0 6 0 13 1 16 0 0 1 0 21 0 29 0 0 0 0 0 31 1 39 0 
16 0 6 0 71 0 1 19 5 34 4 11 71 0 0 0 14 0 19 0 0 14 27 10 0 5 19 19 0 0 12 0 0 0 9 35 0 19 8 0 0 0 0 43 35 0 12 0 2 54 1 39 5 
0 11 26 33 0 29 34 0 49 26 0 0 55 19 2 26 0 0 77 29 4 2 3 11 5 3 25 0 53 5 0 6 0 20 13 10 0 0 0 21 0 20 0 34 2 80 45 0 11 0 81 0 0 
13 40 26 0 0 0 0 30 37 2 11 0 9 0 4 1 29 0 0 0 0 21 24 17 32 0 8 18 21 24 33 0 0 0 37 0 11 23 0 16 12 48 0 0 6 123 24 23 18 0 0 27 7 
