53 30
0 25 30 3 0 2 68 0 0 32 16 0 0 0 26 6 38 0 12 0 22 0 0 0 4 14 0 0 16 0 6 14 19 6 0 18 34 3 32 2 0 32 32 0 0 14 5 41 0 6 0 5 0 
0 26 1 39 5 50 0 20 5 1 29 3 19 22 0 32 22 4 0 0 1 40 1 0 12 0 0 20 5 10 38 0 0 12 14 7 22 0 11 16 20 0 13 24 32 3 0 32 16 26 0 0 12 
4 26 53 0 40 0 0 0 0 0 0 0 0 0 2 0 2 0 0 0 13 0 14 0 0 18 21 26 11 0 0 0 11 17 0 11 0 0 1 11 5 0 0 0 22 3 57 9 44 0 0 0 0 
34 0 32 10 46 65 66 44 0 0 7 3 0 26 3 0 0 28 23 0 0 0 0 29 15 0 3 22 0 0 2 0 0 0 6 0 18 1 0 59 9 0 36 0 0 25 15 0 40 0 52 44 28 
0 0 37 18 14 0 0 0 38 0 17 7 0 0 3 0 18 18 19 0 0 0 6 20 0 25 0 21 6 21 19 5 16 6 17 19 12 1 17 46 6 4 15 0 1 23 0 0 11 9 9 2 1 
0 0 17 5 0 0 0 25 29 0 8 0 23 0 32 21 29 31 0 17 0 14 7 0 0 0 26 20 5 21 0 26 6 3 18 0 4 0 7 15 0 0 8 1 0 29 0 0 19 0 21 12 116 
14 45 14 0 0 51 48 20 0 40 0 15 24 0 14 0 0 14 12 11 0 16 25 3 8 16 72 20 23 0 0 14 4 6 28 0 29 14 30 1 73 34 0 2 21 13 45 14 0 34 22 26 5 
10 0 0 36 17 38 43 0 0 7 0 0 3 11 0 11 21 13 0 0 15 0 0 3 8 2 18 3 11 5 0 3 2 7 38 0 5 1 0 0 0 0 26 34 1 5 11 0 5 43 22 48 0 
33 15 0 0 2 0 0 0 7 0 0 17 43 30 2 0 28 0 26 32 0 23 36 0 20 6 0 17 24 7 5 9 8 30 0 19 0 0 13 0 23 6 4 38 33 13 34 16 16 0 46 2 1 
57 20 30 0 0 6 0 0 23 0 0 6 11 11 0 16 9 15 12 0 7 8 20 16 11 0 0 0 0 0 0 0 47 0 0 0 0 8 0 0 7 26 20 24 0 0 0 0 32 49 1 0 4 
0 15 36 2 40 19 5 0 22 32 10 16 0 10 0 1 0 41 23 0 0 11 15 0 0 0 5 3 15 0 22 5 33 7 14 26 6 8 44 42 16 20 3 0 37 29 6 12 6 0 18 25 16 
0 0 19 0 0 0 0 35 2 0 36 40 2 12 0 9 0 1 8 21 0 0 9 0 9 0 7 0 3 3 2 3 30 9 0 3 6 0 5 0 0 1 35 31 1 36 9 0 0 16 4 25 0 
5 40 0 0 0 30 0 9 65 0 1 0 13 0 2 12 5 34 12 0 0 0 0 23 0 0 0 12 0 21 0 8 14 0 0 2 0 2 10 0 67 39 0 0 1 9 11 0 9 9 0 34 28 
14 22 1 1 0 0 13 0 0 0 1 85 9 34 14 0 0 22 0 22 9 0 22 13 0 1 6 15 0 3 9 0 8 17 1 0 3 0 12 22 0 6 4 0 22 0 13 6 37 9 56 38 0 
0 13 5 0 0 20 9 0 0 9 4 0 13 16 27 5 0 23 27 18 0 18 0 0 0 21 0 0 8 16 13 0 0 0 1 2 0 16 0 4 32 5 0 25 26 0 0 0 0 0 0 0 43 
0 0 0 29 0 35 18 33 14 3 0 44 0 14 17 0 11 0 7 0 13 0 7 0 10 7 0 0 23 0 2 26 46 0 0 0 10 5 6 4 10 0 24 4 2 34 23 0 6 0 18 84 28 
1 9 8 0 2 0 0 8 11 10 16 16 0 0 0 8 0 0 16 10 21 0 9 0 0 0 0 29 10 0 18 11 0 0 16 5 3 0 6 0 2 21 8 0 9 2 0 0 6 12 8 0 3 
37 11 7 19 0 27 0 29 0 22 12 0 38 4 0 3 0 51 2 11 0 0 0 0 19 0 0 0 0 0 0 0 27 2 0 0 2 0 2 16 54 0 7 0 0 0 0 42 0 0 0 0 0 
3 0 0 0 12 0 0 0 0 3 0 1 33 7 0 0 12 34 26 0 0 4 3 7 0 3 24 10 21 23 0 20 0 0 0 18 0 13 0 12 0 4 21 0 0 5 55 0 0 18 12 46 23 
10 39 0 4 53 0 1 44 0 0 46 36 11 0 0 0 0 55 0 27 0 57 24 12 0 6 6 17 14 0 3 28 0 2 0 7 0 12 15 14 62 0 0 0 4 1 0 26 8 7 46 29 0 
28 20 0 3 14 0 4 0 0 3 0 5 16 0 46 0 5 0 25 0 29 3 9 0 3 18 0 22 31 5 12 2 0 14 0 21 10 0 0 40 1 9 0 12 1 28 1 14 0 5 0 30 0 
48 0 0 0 46 0 0 26 17 0 29 11 0 28 0 20 19 3 0 10 0 29 5 0 14 1 0 0 21 0 1 8 0 29 0 0 0 13 8 29 0 13 26 0 0 13 47 0 15 34 0 9 0 
0 0 6 64 0 0 42 5 64 0 33 8 39 7 20 0 0 0 21 39 30 9 0 9 18 7 0 0 1 0 0 2 8 4 2 3 0 24 0 21 2 4 0 0 25 0 0 30 0 41 40 48 0 
10 7 8 62 0 0 3 33 18 8 59 5 18 29 21 0 12 13 0 15 0 0 47 8 0 6 20 4 29 18 5 10 22 0 3 0 13 0 0 0 11 28 33 0 0 0 39 18 22 27 4 7 0 
23 22 0 0 39 0 43 10 0 24 0 0 9 4 16 0 0 16 28 28 0 51 11 23 0 0 0 0 0 0 24 0 0 27 0 0 0 31 18 0 7 28 18 61 0 3 1 17 16 0 1 0 18 
4 7 0 0 0 45 2 0 0 8 0 1 11 0 22 16 0 0 0 8 18 6 15 12 0 1 0 17 39 7 18 0 17 11 3 0 6 9 0 0 0 0 21 0 3 0 1 18 5 24 44 0 0 
0 0 12 0 48 0 37 44 6 2 0 11 0 0 49 16 0 0 17 4 22 0 0 0 19 1 39 0 0 15 0 0 0 6 16 0 0 29 6 6 26 9 22 20 6 0 0 0 0 0 9 69 0 
0 30 0 0 1 0 0 25 0 0 0 0 13 17 0 19 0 6 0 0 2 0 28 0 0 6 4 11 13 0 13 36 25 0 0 0 0 18 0 32 6 0 26 0 0 0 23 11 0 16 0 29 0 
0 42 22 0 32 35 17 13 23 0 39 9 21 0 0 0 0 0 17 0 13 9 12 17 26 14 0 0 12 27 5 22 0 28 3 18 54 0 16 18 20 28 14 27 8 22 0 19 0 52 22 0 16 
0 5 16 0 26 0 32 3 68 10 12 31 17 14 15 8 28 34 25 0 0 0 3 11 19 16 0 21 21 0 0 24 0 29 0 0 1 0 32 5 9 7 34 26 28 11 29 0 0 0 7 25 56 
