53 30
17 0 0 0 36 52 0 9 6 0 0 24 0 0 34 10 2 0 2 0 0 16 0 0 9 24 6 22 2 0 5 0 43 0 0 0 0 0 0 0 36 0 0 6 29 0 0 22 34 0 0 8 0 
0 9 46 54 18 4 33 31 0 12 2 12 8 38 0 14 32 38 0 0 9 0 8 0 13 4 38 0 0 1 8 0 25 30 0 2 0 2 31 27 8 8 0 13 0 0 14 51 76 0 58 38 0 
0 0 5 21 0 0 0 9 5 0 21 0 0 6 0 18 17 18 0 12 25 4 14 0 0 0 7 0 0 29 16 4 6 9 0 0 0 3 7 8 8 5 23 3 0 0 45 9 0 5 0 34 0 
11 48 0 1 23 43 22 69 0 40 30 1 0 42 0 0 3 11 25 13 0 5 12 8 24 3 25 0 11 23 0 6 32 0 15 18 14 11 32 30 17 11 29 18 7 1 3 0 0 5 14 44 60 
0 26 0 57 4 1 14 1 31 23 15 30 0 31 0 0 0 12 24 0 12 29 12 0 18 8 0 40 0 0 0 22 7 0 4 0 20 0 37 24 0 0 6 16 53 28 0 0 22 0 69 0 22 
28 42 0 0 0 5 5 0 42 29 0 0 0 0 12 0 2 0 0 0 0 28 0 0 0 1 0 0 58 13 3 0 0 0 0 34 0 8 41 0 0 0 0 0 16 0 4 0 0 50 34 0 0 
65 37 0 0 0 0 0 6 0 0 0 0 29 13 0 0 0 0 13 30 0 13 0 0 0 5 15 0 0 0 0 52 0 0 34 10 0 30 37 0 5 47 10 6 10 0 0 0 0 30 21 0 10 
20 0 43 5 13 7 1 20 0 7 0 6 8 0 5 7 27 0 0 0 11 0 0 0 0 0 17 0 21 18 11 7 29 0 10 0 0 5 0 11 5 0 0 2 28 3 19 1 10 4 48 0 40 
0 21 0 0 0 6 0 0 21 12 0 54 0 39 13 8 14 74 16 0 23 16 0 0 0 0 10 13 0 34 15 0 0 0 4 0 0 0 0 0 2 0 0 49 0 0 35 12 18 0 33 34 41 
38 0 0 36 4 31 11 7 0 0 0 0 0 7 0 0 23 0 0 0 29 12 11 3 15 47 7 3 25 0 0 3 32 5 0 9 21 0 0 13 18 8 5 0 3 6 18 0 0 1 2 0 0 
7 46 50 16 40 47 0 37 13 0 0 3 16 47 6 4 15 0 11 27 26 15 4 0 18 34 25 11 15 6 13 12 0 0 14 6 51 34 0 9 7 1 4 70 40 20 98 0 19 48 37 22 10 
0 5 0 0 2 4 10 0 28 12 10 16 1 0 18 0 0 12 0 0 0 12 6 16 12 0 0 0 4 9 16 0 0 37 0 0 28 6 6 24 0 10 28 40 27 5 15 14 0 0 5 0 22 
0 0 0 0 0 20 18 0 0 0 5 0 24 26 0 0 13 5 11 9 12 5 4 7 40 14 1 6 0 11 0 12 25 0 11 0 0 20 0 26 16 8 0 16 7 0 1 3 1 4 0 27 0 
44 3 0 49 22 13 0 13 0 9 42 13 8 39 4 8 0 1 15 12 2 0 0 0 0 0 0 0 18 0 11 12 2 0 22 29 16 33 0 0 0 4 0 0 21 0 0 0 2 0 0 9 26 
29 68 0 7 2 42 2 0 0 8 0 0 32 0 46 1 1 2 8 0 0 5 18 0 5 24 19 0 0 15 14 22 0 19 8 5 0 37 0 0 57 63 23 44 26 25 35 0 32 52 1 6 38 
26 13 10 0 0 0 5 10 44 8 0 16 47 3 44 29 0 21 5 0 0 5 0 23 5 0 12 0 0 0 0 31 12 0 0 0 0 15 0 6 26 9 31 0 36 0 0 0 2 9 13 39 15 
0 15 0 0 4 38 25 0 40 0 25 32 0 0 0 0 14 12 0 0 12 27 8 4 0 7 0 26 7 0 11 34 25 0 0 17 0 0 0 31 9 11 0 46 0 0 0 0 0 0 0 0 41 
53 0 25 5 38 6 29 31 31 0 5 41 0 2 19 15 0 0 0 0 24 0 24 0 22 17 16 0 10 0 0 0 12 0 18 0 0 5 11 28 0 27 2 9 30 0 43 0 10 47 16 48 10 
86 1 18 44 4 38 34 31 19 59 0 71 0 31 0 0 30 39 12 0 0 8 0 0 19 8 0 40 23 0 24 8 11 22 0 33 0 28 63 26 31 12 0 38 31 0 65 44 0 4 0 74 0 
0 44 0 21 18 0 18 0 0 0 36 2 0 0 0 11 0 11 37 9 0 18 7 37 0 19 11 0 2 14 0 0 19 0 9 3 5 15 15 4 0 7 0 6 13 56 36 37 0 0 42 0 14 
0 0 0 0 0 19 10 45 0 0 0 0 0 0 0 0 4 4 0 24 32 32 0 4 0 0 2 0 0 0 31 11 6 0 14 3 0 0 3 0 0 0 2 24 31 7 0 17 2 2 20 0 45 
0 30 22 0 10 0 6 32 6 24 0 4 0 0 0 8 34 0 0 3 17 3 0 0 0 1 21 11 0 6 28 0 0 36 0 24 15 36 8 38 0 9 1 24 15 12 0 31 0 23 14 0 2 
25 4 27 0 19 7 0 0 0 0 37 0 19 0 27 3 0 0 0 7 0 3 0 0 3 6 1 32 0 79 0 12 0 5 0 0 0 22 5 0 0 25 1 14 21 6 0 4 2 2 0 2 0 
9 35 0 4 9 7 0 0 15 33 27 0 0 0 0 0 0 12 31 7 22 0 19 0 1 0 29 5 12 19 9 23 14 2 11 2 35 4 0 12 0 9 37 1 28 2 0 27 19 31 0 19 0 
23 0 0 0 0 0 0 0 0 2 0 7 0 0 0 0 27 26 21 18 0 4 0 23 16 21 0 0 0 1 1 18 0 0 0 0 0 18 22 1 0 41 0 47 0 0 21 0 1 3 0 12 13 
0 15 11 11 2 5 0 0 44 0 0 9 0 0 0 33 10 0 12 16 17 0 4 0 0 0 8 7 8 14 0 0 25 4 9 19 0 1 0 22 0 0 28 1 0 31 0 5 1 0 16 36 26 
23 18 25 0 0 39 6 0 24 26 0 33 28 12 12 0 12 24 2 8 8 20 0 51 15 26 0 10 11 29 0 38 0 5 16 0 3 0 2 17 17 0 0 24 11 0 27 0 58 32 8 54 9 
22 96 0 13 24 11 6 17 12 14 0 12 2 0 0 17 3 0 28 16 30 28 0 0 17 13 17 24 0 0 21 0 62 0 23 0 0 0 0 33 27 1 1 0 0 15 19 0 0 79 9 0 0 
20 0 0 0 0 28 0 25 43 14 0 26 52 13 14 0 0 39 0 33 3 0 31 25 3 25 0 1 15 9 0 2 0 0 0 12 0 17 0 51 0 30 0 47 7 0 0 35 0 9 0 76 18 
38 38 49 0 22 5 0 21 13 31 25 0 18 6 5 0 0 0 0 25 0 28 16 0 0 0 0 0 19 0 12 14 37 0 0 0 36 0 8 2 33 11 2 15 25 18 44 0 0 30 1 49 45 
