53 30
20 4 0 3 0 26 38 0 29 38 0 11 0 19 0 3 0 14 0 24 0 0 0 18 14 21 3 0 0 14 1 32 2 0 49 0 0 0 18 0 0 0 0 24 38 0 0 38 5 0 0 0 39 
0 15 0 0 63 13 0 0 16 54 11 15 0 23 10 11 13 21 13 0 0 1 0 37 8 25 15 0 0 0 26 15 0 15 0 12 24 0 26 0 32 20 0 22 0 21 0 0 27 33 20 18 1 
8 4 0 0 25 18 0 19 8 34 13 22 48 6 0 2 5 11 3 0 0 9 0 24 0 6 19 20 14 16 0 0 2 19 0 4 13 0 8 21 0 20 8 34 0 0 0 0 0 21 0 27 0 
0 52 0 19 0 42 0 0 8 0 6 2 13 35 28 3 59 0 0 0 0 0 0 13 10 42 13 15 15 0 0 0 0 0 0 0 0 12 23 0 15 13 25 27 2 0 40 42 68 11 0 0 14 
0 4 0 12 56 0 50 27 2 0 22 0 0 0 0 9 9 16 14 17 0 6 0 4 23 9 11 19 0 3 16 0 20 19 17 0 0 31 3 15 14 0 0 0 8 21 58 15 29 9 0 0 0 
0 2 45 0 35 31 0 5 18 0 37 0 33 0 0 18 6 0 63 14 3 0 0 27 1 15 0 0 0 0 0 16 0 0 26 26 0 22 0 35 39 10 0 0 41 0 41 57 27 0 10 4 34 
0 40 3 14 0 26 0 13 0 0 0 73 5 4 6 70 21 30 0 0 0 0 6 16 34 17 6 0 0 19 29 26 0 0 18 17 2 0 26 0 0 19 17 32 0 0 4 13 14 8 15 22 76 
0 55 0 0 39 5 0 25 0 2 0 0 33 0 8 5 0 0 0 0 0 42 7 8 12 10 25 0 0 16 0 17 47 15 0 17 0 0 3 0 0 0 0 17 28 33 1 18 17 0 29 0 0 
29 37 0 31 37 34 28 38 54 0 3 3 36 16 30 0 0 0 0 22 0 17 11 5 17 5 48 0 9 34 19 0 0 21 4 20 2 5 28 3 4 0 3 0 34 26 0 0 36 0 43 0 0 
0 27 4 0 2 0 47 14 0 5 27 39 0 0 0 4 10 11 17 0 0 24 29 33 27 8 2 25 45 0 0 5 2 0 5 19 13 0 0 0 0 12 1 1 0 34 0 0 24 1 0 40 25 
17 27 0 27 37 0 0 3 18 1 17 30 3 34 0 0 0 21 0 0 31 0 11 0 0 10 19 26 15 0 0 0 0 15 23 0 0 4 14 19 6 37 9 14 0 5 10 0 0 0 0 6 0 
0 25 0 17 14 41 8 21 44 16 10 0 5 7 29 12 18 13 0 0 11 26 0 1 11 24 11 16 46 8 7 7 13 3 14 0 0 1 1 0 1 21 21 13 0 0 46 0 27 41 0 1 14 
37 0 0 37 17 15 0 24 12 11 3 29 0 25 21 37 0 0 0 0 43 43 0 1 6 9 0 3 17 0 18 24 0 12 0 37 0 53 13 0 54 28 0 0 7 7 0 0 24 9 29 16 9 
0 0 5 29 4 36 1 27 10 0 0 7 17 0 2 5 56 0 0 0 17 0 0 0 0 21 0 0 0 21 0 3 0 0 0 16 0 6 7 16 0 59 0 6 0 20 0 0 12 24 0 0 14 
0 0 42 18 0 28 37 0 22 20 0 0 11 34 13 32 27 21 18 1 9 5 14 10 12 0 14 0 0 13 14 0 26 4 19 22 0 0 3 0 0 0 24 4 28 0 0 43 19 0 0 72 14 
0 11 0 4 0 2 0 5 12 0 4 36 0 0 28 0 22 0 33 30 17 0 13 0 4 0 0 3 0 0 4 0 5 0 0 10 14 12 15 3 0 4 3 22 16 0 3 36 0 30 2 0 0 
0 47 7 0 24 0 0 15 6 0 0 0 5 16 6 0 36 14 0 0 16 0 47 0 0 0 20 0 47 5 26 19 0 0 8 0 19 12 25 0 7 8 8 0 12 5 11 46 20 34 0 2 36 
52 0 0 23 0 0 8 0 29 0 0 62 0 12 16 33 0 0 16 33 0 0 15 9 0 4 43 6 0 12 16 0 5 15 0 0 6 70 0 0 0 6 0 0 0 7 9 0 33 8 10 0 29 
34 0 0 21 86 0 0 10 0 0 15 0 0 3 4 37 3 0 4 29 0 18 0 10 16 0 7 0 0 0 0 0 0 7 0 3 7 10 12 0 28 17 0 39 11 9 0 10 19 9 17 45 37 
0 73 28 0 39 1 8 23 5 0 10 17 0 33 16 26 11 24 31 32 16 29 0 0 0 16 0 0 14 15 54 27 31 5 3 0 29 0 0 3 53 58 0 0 76 0 46 15 20 71 32 16 0 
6 1 0 14 34 1 2 0 0 0 17 6 0 31 36 3 0 7 0 16 3 23 16 0 23 3 1 3 8 0 0 7 0 6 7 0 8 0 33 7 0 11 0 0 63 0 13 0 0 0 45 8 0 
0 0 50 1 84 0 53 0 0 0 0 21 0 36 2 0 3 0 4 0 0 0 19 20 0 21 13 0 0 2 19 41 0 0 28 0 7 0 12 0 0 19 29 39 0 0 0 7 0 0 76 40 50 
0 15 20 0 0 24 21 24 9 10 39 5 0 42 36 30 1 0 17 10 0 0 20 1 11 1 16 13 20 30 17 0 4 0 9 15 5 0 0 0 7 20 0 0 0 8 0 34 0 20 36 0 10 
0 0 14 0 0 30 36 0 0 7 31 0 25 11 35 40 21 0 11 15 12 6 0 13 10 3 0 28 15 16 0 19 0 5 8 2 16 26 0 0 12 17 13 0 0 17 31 0 8 35 8 11 31 
0 0 0 8 6 0 0 0 31 10 20 8 0 9 23 0 0 30 0 10 9 15 1 3 36 0 0 0 3 20 20 3 0 0 0 0 0 0 0 15 3 0 0 0 0 0 0 30 21 0 0 0 7 
0 35 0 11 13 23 16 4 37 0 0 5 11 22 0 0 38 0 0 0 32 17 22 0 1 15 7 0 21 0 0 0 0 0 12 0 28 9 10 0 0 0 0 0 0 37 0 0 0 0 0 15 82 
0 34 9 46 6 18 0 0 0 17 0 31 1 4 35 6 0 0 17 0 0 14 0 4 0 25 12 22 12 4 0 20 4 21 5 0 13 0 0 7 5 3 0 0 11 40 2 0 2 17 5 6 20 
17 20 15 76 19 35 8 26 95 36 43 1 55 28 0 13 27 57 0 24 0 13 0 24 0 20 15 0 0 17 15 0 0 26 2 32 2 33 0 24 72 65 14 30 38 52 11 7 49 0 10 0 74 
0 0 0 49 0 0 0 0 0 0 30 1 0 27 0 0 0 8 5 0 0 36 0 50 22 22 0 19 0 0 17 0 0 42 5 22 14 11 0 5 30 1 25 10 14 7 30 29 0 0 22 22 56 
0 9 0 0 5 21 0 2 28 0 20 0 6 0 0 17 0 0 0 0 0 0 0 18 0 0 22 0 17 12 0 0 22 0 0 0 8 1 0 0 35 0 0 0 25 0 0 0 0 0 0 0 0 
