53 30
7 1 0 29 0 0 19 27 0 0 15 0 0 17 0 0 0 52 10 0 0 24 19 0 29 13 17 23 15 0 0 21 0 0 0 20 19 12 0 15 32 9 6 5 55 0 4 6 13 0 0 48 31 
49 13 5 8 28 17 0 66 0 0 0 34 28 19 0 29 24 0 1 0 20 1 7 0 10 6 4 0 0 0 0 17 29 0 30 0 21 0 16 12 3 34 0 0 4 70 0 30 54 97 6 11 8 
0 13 22 14 0 59 0 0 37 26 0 0 0 0 0 0 0 2 13 21 16 22 0 0 25 0 0 3 44 0 2 0 19 0 13 16 27 5 4 0 30 0 8 0 30 28 0 15 0 21 0 113 47 
11 2 0 41 36 28 30 27 0 27 10 0 2 23 0 0 0 13 8 34 4 45 20 22 20 0 0 0 0 0 6 19 8 28 16 35 9 0 0 39 44 0 0 1 50 0 20 0 0 40 2 0 11 
39 7 21 0 2 48 3 15 13 0 32 5 0 0 0 1 0 12 0 0 48 13 22 24 24 0 0 24 13 0 2 0 0 0 19 0 0 66 0 0 6 13 5 28 4 2 0 0 0 0 0 31 0 
32 9 31 0 0 15 0 16 13 0 7 1 46 0 35 0 28 5 0 25 15 32 14 17 0 22 16 36 0 0 0 0 47 31 15 12 31 0 3 12 29 0 0 0 21 0 2 33 16 0 0 5 29 
81 5 42 20 0 0 0 12 0 0 15 15 29 23 6 0 3 9 11 29 32 0 0 19 0 39 19 16 0 29 30 0 0 27 8 0 0 11 36 5 0 29 0 0 0 27 26 5 0 24 9 0 11 
17 3 10 35 0 15 0 5 6 5 28 31 22 39 15 0 0 0 4 23 24 0 35 22 0 15 0 0 15 0 8 0 21 31 16 0 0 19 14 0 16 0 34 0 0 23 0 0 0 11 0 0 39 
3 10 8 29 0 48 15 24 0 0 11 0 0 0 0 13 31 0 33 4 0 0 3 16 20 19 15 0 0 11 0 54 15 0 0 20 0 0 7 6 11 0 0 0 0 0 0 13 43 8 0 0 0 
43 2 0 38 0 0 23 5 16 0 0 0 31 6 0 0 10 0 17 6 0 18 19 3 8 7 10 0 0 11 0 29 12 0 12 0 0 4 0 0 14 9 9 37 7 0 12 1 68 15 10 0 0 
0 106 0 5 1 30 23 0 0 16 31 17 0 13 0 17 9 1 0 30 0 14 0 27 5 5 6 4 0 23 15 0 6 7 33 23 0 16 37 36 0 31 7 17 26 29 0 39 0 0 27 8 16 
6 64 0 2 20 39 38 32 21 0 6 0 0 0 13 12 0 12 1 0 0 0 38 8 40 4 4 13 18 49 12 4 24 17 0 29 0 5 4 1 4 17 0 10 31 7 0 40 0 5 28 0 30 
39 0 0 22 0 43 33 5 0 0 5 19 42 6 0 0 0 12 8 22 11 19 0 2 0 25 0 0 15 17 21 11 0 0 13 0 0 13 15 6 52 22 0 0 31 40 6 0 36 0 13 0 5 
0 39 0 0 0 9 15 0 21 0 21 11 4 34 31 0 4 0 0 3 4 0 64 0 0 20 0 0 6 0 0 0 25 7 7 0 22 3 0 15 21 19 20 0 10 0 0 40 0 0 10 0 13 
0 0 0 39 0 13 0 0 7 0 9 0 0 35 35 24 0 0 6 31 25 36 0 7 8 0 24 22 1 0 2 0 0 0 0 9 49 10 18 3 0 0 0 3 30 18 6 0 39 0 16 0 16 
0 19 0 13 42 31 0 0 0 0 0 0 0 12 0 0 0 9 3 2 0 2 8 0 0 19 0 0 25 0 0 0 2 32 0 10 31 0 0 0 0 0 0 6 0 0 0 4 0 0 25 0 6 
13 0 0 4 0 30 17 0 3 0 9 1 1 10 0 15 0 3 0 13 2 0 0 27 14 16 10 0 0 0 8 0 0 3 0 3 0 0 24 0 0 0 39 0 11 0 41 13 0 4 0 0 0 
0 0 16 52 0 34 31 11 4 0 7 0 0 38 46 9 7 32 14 2 26 4 11 6 0 26 17 0 12 9 27 20 1 19 20 14 15 31 0 8 14 0 0 0 1 11 32 53 34 32 0 6 6 
11 8 8 30 43 8 0 45 5 0 0 0 38 9 18 0 0 16 5 12 29 0 28 0 0 0 26 0 5 6 10 12 26 33 7 2 4 17 0 2 4 11 9 9 34 1 0 45 4 2 83 0 88 
0 1 0 2 3 2 22 52 0 31 14 0 30 4 0 0 0 10 8 0 0 23 0 36 0 0 0 0 6 0 14 0 0 4 21 25 19 0 0 0 31 1 30 8 9 2 0 6 0 0 22 28 0 
8 10 22 0 9 23 0 0 37 0 13 0 0 0 0 0 0 0 0 27 15 17 0 0 30 8 0 0 0 0 0 0 0 12 0 37 0 0 19 0 5 0 0 40 0 35 27 12 0 4 8 0 6 
0 64 8 25 23 47 0 38 0 9 21 20 16 0 13 0 30 0 2 4 5 0 0 0 0 0 0 18 5 0 0 0 16 0 9 0 10 14 0 10 0 5 0 0 0 4 9 0 0 4 53 0 15 
45 0 36 0 22 0 0 0 0 0 9 0 0 0 49 0 1 0 6 47 19 0 3 8 17 35 0 62 15 0 0 19 0 0 0 16 0 0 36 5 0 18 0 0 0 0 19 25 0 24 0 0 38 
0 75 8 10 0 0 16 1 37 0 36 36 0 22 0 16 1 0 15 0 0 11 20 0 20 0 29 29 0 8 0 7 9 0 13 15 0 26 10 8 23 0 7 0 12 0 1 46 10 39 0 4 25 
51 0 0 24 0 0 0 14 0 0 20 0 0 0 0 0 0 0 27 32 0 40 0 3 0 0 0 10 0 1 27 0 0 5 0 0 13 11 0 0 13 8 0 0 0 44 0 0 0 24 12 19 3 
20 0 0 3 7 0 0 8 34 0 0 0 0 34 10 3 25 3 0 29 5 28 16 40 0 0 16 0 0 0 0 16 7 0 24 0 0 13 16 8 27 25 31 2 12 2 4 27 29 0 0 23 0 
23 47 38 30 1 0 15 0 8 16 5 0 13 53 0 0 2 0 2 0 53 15 0 3 0 13 0 0 0 0 22 13 49 9 0 0 3 8 0 13 0 0 0 0 56 0 26 34 0 0 2 22 18 
0 12 2 47 1 0 4 59 5 2 13 16 0 17 0 4 0 0 0 0 13 0 0 0 0 0 26 17 20 0 14 5 39 16 4 0 0 6 10 0 12 9 0 3 0 6 4 2 20 16 29 1 45 
7 75 23 37 23 0 31 28 20 10 34 14 17 8 14 0 12 28 43 12 5 27 37 5 6 40 0 8 26 18 18 0 0 18 7 14 29 0 0 9 11 43 0 0 40 5 43 0 34 11 23 22 0 
0 9 0 18 37 28 32 0 39 0 0 0 0 33 24 0 0 29 0 0 0 18 0 0 0 0 19 0 0 12 0 0 6 13 21 0 20 0 8 0 0 0 22 0 0 0 10 8 44 0 0 0 0 
