53 30
5 43 15 18 10 28 9 7 3 43 106 34 13 11 31 15 0 15 21 0 12 19 4 20 11 0 0 16 28 0 38 0 12 11 19 17 5 0 12 29 29 11 38 20 51 51 36 38 0 0 8 0 0 
0 45 0 26 30 0 0 40 12 23 2 3 39 0 11 22 0 26 23 12 0 1 0 0 9 0 11 0 1 14 0 0 23 32 0 18 5 11 0 2 11 4 7 42 0 4 0 40 0 0 0 39 0 
0 47 0 20 0 35 7 0 8 0 5 0 19 0 0 2 0 2 16 0 0 0 15 42 51 0 52 0 6 0 4 12 31 10 16 0 29 20 0 49 0 1 6 0 0 4 40 21 14 47 0 0 47 
51 24 36 1 47 21 22 24 15 32 0 14 0 4 0 8 0 21 18 8 25 30 18 0 22 12 11 8 1 0 0 25 0 27 14 18 0 6 62 0 18 29 0 21 3 25 0 0 29 6 0 40 0 
58 0 0 27 48 26 13 21 30 36 18 0 0 6 24 16 33 36 0 6 17 0 22 7 2 15 30 26 21 14 20 48 3 5 0 17 47 23 41 6 0 0 56 21 0 18 0 30 0 14 0 0 44 
0 17 13 17 14 0 0 12 19 0 12 8 0 11 4 0 0 0 0 6 42 10 4 0 17 0 24 19 18 0 2 0 14 9 0 21 0 1 0 0 3 4 6 0 4 26 0 0 0 11 0 0 0 
5 50 13 0 0 0 29 53 7 2 23 1 2 0 0 43 0 0 0 0 10 1 0 0 3 0 0 3 0 0 11 0 8 26 0 1 30 1 6 18 5 0 32 33 0 16 39 8 6 0 0 13 0 
0 52 0 16 1 1 20 0 0 0 14 4 37 12 0 0 0 0 23 16 20 4 0 0 0 4 0 0 0 0 6 0 5 0 0 0 0 0 0 0 20 44 0 2 0 0 6 1 0 37 0 0 6 
33 0 25 0 16 5 8 0 0 0 9 9 0 8 6 0 12 13 15 9 0 27 9 0 22 0 3 0 6 0 8 19 0 3 4 5 0 19 18 0 0 15 28 1 0 0 12 1 17 0 17 10 0 
0 6 14 35 19 0 0 45 0 0 0 0 4 53 0 7 15 0 9 5 0 8 13 0 5 0 35 15 0 0 12 21 15 6 13 32 0 6 17 0 7 9 13 0 0 32 0 15 0 6 11 1 44 
0 0 7 73 2 6 34 17 25 62 27 2 0 0 4 0 8 19 0 0 3 0 0 0 37 9 0 0 5 26 19 0 9 22 9 7 0 0 19 6 103 9 34 36 0 0 0 4 0 25 41 0 0 
28 0 0 8 3 76 33 48 8 31 7 17 0 0 0 0 10 0 2 0 0 0 2 16 0 8 12 0 4 0 14 5 0 1 0 10 0 0 5 31 55 13 43 0 0 0 24 23 3 0 20 23 0 
0 14 0 0 0 16 0 9 0 0 9 15 0 0 35 14 9 0 0 0 7 0 4 1 4 0 25 21 0 1 0 0 21 0 3 11 0 0 7 0 0 0 36 4 16 0 0 0 5 35 0 4 6 
38 25 36 63 0 2 17 25 40 22 14 6 21 18 12 0 36 21 14 0 27 18 3 33 28 28 43 2 18 1 4 29 4 4 32 22 0 0 10 9 5 6 0 3 85 0 17 37 1 44 49 2 43 
0 5 9 0 0 13 0 0 0 7 0 0 0 0 0 0 5 11 0 14 0 0 0 0 0 0 10 0 0 0 0 0 7 0 0 10 0 0 11 0 0 0 2 0 8 0 0 0 3 0 0 0 0 
0 6 13 0 9 4 39 9 26 1 46 0 0 0 0 25 1 7 0 14 0 0 0 7 29 2 0 0 0 0 25 0 0 10 5 4 11 0 0 0 0 0 0 40 0 15 2 0 24 0 7 45 0 
0 40 0 19 0 60 45 0 7 14 3 31 49 42 6 23 6 15 17 0 0 1 29 12 0 6 15 8 25 0 0 5 15 31 22 15 23 0 0 41 11 0 14 42 36 20 0 0 0 24 1 53 0 
0 47 18 49 1 40 0 42 0 30 0 16 0 0 0 25 15 13 3 0 4 0 42 0 5 0 0 15 0 27 13 15 0 9 7 15 3 0 0 0 23 0 9 35 0 35 39 12 0 0 8 0 97 
0 0 6 44 0 23 0 21 21 0 41 13 20 0 0 0 4 3 0 0 0 0 1 2 13 1 19 0 2 4 0 0 3 24 0 3 24 0 0 0 0 30 36 3 0 0 3 35 38 0 7 0 6 
49 29 10 15 8 20 27 14 26 5 6 0 0 0 1 4 0 29 34 0 29 0 14 0 0 19 11 19 27 0 2 0 9 29 19 27 0 15 6 0 0 32 41 16 19 17 0 5 40 49 0 11 0 
0 1 0 0 0 0 0 0 0 4 3 28 0 0 0 0 12 18 0 0 0 0 0 0 0 0 0 0 4 9 0 0 4 0 6 16 7 7 5 28 4 0 8 0 0 0 0 0 0 0 0 0 0 
10 6 0 36 0 28 33 0 0 39 52 10 13 0 0 0 20 2 0 16 24 10 0 0 0 0 0 4 0 0 0 0 0 50 0 22 1 27 0 24 0 10 0 1 26 39 0 0 67 0 2 21 0 
0 35 12 22 12 55 1 11 3 22 17 0 19 4 4 0 0 0 48 31 0 0 0 0 14 20 17 15 0 3 0 0 0 9 10 13 0 12 0 0 3 0 9 17 15 5 0 0 0 0 9 0 0 
0 0 0 0 20 0 0 22 0 6 28 0 18 6 27 4 27 20 7 0 0 10 0 10 8 7 5 0 15 10 18 15 7 10 7 0 0 0 0 12 24 0 0 0 10 6 51 5 0 0 42 55 0 
38 12 0 1 55 21 0 0 0 18 0 28 0 0 0 10 22 0 0 0 9 0 25 14 0 0 10 0 5 0 10 0 0 19 5 0 0 37 15 0 2 21 0 24 10 4 0 10 20 0 17 0 57 
0 0 0 21 0 52 0 0 12 0 4 0 0 20 0 0 0 24 4 4 0 0 9 0 41 1 1 0 0 24 0 0 0 36 0 0 0 3 32 36 0 3 0 21 0 0 0 0 0 0 18 1 0 
0 1 3 0 0 10 0 0 71 26 2 10 39 34 0 0 19 0 32 0 8 3 0 7 21 0 0 0 8 0 6 19 0 0 0 2 6 1 31 0 16 0 41 21 0 21 0 0 0 0 27 0 0 
41 54 87 45 3 23 38 65 0 1 38 0 0 0 0 8 17 0 0 10 0 0 21 0 0 0 0 20 45 4 4 19 0 24 28 0 30 23 0 0 10 0 6 41 0 0 0 13 5 39 0 0 24 
0 49 0 12 36 39 11 0 17 43 16 23 22 3 0 0 22 45 3 0 23 0 0 19 11 11 0 0 5 16 0 25 21 0 11 31 11 9 66 0 0 33 7 7 56 33 5 20 10 0 0 53 43 
0 0 3 34 26 0 0 4 0 0 39 0 2 9 0 0 0 0 6 7 0 14 14 3 9 0 16 36 0 0 27 27 0 9 24 23 27 0 10 0 37 3 0 0 0 0 0 16 36 0 0 0 0 
