8 5
0 0 0 0 0 0 0 0 
7 0 0 0 0 0 0 7 
3 1 2 0 0 0 0 0 
0 0 0 0 0 0 0 0 
0 0 0 0 0 0 0 0 
