8 5
0 1 5 0 0 0 7 0 
0 3 0 0 0 0 0 0 
2 2 0 0 0 0 0 0 
0 0 0 0 0 0 3 0 
4 2 0 0 0 0 1 0 
