8 5
0 1 0 4 0 4 0 0 
0 0 0 0 0 0 0 0 
0 0 4 0 0 0 4 0 
0 3 0 1 1 3 0 0 
0 0 0 7 0 3 1 0 
