8 5
0 7 0 0 3 5 0 0 
0 0 0 0 0 1 0 0 
0 1 1 0 2 4 9 0 
0 0 1 0 0 0 0 0 
0 0 2 1 1 0 0 0 
