8 5
0 0 3 0 2 0 0 5 
1 0 0 0 0 0 0 0 
6 3 0 1 6 4 2 0 
0 5 1 1 0 0 0 6 
0 0 0 0 0 0 0 0 
