8 5
0 2 0 0 0 0 0 0 
0 1 0 0 0 0 0 0 
0 1 0 0 0 0 0 1 
8 0 7 0 2 0 0 12 
9 1 0 3 4 0 0 1 
