8 5
0 0 0 0 3 2 0 5 
0 0 0 2 0 1 1 0 
0 0 0 0 0 0 0 0 
0 0 0 0 0 0 0 0 
0 0 0 0 0 0 0 0 
