8 5
0 0 4 0 0 2 4 0 
0 0 0 0 2 0 0 0 
6 0 2 0 7 2 4 0 
11 4 0 0 3 6 1 5 
0 0 0 0 2 0 1 0 
