8 5
11 2 0 0 0 5 0 7 
0 0 0 0 0 1 0 0 
0 3 0 2 6 0 0 0 
0 0 4 0 1 0 3 1 
1 4 0 0 2 5 0 0 
