8 5
11 0 2 3 0 1 0 0 
11 6 4 4 4 0 8 2 
0 0 1 0 0 0 0 0 
0 3 0 0 3 0 0 0 
0 0 0 0 0 4 3 0 
