8 5
3 1 1 5 0 4 0 0 
0 0 0 0 2 0 0 0 
2 0 0 0 0 0 0 0 
0 1 1 5 2 0 4 0 
7 6 0 4 4 2 1 11 
