8 5
10 4 4 3 0 4 1 0 
2 1 2 0 0 0 0 0 
0 2 1 0 3 0 0 0 
0 0 0 1 0 3 0 0 
5 1 4 2 0 0 1 0 
