8 5
1 2 0 3 5 0 0 0 
2 0 0 0 1 0 0 2 
2 2 0 2 2 0 0 7 
1 0 0 0 2 0 0 2 
3 0 6 0 1 1 5 0 
