8 5
0 6 0 0 2 0 2 6 
0 0 2 0 2 0 0 0 
0 2 0 0 1 4 0 1 
5 0 0 3 2 3 4 2 
0 0 2 1 2 2 0 2 
