8 5
0 0 0 0 3 0 0 0 
5 0 1 1 2 8 7 4 
0 0 1 0 2 0 0 0 
1 4 5 2 4 3 4 1 
0 0 0 0 0 0 0 0 
