8 5
0 1 1 4 0 3 1 2 
1 9 0 3 4 3 3 3 
0 8 0 2 0 0 0 6 
0 5 1 0 1 3 2 0 
0 0 1 1 0 0 0 0 
