8 5
3 3 2 2 1 1 1 3 
0 3 2 1 5 1 1 0 
6 2 0 0 2 0 0 0 
1 1 3 0 0 1 1 0 
2 6 0 0 0 4 0 0 
