8 5
2 0 0 0 0 4 0 0 
0 1 0 0 1 1 3 0 
3 6 2 0 1 4 7 0 
0 5 0 0 0 0 4 0 
1 2 9 8 2 7 3 0 
