8 5
1 2 0 0 3 7 1 0 
0 0 4 1 3 2 4 1 
2 1 1 1 0 0 1 0 
0 0 0 1 2 3 2 3 
2 0 2 0 3 0 10 3 
