8 5
5 0 0 3 3 0 0 2 
4 0 0 1 3 1 0 4 
1 4 2 0 0 2 1 1 
0 1 1 3 3 2 0 0 
0 0 3 0 0 3 1 6 
