8 5
4 10 1 2 5 1 3 6 
5 2 5 0 0 5 0 5 
5 0 0 0 2 5 0 2 
3 5 0 1 1 0 1 1 
0 1 0 0 2 1 0 2 
