10 6
0 8 0 0 0 1 4 0 0 8 
0 0 0 0 0 2 0 0 4 0 
0 0 0 0 2 5 0 3 3 2 
0 0 0 0 0 2 0 0 0 0 
0 6 0 0 0 0 0 6 0 2 
8 8 1 3 3 1 1 1 9 1 
