10 6
0 0 0 4 0 4 0 0 0 6 
8 0 1 0 2 0 0 3 11 6 
9 0 3 0 4 0 0 0 1 11 
0 0 0 0 0 0 0 0 0 2 
1 6 0 4 0 0 0 0 10 8 
0 0 0 0 0 0 0 0 0 4 
