10 6
0 8 0 0 0 4 0 4 0 2 
0 0 4 3 0 0 0 0 5 0 
6 1 2 0 4 0 0 0 13 4 
0 7 0 2 0 0 2 6 2 1 
0 0 2 0 2 2 0 6 2 4 
0 2 4 0 0 0 0 0 0 0 
