10 6
0 0 0 0 0 0 0 0 0 0 
5 0 0 0 2 9 2 4 0 3 
0 0 0 0 2 0 1 1 0 1 
1 0 0 4 0 0 8 5 2 0 
0 6 0 5 0 0 1 7 5 0 
0 0 3 3 2 2 1 1 0 0 
