10 6
0 0 0 0 0 0 0 0 0 0 
6 4 5 2 5 4 5 8 6 7 
0 0 0 0 0 1 0 0 0 0 
9 0 0 0 5 0 2 1 0 14 
6 5 0 4 0 5 1 0 0 4 
6 0 0 1 0 0 4 0 0 0 
