10 6
0 0 0 1 6 0 0 0 0 7 
0 0 5 2 2 5 0 7 0 0 
0 0 0 0 0 0 1 0 0 3 
2 2 2 3 2 0 4 0 0 1 
0 0 0 1 1 3 0 0 0 0 
1 14 0 4 0 5 6 6 0 8 
