10 6
17 2 0 0 1 9 0 6 8 0 
0 3 0 0 0 3 0 0 3 0 
0 0 0 0 0 0 0 0 0 0 
10 9 0 3 0 2 5 2 0 11 
5 5 1 3 1 4 5 1 3 5 
5 0 0 0 0 0 0 0 0 0 
