10 6
0 0 6 0 3 1 0 0 6 0 
1 0 0 0 1 0 0 0 3 0 
10 2 3 0 5 5 0 6 2 1 
0 0 0 0 0 0 0 0 0 0 
1 1 0 0 5 2 2 0 1 0 
0 0 6 2 6 2 0 0 10 3 
