10 6
0 2 17 0 0 4 0 0 13 2 
0 8 0 0 0 0 3 0 0 8 
0 0 0 0 0 0 0 0 0 0 
0 0 0 0 4 4 0 0 3 5 
10 5 4 4 7 1 0 6 5 15 
0 5 0 6 0 4 0 0 0 3 
