10 6
2 8 0 0 0 0 0 6 0 0 
0 0 2 4 2 0 3 0 0 3 
2 3 5 4 0 1 2 0 1 4 
0 0 0 6 0 0 0 0 1 5 
0 1 0 0 0 0 0 0 0 3 
4 11 2 1 3 4 2 3 0 0 
