10 6
0 0 0 0 4 0 2 3 4 2 
5 1 3 0 0 0 0 0 0 0 
5 0 3 4 1 9 4 3 0 3 
4 1 1 0 1 2 2 4 0 0 
0 0 3 0 0 0 0 0 0 0 
3 4 0 0 2 7 6 0 0 4 
