10 6
0 3 0 0 3 1 1 0 0 0 
0 0 0 3 0 0 1 0 0 0 
6 0 0 2 0 0 6 0 0 0 
1 11 4 1 1 3 4 4 12 0 
24 1 1 4 5 0 4 7 2 2 
0 0 7 0 0 0 7 0 5 4 
