10 6
1 0 4 6 1 0 3 5 8 9 
13 4 4 1 2 3 5 2 8 4 
0 0 0 0 0 0 0 0 0 1 
0 3 0 1 3 0 0 0 0 0 
0 0 4 0 0 0 4 0 0 0 
4 0 2 2 0 0 0 7 0 4 
