10 6
9 10 4 0 7 3 0 0 6 8 
15 0 7 7 0 0 0 4 0 2 
0 2 7 0 0 0 1 0 2 0 
2 0 3 0 2 0 0 0 1 0 
0 0 0 3 0 2 1 0 1 0 
0 0 3 1 11 1 4 3 0 0 
