8 5
0 0 0 0 0 0 0 0 
6 0 0 0 2 0 8 3 
0 0 0 0 0 0 0 0 
0 0 0 0 0 0 0 0 
7 6 0 0 0 0 0 10 
