10 6
0 0 0 0 1 2 0 0 3 0 
0 7 5 0 1 0 4 1 7 0 
3 0 0 0 4 2 1 2 1 1 
1 0 0 0 0 0 0 0 0 2 
4 1 0 1 4 5 3 3 0 4 
3 5 3 4 3 1 6 4 6 2 
