10 6
0 0 0 6 0 0 2 0 4 8 
7 0 12 2 2 6 5 0 3 9 
9 0 0 0 3 0 1 0 1 11 
0 0 0 0 0 0 0 0 0 0 
1 8 6 0 0 0 1 1 6 0 
1 1 2 0 1 4 3 0 2 0 
