10 6
4 2 0 0 4 0 3 0 0 3 
9 4 1 0 5 3 1 2 1 15 
0 3 0 0 0 0 0 0 2 0 
3 0 2 3 3 3 0 3 2 0 
7 1 10 0 0 0 3 6 9 0 
0 0 13 5 0 3 4 5 1 0 
