10 6
2 0 1 0 4 1 4 0 3 0 
6 7 8 0 0 3 6 5 6 0 
0 2 1 0 4 0 2 2 7 2 
0 2 8 3 2 1 0 0 3 0 
0 0 0 0 0 0 0 0 2 0 
0 3 7 0 9 0 3 3 4 0 
