10 6
0 9 0 2 0 0 0 4 7 2 
0 2 2 2 6 0 1 1 6 0 
4 2 0 4 3 0 3 0 0 2 
0 0 6 2 0 0 2 0 8 0 
0 7 8 1 3 1 0 10 0 7 
2 4 4 4 3 5 1 2 6 2 
