10 6
0 0 0 2 2 0 2 0 0 1 
0 0 5 4 1 1 0 8 0 2 
9 0 1 4 1 0 0 1 0 15 
6 0 2 6 1 0 0 2 8 7 
0 0 4 4 1 1 4 3 6 9 
0 0 3 6 0 3 0 1 0 8 
