10 6
3 0 9 0 5 5 5 2 0 14 
0 4 0 0 3 0 4 0 0 0 
8 4 0 3 1 4 0 0 8 0 
0 2 0 0 0 0 0 0 0 2 
4 0 7 9 5 3 5 4 1 9 
3 9 0 0 5 1 1 1 9 2 
