10 6
0 3 0 2 0 1 0 0 0 0 
0 5 8 3 1 3 4 16 1 2 
7 3 6 0 3 0 0 6 7 0 
8 5 5 0 3 0 6 7 8 0 
7 0 5 0 0 0 0 14 1 0 
0 8 0 0 0 0 0 2 2 10 
