10 6
3 0 0 3 0 0 0 0 0 2 
4 6 4 5 5 0 2 6 0 5 
11 0 2 6 5 4 3 0 4 9 
7 5 0 0 0 1 6 6 2 5 
0 0 0 0 0 4 0 0 1 4 
0 0 6 0 0 1 4 2 4 1 
