10 6
0 5 3 0 2 0 5 3 6 3 
4 0 2 2 6 2 3 4 4 3 
0 0 1 1 6 0 3 0 4 0 
0 0 2 0 3 0 0 0 0 7 
4 3 1 1 7 0 0 0 4 0 
8 4 1 6 4 6 2 4 17 0 
