8 5
0 0 0 1 0 1 1 0 
0 0 1 3 0 2 3 0 
0 0 0 0 0 0 0 0 
0 0 0 0 0 0 0 0 
7 0 0 0 0 0 0 7 
