12 7
0 3 0 0 9 1 6 0 0 0 0 3 
0 0 3 0 0 13 8 0 3 0 4 6 
0 0 0 0 0 2 2 0 0 3 0 0 
0 0 0 0 0 0 2 0 0 0 2 3 
5 0 0 0 5 2 6 0 0 5 0 0 
0 0 0 3 0 9 5 0 5 1 2 6 
0 0 0 0 3 6 10 2 0 4 0 0 
