12 7
9 0 4 0 0 0 10 1 0 5 0 0 
0 6 0 0 0 6 0 0 0 3 0 4 
8 17 0 0 0 0 0 4 15 0 0 10 
3 0 0 0 0 6 0 2 0 7 0 0 
0 0 0 0 0 0 4 0 0 1 0 0 
0 13 0 0 0 0 0 0 1 2 9 3 
12 7 0 0 3 6 6 1 9 6 0 3 
