12 7
8 2 0 0 1 1 0 0 3 0 0 2 
0 1 0 0 0 0 0 0 0 0 0 0 
6 7 0 0 0 5 0 0 0 8 0 0 
1 1 0 0 0 0 2 1 2 0 0 3 
6 0 0 0 0 0 0 8 0 0 1 0 
11 1 0 4 0 0 5 1 9 1 6 16 
1 0 1 12 0 0 3 0 0 9 6 1 
