12 7
0 4 0 5 4 7 0 0 8 0 0 0 
0 0 1 7 0 1 0 2 0 0 2 0 
7 0 1 0 0 2 1 7 2 0 5 0 
0 0 0 0 6 1 1 0 0 1 9 1 
30 9 0 1 2 0 0 0 1 6 19 11 
0 3 0 0 3 1 0 0 5 0 2 0 
0 0 0 0 4 1 0 0 2 0 5 0 
