12 7
0 0 5 3 0 0 0 6 0 2 7 0 
0 0 0 0 0 0 0 1 0 2 0 0 
0 0 5 0 3 0 0 2 0 4 3 0 
3 0 0 0 0 0 0 0 0 0 0 0 
2 10 0 1 0 0 3 1 0 8 0 0 
0 0 0 1 1 6 0 3 0 3 0 8 
14 6 5 3 6 0 1 2 2 14 0 0 
