12 7
0 0 4 0 4 0 0 0 10 0 1 6 
8 0 4 5 0 0 0 0 15 5 0 9 
0 3 2 0 3 0 0 0 0 0 0 0 
0 0 0 2 0 3 0 0 1 0 0 0 
10 1 6 2 6 0 1 6 15 0 6 5 
10 0 0 7 0 2 0 0 0 0 3 5 
0 0 12 8 0 0 4 0 6 1 8 9 
