12 7
0 13 0 0 0 0 0 0 5 8 7 3 
0 12 0 0 6 0 0 0 0 0 3 0 
0 2 0 0 0 0 0 0 0 0 0 3 
0 0 1 1 0 0 0 0 0 0 0 0 
0 1 7 0 0 0 3 0 0 15 0 2 
11 7 1 1 1 9 1 2 5 10 2 8 
9 11 0 0 0 4 6 0 10 9 4 5 
