12 7
1 10 0 5 1 1 0 0 0 0 0 14 
1 9 4 2 0 4 0 0 0 0 9 6 
0 0 0 10 0 0 3 0 0 0 7 0 
0 0 1 1 0 0 0 1 0 0 0 1 
1 7 0 0 0 4 4 3 2 1 1 3 
5 4 3 2 0 4 0 4 0 7 0 9 
0 0 1 0 0 0 0 0 0 0 0 0 
