12 7
0 0 0 5 0 0 0 0 0 0 0 0 
0 0 5 4 0 0 0 0 1 0 0 0 
2 1 0 0 1 11 1 8 7 1 1 7 
1 10 0 1 0 1 0 0 0 7 0 0 
0 1 0 2 0 0 0 0 0 0 7 8 
4 3 0 2 0 0 0 0 0 2 0 0 
2 3 2 0 4 3 0 3 6 5 0 0 
