12 7
0 0 0 0 6 0 0 0 0 0 0 7 
0 0 0 0 0 0 0 0 0 0 0 0 
7 0 0 2 2 2 0 0 8 0 3 0 
9 2 8 0 4 0 0 0 0 7 4 0 
7 12 2 2 1 7 2 0 0 17 0 0 
0 2 1 1 10 6 0 1 7 7 9 6 
2 0 7 1 7 1 0 0 6 4 5 0 
