12 7
0 0 0 0 4 1 0 3 0 2 0 2 
0 0 4 4 0 0 4 4 2 4 0 0 
6 9 0 2 0 2 7 1 0 0 9 0 
3 17 1 1 6 0 0 9 2 2 0 14 
0 4 5 2 1 0 5 4 6 0 11 1 
0 0 0 0 3 0 0 0 0 4 6 2 
3 8 2 0 0 0 2 1 0 11 2 0 
