12 7
0 0 2 0 1 0 1 6 4 0 3 0 
0 5 0 0 1 4 5 0 0 0 5 0 
0 0 4 3 4 1 0 0 0 0 0 0 
0 0 2 0 2 0 2 0 4 1 1 3 
0 0 1 0 3 0 2 2 2 0 0 0 
10 5 4 3 6 4 6 4 0 10 6 9 
1 0 2 2 5 2 1 0 0 0 0 0 
