12 7
0 2 5 0 3 0 0 0 0 7 0 5 
2 0 1 8 11 0 1 1 3 0 1 2 
0 5 2 8 2 0 3 4 0 5 0 3 
8 0 0 1 1 0 6 0 0 1 0 0 
0 4 7 0 0 0 0 0 0 10 0 0 
0 0 0 0 6 2 0 2 0 0 5 1 
11 6 0 0 0 0 5 5 0 0 1 16 
