12 7
0 3 1 0 0 0 1 1 0 0 6 5 
3 7 4 1 2 4 2 0 11 0 0 3 
0 0 2 0 0 0 0 0 1 0 0 3 
14 0 2 0 0 3 0 0 0 3 3 11 
0 5 6 0 0 0 0 0 0 0 1 0 
0 1 7 3 5 4 0 2 0 10 0 2 
13 8 1 9 0 3 5 0 2 8 17 8 
