12 7
0 7 0 3 0 0 2 1 13 0 4 0 
0 9 0 0 0 4 0 0 0 0 7 0 
1 1 0 0 0 1 0 0 1 0 2 0 
0 4 3 2 4 7 7 2 3 1 4 6 
0 0 8 14 0 10 0 0 0 3 20 5 
0 0 9 0 0 0 5 2 5 0 0 5 
0 0 0 16 4 1 0 3 5 6 0 0 
