12 7
0 0 3 0 1 2 0 0 2 0 1 1 
0 0 2 0 6 3 0 0 3 0 6 0 
0 2 9 0 10 4 4 3 5 0 19 3 
0 2 1 10 0 13 0 1 0 4 6 8 
0 0 0 0 0 2 0 0 0 0 0 0 
0 7 2 7 10 1 0 0 11 0 2 0 
0 0 0 0 1 3 4 4 1 0 9 4 
