12 7
1 0 7 0 5 0 0 0 2 2 6 1 
12 10 14 13 0 0 0 4 0 6 0 13 
0 12 9 3 0 4 0 6 0 0 8 0 
0 1 6 1 10 3 3 0 0 0 0 2 
0 0 5 3 0 3 0 5 5 0 4 8 
0 0 0 9 0 0 0 1 3 0 0 7 
4 0 0 1 1 0 3 0 0 0 0 0 
