12 7
7 8 5 0 3 3 7 3 1 2 0 0 
0 0 1 0 2 0 0 0 0 0 0 0 
2 5 6 0 3 6 2 0 0 7 0 0 
10 14 8 3 4 5 7 2 6 3 2 15 
0 0 0 0 0 2 0 0 0 0 0 1 
5 0 2 1 5 0 0 0 1 1 0 8 
4 0 8 0 0 0 4 3 0 1 6 0 
