12 7
4 0 4 4 0 4 1 5 0 6 0 0 
0 7 5 0 0 5 3 6 5 0 0 1 
9 0 0 0 1 0 0 0 1 10 0 0 
0 0 7 0 6 2 2 0 2 2 0 2 
6 2 1 7 1 3 0 0 7 0 0 1 
11 11 0 1 5 8 1 5 3 5 4 14 
0 0 0 2 0 0 0 0 0 0 0 0 
