12 7
0 0 0 0 2 0 1 5 0 2 0 0 
0 0 0 0 3 0 0 3 0 0 2 5 
9 3 10 5 3 1 5 2 4 10 18 3 
0 0 0 0 0 1 0 0 0 0 2 0 
0 2 2 6 1 0 2 4 0 6 2 1 
0 0 0 0 6 5 5 0 0 1 5 12 
9 12 0 2 1 2 4 0 0 6 1 20 
