12 7
0 6 0 18 3 11 3 5 3 3 3 6 
0 14 0 4 0 2 1 4 0 1 0 10 
0 10 0 0 0 0 0 0 4 0 0 0 
0 7 0 0 1 5 0 3 0 3 0 0 
0 6 3 9 4 1 1 6 3 8 7 8 
0 12 3 0 0 2 0 0 3 0 0 0 
0 3 0 6 0 0 1 6 0 0 0 0 
