12 7
0 2 0 3 5 6 0 5 3 0 4 10 
2 0 0 0 1 0 0 0 0 0 0 0 
10 2 4 0 3 2 0 4 12 1 18 2 
3 5 0 0 3 9 0 2 0 3 0 0 
3 1 0 1 3 0 3 7 2 5 4 2 
0 0 0 0 0 6 0 1 3 0 0 6 
0 0 3 7 9 0 0 4 4 3 1 0 
