12 7
2 1 11 0 0 6 1 1 0 5 8 0 
10 11 3 0 7 1 11 1 0 2 10 4 
0 0 5 0 1 4 5 1 1 0 0 9 
0 5 1 3 7 2 3 2 2 2 0 8 
0 0 0 0 2 1 0 0 0 0 0 1 
9 0 0 0 1 7 0 0 0 14 0 0 
9 8 0 0 8 1 4 3 0 9 0 5 
