12 7
7 0 13 9 5 2 1 1 0 3 3 20 
0 3 0 1 5 0 0 3 0 5 0 9 
0 0 0 0 1 2 0 2 2 0 0 6 
7 0 8 2 2 1 0 8 0 0 6 1 
0 0 4 2 2 2 0 3 2 1 1 1 
1 0 0 0 7 0 0 0 8 9 6 0 
0 0 5 2 0 4 0 15 0 5 0 0 
