12 7
0 0 1 0 0 0 0 0 0 0 0 0 
0 5 7 0 0 0 1 1 0 0 8 0 
0 0 3 0 0 3 1 0 0 3 0 0 
6 2 4 3 10 2 6 3 1 1 0 15 
10 1 0 6 0 4 0 2 0 3 0 11 
19 2 1 8 7 8 6 3 1 5 0 3 
2 0 0 0 0 3 1 1 1 3 0 1 
