12 7
0 9 0 1 5 0 0 0 0 1 2 10 
4 7 0 7 4 2 2 6 6 4 0 0 
9 0 0 3 0 4 0 0 0 6 2 5 
7 8 2 3 2 2 4 2 7 6 9 1 
0 9 0 1 1 2 0 0 0 3 16 0 
6 0 0 3 4 0 3 0 0 10 11 0 
7 0 0 0 0 0 0 7 0 1 1 1 
