12 7
5 10 1 4 7 1 0 0 0 14 0 20 
2 2 0 2 0 5 0 2 3 4 4 2 
2 0 0 1 0 0 0 4 0 0 0 1 
2 0 1 1 0 0 0 0 0 2 1 4 
0 0 7 2 0 3 0 4 6 0 0 1 
9 0 10 1 1 1 4 0 0 3 5 5 
6 4 0 2 6 2 3 3 0 1 5 13 
