12 7
7 0 0 6 4 1 6 6 2 11 3 3 
10 3 6 0 3 5 5 4 5 0 5 12 
0 2 0 0 0 5 0 1 3 0 2 0 
0 0 10 1 0 1 2 5 6 1 1 3 
0 9 1 0 0 4 0 0 6 4 2 0 
0 0 1 0 7 0 0 0 0 0 4 7 
0 9 0 0 6 0 3 0 2 6 17 0 
