14 8
0 0 0 9 0 0 0 0 0 0 5 0 9 3 
0 0 0 0 0 0 0 0 3 0 0 0 1 1 
9 11 0 0 0 0 0 1 0 9 3 0 11 1 
0 8 0 4 3 6 1 4 12 2 8 1 1 8 
0 0 0 0 0 0 0 7 3 0 1 0 5 0 
0 0 0 0 0 0 0 0 5 0 12 0 0 6 
13 0 2 5 1 3 0 6 3 3 9 1 8 10 
0 0 0 1 6 0 0 0 0 0 10 0 0 2 
