14 8
0 7 0 2 0 16 0 0 4 4 0 0 5 0 
6 0 0 0 3 0 0 3 0 0 0 0 0 0 
0 9 11 17 1 3 4 0 5 0 15 3 11 10 
4 0 0 4 2 2 3 0 0 6 0 0 0 0 
0 0 0 0 0 1 4 3 0 0 5 1 0 2 
0 0 0 2 8 4 13 0 0 0 0 1 5 7 
12 0 7 0 0 0 0 0 6 0 0 0 12 2 
6 0 1 2 6 21 0 3 5 4 5 0 0 0 
