14 8
0 19 0 0 4 0 5 2 2 7 9 15 0 0 
0 0 0 0 5 0 1 1 0 0 0 0 0 0 
3 0 2 0 6 0 0 5 0 0 9 2 0 0 
0 0 0 0 0 0 1 3 0 0 0 0 0 0 
0 0 0 0 0 0 0 0 2 0 1 2 0 0 
12 0 11 6 7 5 1 4 0 11 8 4 11 11 
8 10 0 9 1 6 3 0 19 4 0 18 8 0 
16 0 0 0 4 0 3 4 4 12 0 11 1 0 
