14 8
0 0 0 3 0 0 4 1 2 0 3 0 0 2 
0 0 0 0 5 2 3 0 0 2 0 0 0 1 
0 0 0 0 0 0 0 1 2 0 0 0 0 0 
0 13 1 1 0 6 0 1 0 4 9 0 0 8 
0 0 0 12 0 4 0 0 9 10 0 0 4 0 
0 0 1 12 4 0 0 0 1 0 0 5 0 0 
19 13 0 0 0 0 2 6 1 3 7 1 0 3 
0 13 9 2 7 0 6 6 0 2 3 4 0 5 
