14 8
13 0 0 6 7 0 0 0 0 0 5 7 0 13 
0 4 0 2 0 6 0 2 0 4 0 0 0 0 
0 0 20 0 0 9 5 1 1 7 2 5 15 0 
11 0 0 0 0 3 0 0 6 0 2 11 0 6 
11 2 0 2 0 1 0 0 2 9 2 0 0 1 
9 9 10 0 5 0 7 4 1 7 5 0 18 8 
2 3 0 8 2 4 0 0 0 0 0 0 0 0 
0 0 0 1 0 0 2 0 1 0 0 0 5 0 
