14 8
3 0 0 5 0 0 0 0 0 0 0 0 0 4 
0 0 5 5 0 0 0 0 0 0 7 0 0 0 
0 0 8 0 7 5 0 3 0 0 13 1 0 0 
12 0 0 0 14 0 0 0 0 14 0 5 9 0 
11 0 1 3 5 1 1 0 0 5 0 9 0 2 
3 0 6 19 5 7 2 5 2 3 9 0 1 10 
0 7 1 3 0 11 7 0 2 0 4 3 0 8 
6 0 3 0 0 0 10 5 0 0 4 0 0 0 
