14 8
11 3 1 3 8 0 0 5 0 0 4 9 7 0 
3 0 3 0 18 1 0 0 1 4 0 0 8 0 
0 11 0 5 9 0 6 0 3 1 3 0 14 0 
0 0 0 0 0 0 2 0 4 0 0 0 6 0 
0 0 1 2 2 2 0 0 0 0 4 0 0 0 
4 0 0 10 4 0 5 6 6 0 1 3 2 1 
8 0 0 4 0 8 0 0 0 0 0 0 0 5 
0 0 0 1 1 0 6 0 11 0 2 0 7 5 
