14 8
8 8 1 0 10 0 7 1 9 5 3 0 8 4 
0 0 3 2 0 10 0 0 0 0 0 0 0 4 
0 0 0 7 1 0 3 0 0 5 7 0 0 0 
0 0 0 1 5 1 1 4 1 1 12 0 0 3 
0 8 7 2 5 0 0 0 0 6 0 0 0 0 
0 0 0 11 0 0 9 0 0 4 4 0 0 10 
3 7 0 4 0 5 0 2 1 8 0 0 0 0 
0 0 0 3 4 0 3 3 3 5 2 0 6 0 
