14 8
0 0 0 2 12 4 5 0 1 12 1 3 0 0 
0 0 9 5 1 1 0 0 2 4 0 13 0 0 
0 0 0 10 8 0 3 0 0 2 2 5 15 0 
0 0 0 9 7 8 0 0 0 1 7 15 0 2 
0 8 0 3 0 0 5 0 0 1 9 5 0 0 
7 5 2 2 0 7 2 6 0 0 1 0 0 0 
0 0 0 0 0 0 0 0 5 0 1 3 1 0 
6 4 0 0 0 6 13 4 6 0 9 3 1 0 
