14 8
0 4 8 0 1 0 0 0 2 7 5 1 0 11 
0 0 8 1 1 5 2 0 0 0 3 0 8 0 
3 0 2 5 2 4 0 0 3 1 2 0 0 0 
0 0 0 0 2 0 2 3 0 0 0 0 0 0 
0 4 2 4 7 4 0 0 2 12 0 0 0 0 
0 0 0 0 6 0 0 1 0 0 0 0 0 0 
11 3 11 1 4 7 6 5 3 8 2 1 0 7 
0 0 0 0 1 0 0 0 7 10 1 0 0 0 
