14 8
0 0 7 0 0 0 10 0 0 0 2 0 0 0 
8 7 6 0 4 0 5 0 3 0 6 0 0 2 
0 0 0 0 0 0 0 5 0 0 2 0 1 0 
0 5 4 0 4 1 6 3 0 3 6 2 10 6 
0 12 10 2 0 2 6 5 0 2 0 0 2 11 
8 0 13 3 0 3 7 0 8 0 0 9 3 0 
11 0 1 1 14 4 0 4 3 7 0 7 0 9 
0 0 5 0 8 0 7 0 0 3 6 0 2 0 
