14 8
0 12 5 0 0 0 0 4 0 0 7 0 0 12 
5 2 0 1 0 6 0 1 5 0 3 0 5 10 
0 0 0 0 0 0 0 11 1 2 3 0 0 6 
9 0 11 0 0 4 0 0 3 8 2 0 1 15 
2 0 0 0 0 0 4 0 0 0 3 0 0 7 
1 5 9 0 0 0 5 0 7 0 0 12 0 0 
23 7 0 5 0 2 0 9 1 0 0 0 5 0 
15 1 0 7 0 14 2 0 5 1 15 11 4 0 
